GEOID,age_c,total_pop_c,total_white_c,total_black_c,total_hispanic_c,poverty_c,income_c,public_assistance_c,owner_c,renter_c,vehicles_c,prop_value_c,year
01001,36,49584,38636,8827,1012,13305,51463,18288,14182,4106,18288,130700,2009
01003,41,171997,146381,16851,4989,49464,48918,68497,53056,15441,68497,173100,2009
01005,37.5,29663,14251,13724,1262,7430,32537,10645,7079,3566,10645,83400,2009
01007,38.6,21464,16182,4953,190,5582,41236,7525,5915,1610,7525,81300,2009
01009,38.2,56804,50787,473,4134,14213,45406,19228,15929,3299,19228,109700,2009
01011,37.4,10917,2427,8182,252,2488,26209,3929,2762,1167,3929,65700,2009
01013,39.2,20189,11451,8328,74,5392,31938,8056,5584,2472,8056,68000,2009
01015,38.1,112969,85467,21946,2725,31366,38382,47046,33649,13397,47046,94600,2009
01017,39.6,34704,20758,12947,462,9416,32433,13672,10020,3652,13672,79200,2009
01019,43.5,24427,22441,1373,293,7564,40240,10261,8122,2139,10261,96200,2009
01021,37.1,42272,35168,4417,1978,11809,38966,16176,12380,3796,16176,102100,2009
01023,42.7,14229,7816,6195,84,4102,30749,5780,4791,989,5780,61500,2009
01025,38.9,26438,14480,11008,144,6262,27080,9259,7343,1916,9259,72400,2009
01027,41.6,13769,11077,1979,366,4228,37652,5774,4346,1428,5774,78400,2009
01029,40,14579,13444,781,142,3726,33742,5279,3977,1302,5279,88600,2009
01031,36.9,46802,34763,8424,1931,13234,41973,18850,12772,6078,18850,113500,2009
01033,40.9,54546,43830,8701,875,15737,39366,22881,16784,6097,22881,92900,2009
01035,42.5,13114,7124,5808,20,3798,27216,5401,4384,1017,5401,67800,2009
01037,43.4,10777,7144,3505,15,3112,33595,4528,3711,817,4528,68800,2009
01039,41.6,36688,30954,4586,403,10121,33278,14651,10912,3739,14651,80100,2009
01041,39.6,13687,9911,2968,145,3786,31058,5857,3802,2055,5857,70600,2009
01043,39.1,80630,75097,977,3115,22229,38394,30993,22810,8183,30993,103600,2009
01045,34.9,48233,34624,9706,1954,13531,42225,19257,11842,7415,19257,88800,2009
01047,36.7,42748,13542,28512,352,11349,26442,17077,10466,6611,17077,70300,2009
01049,37.6,68183,58249,1047,7133,18188,33634,24999,18975,6024,24999,80300,2009
01051,36.8,76714,57273,16430,1393,18898,52971,25417,19737,5680,25417,131400,2009
01053,38,37561,23390,11810,527,9797,32321,14222,10484,3738,14222,81100,2009
01055,39.3,103150,83206,14851,3021,29799,36378,42687,31052,11635,42687,95300,2009
01057,40.7,17651,15052,1999,197,5311,35754,7414,5639,1775,7414,71400,2009
01059,38.1,30847,24971,1161,4127,8854,33380,12372,8484,3888,12372,76700,2009
01061,42.1,25800,21991,2664,640,6902,31055,10410,7764,2646,10410,71500,2009
01063,41.2,9112,1827,7167,72,2354,22352,3692,2516,1176,3692,71700,2009
01065,36.5,17994,7251,10562,65,4190,29841,6263,4537,1726,6263,70900,2009
01067,41.6,16580,10948,5017,395,4430,35792,6312,5213,1099,6312,88500,2009
01069,38.2,97091,68400,24485,1920,25238,41096,36981,25411,11570,36981,111300,2009
01071,40.6,52898,47777,1861,944,14858,35073,21352,16585,4767,21352,84200,2009
01073,36.8,662212,356673,268824,20456,173053,44718,267675,178927,88748,267675,132700,2009
01075,41.2,14438,12346,1735,294,4069,31094,6145,4592,1553,6145,64100,2009
01077,39.6,88550,76798,8862,1410,24622,37691,36458,26555,9903,36458,100600,2009
01079,39.3,34094,26413,4132,577,10381,41472,13587,10783,2804,13587,92100,2009
01081,26.9,130669,93345,30173,2607,30995,38588,54137,33153,20984,54137,131000,2009
01083,38,74076,59782,9650,3028,18589,44997,26114,19932,6182,26114,115100,2009
01085,38.8,12632,3548,8923,25,3510,30270,4781,3637,1144,4781,61800,2009
01087,34,22304,3423,18329,113,4824,26305,8233,5436,2797,8233,78700,2009
01089,37.1,314047,215626,73516,8861,83006,54979,124546,87402,37144,124546,147700,2009
01091,39.3,21210,9814,11198,82,5600,30819,8551,6262,2289,8551,76500,2009
01093,41.4,29415,27303,1093,537,9041,32224,13081,9615,3466,13081,71500,2009
01095,37.4,87925,75289,1338,9346,23168,37396,33073,24119,8954,33073,98100,2009
01097,35.3,405331,245242,138513,7130,107926,40476,155657,106075,49582,155657,113200,2009
01099,38.9,22790,12891,9130,114,6633,29810,9502,6942,2560,9502,81800,2009
01101,33.8,224369,95890,118231,4255,57595,43015,89589,56488,33101,89589,116300,2009
01103,38.5,115197,92073,13159,6691,32183,42913,46200,33667,12533,46200,109800,2009
01105,36.4,10689,3249,7301,69,3267,26270,4489,3001,1488,4489,60600,2009
01107,40,19528,10934,8299,194,5421,27150,8226,6013,2213,8226,73700,2009
01109,32.5,30136,17684,11132,527,7979,28065,12862,7318,5544,12862,85500,2009
01111,40.3,22504,16912,4873,396,5555,35137,7834,6151,1683,7834,85500,2009
01113,37.1,50029,26925,20206,1341,13673,32064,21500,13185,8315,21500,91300,2009
01115,37.8,77585,68212,6818,1167,19766,48425,26355,21721,4634,26355,119600,2009
01117,35.7,182996,153473,17755,6891,50611,67534,69779,56153,13626,69779,188000,2009
01119,35.6,13267,3462,9402,185,3252,20994,5334,3525,1809,5334,54900,2009
01121,38,80190,52721,25208,1109,21419,35865,30715,22136,8579,30715,84500,2009
01123,41.3,40778,29327,10434,443,11015,36637,15983,11768,4215,15983,88100,2009
01125,31.6,178754,116555,54922,3336,42365,39579,69685,42562,27123,69685,142600,2009
01127,40,68880,62476,4322,1022,19665,36708,27943,21487,6456,27943,78900,2009
01129,39.2,17212,11116,4467,34,4978,34738,6634,5692,942,6634,73600,2009
01131,35.5,12552,3414,9112,0,3059,22006,4366,3278,1088,4366,53400,2009
01133,41.2,24190,23005,30,629,6752,29818,9376,6842,2534,9376,77700,2009
02013,37.2,2959,295,291,281,215,56250,355,147,208,355,122100,2009
02016,40.8,5505,1862,560,884,332,72989,563,166,397,563,165400,2009
02020,32.2,280389,184109,15976,22723,69804,70151,103602,63156,40446,103602,255900,2009
02050,26.2,17151,2077,32,57,3147,53120,4178,2551,1627,4178,119200,2009
02060,36,682,369,0,14,190,62500,274,139,135,274,170500,2009
02068,42.9,1529,1383,34,9,299,76250,521,334,187,521,167000,2009
02070,29.6,4946,1017,11,157,1007,60466,1443,874,569,1443,171900,2009
02090,29.1,96843,71482,5416,6186,21962,65121,32211,19095,13116,32211,198200,2009
02100,47.6,2424,2029,10,78,765,44284,1187,852,335,1187,186300,2009
02105,43.3,2042,851,0,84,619,43208,976,719,257,976,169000,2009
02110,37.6,30777,21480,197,1479,7716,76437,11848,7552,4296,11848,284000,2009
02122,39.7,53052,44582,295,1570,12835,55966,19603,14280,5323,19603,183000,2009
02130,38.2,13132,9103,16,489,3809,57500,5962,3632,2330,5962,209600,2009
02150,32.5,13147,7159,100,1088,3201,59655,4605,2555,2050,4605,173800,2009
02164,24.8,1399,433,9,24,315,41458,465,303,162,465,169600,2009
02170,34.1,82099,69095,767,2941,16105,66052,21956,17535,4421,21956,205000,2009
02180,27.1,9339,1635,200,157,1706,55766,2580,1449,1131,2580,129500,2009
02185,26,6716,864,73,154,1478,66556,2049,861,1188,2049,143400,2009
02188,25.3,7430,895,8,54,1327,57885,1738,899,839,1738,132100,2009
02195,42.6,3862,2754,0,3,1071,61115,1650,1298,352,1650,181700,2009
02198,37.9,5572,2863,0,159,1576,45889,2319,1607,712,2319,144000,2009
02220,38.5,8811,5658,94,431,2339,58895,3516,1932,1584,3516,317600,2009
02230,38.2,1071,906,20,36,245,71295,379,245,134,379,259800,2009
02240,33.7,6760,5223,168,287,1508,59407,2228,1514,714,2228,159300,2009
02261,38.7,9529,6747,40,103,2440,55952,3666,2630,1036,3666,163700,2009
02270,21.9,7577,436,0,25,1302,36712,1659,1039,620,1659,70300,2009
02275,38.7,2168,1423,30,50,658,49508,961,755,206,961,167200,2009
02282,37.6,418,174,0,7,116,66250,166,109,57,166,151700,2009
02290,33.9,5813,1425,0,131,1232,33716,2119,1444,675,2119,89900,2009
04001,30.2,69341,13466,195,4136,13307,28378,18847,14399,4448,18847,83400,2009
04003,40.4,127613,75455,5046,40211,32932,43304,48412,33923,14489,48412,148900,2009
04005,30.2,127312,69207,1415,15889,29024,48259,44315,26999,17316,44315,254700,2009
04007,46.5,51850,34729,119,8753,12290,36930,19079,14845,4234,19079,151200,2009
04009,32,34780,18793,795,9646,8401,40889,11044,7844,3200,11044,109300,2009
04011,36.5,7723,3863,9,3544,2079,45476,2910,1462,1448,2910,64800,2009
04012,50.4,20055,12495,195,4796,6228,31640,9530,7099,2431,9530,97700,2009
04013,33.3,3855521,2276082,160225,1178943,885412,55223,1338468,900296,438172,1338468,243300,2009
04015,45.2,192988,155155,1387,26447,50811,40157,75262,53974,21288,75262,179300,2009
04017,32.8,110458,46651,1187,10676,25758,38197,34623,25449,9174,34623,123700,2009
04019,36.8,990213,566377,30950,324836,231285,45885,370264,244175,126089,370264,196900,2009
04021,35.3,296113,172322,10020,88387,78383,49301,108345,83824,24521,108345,169700,2009
04023,34.7,42550,7944,50,33986,8680,37204,11075,8299,2776,11075,146500,2009
04025,47.7,209365,173488,1265,26417,54517,43965,85707,63124,22583,85707,232700,2009
04027,34.7,188983,74026,3447,105211,53437,38854,70289,49606,20683,70289,132300,2009
05001,42,19385,14078,4718,261,5462,36341,8388,5406,2982,8388,74200,2009
05003,38.7,22337,15026,5885,1004,6711,33007,9444,6512,2932,9444,60800,2009
05005,49.7,41468,39908,98,568,11781,34534,18016,13994,4022,18016,111200,2009
05007,34.5,209931,165948,2813,29345,53752,50377,73877,52387,21490,73877,153200,2009
05009,40.6,36341,34762,141,534,9601,36839,13846,10238,3608,13846,102400,2009
05011,40,11967,7087,3395,1370,3485,26207,4922,3367,1555,4922,58200,2009
05013,41.1,5411,3939,1210,151,1582,32148,2284,1934,350,2284,46900,2009
05015,41.9,27321,22547,95,3931,7316,32978,10780,7571,3209,10780,112900,2009
05017,40.9,12279,4958,6561,538,3469,20543,5156,3152,2004,5156,49900,2009
05019,31.8,23601,16751,5184,967,5354,31409,8691,5799,2892,8691,76500,2009
05021,43.5,16045,15410,27,221,4687,29282,7163,5317,1846,7163,57400,2009
05023,45.8,25292,24213,173,438,7384,36405,10145,7985,2160,10145,103400,2009
05025,40.5,8640,7102,1225,191,2442,35063,3370,2574,796,3370,63500,2009
05027,37.2,24292,14557,8861,433,6891,35258,10266,7145,3121,10266,72300,2009
05029,39.4,20619,17077,2501,644,5479,33554,8185,6302,1883,8185,78300,2009
05031,33.1,91474,76304,10036,3156,23883,39431,35159,21930,13229,35159,102800,2009
05033,36.4,58740,51657,812,3055,16106,38942,21350,15442,5908,21350,91900,2009
05035,32.9,52199,24790,25020,1088,14182,32323,20004,11474,8530,20004,100200,2009
05037,36.9,18801,13917,4561,284,5179,36036,7169,5172,1997,7169,70900,2009
05039,41.4,8214,4484,3482,227,2143,28233,3297,2350,947,3297,52900,2009
05041,38.1,13737,6474,6465,579,4007,27072,5769,3359,2410,5769,52800,2009
05043,34.8,18699,12685,5248,515,5266,32061,7704,5078,2626,7704,69200,2009
05045,30.8,104468,87924,10735,3026,26387,44600,38552,25646,12906,38552,123000,2009
05047,41.2,18037,16873,12,424,4640,30991,6800,5227,1573,6800,78900,2009
05049,46.1,11700,11248,0,122,3030,30771,4461,3533,928,4461,81700,2009
05051,44.2,96285,82073,7719,3688,24670,36454,38680,27445,11235,38680,122300,2009
05053,38.7,17544,16252,706,333,5089,51238,6558,5314,1244,6558,96200,2009
05055,37.2,40190,38395,322,680,11652,38012,16392,10910,5482,16392,85400,2009
05057,36.2,23094,12827,6710,3181,6693,35518,8949,6013,2936,8949,65200,2009
05059,39,31621,26779,3244,710,7999,36095,11660,9020,2640,11660,75200,2009
05061,39.2,14253,9462,2986,1499,4007,33180,5463,3892,1571,5463,68600,2009
05063,39.3,34462,31634,861,1028,10148,34798,14431,10567,3864,14431,80200,2009
05065,45.5,13086,12421,218,175,4084,32269,5715,4436,1279,5715,77800,2009
05067,38.6,17038,13146,3290,310,4667,28680,6862,4455,2407,6862,61000,2009
05069,36.3,79698,35114,41156,1228,19761,35265,30168,19407,10761,30168,72900,2009
05071,36.6,24576,20871,385,2757,5995,30953,8911,6287,2624,8911,77100,2009
05073,43.1,7715,4691,2899,68,2214,26491,3130,2381,749,3130,43800,2009
05075,40.3,16912,16269,44,179,4831,29119,7069,4855,2214,7069,56600,2009
05077,37.5,10776,4345,6140,128,2697,26283,4204,2639,1565,4204,52500,2009
05079,36.4,13753,8863,4407,288,3011,34876,4314,3032,1282,4314,64900,2009
05081,41.4,12921,9458,2811,182,3647,32884,5513,3915,1598,5513,73200,2009
05083,40.6,22550,20971,223,510,6336,35716,8821,6943,1878,8821,75400,2009
05085,35.3,63424,55884,4291,1712,17188,50295,23003,17002,6001,23003,115000,2009
05087,40.6,15478,14251,42,716,3872,36667,5440,4188,1252,5440,99100,2009
05089,48.3,16581,15902,0,198,4705,31772,6750,5466,1284,6750,93200,2009
05091,37.5,42971,30783,10152,918,11199,39090,16600,10766,5834,16600,86000,2009
05093,34.6,46778,28703,15712,1444,13215,32940,18639,11079,7560,18639,65600,2009
05095,43.2,8606,4975,3364,85,2479,29607,3739,2273,1466,3739,51000,2009
05097,45.3,9064,8351,0,382,2707,36095,3596,2996,600,3596,77700,2009
05099,40,9324,5934,2573,572,3067,32969,4595,3018,1577,4595,56700,2009
05101,44,8311,7974,31,38,2572,28166,3527,2804,723,3527,76200,2009
05103,42,26016,14926,10308,339,7357,30167,11019,7663,3356,11019,58100,2009
05105,40.7,10294,9658,256,167,3051,44921,4060,3250,810,4060,83800,2009
05107,34.8,22002,7870,13611,413,6201,26336,8905,4706,4199,8905,56600,2009
05109,39.7,10763,9498,417,583,3137,33024,4345,3334,1011,4345,72100,2009
05111,38.2,24865,22074,1826,567,6945,31894,10163,6612,3551,10163,64100,2009
05113,42.5,20140,18394,30,900,5487,33274,7879,6218,1661,7879,78700,2009
05115,35.4,58963,52644,1878,2649,15060,38511,22207,15424,6783,22207,93500,2009
05117,43.1,8776,7297,1360,26,2636,32176,3868,2657,1211,3868,69900,2009
05119,35.5,375518,217860,126579,15624,96694,44370,155631,95178,60453,155631,127000,2009
05121,41,18058,17206,184,252,5048,28427,7490,5598,1892,7490,68100,2009
05123,36,26769,11566,13366,1476,6367,27016,9729,5877,3852,9729,61300,2009
05125,38.1,95000,86427,3923,2283,26814,51082,36828,27789,9039,36828,123100,2009
05127,40.1,11170,9517,0,941,3167,33969,4375,3229,1146,4375,67900,2009
05129,45.6,8002,7664,0,48,2208,27071,3344,2575,769,3344,67300,2009
05131,36.2,121325,90829,7221,13166,31146,39131,47336,29965,17371,47336,103600,2009
05133,33.9,16516,10316,597,4864,4167,34090,5774,4419,1355,5774,71900,2009
05135,45.7,17689,16860,70,225,4614,29589,7049,5704,1345,7049,74300,2009
05137,46.6,11920,11631,0,188,3193,27167,4578,3593,985,4578,79400,2009
05139,39.8,43157,27205,14232,866,12607,35732,18098,12413,5685,18098,67200,2009
05141,45.5,16411,15559,167,279,4426,30531,6750,5168,1582,6750,75900,2009
05143,30.9,193353,150022,6066,25263,47543,43317,73521,41334,32187,73521,152100,2009
05145,35.7,73838,66825,3199,2165,19906,38417,27758,19303,8455,27758,90300,2009
05147,40.9,7677,5250,2308,12,2360,27880,3643,2118,1525,3643,53700,2009
05149,36.5,21912,16621,284,4253,5628,36398,7758,5367,2391,7758,71200,2009
06001,36.1,1457095,540164,183565,310688,331446,68863,520096,291316,228780,520096,606700,2009
06003,39.5,1153,818,0,27,265,54605,444,296,148,444,433300,2009
06005,46.3,38039,30658,830,4020,10036,57347,14364,11225,3139,14364,354500,2009
06007,36.6,217917,167499,3292,27788,51224,42002,85207,51677,33530,85207,273600,2009
06009,47.7,46548,38905,651,4565,13004,57676,18153,14493,3660,18153,370100,2009
06011,33,21001,9066,229,10663,4877,47150,6690,4354,2336,6690,290800,2009
06013,38,1015571,519549,91758,226432,256196,77838,364336,257566,106770,364336,574700,2009
06015,37.4,28729,19357,970,4630,6128,38408,9750,6280,3470,9750,246600,2009
06017,41.6,175941,142021,757,20242,47221,70765,65379,49999,15380,65379,471200,2009
06019,30.3,890750,317043,43713,428139,201585,46230,278525,154847,123678,278525,268800,2009
06021,34.5,27891,16119,193,9648,7129,40973,9558,6648,2910,9558,244800,2009
06023,36.5,129003,102040,1319,10705,30117,39124,52520,29941,22579,52520,327900,2009
06025,30.8,160034,26646,5270,121781,37138,37595,46405,26261,20144,46405,205800,2009
06027,44.5,17438,11945,36,3089,4810,44952,7801,4975,2826,7801,303500,2009
06029,30.3,780953,326391,43409,360187,177929,46216,239277,147930,91347,239277,226800,2009
06031,30,146696,55815,10971,70992,30460,46595,39263,21760,17503,39263,221300,2009
06033,43.1,64756,49152,1512,10002,16061,41182,25160,17216,7944,25160,295100,2009
06035,36.6,34428,23520,3423,5287,6962,48653,10288,6984,3304,10288,225200,2009
06037,33.8,9785295,2827681,836940,4627543,2140307,54828,3178266,1544182,1634084,3178266,521900,2009
06039,33.1,144794,59419,5642,72444,32455,46083,41972,26882,15090,41972,297000,2009
06041,43.7,246711,185063,7519,33639,61034,87728,101086,65084,36002,101086,880000,2009
06043,46.4,17865,14641,100,1810,5238,47808,7683,5160,2523,7683,287000,2009
06045,40.8,86030,61054,506,17274,21535,43404,33967,21945,12022,33967,421500,2009
06047,29.4,242235,84708,8428,126272,56977,43848,73128,41208,31920,73128,282900,2009
06049,45.5,9162,7299,176,1161,2511,34007,3773,2655,1118,3773,160100,2009
06051,38.3,12925,9100,121,2965,2778,51970,5014,3017,1997,5014,464400,2009
06053,32.5,404922,144683,12602,210808,89382,59693,125360,67457,57903,125360,608800,2009
06055,39.3,132173,79953,2464,38601,31700,68416,48094,31794,16300,48094,601800,2009
06057,46.5,97063,85207,459,7270,26779,58186,39542,30061,9481,39542,457600,2009
06059,35.3,2976831,1390222,47501,987175,689212,73738,974001,598752,375249,974001,625700,2009
06061,39.8,332059,259210,4674,39178,90471,73550,125046,92464,32582,125046,457100,2009
06063,48.7,20550,17795,183,1527,6310,44727,10050,6522,3528,10050,284900,2009
06065,33.1,2036304,865067,119210,879799,475154,58155,645185,453241,191944,645185,355800,2009
06067,34.4,1375605,717907,135479,271667,330048,56799,503437,302812,200625,503437,346900,2009
06069,33.5,54752,22445,522,28809,13395,68567,16671,11089,5582,16671,594900,2009
06071,30.7,1986635,721965,168906,925914,450648,55461,588796,384428,204368,588796,338300,2009
06073,34.5,2987543,1531102,145459,906922,689829,62901,1045259,596414,448845,1045259,516400,2009
06075,38.2,797271,355969,50660,113107,142819,70040,324185,123010,201175,324185,781500,2009
06077,32,664641,261622,46596,241865,154434,54540,207667,129882,77785,207667,355000,2009
06079,38.8,262149,192137,4957,49374,63561,55555,102663,62794,39869,102663,534300,2009
06081,38.8,701886,320697,21434,161800,171068,84426,252860,156000,96860,252860,786500,2009
06083,33.7,402025,211077,7111,155814,89441,59350,140502,76347,64155,140502,620800,2009
06085,35.5,1729378,664913,41874,444128,411525,85569,585424,350525,234899,585424,704200,2009
06087,36.7,251398,158244,2412,72956,58471,64349,93754,55956,37798,93754,675300,2009
06089,40.8,179387,149488,1759,13854,47042,44755,69471,45886,23585,69471,269800,2009
06091,48.3,3240,2782,24,380,822,53750,1403,1037,366,1403,346400,2009
06093,46.6,44404,35875,613,4303,12447,37938,19838,13302,6536,19838,236800,2009
06095,35.9,406461,179048,57337,89411,98605,67920,136906,90734,46172,136906,430700,2009
06097,39.3,464218,320039,6748,103650,113745,63848,179061,112903,66158,179061,564500,2009
06099,32.2,505165,252428,13951,196701,118902,51529,159927,101045,58882,159927,321700,2009
06101,34.2,90731,48995,1614,24487,22989,52155,30747,19532,11215,30747,279800,2009
06103,39.3,60601,44737,500,12141,15765,36949,23291,14980,8311,23291,227900,2009
06105,50.4,13922,11922,69,705,3600,35551,5759,4409,1350,5759,255200,2009
06107,29.3,416299,151281,5527,235858,96747,43164,123180,73549,49631,123180,217500,2009
06109,45.9,55761,46080,1282,5536,14197,48354,22117,15478,6639,22117,339300,2009
06111,36.1,792313,411508,13149,295566,190353,74828,257178,173991,83187,257178,593200,2009
06113,29.1,192974,103211,4391,54933,41321,56232,67500,36894,30606,67500,413900,2009
06115,30.8,70906,42914,1450,15929,17485,46410,24212,14243,9969,24212,242900,2009
08001,32,419439,236775,12319,146158,102948,55258,145749,100881,44868,145749,198600,2009
08003,31.5,15353,7790,60,6731,3725,32362,5809,3396,2413,5809,135300,2009
08005,35.5,544157,362796,49488,91419,137916,58968,212465,143390,69075,212465,233400,2009
08007,21.7,12225,9940,90,1876,2028,54909,2714,2379,335,2714,297600,2009
08009,47,3847,3362,22,358,1112,33504,1779,1422,357,1779,67300,2009
08011,39.3,6128,3549,336,1936,1432,35647,2027,1345,682,2027,68000,2009
08013,35,295524,236828,2430,38360,68396,65040,115180,75001,40179,115180,350600,2009
08014,35,52882,42555,342,5937,12736,76240,18863,14092,4771,18863,258000,2009
08015,46.3,16870,14663,256,1532,4738,42808,7432,5521,1911,7432,239900,2009
08017,45.3,1622,1498,0,104,403,46313,651,525,126,651,81700,2009
08019,43.9,8886,8079,0,499,2316,62823,4031,3265,766,4031,281900,2009
08021,39.6,8021,3393,23,4469,2275,33141,3094,2355,739,3094,102800,2009
08023,48,3282,1087,12,2046,762,23041,1306,974,332,1306,103000,2009
08025,36.4,6311,4136,504,1503,825,35494,1213,831,382,1213,79600,2009
08027,50,3598,3330,0,158,1189,44713,1821,1322,499,1821,228000,2009
08029,44.5,30353,25361,202,4035,8367,40658,11834,8878,2956,11834,186900,2009
08031,33.3,582447,296051,56316,196824,119559,45438,246770,132793,113977,246770,236700,2009
08033,43.7,1771,1640,0,63,501,41961,674,530,144,674,121100,2009
08035,35.5,269451,231152,3875,19022,73491,99522,93751,78269,15482,93751,339800,2009
08037,32.8,50614,35176,61,14036,10135,69139,16475,10822,5653,16475,490400,2009
08039,42.2,22786,20538,184,1297,6535,74345,8074,7247,827,8074,335500,2009
08041,34.5,586446,431648,34583,78295,149176,56570,221168,148870,72298,221168,211900,2009
08043,42.2,47393,38039,2166,5132,11019,37852,16963,12659,4304,16963,152200,2009
08045,34.5,52878,38780,46,12543,13390,64837,19154,12867,6287,19154,334700,2009
08047,43.1,5177,4697,94,283,1337,55455,2382,1805,577,2382,286700,2009
08049,39.9,13550,12373,48,761,3122,58981,5252,3904,1348,5252,257700,2009
08051,30.4,14924,13424,29,949,2984,44577,5777,3587,2190,5777,320800,2009
08053,34.2,554,526,0,0,117,53750,195,130,65,195,360000,2009
08055,45.7,7713,4446,160,2677,2019,31136,3394,2497,897,3394,119900,2009
08057,50.1,1305,1222,0,60,456,32788,624,453,171,624,144100,2009
08059,39.5,529025,425357,5875,71754,142976,65891,215592,156452,59140,215592,257800,2009
08061,49.2,1644,1553,0,49,507,42422,744,502,242,744,68800,2009
08063,39.3,8072,6120,217,1501,1980,40754,2978,2028,950,2978,97500,2009
08065,34.4,8025,4440,16,3374,1722,39147,3007,1895,1112,3007,171600,2009
08067,37.3,49678,40113,316,5446,13276,53713,21068,14338,6730,21068,329100,2009
08069,34.7,286978,244722,1996,28282,72011,54755,114856,77461,37395,114856,243300,2009
08071,43.1,15814,8753,95,6367,4107,37587,6405,4564,1841,6405,131200,2009
08073,42.6,5285,4244,299,567,1352,39572,2007,1375,632,2007,103300,2009
08075,38.2,20828,16884,492,2904,5454,39992,8066,5490,2576,8066,116800,2009
08077,38.1,137879,116441,812,16450,36881,50611,54811,39539,15272,54811,209400,2009
08079,59,1077,1040,0,13,341,52153,469,406,63,469,230400,2009
08081,36.2,13555,11198,0,1921,3730,53723,5375,3991,1384,5375,163900,2009
08083,41.4,25000,18796,0,2435,7170,43697,10114,7311,2803,10114,183500,2009
08085,41.3,39303,31229,126,6843,10362,44922,15640,11875,3765,15640,188600,2009
08087,36.1,27630,17694,174,9266,7048,43317,10149,7034,3115,10149,135800,2009
08089,41.3,18833,10818,85,7341,5236,32149,7747,5129,2618,7747,90300,2009
08091,45.8,4519,4178,0,271,1261,58836,1686,1206,480,1686,394900,2009
08093,44.1,16788,15313,77,939,4621,60186,6989,5997,992,6989,241300,2009
08095,40.7,4479,3382,9,1017,1149,39830,1862,1376,486,1862,96800,2009
08097,41.9,15314,13547,8,1296,3671,62318,7152,4284,2868,7152,717700,2009
08099,35.5,13206,7862,44,4982,3404,35166,5043,3440,1603,5043,76300,2009
08101,38,153814,86448,2354,60305,40157,40805,59807,41846,17961,59807,138100,2009
08103,37.2,6183,5510,3,477,1731,54812,2626,1986,640,2626,186300,2009
08105,40.3,11743,6997,23,4478,2488,39683,3660,2869,791,3660,130100,2009
08107,37.3,22356,20817,107,954,6131,64046,9732,7189,2543,9732,417100,2009
08109,38.1,6929,3468,7,3267,1711,29523,2663,1846,817,2663,112300,2009
08111,45.5,686,591,0,71,144,44336,359,196,163,359,290500,2009
08113,36.9,7385,6515,0,680,1660,60457,3053,1894,1159,3053,500800,2009
08115,48.9,2378,2108,0,215,619,37792,941,683,258,941,81900,2009
08117,33,26246,21674,153,3642,5566,67329,9858,6670,3188,9858,450700,2009
08119,45.7,21554,19471,69,1067,6514,56686,8787,7606,1181,8787,224800,2009
08121,44,4647,4132,0,455,1419,38818,2138,1479,659,2138,99900,2009
08123,32,241221,166542,1240,66073,59429,55795,83287,60117,23170,83287,198200,2009
08125,38.7,9630,7617,9,1899,2748,39945,3984,2652,1332,3984,104300,2009
09001,38.7,892843,618312,87980,133093,226816,81114,325920,232118,93802,325920,484200,2009
09003,39.2,874409,605481,103955,118714,222351,62829,339516,226890,112626,339516,242900,2009
09005,42.5,188411,173671,1956,6853,50900,69561,73704,58032,15672,73704,287200,2009
09007,41.3,164004,143912,6996,6551,43892,74965,65476,49665,15811,65476,303100,2009
09009,38.1,843532,593942,96426,108551,212204,61234,322752,212218,110534,322752,271500,2009
09011,39.3,266183,216276,13713,17576,70462,65120,104468,72449,32019,104468,263800,2009
09013,37.6,148526,131739,4104,5562,37104,76498,52993,40452,12541,52993,257600,2009
09015,38,116579,101333,1770,9576,28820,57427,42653,30363,12290,42653,226300,2009
10001,35.8,151332,104317,32571,6624,40233,52016,56740,41231,15509,56740,198100,2009
10003,36.3,527774,343102,117395,39011,130611,63160,195137,138957,56180,195137,245800,2009
10005,44.4,184726,143208,23937,12172,49256,50537,73283,58848,14435,73283,235000,2009
11001,35.4,588433,187734,321511,49813,110035,56519,250723,113066,137657,250723,440500,2009
12001,27.5,238990,159374,45732,17368,50686,39345,96518,51541,44977,96518,185500,2009
12003,34.6,25478,20973,3241,631,5914,46315,7680,5860,1820,7680,133000,2009
12005,38.3,163451,131103,18276,5869,44529,46240,68632,44450,24182,68632,178100,2009
12007,37.9,28841,21023,5806,851,5975,40519,8484,6709,1775,8484,122100,2009
12009,44,532697,424063,49382,36273,143543,49114,218885,166698,52187,218885,195800,2009
12011,38.5,1759132,843696,418303,407221,419536,51731,670472,469639,200833,670472,260500,2009
12013,37.2,13525,10359,2339,620,2926,29642,4297,3214,1083,4297,87500,2009
12015,54.6,156043,136295,7670,7503,49139,44639,72646,60037,12609,72646,193500,2009
12017,52.9,138161,124883,3808,5348,40123,37807,59189,49911,9278,59189,143900,2009
12019,37.1,179850,141608,16921,12274,49728,60352,65356,50993,14363,65356,187000,2009
12021,45.2,313165,211525,17059,78805,79961,58133,118289,90707,27582,118289,374200,2009
12023,38,67397,51301,11357,2666,15205,39078,22396,16283,6113,22396,127200,2009
12027,35.6,34890,18755,4094,11397,7728,37226,10959,8572,2387,10959,110600,2009
12029,41.6,14800,13514,1005,188,2896,31426,4014,3420,594,4014,96300,2009
12031,34.7,846385,502791,243597,51303,212487,49135,336727,212250,124477,336727,175400,2009
12033,36.6,303292,207535,64948,11053,76302,43148,117436,78816,38620,117436,146900,2009
12035,47.7,85623,67324,8239,6560,26583,47573,36718,29056,7662,36718,227200,2009
12037,43.3,10998,8886,1283,643,2986,38436,4505,2970,1535,4505,209500,2009
12039,37.6,46725,16633,25424,4083,10952,35423,16032,11673,4359,16032,96000,2009
12041,38.3,16771,14720,801,647,3847,41048,5469,4458,1011,5469,105900,2009
12043,42.2,11070,7742,935,1936,2544,39260,3705,3000,705,3705,103200,2009
12045,42.3,15714,11465,2954,586,3733,38574,5198,4087,1111,5198,152600,2009
12047,36.6,14228,7798,4968,1261,2988,35632,4173,3202,971,4173,75200,2009
12049,32.8,28684,13913,1997,11878,6725,38865,8418,6088,2330,8418,113300,2009
12051,30.6,39244,15003,4971,18451,8105,37354,10773,7543,3230,10773,116400,2009
12053,47,166338,139723,8034,14221,46542,42457,67440,57266,10174,67440,160900,2009
12055,49.7,97738,70626,8624,15834,26923,33902,40493,32321,8172,40493,121500,2009
12057,35.3,1167116,668755,180329,260297,290672,49594,455764,289368,166396,455764,200600,2009
12059,40.2,19065,16703,1027,468,4566,33868,6839,5428,1411,6839,80600,2009
12061,47.2,131811,105108,10825,12652,38928,46550,59473,45229,14244,59473,201700,2009
12063,38.7,49618,33480,12903,1811,11636,36442,17311,12818,4493,17311,97300,2009
12065,43.3,13933,8563,4582,434,3149,44011,4739,3732,1007,4739,126500,2009
12067,31.2,7981,6722,460,513,1443,46551,1918,1533,385,1918,156800,2009
12069,47.2,297828,232718,25640,29690,81659,44837,117186,95158,22028,117186,173700,2009
12071,44,573676,424111,41237,93069,162920,50362,243989,182413,61576,243989,222700,2009
12073,27.8,261023,157072,80571,11746,58876,42889,108592,58407,50185,108592,192300,2009
12075,42.9,38555,31646,3683,2131,10235,35294,14472,11226,3246,14472,106700,2009
12077,34.6,7811,6437,787,525,1326,39583,1884,1443,441,1884,105400,2009
12079,38.9,18924,10533,7176,886,4682,36682,6614,4828,1786,6614,88500,2009
12081,44.3,313011,237111,25887,40322,85788,47935,132428,97163,35265,132428,223100,2009
12083,45.6,318886,245627,35688,28181,89837,40306,131742,104207,27535,131742,149400,2009
12085,48.2,138791,113066,7669,13969,37155,52734,57933,45601,12332,57933,274600,2009
12086,37.2,2457044,443615,444667,1507621,567310,42969,827931,482841,345090,827931,277200,2009
12087,45.4,74024,54501,3890,13683,18591,54946,30831,20519,10312,30831,570500,2009
12089,41.6,67977,59077,5395,1737,19229,57907,26085,20439,5646,26085,204500,2009
12091,36.8,180955,141283,17054,10623,49785,53741,74014,48741,25273,74014,205600,2009
12093,37.3,39936,26449,3128,9128,9332,38643,12766,9874,2892,12766,134000,2009
12095,33.2,1062344,528340,201140,259505,254834,50352,391808,235367,156441,391808,233900,2009
12097,34.9,254739,116874,22825,103311,67675,46315,89725,61433,28292,89725,208600,2009
12099,42.5,1268601,806096,196241,218773,315491,53538,508520,375483,133037,508520,278500,2009
12101,42.8,453933,375430,16975,44698,119288,43690,178950,141664,37286,178950,160700,2009
12103,44.7,915003,720442,89790,62553,232289,44838,407341,286539,120802,407341,188500,2009
12105,38.7,566657,385862,75507,85372,158252,44043,224299,160904,63395,224299,139800,2009
12107,41.4,73250,53836,12013,6072,18386,33711,27993,21357,6636,27993,106700,2009
12109,41.4,174994,150610,10563,7801,46348,63630,67016,52228,14788,67016,300000,2009
12111,41.9,255984,168198,42170,37165,67833,46656,98853,76209,22644,98853,191700,2009
12113,38.2,147302,126171,7084,5764,38616,54250,50928,39678,11250,50928,183000,2009
12115,50.7,367446,317090,16056,25123,101051,49013,165707,128309,37398,165707,243000,2009
12117,37,408694,280848,41681,62145,102215,58313,151597,106575,45022,151597,243700,2009
12119,50.4,71519,55785,8629,5700,23279,41010,31659,25284,6375,31659,159200,2009
12121,41.6,39256,30794,4002,3234,9268,34157,13531,10365,3166,13531,112700,2009
12123,38,20723,15300,4380,467,5022,35900,7074,5976,1098,7074,87600,2009
12125,37.1,14574,10270,3231,623,2442,40694,3319,2284,1035,3319,110500,2009
12127,43.3,494449,380830,47985,49537,125036,43326,200018,150603,49415,200018,187200,2009
12129,38.9,30232,24812,3738,908,7630,52353,10956,9184,1772,10956,143100,2009
12131,41.6,52528,44827,3408,1857,14375,46159,21530,16062,5468,21530,214800,2009
12133,41.2,22997,17969,3062,714,5533,35090,8300,6358,1942,8300,103100,2009
13001,37.4,17871,13127,3370,1170,4703,33537,6806,5062,1744,6806,79600,2009
13003,31,8124,4713,1404,1967,1877,33548,2628,1823,805,2628,51800,2009
13005,35.8,10464,8049,1880,445,2416,31661,3578,2497,1081,3578,64500,2009
13007,29.6,3810,1585,2205,0,911,30403,1264,842,422,1264,69300,2009
13009,34.8,46252,24744,20013,681,9496,38273,15320,9644,5676,15320,105300,2009
13011,36.8,16388,14774,596,676,4337,41039,5813,4479,1334,5813,136000,2009
13013,32.7,66458,51393,7455,4768,16752,48285,22711,16757,5954,22711,139900,2009
13015,35.3,92490,75960,8864,5495,24671,50075,32836,23749,9087,32836,146300,2009
13017,36.1,17535,10262,5936,1272,4615,30078,6676,4154,2522,6676,68500,2009
13019,36.4,16814,13982,1969,543,4430,32029,6596,4474,2122,6596,78600,2009
13021,34.9,155034,70931,76766,2773,37137,38207,59044,34327,24717,59044,115200,2009
13023,36,12584,8816,3533,13,2878,37542,4251,2986,1265,4251,66900,2009
13025,37.3,15442,14269,884,142,4298,39569,5710,4864,846,5710,65900,2009
13027,38.5,16324,9424,5827,725,4588,40840,6502,4780,1722,6502,91600,2009
13029,34.9,30109,23587,4130,971,8246,63858,10616,8037,2579,10616,180800,2009
13031,24.7,66366,43847,18854,1768,14098,34723,23875,13607,10268,23875,126200,2009
13033,35.2,22807,10679,11484,422,5170,31482,7733,5387,2346,7733,72400,2009
13035,36.9,23596,16442,6405,530,5786,52760,7631,5937,1694,7631,137800,2009
13037,36.8,6113,2218,3643,241,1108,27723,1821,1301,520,1821,62600,2009
13039,30.8,47003,34738,9020,1326,12770,48967,17729,11770,5959,17729,156700,2009
13043,35.7,10380,6362,2208,1348,2404,35951,3126,2160,966,3126,77700,2009
13045,33,110641,83894,18943,5269,28103,44693,39932,27049,12883,39932,137400,2009
13047,37.4,62075,57964,1333,1182,17149,45295,23758,17906,5852,23758,126900,2009
13049,37.5,10700,7271,3082,205,2335,39734,3457,2507,950,3457,70300,2009
13051,34.2,248078,131828,99776,7400,62208,44464,98528,57994,40534,98528,169300,2009
13053,25,14364,8181,3667,1671,2028,48035,2630,757,1873,2630,78200,2009
13055,36.6,26492,22421,2901,915,6498,31550,9049,6588,2461,9049,79900,2009
13057,34.9,201233,165531,10784,17620,54898,66248,71826,57495,14331,71826,199800,2009
13059,24.5,113112,68651,28960,9839,20953,33364,42151,18814,23337,42151,160800,2009
13061,44.6,3156,908,2219,10,768,26769,1277,959,318,1277,59400,2009
13063,31,271652,58800,162349,30997,60129,44308,88071,54009,34062,88071,129700,2009
13065,35.1,7004,4642,2185,46,1772,32410,2576,1837,739,2576,63900,2009
13067,34.5,690430,414149,153753,77837,170768,66515,250395,177268,73127,250395,210000,2009
13069,34.1,40198,24920,10772,3853,10439,33119,14486,10274,4212,14486,75500,2009
13071,34.1,44633,26886,10012,6903,11810,31707,15906,9716,6190,15906,82000,2009
13073,36.6,108015,82586,15636,3560,30611,67115,38700,31858,6842,38700,163200,2009
13075,36.2,16419,10778,4742,810,4387,31521,6298,4640,1658,6298,73900,2009
13077,35.6,118531,88587,20391,6611,31895,61854,41359,31141,10218,41359,174800,2009
13079,38.6,12511,9167,2876,305,3684,35979,5086,3932,1154,5086,91500,2009
13081,35.5,22062,11324,9988,653,5846,27545,8432,4824,3608,8432,97300,2009
13083,36.8,16070,15255,107,253,4209,40081,5720,4516,1204,5720,118700,2009
13085,40,21330,19972,2,609,5859,52658,7652,5946,1706,7652,210700,2009
13087,35.7,28495,15633,11307,1170,7842,32769,11726,7429,4297,11726,96500,2009
13089,33.9,733060,224967,392717,73901,158655,51973,270124,160724,109400,270124,192200,2009
13091,36.1,19695,13160,5916,425,4251,31334,6936,4840,2096,6936,74200,2009
13093,38.7,11641,5249,5756,610,2537,30172,3790,2504,1286,3790,64300,2009
13095,32.8,95330,31414,60431,1443,23833,34597,36755,18166,18589,36755,99000,2009
13097,33.5,122657,70665,40634,7113,31115,55512,42423,29982,12441,42423,156600,2009
13099,37.8,11812,5644,6025,40,3053,28063,4433,3053,1380,4433,69600,2009
13101,30.5,4157,2519,76,1562,1072,35230,1265,862,403,1265,73300,2009
13103,34.6,50357,40946,7150,1154,13550,53883,17163,12900,4263,17163,146300,2009
13105,39,20574,13469,6136,765,5449,32213,7845,5689,2156,7845,82500,2009
13107,35.3,22620,13563,7448,1498,5748,27924,8382,5491,2891,8382,74500,2009
13109,36.3,11446,6679,3428,1147,2674,37473,4034,2823,1211,4034,81000,2009
13111,46.7,22434,21517,36,294,7527,36785,10786,8592,2194,10786,164700,2009
13113,40.9,105303,75724,19305,4408,29046,81206,36539,30854,5685,36539,250500,2009
13115,36.3,95239,72502,12539,7419,24669,41952,35073,23843,11230,35073,119000,2009
13117,35.8,157514,131235,4553,12911,43425,88040,54161,46746,7415,54161,275200,2009
13119,39.2,21701,19052,1896,414,5562,34725,7929,5800,2129,7929,106500,2009
13121,34,987148,431795,419317,80092,192621,58573,355452,206023,149429,355452,250800,2009
13123,39.5,28381,25004,0,2826,8036,34325,12091,8460,3631,12091,134100,2009
13125,38.5,2736,2359,337,10,740,34036,1036,749,287,1036,69600,2009
13127,38.7,74507,50277,18910,3546,18776,48785,29142,18650,10492,29142,172100,2009
13129,34.8,51760,41903,1844,6992,13463,40283,18653,12706,5947,18653,122600,2009
13131,36.4,24801,14979,6987,2355,6503,34025,9446,6165,3281,9446,93800,2009
13133,43.6,15629,8833,6031,579,4196,38973,5943,4589,1354,5943,120600,2009
13135,33.1,766912,397776,152088,129052,190526,65136,254515,187119,67396,254515,194300,2009
13137,35.9,41790,33905,1868,4694,10888,40412,15125,11335,3790,15125,140700,2009
13139,33,177685,115371,11360,45961,42005,51222,56272,39389,16883,56272,171100,2009
13141,38.2,9449,2188,7179,42,1669,26786,2684,2072,612,2684,72100,2009
13143,37,28559,25960,1472,338,7739,38290,10524,7637,2887,10524,109700,2009
13145,40.5,28884,22070,5317,620,8463,63368,10654,9368,1286,10654,190500,2009
13147,41.7,24088,18705,4791,378,6701,38132,9103,7034,2069,9103,122000,2009
13149,37.2,11423,9892,1159,117,2943,40640,4078,2906,1172,4078,93400,2009
13151,33.7,182952,110591,55093,8586,49163,65002,62656,51256,11400,62656,171700,2009
13153,34.1,130910,84574,35139,5249,34336,54037,50122,34072,16050,50122,128400,2009
13155,37.5,10138,7078,2545,506,2343,37328,3433,2594,839,3433,74800,2009
13157,35.8,58644,49660,4367,2770,15598,48114,20810,15448,5362,20810,153800,2009
13159,36.7,13588,9888,3067,462,3747,42242,5088,3796,1292,5088,115200,2009
13161,35.8,13312,10056,2117,1063,3715,29932,4918,3331,1587,4918,74600,2009
13163,37.4,16480,6965,9047,352,4399,29036,6459,4507,1952,6459,69400,2009
13165,40.7,8532,4905,2939,688,2039,26652,3097,2338,759,3097,70000,2009
13167,38.3,9202,5503,3565,67,2227,25789,3091,2061,1030,3091,69600,2009
13169,39,27256,20091,6427,356,7655,49337,9865,8198,1667,9865,124400,2009
13171,37.7,17010,11641,4990,276,4481,35835,6299,3987,2312,6299,109400,2009
13173,33.8,7967,5594,1911,235,2426,34497,2939,1711,1228,2939,66400,2009
13175,37,47510,29332,16472,783,11761,38247,17037,11486,5551,17037,88400,2009
13177,34.8,32861,25384,5719,604,8283,60456,10595,8194,2401,10595,135300,2009
13179,25.1,60994,28561,25033,4265,15319,40911,21027,10012,11015,21027,110100,2009
13181,43.6,8038,5231,2530,31,2320,35350,3474,2685,789,3474,99300,2009
13183,29.2,11394,7304,2802,1067,2554,41943,3525,2250,1275,3525,80800,2009
13185,29.3,102440,61131,34409,3224,26527,39200,40175,23066,17109,40175,124700,2009
13187,34.4,26417,23963,504,1191,6548,41589,9867,6932,2935,9867,159200,2009
13189,37.8,21624,12804,8187,450,6049,34897,8316,5502,2814,8316,87400,2009
13191,40.3,11268,7148,3866,108,2937,37629,4521,3355,1166,4521,98000,2009
13193,36.9,13397,4852,8094,106,2968,28382,4424,2934,1490,4424,68300,2009
13195,37.7,27735,23963,2384,836,7566,40106,9775,7325,2450,9775,128300,2009
13197,39.2,7026,3972,2339,560,1543,32432,2561,1963,598,2561,78400,2009
13199,38,22858,13068,9248,304,6196,37305,8867,6479,2388,8867,97400,2009
13201,38,6166,4245,1853,10,1758,33125,2432,1685,747,2432,78200,2009
13205,37.2,23808,11672,11176,695,5810,36344,8483,5703,2780,8483,75100,2009
13207,39,24728,17558,6345,447,7018,50579,9244,7236,2008,9244,147600,2009
13209,33,8939,6152,2285,427,2374,33970,3287,2330,957,3287,78800,2009
13211,39.4,18120,12981,4447,327,5108,44845,6699,5006,1693,6699,162300,2009
13213,34.5,40535,34760,357,4687,10400,38348,14286,10496,3790,14286,101100,2009
13215,32.5,188737,87794,84823,7770,47988,40549,72631,40792,31839,72631,126100,2009
13217,32.9,94076,56167,31403,3414,24035,52743,32281,24380,7901,32281,150000,2009
13219,37.5,31422,27075,2093,1231,8981,69959,11336,9361,1975,11336,221900,2009
13221,40.2,13927,10771,2650,392,3256,44465,4731,3791,940,4731,130100,2009
13223,32.5,125780,98633,17919,5393,35503,60138,45180,36556,8624,45180,149100,2009
13225,34.1,26019,12801,11497,1367,6271,43391,8698,5946,2752,8698,114400,2009
13227,41.2,30021,28150,679,737,8658,50145,11903,9646,2257,11903,172500,2009
13229,37.4,17830,15239,1893,587,4709,35137,6738,5070,1668,6738,75500,2009
13231,37.5,17012,14231,2123,273,5081,52579,6014,4895,1119,6014,152300,2009
13233,35.8,41414,30969,5275,4603,10524,39968,14951,10547,4404,14951,104100,2009
13235,41.3,9778,6341,3250,187,2301,32053,3601,2606,995,3601,72100,2009
13237,42.8,20145,13494,5609,923,6046,41297,8379,6299,2080,8379,163200,2009
13239,36.4,2647,1422,1177,48,671,30985,1074,800,274,1074,67200,2009
13241,43.9,16464,14646,151,1259,4537,34308,7300,5183,2117,7300,173800,2009
13243,36.5,7259,2701,4299,20,1608,28193,2494,1700,794,2494,67400,2009
13245,32.5,198079,83085,101473,5413,47692,37339,75392,43307,32085,75392,97800,2009
13247,35.7,81444,40631,29887,7669,20047,55681,27659,19645,8014,27659,167500,2009
13249,34.7,4129,2994,959,81,1024,38722,1475,940,535,1475,82700,2009
13251,38.2,15077,8158,6638,0,3627,32943,5238,4139,1099,5238,74400,2009
13253,41.2,9068,5532,3309,31,2236,35364,3287,2528,759,3287,70700,2009
13255,35.5,63073,39787,20011,1666,16216,41319,22917,14603,8314,22917,123700,2009
13257,38.9,25343,21426,2970,388,6375,34309,9247,6484,2763,9247,103400,2009
13259,39.1,4638,1381,3126,107,1145,33772,1585,971,614,1585,55700,2009
13261,33.4,32363,14622,15821,1221,7900,32245,11972,7445,4527,11972,85700,2009
13263,40.3,6496,2604,3810,0,1661,30523,2502,2011,491,2502,81200,2009
13265,41,1863,683,1115,61,478,21116,724,515,209,724,64400,2009
13267,33.6,23310,13486,6249,2796,5292,36028,7206,4784,2422,7206,77300,2009
13269,37.7,8654,4930,3559,66,2382,23458,3343,2596,747,3343,60200,2009
13271,36.8,13146,7081,4275,1565,2490,24609,4192,2674,1518,4192,59000,2009
13273,37.3,10364,3824,6262,136,2739,26723,3916,2400,1516,3916,70000,2009
13275,38.8,45275,26870,16729,1025,11563,36036,17697,11351,6346,17697,120500,2009
13277,33.7,41932,24975,11542,4586,10516,37121,14650,9464,5186,14650,102500,2009
13279,35.1,27601,17197,6615,3178,6616,30203,9923,5861,4062,9923,81500,2009
13281,49.9,10752,10429,45,198,3414,39908,4969,4199,770,4969,198200,2009
13283,37.8,6907,4489,2343,38,1607,27627,2388,1659,729,2388,67500,2009
13285,35,63414,39650,20965,1639,16229,39788,23478,14869,8609,23478,124500,2009
13287,35.9,9374,5151,3731,385,2390,30414,3395,2154,1241,3395,72000,2009
13289,38.6,10259,5797,4293,104,2096,29593,3178,2599,579,3178,63900,2009
13291,48.5,20699,19799,230,270,6480,38100,9331,7361,1970,9331,183600,2009
13293,37.8,27501,18865,7681,602,7272,33634,10585,7206,3379,10585,92000,2009
13295,38.2,64295,59468,2654,790,18274,38646,25393,18515,6878,25393,104300,2009
13297,36.2,82243,65334,12689,2502,22448,52160,28503,21053,7450,28503,162000,2009
13299,36.9,35658,24139,9864,1094,8809,33545,13435,8857,4578,13435,72100,2009
13301,43.1,5887,2440,3411,15,1605,32892,2378,1673,705,2378,61600,2009
13303,38.2,20608,9416,10766,280,4905,31178,7226,5084,2142,7226,74600,2009
13305,36.3,28954,21401,5640,1347,6760,38457,9571,6809,2762,9571,87600,2009
13307,40.1,2203,1143,752,231,608,25030,885,646,239,885,73700,2009
13309,37.6,6819,4073,2665,72,1215,35625,1780,1358,422,1780,66900,2009
13311,41.3,24702,22962,652,403,6815,42295,9677,7702,1975,9677,168500,2009
13313,33.2,92292,59280,3023,27567,22959,42783,31452,21583,9869,31452,127800,2009
13315,39,8721,5315,3128,140,1775,28863,2619,2208,411,2619,52200,2009
13317,43.5,10292,5592,4190,319,2680,32074,4063,3040,1023,4063,82300,2009
13319,37.8,10044,5724,3973,208,2546,36353,3722,2873,849,3722,72500,2009
13321,39.1,21351,14513,6216,296,5849,36707,8025,5405,2620,8025,81800,2009
15001,39.4,172370,57158,924,19716,43338,55645,63209,41550,21659,63209,366700,2009
15003,36.9,902564,191763,27643,70906,214569,67066,303794,170135,133659,303794,537800,2009
15005,63.6,78,21,0,0,8,52813,71,0,71,71,NA,2009
15007,39.9,63033,19903,363,6291,15814,63317,21968,14281,7687,21968,580500,2009
15009,37.9,142196,48935,723,13740,33006,63659,48934,28448,20486,48934,606200,2009
16001,33.9,368791,322652,3851,24278,95446,55888,141719,99280,42439,141719,207800,2009
16003,45.4,3520,3294,3,35,1154,37255,1541,1207,334,1541,192300,2009
16005,29.6,80428,70546,385,4693,20010,44162,29302,20660,8642,29302,126000,2009
16007,40.5,5859,5587,10,187,1920,44263,2409,1907,502,2409,126500,2009
16009,43.1,9246,7967,105,245,2626,38198,3668,2767,901,3668,121000,2009
16011,31.4,43635,33231,236,6812,10839,44380,13986,11257,2729,13986,120000,2009
16013,38.8,21775,17475,6,3772,5424,56601,8833,6007,2826,8833,501300,2009
16015,45.2,7467,6891,0,324,2023,49341,2879,2310,569,2879,180200,2009
16017,44.2,40878,38633,134,942,10670,42736,15461,12118,3343,15461,226500,2009
16019,31.3,96238,84024,501,9146,25265,49823,34461,25343,9118,34461,144500,2009
16021,42.1,10748,9903,0,443,2629,35473,3992,3206,786,3992,173300,2009
16023,44.6,2769,2639,0,113,843,34229,1221,953,268,1221,103200,2009
16025,41,1040,863,2,143,331,50114,403,328,75,403,209100,2009
16027,30.8,176820,131576,1116,37638,44989,42912,60438,43566,16872,60438,147500,2009
16029,38.6,6888,6441,0,352,2036,43918,2687,2046,641,2687,111300,2009
16031,33.3,21154,15725,40,4875,5614,39167,7394,5204,2190,7394,105500,2009
16033,38.1,984,544,0,408,338,38405,387,271,116,387,76300,2009
16035,47.7,8192,7538,31,218,2545,41875,3702,2822,880,3702,119300,2009
16037,44.9,4129,3954,0,78,1289,41958,1969,1604,365,1969,131400,2009
16039,28.5,28791,22046,411,4026,7473,44015,9672,6240,3432,9672,140100,2009
16041,31.6,12272,11210,0,899,3331,44753,4019,3141,878,4019,154500,2009
16043,31.8,12537,10584,0,1677,3372,43486,4368,3557,811,4368,116700,2009
16045,41.2,16355,14478,0,1368,4525,41847,6298,4987,1311,6298,159000,2009
16047,36.7,14320,10642,20,3360,3786,37732,5401,3952,1449,5401,123700,2009
16049,47,15286,14145,33,314,4245,34456,6201,4621,1580,6201,130200,2009
16051,29.8,22892,20090,16,2296,6101,50181,7322,5931,1391,7322,145300,2009
16053,33.1,20142,14410,39,5244,4915,40322,6691,4471,2220,6691,130600,2009
16055,38.1,133461,123514,395,4554,36164,45446,52146,37417,14729,52146,213000,2009
16057,26,37511,34331,305,1012,8268,36448,14200,7894,6306,14200,173200,2009
16059,47.1,7818,7364,55,239,2176,38750,3329,2536,793,3329,171400,2009
16061,47.6,3645,3284,0,64,1001,36000,1592,1126,466,1592,109700,2009
16063,33.8,4533,3364,3,1112,1249,45903,1752,1243,509,1752,116300,2009
16065,21.9,37120,34126,220,1663,7418,35511,10004,5186,4818,10004,162800,2009
16067,35.7,18800,12637,0,5588,5051,40344,6685,5207,1478,6685,96800,2009
16069,40.2,38691,34410,71,1017,10281,42919,15837,10533,5304,15837,147600,2009
16071,38.4,4148,3979,0,119,1147,43912,1571,1207,364,1571,120900,2009
16073,36.3,10995,7728,14,2739,2958,31660,4010,2883,1127,4010,127800,2009
16075,36.7,22534,18450,19,3282,6052,44480,8198,6233,1965,8198,125600,2009
16077,34.5,7689,5259,0,2106,2168,37455,2701,1934,767,2701,112600,2009
16079,45.1,12794,11960,2,317,3679,35357,5790,4179,1611,5790,134900,2009
16081,33.6,8422,6850,0,1294,2386,51125,3465,2097,1368,3465,289900,2009
16083,34.5,72578,61415,147,8908,19005,41577,27024,18463,8561,27024,139400,2009
16085,44.7,8667,8080,0,364,2706,52523,3972,2906,1066,3972,287800,2009
16087,42.1,10011,7995,11,1715,3024,35897,4026,3013,1013,4026,139800,2009
17001,40.3,66892,62870,2110,628,17940,43460,27579,20150,7429,27579,96600,2009
17003,43,8254,5206,2780,64,2228,28983,3603,2581,1022,3603,54900,2009
17005,38.4,18173,16256,1172,285,4364,47240,6310,5126,1184,6310,103000,2009
17007,35.9,52400,40025,1065,9996,12970,59202,16899,13569,3330,16899,166700,2009
17009,35.7,6593,4788,1249,435,1521,33472,2148,1545,603,2148,71800,2009
17011,41.8,34795,31712,240,2278,10047,45329,14651,11026,3625,14651,101900,2009
17013,42.9,5076,4995,6,12,1310,44016,2043,1584,459,2043,92500,2009
17015,45,15878,15094,167,374,4789,42969,6969,5321,1648,6969,94200,2009
17017,37.5,13575,10994,166,2252,3428,41083,5029,3724,1305,5029,72600,2009
17019,26.8,192135,143339,22398,7785,41649,42561,76361,42151,34210,76361,139500,2009
17021,41.3,34543,32698,493,421,9141,41195,14005,10914,3091,14005,79000,2009
17023,40.7,16778,16390,30,124,4869,43364,7032,5379,1653,7032,81700,2009
17025,41.5,13729,13318,35,140,3761,37660,5874,4491,1383,5874,69800,2009
17027,39.2,36235,33485,1319,793,9957,54313,13871,11014,2857,13871,119300,2009
17029,29.9,52144,48411,1665,1013,11905,35102,21076,12477,8599,21076,87500,2009
17031,34.7,5257001,2376862,1329785,1181767,1209994,53903,1941417,1179389,762028,1941417,267200,2009
17033,42.1,19545,17914,528,398,5323,40006,8067,6220,1847,8067,71700,2009
17035,40.3,10802,10549,33,58,3022,42215,4313,3448,865,4313,80600,2009
17037,27.2,104279,84353,5958,9555,22631,53291,36181,22729,13452,36181,190300,2009
17039,40.9,16290,15596,161,293,4444,46623,6969,5312,1657,6969,92900,2009
17041,38.1,19436,18005,101,1016,5287,47431,7596,5964,1632,7596,91900,2009
17043,37.2,925530,673948,38518,109972,238478,76355,337055,258741,78314,337055,315700,2009
17045,42.6,18750,17981,96,207,5033,38624,7899,5916,1983,7899,73100,2009
17047,43.6,6526,6401,16,0,1898,40741,2889,2254,635,2889,62000,2009
17049,38.4,34329,33230,25,458,8878,46658,13412,10575,2837,13412,103300,2009
17051,40.4,21015,20510,48,231,5729,39615,8180,6664,1516,8180,71100,2009
17053,41.1,13968,13354,221,301,3808,46141,5606,4383,1223,5606,91300,2009
17055,41.2,39301,38140,111,382,10499,33711,16100,12530,3570,16100,59100,2009
17057,41.8,36860,34416,1164,822,10031,40681,14877,11451,3426,14877,78300,2009
17059,41.9,5921,5763,47,12,1792,33954,2775,2178,597,2775,51900,2009
17061,41,13765,13439,61,85,3890,39846,5749,4465,1284,5749,71100,2009
17063,36,46513,41336,673,3578,12078,64455,16679,12934,3745,16679,187900,2009
17065,41.9,8186,7940,0,150,2431,34014,3487,2819,668,3487,65200,2009
17067,43.6,18720,18240,41,181,5502,42732,8024,6354,1670,8024,76200,2009
17069,44.2,4470,4369,15,35,1254,32083,1929,1495,434,1929,61800,2009
17071,45.2,7550,7252,21,79,2257,39536,3584,2557,1027,3584,74300,2009
17073,42.1,49523,45950,697,2023,14121,48618,20295,15671,4624,20295,103800,2009
17075,42.7,30017,27605,333,1605,8484,46762,11902,9023,2879,11902,100500,2009
17077,26.2,58526,45605,7866,1756,11898,29493,24362,12495,11867,24362,92800,2009
17079,42.4,9645,9490,28,47,2901,45252,4084,3292,792,4084,75500,2009
17081,40.1,40063,35227,3351,652,10357,40343,15790,11739,4051,15790,84500,2009
17083,39.3,22412,21680,119,225,6100,51553,8642,6821,1821,8642,110400,2009
17085,46.3,22160,21215,163,591,6851,52514,10083,7997,2086,10083,136200,2009
17087,38.3,13653,11482,1606,356,3055,45934,4329,3538,791,4329,91000,2009
17089,33.7,494371,310127,26104,136844,120044,68327,161543,125677,35866,161543,242300,2009
17091,36,111244,84445,16380,7868,27317,50911,40202,28197,12005,40202,138600,2009
17093,32.7,94070,71499,3964,14654,23863,79504,30248,26118,4130,30248,250800,2009
17095,41.3,52077,45147,3671,2046,13849,38535,21876,15131,6745,21876,79600,2009
17097,35.9,702558,474616,44992,130991,174237,78423,234840,185670,49170,234840,288600,2009
17099,40,112293,100570,874,7904,30380,50270,45094,33918,11176,45094,122500,2009
17101,38.8,16550,14663,1306,357,4154,38085,6343,4663,1680,6343,66200,2009
17103,40.9,34994,31438,1166,1469,9357,50483,13550,10132,3418,13550,113600,2009
17105,40.2,37965,34422,1863,1124,9788,49799,14606,11069,3537,14606,98900,2009
17107,37.9,29942,25675,3307,554,7110,47644,10999,8132,2867,10999,93900,2009
17109,25.6,32907,29342,1452,634,7081,32337,12889,7863,5026,12889,84100,2009
17111,36.8,312946,265197,2874,33209,80905,77314,106951,90721,16230,106951,251200,2009
17113,30.6,163686,139114,10881,5664,38881,55812,62321,42172,20149,62321,147100,2009
17115,39.7,108772,88328,15575,1429,29485,44107,46269,33028,13241,46269,88000,2009
17117,41.2,48148,46621,378,398,13424,46857,19612,15692,3920,19612,88900,2009
17119,37.9,266886,233390,21424,5748,71482,50877,107219,79678,27541,107219,117700,2009
17121,41,39488,36550,1081,465,11135,37446,16436,12095,4341,16436,68600,2009
17123,43.3,12831,12252,46,298,3424,47484,5443,4352,1091,5443,102600,2009
17125,41.8,15075,14668,16,148,4375,42687,6470,5239,1231,6470,81800,2009
17127,41,15081,13694,711,206,4246,38237,6518,5117,1401,6518,82300,2009
17129,42.4,12460,12088,208,145,3645,56821,5129,4126,1003,5129,112500,2009
17131,42.7,16440,15881,63,274,4876,51200,6714,5444,1270,6714,103200,2009
17133,39.3,32358,31359,129,421,8917,66850,11968,9773,2195,11968,188700,2009
17135,40.9,29782,27888,1026,384,7790,39514,11507,8898,2609,11507,77000,2009
17137,39.6,35300,32008,1889,579,9229,44539,14017,9841,4176,14017,90500,2009
17139,41.4,14344,13970,26,121,3955,45385,5513,4343,1170,5513,88300,2009
17141,39.3,54841,48755,418,4680,14329,55479,20217,15407,4810,20217,148800,2009
17143,36,183474,138956,30828,5177,44895,47702,74654,51136,23518,74654,113700,2009
17145,39,22542,19790,1847,582,5715,39031,8674,6838,1836,8674,73400,2009
17147,42.7,16499,16005,99,171,4736,55603,6582,5276,1306,6582,120000,2009
17149,42,16484,15929,167,131,4568,40648,6825,5330,1495,6825,75100,2009
17151,45.9,4071,3575,169,235,1258,39153,1751,1340,411,1751,85100,2009
17153,39.7,6430,4174,1968,124,1958,28775,2832,1949,883,2832,44900,2009
17155,43.8,5977,5615,46,252,1697,54528,2524,1999,525,2524,117800,2009
17157,40,32851,28751,3084,573,8296,43395,12093,9428,2665,12093,87800,2009
17159,40.9,15621,15124,100,144,4643,39068,6965,5351,1614,6965,74500,2009
17161,39.1,146670,114982,11391,15116,37590,45585,60300,43112,17188,60300,109200,2009
17163,36.2,261268,170587,75071,7129,69313,47029,102488,70199,32289,102488,116300,2009
17165,41.2,25906,23969,943,341,7395,33341,11315,8301,3014,11315,66800,2009
17167,39,194049,164553,20370,2692,51093,50733,81988,58338,23650,81988,114000,2009
17169,43.6,6917,6667,13,96,2058,42425,3040,2397,643,3040,70400,2009
17171,42.5,5238,5204,0,19,1582,48611,2352,1754,598,2352,83300,2009
17173,43,21854,21361,91,161,6245,45340,9170,7406,1764,9170,84000,2009
17175,42.6,6076,5914,6,80,1760,47795,2517,1977,540,2517,82100,2009
17177,42.3,46821,40724,3818,1047,12879,43561,19565,14420,5145,19565,103300,2009
17179,39.5,130789,124994,1163,1920,36882,54271,53154,41403,11751,53154,121800,2009
17181,42.3,18078,16912,143,656,4969,38028,7188,5512,1676,7188,83000,2009
17183,39.3,80926,66714,9283,2938,20854,39249,32744,23243,9501,32744,74500,2009
17185,41.3,12199,11786,136,122,3508,44738,5106,4057,1049,5106,73800,2009
17187,40.1,17551,15927,262,898,4537,38433,7010,5079,1931,7010,81100,2009
17189,40.9,14725,14227,135,176,4378,52527,6241,5072,1169,6241,99300,2009
17191,42.4,16505,16057,135,131,5066,37128,7458,5560,1898,7458,60600,2009
17193,43.5,14772,14284,81,137,4560,40070,6722,5290,1432,6722,58400,2009
17195,41.1,59059,51575,768,5817,15784,43719,23831,17865,5966,23831,95300,2009
17197,34.3,664361,466131,69785,93099,163803,74118,212629,180845,31784,212629,235800,2009
17199,39.6,64212,59883,2106,958,17448,39286,26269,19196,7073,26269,86700,2009
17201,37.2,295803,222546,33259,29195,73773,46882,111144,78866,32278,111144,124400,2009
17203,39.1,37950,36678,140,453,10412,63917,14038,11644,2394,14038,145700,2009
18001,34.2,33955,32306,99,1193,8967,43208,12458,9684,2774,12458,109900,2009
18003,35.1,348646,273885,39631,20625,89779,47901,136019,95724,40295,136019,108400,2009
18005,38.1,74681,66907,1274,3080,20131,52545,28546,21462,7084,28546,126100,2009
18007,40.3,8723,8128,81,367,2315,45603,3513,2728,785,3513,85200,2009
18009,41.9,13254,12869,0,124,3803,40372,5711,4471,1240,5711,77200,2009
18011,38.2,53931,50907,598,1027,15154,67322,20282,16327,3955,20282,164000,2009
18013,45,14724,14182,68,190,4425,51904,6023,5064,959,6023,158900,2009
18015,39.6,19863,18821,70,806,5817,47030,8039,6277,1762,8039,107500,2009
18017,38.2,39263,33699,624,4256,10807,43006,15576,11757,3819,15576,82500,2009
18019,37.5,105280,91893,7230,3164,28405,47011,43745,30877,12868,43745,121700,2009
18021,38.6,26682,25835,167,262,7564,43943,10424,8037,2387,10424,88500,2009
18023,36.4,34081,29070,155,4553,8647,47453,12099,8912,3187,12099,100800,2009
18025,40.1,10795,10524,126,40,2989,34883,4304,3590,714,4304,86100,2009
18027,35.5,30205,28525,74,1169,7590,42562,10906,8373,2533,10906,91600,2009
18029,39.4,49608,48068,257,412,13679,55949,18297,14389,3908,18297,157200,2009
18031,37.1,25066,24162,16,258,7138,45265,9906,6921,2985,9906,115600,2009
18033,36.8,41759,39991,27,923,11169,45792,15830,12863,2967,15830,111900,2009
18035,34.4,115548,102740,6611,1655,28388,37386,46561,30488,16073,46561,91700,2009
18037,39.1,41207,38542,51,2139,11228,53286,15755,12330,3425,15755,124700,2009
18039,33.8,197851,153686,9997,27687,51231,47840,71093,51032,20061,71093,124100,2009
18041,39.8,24313,23391,336,199,6803,38060,10111,7323,2788,10111,87500,2009
18043,38.3,73031,66258,3637,1317,20013,52242,28672,21139,7533,28672,143300,2009
18045,41.8,17075,16492,13,302,4821,43431,7154,5645,1509,7154,86600,2009
18047,39.1,23074,22831,0,166,6257,50937,8297,6745,1552,8297,133300,2009
18049,40.7,20251,18961,243,717,5979,41483,8431,6295,2136,8431,96100,2009
18051,39.8,32834,31256,807,320,8816,45426,13307,10416,2891,13307,96100,2009
18053,39.1,69203,60503,5134,2018,18473,38797,27689,19670,8019,27689,83400,2009
18055,41.4,32715,31813,9,357,9277,40252,13663,10570,3093,13663,85200,2009
18057,35.4,261328,230447,8663,7522,69052,82088,91837,72921,18916,91837,208000,2009
18059,39,65777,62132,1354,966,19569,60878,25323,20435,4888,25323,156200,2009
18061,38.8,36973,35604,132,355,10064,50544,13433,11452,1981,13433,124100,2009
18063,36.5,133949,121731,5298,2994,38392,65246,50634,41286,9348,50634,157600,2009
18065,40.4,47481,45823,710,473,13255,41816,19228,14580,4648,19228,92900,2009
18067,39.1,83685,73609,5804,1849,23964,46901,34334,24134,10200,34334,109000,2009
18069,38.7,37890,36621,12,472,10095,45490,14488,11610,2878,14488,97800,2009
18071,37.2,42131,38857,231,2217,12091,42525,17143,12245,4898,17143,108800,2009
18073,37.7,32197,30340,232,1293,9089,53369,12078,9210,2868,12078,137800,2009
18075,39,21270,20206,8,619,5629,38026,8389,6620,1769,8389,78700,2009
18077,39,32628,30824,524,495,8302,40704,12621,9156,3465,12621,104300,2009
18079,37.9,28052,26975,258,413,8367,43490,11659,8597,3062,11659,89500,2009
18081,36.4,136081,127326,2026,3016,36184,59973,50634,38161,12473,50634,142200,2009
18083,37.7,37970,36048,737,424,10340,39215,15466,10891,4575,15466,82300,2009
18085,36.8,76096,68819,451,5269,21801,49897,30418,23420,6998,30418,129200,2009
18087,31.5,36857,33699,24,1377,9903,49324,12461,10236,2225,12461,144300,2009
18089,36.9,491203,282422,123536,71324,124411,47962,184343,130525,53818,184343,129100,2009
18091,38.9,110102,91392,11338,4839,28676,47090,42080,32083,9997,42080,117800,2009
18093,40.8,45891,44262,253,494,13010,40328,18774,14721,4053,18774,95700,2009
18095,39,131015,114536,9591,3058,33555,43372,51732,38282,13450,51732,96600,2009
18097,33.7,878881,564844,217603,61402,209128,43858,358284,212007,146277,358284,121500,2009
18099,37,46605,41559,179,4023,12689,50786,17245,13452,3793,17245,120200,2009
18101,41.5,10067,9849,1,133,2838,42257,4114,3388,726,4114,82300,2009
18103,39.4,36508,33060,1570,612,9466,38872,13752,10406,3346,13752,84600,2009
18105,27,127855,112419,4137,2918,26265,38124,49382,27599,21783,49382,141600,2009
18107,38.8,37828,35567,329,1290,10146,48572,14750,10774,3976,14750,105600,2009
18109,38.7,70179,68021,350,669,19650,54926,25651,20495,5156,25651,138200,2009
18111,41.3,13974,13128,70,569,3972,53028,5563,4510,1053,5563,109300,2009
18113,35.8,47729,41663,76,5123,12961,46744,17536,13712,3824,17536,110400,2009
18115,39.8,5871,5718,38,78,1839,49661,2397,1817,580,2397,137100,2009
18117,39,19536,18887,237,190,5351,35667,7588,5820,1768,7588,89300,2009
18119,40.7,22371,21690,32,226,5996,42465,8650,7068,1582,8650,92400,2009
18121,41,17094,16126,383,154,4176,37962,6338,5239,1099,6338,89100,2009
18123,39.7,18872,18012,489,202,5022,43918,7548,5866,1682,7548,94700,2009
18125,41.3,12496,12297,23,107,3924,39685,5539,4441,1098,5539,80400,2009
18127,37.8,160073,141168,3963,10775,42751,60797,61304,47500,13804,61304,158400,2009
18129,40.8,26244,25412,239,399,7488,57775,10446,8881,1565,10446,117900,2009
18131,41.3,13739,13138,43,269,3807,46141,5203,4086,1117,5203,97100,2009
18133,36.6,36993,34448,1289,506,8980,49821,12683,9903,2780,12683,115900,2009
18135,40.5,25914,24867,48,514,7670,40993,10698,8431,2267,10698,78900,2009
18137,38.4,27378,26559,116,378,7758,47397,10694,8319,2375,10694,134400,2009
18139,39.8,17425,16835,253,151,4987,45661,6867,5201,1666,6867,106000,2009
18141,35.2,266400,207461,30839,16508,64749,44579,101237,72269,28968,101237,112500,2009
18143,38.1,23646,23021,43,296,6774,38372,9624,7316,2308,9624,95000,2009
18145,39.2,43964,41455,310,1182,12123,51448,17067,12803,4264,17067,122300,2009
18147,40.5,20167,19583,42,472,5982,51120,8363,6726,1637,8363,110800,2009
18149,40,23398,22271,100,669,6502,38729,9055,7421,1634,9055,96500,2009
18151,38.1,33544,30318,160,1003,9903,46818,14276,11085,3191,14276,120800,2009
18153,37.8,21316,20234,753,215,5444,41292,8284,6330,1954,8284,74100,2009
18155,39.3,9627,9574,0,14,2737,44246,4107,3369,738,4107,117000,2009
18157,26,162527,134769,5256,11414,35217,41842,61386,33691,27695,61386,129100,2009
18159,41.3,16055,15689,45,278,4777,50556,6853,5150,1703,6853,115900,2009
18161,38.4,7083,6919,6,79,2213,42995,3024,2363,661,3024,112000,2009
18163,36.9,174544,152714,14442,2250,44990,42579,72843,47575,25268,72843,108100,2009
18165,41.1,16301,15779,13,185,4604,42451,6676,5093,1583,6676,78200,2009
18167,35.6,105434,93099,6660,1625,25537,37509,41932,27457,14475,41932,88000,2009
18169,40.9,33004,31725,231,457,9392,43198,13426,10335,3091,13426,96900,2009
18171,41.3,8573,8403,0,13,2749,48432,3480,2737,743,3480,94800,2009
18173,39.7,57065,54163,565,673,17200,60553,22223,18824,3399,22223,137700,2009
18175,38.1,27780,27023,29,281,7489,38123,10828,8529,2299,10828,96500,2009
18177,40.1,68151,61633,3184,1402,18608,40956,27699,19495,8204,27699,99500,2009
18179,39.8,27720,26779,177,520,7579,47161,10863,8693,2170,10863,105200,2009
18181,40.9,23840,21515,27,1910,7373,43979,10032,7555,2477,10032,110300,2009
18183,38.4,32504,31467,68,391,8931,51376,13010,11045,1965,13010,122500,2009
19001,45.3,7555,7423,0,49,2192,43487,3347,2488,859,3347,92300,2009
19003,45.7,4072,3950,0,67,1190,40833,1914,1486,428,1914,73100,2009
19005,43.1,14421,13190,36,1133,3853,43904,6007,4431,1576,6007,100000,2009
19007,43.1,12975,12559,33,161,3657,32943,5766,4263,1503,5766,73500,2009
19009,45.8,6140,6022,0,97,1859,42072,2731,2185,546,2731,71300,2009
19011,39.9,26628,25968,133,218,7543,54210,10196,8280,1916,10196,125200,2009
19013,34.3,127369,109801,10082,3505,31849,42959,51366,35242,16124,51366,114400,2009
19015,40.3,26222,25460,163,323,7431,48302,10914,8006,2908,10914,112200,2009
19017,39.1,23505,22858,53,195,6836,53842,9609,7824,1785,9609,129300,2009
19019,37.8,20911,20369,88,186,5934,50360,8391,6449,1942,8391,109100,2009
19021,37.5,19573,14284,280,3975,4959,41938,7579,5308,2271,7579,85700,2009
19023,44.2,14581,14297,28,128,4223,46143,6217,4994,1223,6217,88900,2009
19025,46,9964,9555,105,134,2920,40080,4293,3398,895,4293,68100,2009
19027,43.2,20764,20235,0,285,5572,46034,8614,6303,2311,8614,104800,2009
19029,44.7,13854,13496,57,192,4114,40437,6120,4436,1684,6120,81500,2009
19031,42.3,17987,17443,0,255,5264,52197,7558,5913,1645,7558,120400,2009
19033,42.3,43927,41035,405,1415,11854,44770,19399,13915,5484,19399,106900,2009
19035,46.3,11681,11233,76,246,3277,44055,5327,4109,1218,5327,75500,2009
19037,43.6,12160,11859,9,257,3469,41838,5167,4296,871,5167,93200,2009
19039,40.1,9068,8394,3,628,2394,45684,3690,2834,856,3690,97400,2009
19041,42.5,16676,15890,17,432,4750,43757,7448,5356,2092,7448,96000,2009
19043,44.5,17667,17232,14,212,5050,45603,7615,5762,1853,7615,94600,2009
19045,40.4,49129,45929,984,898,13749,44787,20677,15496,5181,20677,99200,2009
19047,39.7,16479,13129,90,3169,4504,43502,6537,4987,1550,6537,78500,2009
19049,34.7,57115,51494,583,3584,15391,67146,21061,16627,4434,21061,174100,2009
19051,40.4,8549,8318,49,50,2290,45954,3290,2767,523,3290,88700,2009
19053,37.5,8321,7830,75,209,2156,33247,3376,2257,1119,3376,65400,2009
19055,41,17445,17147,4,182,4923,48152,7187,5870,1317,7187,104100,2009
19057,40.8,40700,37084,1453,981,11473,42193,17126,12884,4242,17126,89000,2009
19059,46.5,16616,16249,68,170,5123,49680,8079,6174,1905,8079,156500,2009
19061,38.1,92046,87337,1086,1568,24902,48012,36962,27968,8994,36962,131400,2009
19063,39.6,10357,9555,38,627,2831,43098,4329,3245,1084,4329,78000,2009
19065,42.8,20484,19677,169,376,5669,39043,8640,6740,1900,8640,80600,2009
19067,42.8,16162,15419,202,327,4236,38673,6642,4929,1713,6642,88200,2009
19069,42,10594,9175,12,1298,2682,44813,4098,2982,1116,4098,80700,2009
19071,44.9,7488,7153,33,222,2127,45197,3179,2444,735,3179,90300,2009
19073,44.7,9489,9155,6,217,2864,42354,4311,3296,1015,4311,79300,2009
19075,42.8,12166,11955,3,95,3735,53663,5197,4188,1009,5197,103600,2009
19077,44.4,11032,10668,26,225,3260,48574,4764,3693,1071,4764,95200,2009
19079,41.2,15555,14666,6,370,4399,48084,6681,5082,1599,6681,89100,2009
19081,43.8,11339,10773,17,438,3365,48634,4752,3801,951,4752,79600,2009
19083,43.2,17486,16543,173,606,4981,42397,7540,5407,2133,7540,81600,2009
19085,41.4,15410,15012,10,195,4514,48187,6385,4931,1454,6385,110300,2009
19087,39.3,20078,18563,145,403,5406,42136,8028,5860,2168,8028,94200,2009
19089,43,9488,9305,11,91,2648,44684,4049,3186,863,4049,84800,2009
19091,44.4,9645,9156,0,238,2781,46420,4327,3270,1057,4327,79300,2009
19093,44.6,6971,6807,0,82,2059,43171,3178,2286,892,3178,73800,2009
19095,41.6,15840,15425,35,230,4563,55496,6391,5034,1357,6391,122500,2009
19097,42.7,19892,19477,3,161,5698,43946,8386,6589,1797,8386,103800,2009
19099,41.1,36606,35085,412,543,10164,47432,15121,10899,4222,15121,114300,2009
19101,44.6,15496,14464,141,389,4213,39383,6846,4624,2222,6846,88400,2009
19103,27.5,125810,109334,4477,4068,26833,49413,50733,30292,20441,50733,173400,2009
19105,42.1,20365,19431,333,165,5152,47017,7641,5947,1694,7641,102000,2009
19107,43,10712,10526,7,82,3066,42196,4677,3688,989,4677,73000,2009
19109,46.2,15495,15109,29,202,4417,46176,6775,5546,1229,6775,79200,2009
19111,42.1,35772,32888,1128,966,9768,41700,14644,10753,3891,14644,76200,2009
19113,35.9,204955,185289,6621,4525,53887,52642,85576,62008,23568,85576,132600,2009
19115,38.6,11657,9582,0,1880,3150,47948,4395,3500,895,4395,85700,2009
19117,42.2,9410,9194,5,52,2384,43606,3626,2714,912,3626,80400,2009
19119,40.2,11274,11043,27,120,3208,49838,4502,3706,796,4502,94500,2009
19121,38.9,15253,14811,44,241,4399,57690,5843,4608,1235,5843,141500,2009
19123,38.9,22094,20999,229,327,6085,44713,8932,6709,2223,8932,92200,2009
19125,39.2,32650,31411,146,395,8990,52053,12656,9685,2971,12656,129100,2009
19127,40.1,39093,32180,501,5513,10412,45870,15681,11744,3937,15681,98300,2009
19129,40.8,15052,14477,28,310,3899,56450,5406,4289,1117,5406,138600,2009
19131,43.2,10790,10639,38,81,2894,48397,4186,3501,685,4186,102700,2009
19133,46.6,9118,8852,1,95,2633,38670,4339,3130,1209,4339,66400,2009
19135,43.4,7612,7418,46,16,2149,39632,3237,2514,723,3237,76000,2009
19137,43.5,10968,10523,26,271,3119,37917,4716,3514,1202,4716,79600,2009
19139,37.6,42448,35239,415,5917,11501,50188,16503,12803,3700,16503,118700,2009
19141,44.4,14062,13383,32,422,4030,43024,6035,4608,1427,6035,78600,2009
19143,41.9,6486,6229,0,221,1693,38691,2717,2058,659,2717,68600,2009
19145,43.2,15749,14710,429,370,4365,41213,6459,4749,1710,6459,82400,2009
19147,42.1,9405,9279,0,103,2422,39555,4048,2895,1153,4048,70400,2009
19149,40.7,24356,23244,47,639,7032,54226,9761,7825,1936,9761,118200,2009
19151,46.8,7574,7309,11,154,2077,41119,3470,2765,705,3470,56600,2009
19153,34.6,415949,347596,20827,26802,108796,55915,170313,120145,50168,170313,147700,2009
19155,38.3,89627,82910,922,3865,25314,49192,36644,25848,10796,36644,123300,2009
19157,41.2,18564,17623,103,328,4980,50202,7716,5816,1900,7716,110400,2009
19159,45.6,5062,4994,0,26,1508,42367,2177,1722,455,2177,82800,2009
19161,45.9,10311,9966,0,189,3159,40613,4668,3603,1065,4668,71900,2009
19163,36.9,162994,137578,10382,7842,41844,50656,65629,46652,18977,65629,129300,2009
19165,45.1,12218,11925,0,135,3460,43420,4914,3981,933,4914,98400,2009
19167,33.2,32069,29808,225,1732,8133,49272,11211,9200,2011,11211,112900,2009
19169,24.7,84780,75340,1774,1787,17326,45594,32053,17747,14306,32053,152100,2009
19171,40.9,17659,15250,72,976,5111,45691,7213,5543,1670,7213,97700,2009
19173,44.2,6434,6070,15,304,1843,37987,2798,2178,620,2798,62900,2009
19175,41.9,12076,11631,15,221,3365,42229,5328,3830,1498,5328,84600,2009
19177,42.9,7662,7476,17,22,2210,42797,3088,2413,675,3088,66600,2009
19179,39.5,35484,31950,277,2419,9695,38619,14989,11634,3355,14989,74500,2009
19181,37.9,44192,42662,185,698,12029,60609,16409,12801,3608,16409,148800,2009
19183,40.9,21152,19852,96,914,5627,50201,8338,6349,1989,8338,117800,2009
19185,45.2,6329,6199,0,0,1887,35332,2938,2263,675,2938,56300,2009
19187,38.6,38458,34833,1532,1211,10112,40772,16023,11292,4731,16023,84600,2009
19189,43.3,10835,10314,57,298,3007,39694,4671,3462,1209,4671,86900,2009
19191,39.5,20764,20137,129,222,5408,49645,7934,6074,1860,7934,143500,2009
19193,35.2,101764,81613,2380,11661,25945,44656,39106,26754,12352,39106,92000,2009
19195,43.8,7620,7355,34,154,2255,49871,3255,2633,622,3255,90800,2009
19197,44.1,13039,11739,0,1125,3687,42859,5590,4159,1431,5590,71600,2009
20001,40.7,13403,12420,230,330,3704,39328,5732,4445,1287,5732,63300,2009
20003,41.4,7900,7570,0,0,2377,40212,3115,2494,621,3115,86600,2009
20005,36,16469,14681,1037,366,4126,45146,6137,4264,1873,6137,85900,2009
20007,46.5,4714,4484,20,122,1456,38497,2301,1630,671,2301,52400,2009
20009,40.6,27654,23502,277,3250,7629,42103,11585,8402,3183,11585,65900,2009
20011,37.9,14846,13716,392,236,4026,36651,6013,4493,1520,6013,70100,2009
20013,42.7,10028,8498,142,325,2775,37066,4162,2943,1219,4162,71500,2009
20015,37.4,62878,57959,968,1790,18062,56077,23850,18610,5240,23850,116800,2009
20017,41.7,2880,2708,6,87,796,41719,1179,946,233,1179,83100,2009
20019,47.3,3826,3473,55,47,1074,35433,1659,1293,366,1659,53800,2009
20021,39.5,21295,19321,119,301,6007,36521,8824,6826,1998,8824,63300,2009
20023,49.3,2769,2624,0,59,820,30250,1368,1045,323,1368,66900,2009
20025,45.2,2133,1983,0,90,593,35701,929,715,214,929,59800,2009
20027,43.3,8662,8286,88,143,2455,39044,3687,2773,914,3687,82200,2009
20029,43.7,9367,9178,2,134,2555,33517,4120,3215,905,4120,60400,2009
20031,43.4,8472,8015,44,181,2394,47420,3356,2627,729,3356,92500,2009
20033,48.8,1850,1754,0,51,484,40781,901,661,240,901,39500,2009
20035,38.6,34055,29095,968,2081,9150,40229,13575,9411,4164,13575,75500,2009
20037,32.6,38732,34877,1013,1286,9456,34181,15917,10176,5741,15917,81500,2009
20039,50.2,2966,2847,5,38,918,34268,1526,1173,353,1526,47400,2009
20041,42.1,18976,17640,128,655,5317,45198,7639,5723,1916,7639,92500,2009
20043,38.5,7732,7148,226,130,1982,40238,3057,2286,771,3057,82200,2009
20045,26.8,113724,95411,4330,4408,23767,44835,43434,23618,19816,43434,172300,2009
20047,44.3,3118,2635,9,431,931,37682,1379,1046,333,1379,49900,2009
20049,48.1,3016,2810,0,87,893,31361,1372,1113,259,1372,53900,2009
20051,30.9,27352,25618,153,888,6573,41704,11378,6974,4404,11378,117400,2009
20053,43.7,6247,5597,201,286,1631,43418,2668,2123,545,2668,64200,2009
20055,29.6,41002,20848,477,18078,9249,48819,12269,8880,3389,12269,97900,2009
20057,30.8,32840,15896,453,15309,7885,45442,10967,7513,3454,10967,82300,2009
20059,36.9,26260,24323,238,801,7118,47767,10244,7312,2932,10244,115600,2009
20061,28.2,29951,19666,5121,2680,7502,43890,10457,5710,4747,10457,110700,2009
20063,48.5,2599,2541,0,45,842,38701,1151,890,261,1151,66400,2009
20065,46.6,2566,2360,98,32,729,40677,1287,996,291,1287,61300,2009
20067,33.6,7409,4283,0,2967,2138,55951,2775,2086,689,2775,85900,2009
20069,34.7,5885,4905,0,901,1575,48654,2014,1561,453,2014,91800,2009
20071,47.7,1183,1060,5,83,405,47156,537,425,112,537,66000,2009
20073,45.3,6912,6526,5,177,2021,36424,3172,2357,815,3172,48100,2009
20075,33.6,2583,1891,0,691,789,34478,1131,845,286,1131,71600,2009
20077,44.8,5794,5501,34,126,1769,38529,2674,1872,802,2674,61900,2009
20079,38.5,33699,28971,526,3313,9005,47344,13216,9729,3487,13216,100400,2009
20081,33,4043,2916,27,1048,1006,52649,1383,1062,321,1383,87100,2009
20083,46.4,1960,1886,0,43,601,41078,870,700,170,870,66700,2009
20085,40.3,13346,11681,160,386,3753,51650,4984,4046,938,4984,110900,2009
20087,42.1,18380,17416,69,325,5614,56593,7546,6316,1230,7546,129800,2009
20089,50.6,3175,3125,0,29,1043,37500,1574,1163,411,1574,43800,2009
20091,35.7,525108,444272,19692,30525,138097,73487,201911,146016,55895,201911,206700,2009
20093,32.4,4197,2836,15,1243,1125,40965,1529,1151,378,1529,81700,2009
20095,44.8,7789,7404,16,174,2344,44032,3400,2780,620,3400,76600,2009
20097,42.5,2646,2503,0,106,817,38750,1026,753,273,1026,70600,2009
20099,40,21881,18936,964,752,6111,37674,9144,6415,2729,9144,62100,2009
20101,44.2,1661,1556,0,41,467,40265,749,540,209,749,45900,2009
20103,36.8,73504,60880,6548,2765,18476,59515,25426,17817,7609,25426,160300,2009
20105,46.8,3249,3130,0,66,835,40123,1429,1184,245,1429,65000,2009
20107,42.7,9594,9205,10,136,2917,44363,4022,3381,641,4022,93700,2009
20109,46.2,2641,2491,42,41,783,35121,1291,951,340,1291,66500,2009
20111,31.4,35186,26264,670,6745,8589,35949,13950,8164,5786,13950,91000,2009
20113,40.5,28984,27323,182,785,8092,50501,11603,8586,3017,11603,112400,2009
20115,44.7,12239,11642,93,295,3567,42706,5067,4024,1043,5067,78400,2009
20117,45,10178,9832,76,128,2919,42328,4482,3431,1051,4482,71400,2009
20119,36.9,4438,3715,28,626,1213,45292,1702,1335,367,1702,74300,2009
20121,39,30511,28689,466,661,8843,59888,11543,9235,2308,11543,163200,2009
20123,44.8,6329,6100,12,82,1810,43537,2787,2191,596,2787,66100,2009
20125,40.9,34282,28683,1841,1179,9947,37927,14942,10735,4207,14942,64600,2009
20127,45.6,5966,5626,0,219,1737,39020,2683,2023,660,2683,72600,2009
20129,36.5,3097,2435,0,528,966,41011,1267,850,417,1267,59800,2009
20131,42.5,10118,9803,6,121,2661,46265,3896,3088,808,3896,80900,2009
20133,39.8,16153,14095,311,568,4337,36226,6431,4863,1568,6431,70100,2009
20135,48.3,2949,2747,0,152,885,42500,1342,1055,287,1342,48800,2009
20137,42.6,5456,4831,241,170,1299,34840,2180,1482,698,2180,51200,2009
20139,41.4,16386,15599,102,317,4976,47500,6766,5305,1461,6766,92900,2009
20141,47.9,3885,3806,5,26,1186,33521,1839,1397,442,1839,39700,2009
20143,43,5985,5694,36,146,1711,47350,2347,1938,409,2347,83100,2009
20145,42.3,6394,5511,331,358,1734,38725,2412,1635,777,2412,59600,2009
20147,46.5,5329,5148,16,23,1593,43750,2355,1854,501,2355,57100,2009
20149,37,19391,18136,106,579,5457,51716,7608,5924,1684,7608,124600,2009
20151,44.2,9379,8651,161,429,2586,43545,4054,2592,1462,4054,71300,2009
20153,50.4,2517,2450,0,28,778,34444,1232,901,331,1232,54800,2009
20155,39.9,63214,55547,1732,4160,16967,41365,26011,18540,7471,26011,86800,2009
20157,50.1,4922,4794,1,4,1499,36510,2322,1864,458,2322,46000,2009
20159,37.7,10152,8934,104,809,2708,43592,4084,3049,1035,4084,63200,2009
20161,23.3,69706,57185,4408,3556,13008,37225,23964,11014,12950,23964,148600,2009
20163,43.9,5131,4909,27,75,1543,38013,2343,1841,502,2343,60100,2009
20165,48.4,3203,3094,9,22,965,38263,1563,1275,288,1563,47900,2009
20167,45.3,6685,6350,35,101,1868,37000,3136,2397,739,3136,64400,2009
20169,37.7,54076,45688,1718,4215,13911,43850,21606,14735,6871,21606,108300,2009
20171,43.1,4658,4176,0,454,1458,57843,2172,1744,428,2172,91800,2009
20173,34.2,476195,350313,40861,49727,123764,47768,188977,126889,62088,188977,113600,2009
20175,29.2,22648,9205,667,11618,5372,41290,7571,4963,2608,7571,78400,2009
20177,37.9,173845,135018,14749,15649,46720,46955,73204,48941,24263,73204,112200,2009
20179,45.7,2472,2387,20,49,805,46520,1097,853,244,1097,85600,2009
20181,40.4,5915,4903,20,547,1748,40325,2624,1840,784,2624,81400,2009
20183,50.1,3926,3846,9,40,1264,38347,1830,1535,295,1830,53300,2009
20185,45.2,4380,3928,22,373,1184,37093,1939,1576,363,1939,47000,2009
20187,40.6,2152,1287,11,742,532,46875,709,512,197,709,73900,2009
20189,34,5145,3599,21,1452,1472,49966,1865,1227,638,1865,80200,2009
20191,39.5,23871,22022,148,877,6613,48848,9534,7126,2408,9534,81400,2009
20193,35.6,7420,6993,69,218,1737,41541,3091,1851,1240,3091,84100,2009
20195,48,2949,2873,0,33,890,37463,1318,1092,226,1318,71000,2009
20197,42.3,6804,6459,46,198,1977,53414,2673,2284,389,2673,94300,2009
20199,46.6,1543,1420,0,98,376,38560,627,532,95,627,52700,2009
20201,46.6,5821,5694,0,60,1592,37184,2680,2056,624,2680,52700,2009
20203,35.8,2177,1547,3,591,619,40450,873,654,219,873,66400,2009
20205,43.6,9668,9123,0,224,2902,37985,4102,3119,983,4102,55900,2009
20207,46.8,3331,3173,0,63,921,29681,1610,1200,410,1610,46700,2009
20209,33,153753,73802,39808,33809,37500,37998,58640,37291,21349,58640,95800,2009
21001,39,17872,16876,664,60,4468,29247,6717,5126,1591,6717,79100,2009
21003,37.4,18799,18125,147,219,4973,33929,7099,5416,1683,7099,85400,2009
21005,37.8,21122,20099,554,243,6105,51164,8214,6315,1899,8214,134400,2009
21007,42,8181,7670,282,63,2583,41276,3502,2928,574,3502,72600,2009
21009,39.8,40953,38120,1637,578,11601,36919,16465,11540,4925,16465,95000,2009
21011,38.4,11597,11376,115,36,2980,29054,4159,3311,848,4159,75300,2009
21013,38.6,29093,27602,945,266,7690,22559,11222,7597,3625,11222,56500,2009
21015,35,112514,102317,2795,3450,29938,65964,40722,30931,9791,40722,173800,2009
21017,39.6,19668,17256,1309,899,5627,38301,8253,5020,3233,8253,134000,2009
21019,40.6,48669,45680,1568,436,13701,39309,20359,14312,6047,20359,89600,2009
21021,38.2,28914,24874,2445,595,7347,39113,10989,7557,3432,10989,120600,2009
21023,40.8,8618,8409,91,62,2353,36967,3252,2475,777,3252,87400,2009
21025,39.4,15641,15259,196,94,3696,19329,5919,4401,1518,5919,40200,2009
21027,41.2,19057,18084,469,196,5278,37694,7309,5786,1523,7309,81100,2009
21029,37.4,73528,70874,589,783,20864,52594,27584,22847,4737,27584,140000,2009
21031,38.9,13337,12683,10,372,3812,33063,5361,4308,1053,5361,73400,2009
21033,42.5,12822,11930,517,105,3467,36929,5377,4291,1086,5377,68500,2009
21035,34.2,36036,32833,1497,633,8789,36632,14757,9721,5036,14757,98400,2009
21037,37.1,87509,82641,1724,1256,22105,51890,35185,25691,9494,35185,141300,2009
21039,42.7,5205,5123,21,61,1549,33468,2169,1796,373,2169,66400,2009
21041,37.3,10536,9612,146,487,2776,44087,4085,2675,1410,4085,113500,2009
21043,37.4,27160,26576,197,128,7528,33232,10655,8267,2388,10655,71100,2009
21045,39.5,16306,15689,18,503,4467,26079,6198,5198,1000,6198,67000,2009
21047,27.6,79626,55240,17205,4173,18637,36760,25636,14585,11051,25636,92100,2009
21049,38.4,35481,32655,1717,611,10584,45171,14673,9554,5119,14673,133500,2009
21051,37.2,23792,22484,976,167,5018,22986,7197,5701,1496,7197,50700,2009
21053,41.1,9443,9099,122,159,2763,23187,4074,2854,1220,4074,57600,2009
21055,43.2,9108,8883,50,72,2443,34554,3749,2798,951,3749,70500,2009
21057,43,6832,6459,224,75,1671,27802,2532,1988,544,2532,67900,2009
21059,38.2,93975,86077,4315,1552,26519,42268,39116,26891,12225,39116,104200,2009
21061,40.7,11941,11514,331,10,3393,34678,4720,3740,980,4720,82400,2009
21063,39,8291,7948,265,68,1721,23426,2474,1980,494,2474,63800,2009
21065,38.8,14880,14582,6,59,3995,26390,5783,4351,1432,5783,71200,2009
21067,33.4,287537,217724,38592,16948,67868,46874,118552,68640,49912,118552,155400,2009
21069,39,14604,14089,109,241,4029,30352,5552,4278,1274,5552,81000,2009
21071,38.4,41965,40466,617,327,11350,28479,16395,11970,4425,16395,63000,2009
21073,39.3,48666,41437,4906,1025,12792,48273,21150,13993,7157,21150,132700,2009
21075,42.8,6918,5010,1734,60,2157,28973,3141,1972,1169,3141,53800,2009
21077,39.1,8090,7672,116,204,1881,40700,2846,2104,742,2846,125600,2009
21079,39.2,16829,15815,427,410,4262,37112,5772,4322,1450,5772,107400,2009
21081,34.3,25088,24155,250,388,7014,42405,9073,6530,2543,9073,114900,2009
21083,39.9,37516,33282,1498,1928,10379,35107,14807,11475,3332,14807,84800,2009
21085,38.9,25320,24638,59,97,6711,33091,9648,7508,2140,9648,83600,2009
21087,43,11513,10920,298,174,3355,38333,4604,3558,1046,4604,79300,2009
21089,41.5,37517,36471,188,274,10424,40110,14725,11970,2755,14725,85600,2009
21091,38.3,8601,8302,68,103,2377,44891,3232,2701,531,3232,84200,2009
21093,35.6,98113,78985,10581,3819,27907,46098,38149,25229,12920,38149,126600,2009
21095,40,30999,29259,889,256,8427,27101,12455,8842,3613,12455,52900,2009
21097,40.2,18531,17498,491,335,4990,39928,7313,5078,2235,7313,108800,2009
21099,39,18288,16881,1107,107,4838,29743,7061,5293,1768,7061,77800,2009
21101,39,45274,40509,3307,651,13030,41315,18897,12787,6110,18897,98400,2009
21103,40.2,15842,14513,501,555,4516,43491,6265,4561,1704,6265,119600,2009
21105,43.2,4923,4271,477,48,1347,30932,2118,1765,353,2118,59200,2009
21107,40.6,46234,41934,2640,542,13179,39096,18743,13364,5379,18743,73000,2009
21109,37.4,13399,13189,0,84,3983,26360,5554,4299,1255,5554,63000,2009
21111,37.3,711317,522444,139043,22653,181995,45440,295134,193141,101993,295134,143800,2009
21113,34.6,45551,42090,1639,764,12651,48577,17030,11403,5627,17030,149900,2009
21115,37.4,23837,23226,56,61,6604,32403,8992,6440,2552,8992,71900,2009
21117,35.5,156399,142127,6984,3060,41775,53219,63276,43983,19293,63276,142700,2009
21119,40.4,17197,16743,106,153,4682,28231,6591,4852,1739,6591,54600,2009
21121,37,32326,31270,557,303,8438,21195,12616,8493,4123,12616,64000,2009
21123,41,13579,12677,516,201,3707,38970,5148,4108,1040,5148,92600,2009
21125,37,57023,55054,571,434,14873,35330,20297,15529,4768,20297,93000,2009
21127,38.2,16338,15999,7,132,4290,27002,6054,4165,1889,6054,61400,2009
21129,40.2,7427,7220,90,53,1936,19104,2824,2144,680,2824,51600,2009
21131,39.2,11674,11485,12,53,3105,24848,4804,3423,1381,4804,53100,2009
21133,39.9,23915,23397,108,134,6997,28383,9936,7468,2468,9936,46000,2009
21135,38.6,13840,13565,85,35,3834,25885,5246,4274,972,5246,52500,2009
21137,38.6,25076,23822,583,380,7376,33531,10560,7973,2587,10560,80700,2009
21139,43.3,9609,9358,74,61,2957,40913,3955,3289,666,3955,77400,2009
21141,39.5,27040,24122,1404,1172,7629,37376,10620,8002,2618,10620,84200,2009
21143,45,8325,7542,597,62,2281,39934,3241,2473,768,3241,90900,2009
21145,41.4,65059,55642,6477,904,18616,40847,28159,19347,8812,28159,102300,2009
21147,36,18199,17191,629,217,4691,22441,6400,4717,1683,6400,64100,2009
21149,40.3,9690,9367,20,148,2902,39857,3939,2987,952,3939,73200,2009
21151,32,81334,74738,2457,1142,18988,39854,29720,18236,11484,29720,136900,2009
21153,37.8,13132,12945,10,36,2965,19556,4503,3264,1239,4503,47500,2009
21155,37.6,19245,16748,1832,366,4543,37239,6735,5263,1472,6735,91800,2009
21157,43,31075,30114,169,356,9269,41892,12822,10559,2263,12822,92000,2009
21159,36.3,13300,12386,505,94,3414,22692,4767,3346,1421,4767,52500,2009
21161,40.6,17174,15475,1145,217,4739,37107,6805,4753,2052,6805,94100,2009
21163,36,27230,24775,1155,725,7143,42868,9768,6973,2795,9768,104500,2009
21165,40.1,6687,6394,44,41,1630,29224,2357,1922,435,2357,66900,2009
21167,40.1,21734,19948,939,439,6205,43969,8686,6643,2043,8686,121800,2009
21169,40.3,10115,9731,139,140,2901,35011,4064,3170,894,4064,73500,2009
21171,40.4,11650,10844,377,360,3122,28871,4678,3456,1222,4678,67400,2009
21173,37.1,25093,23625,930,375,6650,34315,9745,6763,2982,9745,99700,2009
21175,37.8,14204,13579,553,40,3034,31322,4434,3180,1254,4434,70900,2009
21177,39.7,31378,29236,1304,298,9267,35617,12979,10089,2890,12979,71900,2009
21179,36.7,42342,38844,2090,556,11663,47012,16234,12835,3399,16234,117600,2009
21181,38.7,6921,6741,88,68,1926,36389,2722,2049,673,2722,73000,2009
21183,38.6,23498,22572,190,432,6233,35587,9057,7023,2034,9057,76300,2009
21185,38.6,56194,50757,2797,1350,15664,78460,19144,16483,2661,19144,230000,2009
21187,38.5,11295,10849,195,209,3372,43481,4715,3464,1251,4715,103500,2009
21189,40.6,4648,4638,0,10,1154,18869,1678,1280,398,1678,63500,2009
21191,37,14951,14502,29,173,3846,44343,5151,4031,1120,5151,103000,2009
21193,38.1,29135,27976,428,242,7782,31151,11236,8214,3022,11236,54600,2009
21195,39.5,65524,63882,190,512,20798,32271,28922,21943,6979,28922,63600,2009
21197,40.5,13589,13220,242,54,3555,30442,5026,3557,1469,5026,78800,2009
21199,40.4,59937,57356,785,759,16273,32434,23683,17460,6223,23683,92700,2009
21201,38.3,2234,2234,0,0,483,30647,825,661,164,825,62400,2009
21203,39.4,16560,16196,108,121,4686,25643,6489,5119,1370,6489,68000,2009
21205,29.4,22549,21190,164,315,5326,30803,7956,5371,2585,7956,85900,2009
21207,40.3,17127,16591,202,246,4550,29153,6884,5439,1445,6884,79400,2009
21209,34.3,42874,38820,2148,1006,11757,59764,15416,11106,4310,15416,162000,2009
21211,37.4,40322,32781,3259,3532,10978,55748,14844,10778,4066,14844,172000,2009
21213,38.1,17001,14711,1708,35,4979,40720,7135,4933,2202,7135,110600,2009
21215,37.7,16707,15893,485,182,4552,57611,5998,5217,781,5998,168400,2009
21217,40,24103,22264,1168,330,6176,33911,9507,6468,3039,9507,88000,2009
21219,36.4,12043,10546,1036,330,3444,40177,4768,3468,1300,4768,76900,2009
21221,43.7,13231,11613,1109,144,3979,41250,5500,4515,985,5500,88600,2009
21223,38.6,8930,8599,28,149,2287,46759,3103,2438,665,3103,111400,2009
21225,34.6,15158,12535,2166,205,4006,39133,5811,4490,1321,5811,76400,2009
21227,32.8,104494,88045,9080,4220,26102,44060,40843,25550,15293,40843,132700,2009
21229,38.7,11365,10121,842,268,3117,42995,4117,3228,889,4117,99700,2009
21231,39,20575,19473,346,560,5643,26513,8073,6013,2060,8073,67200,2009
21233,40.2,13829,12398,676,653,3878,37519,5500,4310,1190,5500,63100,2009
21235,36.7,38257,37048,217,327,9507,27189,13682,9595,4087,13682,65400,2009
21237,37.9,7080,7046,0,0,1517,20960,2422,1823,599,2422,54200,2009
21239,40.1,24482,21330,1268,1400,7117,56478,9854,7105,2749,9854,170900,2009
22001,34.8,59616,46992,11013,715,15820,33882,21721,15197,6524,21721,83200,2009
22003,35.2,25528,17225,6124,1254,5962,36463,8398,5910,2488,8398,73100,2009
22005,33.7,98471,72122,20465,3959,26162,60874,34832,28403,6429,34832,157200,2009
22007,38.3,22986,15015,7202,471,6272,43003,8593,6948,1645,8593,81900,2009
22009,36.6,42184,27922,12703,508,11384,31123,15863,10669,5194,15863,79200,2009
22011,36.3,34828,28307,4511,897,9619,43441,13086,10294,2792,13086,81000,2009
22013,41,14848,8279,6104,205,3964,31741,5672,4173,1499,5672,61900,2009
22015,34,108722,76724,23017,5161,29222,49815,42533,28563,13970,42533,122900,2009
22017,35.6,252467,124317,116717,5583,61153,36536,98086,62407,35679,98086,106700,2009
22019,35.3,185017,131969,44480,3842,50014,42938,72603,51439,21164,72603,100800,2009
22021,37.9,10400,8218,1796,176,2656,39156,3866,2932,934,3866,63300,2009
22023,40.2,7588,7265,51,167,2373,57786,3214,2671,543,3214,108400,2009
22025,37.7,10424,7326,2896,113,3128,33913,4236,3190,1046,4236,64800,2009
22027,39.6,16311,8196,7859,143,4430,29345,6276,4563,1713,6276,56500,2009
22029,39.3,18979,10945,7398,361,5298,26968,7773,5343,2430,7773,71600,2009
22031,38.6,26247,15008,10098,564,6740,36867,9790,7438,2352,9790,78600,2009
22033,31.7,427820,213257,187101,11993,104139,44215,167363,102073,65290,167363,147800,2009
22035,32.6,8265,2136,6047,55,2166,21994,3104,1591,1513,3104,45400,2009
22037,39.2,20871,11163,9227,206,5139,36707,7090,5776,1314,7090,100100,2009
22039,34.6,35490,24195,10022,870,9085,33445,12729,8793,3936,12729,70600,2009
22041,38.3,19996,13402,6356,63,5424,31059,7856,5581,2275,7856,64700,2009
22043,37.4,19785,16733,2329,282,5762,39328,7743,5878,1865,7743,83300,2009
22045,34.6,74602,46675,23596,1604,18859,40803,26227,18221,8006,26227,93500,2009
22047,36.3,32677,15741,16262,410,7986,40774,11430,8456,2974,11430,89200,2009
22049,40.7,15111,10580,4149,189,4174,37536,5938,4213,1725,5938,70500,2009
22051,38.3,440134,262012,114862,40060,105572,48213,160110,105083,55027,160110,170000,2009
22053,35.7,31061,24665,5173,429,8384,39756,11909,8900,3009,11909,81400,2009
22055,33.1,204963,142782,51781,5315,52335,46526,81098,52986,28112,81098,143300,2009
22057,36.1,92852,74348,12508,2025,24735,46196,33670,25835,7835,33670,107300,2009
22059,37.7,13973,11790,1784,129,3756,33307,5169,4258,911,5169,68700,2009
22061,24.4,42801,23895,17211,805,9349,31843,15788,9210,6578,15788,104500,2009
22063,34,116476,106017,6492,2146,30023,52779,40474,32244,8230,40474,130900,2009
22065,34,11790,4215,7086,314,2810,26021,4340,2468,1872,4340,64300,2009
22067,37.7,28761,15551,12917,75,7298,31264,10716,7833,2883,10716,67500,2009
22069,30.6,38976,21651,15158,673,9493,28411,14870,8936,5934,14870,85900,2009
22071,36.7,328669,95856,205608,14289,63926,36258,113935,58276,55659,113935,174800,2009
22073,33.1,150025,92703,52113,2529,36966,38568,55679,35011,20668,55679,105900,2009
22075,36.3,22655,15521,5370,757,5774,50610,7470,5383,2087,7470,176800,2009
22077,40.4,22326,13446,8410,318,5853,37832,8761,6936,1825,8761,97500,2009
22079,36.4,132128,84456,40848,2937,33981,39456,49428,33464,15964,49428,102000,2009
22081,35.7,9117,5112,3769,112,2316,32242,3209,2493,716,3209,67600,2009
22083,37.2,20415,12432,7753,82,5585,35610,7704,5292,2412,7704,66500,2009
22085,40.2,23629,16522,3829,824,6979,34632,10028,7623,2405,10028,71100,2009
22087,35.5,38241,28912,4924,2906,9061,38478,12993,8368,4625,12993,126500,2009
22089,36.5,51410,34614,13714,1951,14343,59884,18180,14933,3247,18180,160500,2009
22091,38.2,10505,4775,5620,65,2766,29124,4272,3226,1046,4272,86200,2009
22093,37.7,21056,10370,10357,235,5802,49883,7569,6013,1556,7569,107100,2009
22095,34,47146,21186,23092,2079,11738,47574,15787,12391,3396,15787,139000,2009
22097,35.7,90983,50545,38068,1140,21886,28110,32367,22568,9799,32367,82200,2009
22099,34.9,51429,33906,15873,608,14091,39186,19429,15196,4233,19429,80800,2009
22101,36.3,51085,30925,15938,1626,14069,38269,19767,13851,5916,19767,81300,2009
22103,38.1,225533,184515,25556,8052,61214,59804,84025,67681,16344,84025,188300,2009
22105,32.6,114229,77216,32540,2522,29642,38067,42670,29383,13287,42670,123500,2009
22107,38.9,5798,2350,3372,55,1594,30572,2399,1287,1112,2399,60700,2009
22109,34.4,108277,77318,19927,2823,28409,47338,38702,28499,10203,38702,112800,2009
22111,40.4,22712,15551,6187,799,6506,35788,8785,7094,1691,8785,75900,2009
22113,36.2,55612,44513,7955,1165,15207,40785,21093,15776,5317,21093,85900,2009
22115,29,47475,33880,6382,3993,13552,40030,18590,10223,8367,18590,79900,2009
22117,37,44844,29775,13882,584,11721,30340,17124,12759,4365,17124,81400,2009
22119,39.5,40719,26062,13435,559,11735,35145,16954,11395,5559,16954,73400,2009
22121,35.2,22323,13547,7798,506,6347,46485,8698,6459,2239,8698,125200,2009
22123,39.7,11520,9032,1845,523,3154,34649,4209,3259,950,4209,65000,2009
22125,39.8,15134,7369,7120,82,3126,43348,4297,3124,1173,4297,136100,2009
22127,38.5,15531,10225,4776,190,4020,30514,5804,4406,1398,5804,59000,2009
23001,39.2,106765,92300,3712,1711,28317,43714,43490,29023,14467,43490,152700,2009
23003,43.7,71974,68562,397,838,19999,35439,30660,22123,8537,30660,82500,2009
23005,39.7,276227,256112,6300,4952,70683,54342,114142,77912,36230,114142,244900,2009
23007,40.4,29757,28857,90,237,7709,39628,11928,8884,3044,11928,122800,2009
23009,44.4,53299,51198,231,536,14322,48899,22149,16752,5397,22149,198800,2009
23011,41.5,120777,115847,706,1381,32660,46368,50736,37050,13686,50736,142200,2009
23013,44.8,40897,39683,86,414,10767,45147,16948,12747,4201,16948,206400,2009
23015,46.7,34789,33888,30,257,9623,48034,14933,12702,2231,14933,195400,2009
23017,43.3,56414,54717,255,516,15140,40055,22799,17966,4833,22799,140800,2009
23019,39.1,148501,141632,976,1486,38545,42366,61295,43234,18061,61295,126400,2009
23021,46.3,17079,16570,6,126,5126,33944,7651,5947,1704,7651,98100,2009
23023,41.2,36511,34552,385,639,9671,54986,14470,10991,3479,14470,191100,2009
23025,42.5,51175,49543,150,350,14103,36210,21198,16124,5074,21198,102400,2009
23027,42.7,38319,37157,105,317,10245,41697,15539,12465,3074,15539,145300,2009
23029,44.1,32590,30006,133,496,9079,34203,14256,10810,3446,14256,98700,2009
23031,41.5,201306,193501,1211,2388,54871,54414,80423,60503,19920,80423,232900,2009
24001,40.5,72598,65985,4429,769,17647,36810,29028,20469,8559,29028,107300,2009
24003,37.6,513711,388042,74878,22295,132917,81824,190308,144959,45349,190308,369200,2009
24005,38.4,786697,524809,190762,23676,199969,63348,310459,210355,100104,310459,259400,2009
24009,38.7,88055,70675,12237,2212,22726,90621,29734,25270,4464,29734,391400,2009
24011,37.9,32727,25717,4268,1641,8730,55844,11974,9142,2832,11974,223200,2009
24013,39.3,168964,154688,6083,3095,45026,80743,58989,49666,9323,58989,351500,2009
24015,37.7,99069,88615,5229,2296,26029,65079,35872,27055,8817,35872,254700,2009
24017,36.1,140181,75326,51637,5134,36927,86141,48971,40124,8847,48971,352000,2009
24019,42.9,31646,21564,8643,689,9041,45095,13310,9411,3899,13310,197000,2009
24021,37.5,224185,180762,17842,12566,58207,80970,81274,62627,18647,81274,355600,2009
24023,41.4,29631,28993,141,174,9009,43802,12806,9760,3046,12806,163700,2009
24025,38.3,240297,196006,27782,6406,65869,75872,90142,73293,16849,90142,293300,2009
24027,37.5,274328,177046,45155,13339,72986,101003,98994,74787,24207,98994,454800,2009
24029,44.1,19998,15806,3151,667,5382,48284,8071,5840,2231,8071,269400,2009
24031,38,946172,504617,150771,142509,236519,92213,344099,240950,103149,344099,487500,2009
24033,34.8,834986,151196,528463,103186,196499,70753,297937,193824,104113,297937,326700,2009
24035,41.3,46653,40865,3829,904,12642,78615,17169,14444,2725,17169,366800,2009
24037,35.1,100140,78501,14011,2750,26497,75427,36668,26699,9969,36668,319700,2009
24039,36.8,25943,14117,10229,591,5344,41615,8341,5590,2751,8341,146900,2009
24041,46.5,36034,29213,4749,1128,11133,61591,16213,12012,4201,16213,350500,2009
24043,38.6,144158,123058,12842,3657,37401,51962,55524,36525,18999,55524,233200,2009
24045,35.9,92827,64866,21504,3145,23419,51352,36262,23769,12493,36262,189500,2009
24047,46.9,49081,39737,7319,1135,15100,52600,22574,17364,5210,22574,289200,2009
24510,34.3,639337,194927,403362,17342,125396,38738,237819,121629,116190,237819,152000,2009
25001,48.1,222629,207158,4223,3927,61932,60096,97119,78751,18368,97119,399900,2009
25003,43.6,130168,120154,3008,3234,33369,49907,55200,38271,16929,55200,202700,2009
25005,38.8,545210,475927,15869,27405,141260,55789,207911,134270,73641,207911,315900,2009
25007,44.4,15675,13616,555,98,3626,62472,5622,4481,1141,5622,686800,2009
25009,39.8,734889,580048,18891,104321,183932,64280,276497,183628,92869,276497,380000,2009
25011,42.8,71826,66904,683,1870,18601,52185,29948,20886,9062,29948,216500,2009
25013,38.1,468171,331130,36169,86599,113480,47617,176909,112444,64465,176909,197200,2009
25015,36.8,155160,136417,3225,6761,34017,57293,57987,39386,18601,57987,252500,2009
25017,38.2,1480260,1184764,55935,82239,359134,77004,561267,363558,197709,561267,427400,2009
25019,37.7,11013,9173,441,598,2224,80020,3493,2566,927,3493,1000001,2009
25021,40.1,657506,548057,31086,17657,166487,80127,252166,179437,72729,252166,414900,2009
25023,40,492313,421319,35140,14139,123743,72904,174288,136718,37570,174288,368000,2009
25025,32.5,730630,381648,140974,129723,133470,51896,274523,105986,168537,274523,392800,2009
25027,38.4,795726,663886,24835,64578,199255,63720,292724,201398,91326,292724,285000,2009
26001,53.8,11361,10971,25,103,3249,35014,4774,4294,480,4774,121300,2009
26003,46.1,9512,8245,748,113,2389,41234,3772,3084,688,3772,111700,2009
26005,37.7,112817,101244,1480,7421,31034,51833,41943,35045,6898,41943,149600,2009
26007,44.8,29718,28776,152,242,8757,36261,13060,10701,2359,13060,105900,2009
26009,45.1,24088,22967,100,383,6808,43167,9741,8153,1588,9741,158800,2009
26011,44.6,16561,15444,380,285,4677,36299,6930,5615,1315,6930,99900,2009
26013,41.7,8650,6495,632,117,2125,40849,3081,2304,777,3081,86700,2009
26015,39.8,58815,56298,229,1097,16866,53848,22436,19123,3313,22436,149200,2009
26017,41.1,107778,99154,1444,4539,29870,44844,44559,35732,8827,44559,110000,2009
26019,43.7,17440,16450,48,341,4902,44445,7194,6213,981,7194,162700,2009
26021,40,160129,124772,23312,6226,42116,42481,63541,46325,17216,63541,135200,2009
26023,38.7,45890,41195,1410,1977,11450,44086,16562,13259,3303,16562,113000,2009
26025,38,136875,111545,13994,5505,35995,42003,54198,39243,14955,54198,111300,2009
26027,40.9,50483,44575,2480,1439,14753,45263,20401,16668,3733,20401,131600,2009
26029,43.6,26098,24755,146,334,8031,48641,11581,9372,2209,11581,166200,2009
26031,45.2,26711,25061,80,244,7815,38189,11704,9405,2299,11704,125800,2009
26033,38.7,38700,28836,2168,806,9277,40088,14661,10563,4098,14661,103900,2009
26035,44.5,30670,29444,164,385,8609,34957,13017,10487,2530,13017,94300,2009
26037,39.2,69534,64685,1112,2043,20193,59529,27678,23045,4633,27678,169100,2009
26039,44,14519,13590,389,198,3997,37584,5833,4847,986,5833,109800,2009
26041,44.4,37413,35417,80,270,10993,42020,16507,13194,3313,16507,101100,2009
26043,44.5,27003,26140,50,246,7437,41288,11376,9118,2258,11376,87700,2009
26045,38.8,106894,92483,6104,4169,28444,54858,42350,31896,10454,42350,155200,2009
26047,41.9,33467,31124,178,423,8886,48773,13873,10717,3156,13873,181000,2009
26049,37.3,432720,322978,83224,10883,114092,44376,173107,124763,48344,173107,122500,2009
26051,46.2,26273,25360,92,292,8289,37289,11743,10125,1618,11743,119400,2009
26053,45.4,16193,14483,533,228,4525,32692,7350,5555,1795,7350,68200,2009
26055,40.5,85076,80345,806,1576,22325,50774,34193,26354,7839,34193,174800,2009
26057,37.3,42230,37272,1520,2014,10292,41868,14407,11278,3129,14407,95900,2009
26059,38.9,46300,44539,304,654,12744,42829,17880,14517,3363,17880,118900,2009
26061,33.8,35214,33171,464,350,7991,31824,14009,9688,4321,14009,83400,2009
26063,45.6,33155,31854,20,638,9508,39317,14631,12226,2405,14631,105300,2009
26065,30.4,278804,212034,29151,17003,62686,45606,108158,67376,40782,108158,140400,2009
26067,35.3,63685,56844,2685,2090,15835,46712,21945,17584,4361,21945,123500,2009
26069,49,26257,25059,212,327,7837,36628,11744,10040,1704,11744,101700,2009
26071,48.9,11923,11328,132,98,3159,34083,5439,4522,917,5439,76100,2009
26073,24.1,66652,59000,1633,1868,13693,36726,24850,14593,10257,24850,130500,2009
26075,38.6,161621,139813,12315,4467,41624,47406,60402,46460,13942,60402,134600,2009
26077,33.5,245053,201174,23931,8247,58862,44553,98318,63674,34644,98318,145700,2009
26079,41.6,17106,16422,65,203,4793,39304,7243,6015,1228,7243,108300,2009
26081,33.8,601813,469359,52158,54830,151831,49908,225517,162421,63096,225517,147700,2009
26083,50,2224,2162,0,11,582,35977,981,850,131,981,79300,2009
26085,46.8,11191,9487,1101,199,2516,30629,3936,3290,646,3936,94100,2009
26087,40.1,91453,85291,1052,3493,25210,56116,33193,28103,5090,33193,171800,2009
26089,47.5,21877,19804,17,1231,6861,56574,9458,7949,1509,9458,239200,2009
26091,38.9,100786,89086,2146,7539,27053,50277,37792,30479,7313,37792,145800,2009
26093,39.4,182081,173086,1019,3133,50821,74210,66818,58424,8394,66818,225900,2009
26095,40.6,6645,5339,791,171,1708,36869,2562,2010,552,2562,89000,2009
26097,46.8,10871,8468,304,142,3049,39919,4724,3870,854,4724,129000,2009
26099,38.6,828469,716797,54799,17116,218236,55466,327546,260724,66822,327546,163600,2009
26101,45.4,24741,22557,813,780,6924,39995,10736,8695,2041,10736,125500,2009
26103,39.2,65298,61180,988,613,16120,43692,25364,18252,7112,25364,120800,2009
26105,44.5,28676,26752,161,1020,8489,39511,12397,9800,2597,12397,120300,2009
26107,34.6,41976,38279,1512,617,9991,36100,16382,11952,4430,16382,121500,2009
26109,44.9,24230,22920,87,278,7226,41514,10977,8802,2175,10977,95900,2009
26111,38.9,82738,77312,771,1582,22656,50361,33105,25652,7453,33105,132100,2009
26113,41.7,14967,14368,56,233,4331,38397,6039,5010,1029,6039,113400,2009
26115,38.9,152899,141997,3146,4118,42801,56855,58686,47515,11171,58686,165400,2009
26117,37.9,62913,58222,1084,1770,16187,41082,22833,18379,4454,22833,115000,2009
26119,51.5,10237,9985,5,81,2984,34409,4447,3871,576,4447,103900,2009
26121,37.1,174156,137911,23363,7596,44690,41800,65654,51070,14584,65654,114100,2009
26123,39.1,49114,44920,473,2512,13817,43278,19031,15864,3167,19031,116400,2009
26125,39.1,1203288,936882,141204,37020,318255,67292,479376,362043,117333,479376,214600,2009
26127,38.7,27808,22954,95,4084,7248,39725,10180,8468,1712,10180,115000,2009
26129,46.5,21359,20455,9,304,5872,35081,8477,7110,1367,8477,108100,2009
26131,51.2,6907,6610,35,70,2147,34140,3401,2913,488,3401,74600,2009
26133,40.7,23069,22053,99,303,6368,37326,8914,7184,1730,8914,102600,2009
26135,48.9,8921,8630,4,109,2596,33028,3963,3325,638,3963,97400,2009
26137,41,23932,22979,8,244,6634,44790,9723,8100,1623,9723,122200,2009
26139,34,258564,224308,2965,20697,68105,57126,91854,75121,16733,91854,162400,2009
26141,49.6,13742,13343,27,87,4327,37536,6475,5721,754,6475,109700,2009
26143,50.8,25280,24490,98,235,7195,34276,11433,9741,1692,11433,110900,2009
26145,38.6,202814,145512,36287,14873,52513,42244,78338,58854,19484,78338,109500,2009
26147,39.3,169260,156991,4029,4486,45898,50648,65677,51768,13909,65677,156100,2009
26149,37.4,62219,55202,1441,4033,16121,43667,22566,17636,4930,22566,116000,2009
26151,41,43291,41031,134,1304,11882,40146,16951,13950,3001,16951,120100,2009
26153,46,8413,7348,181,13,2429,37906,3522,2960,562,3522,88500,2009
26155,39.1,71406,68311,360,1456,19974,46260,27841,21970,5871,27841,133600,2009
26157,40.3,56538,53226,717,1468,16025,42851,21751,18306,3445,21751,116600,2009
26159,38.7,78026,64680,3523,7425,20716,43740,29528,23584,5944,29528,124700,2009
26161,32.5,346007,256585,41002,11597,79457,58807,133925,84739,49186,133925,222900,2009
26163,36.2,1977997,995156,801112,96998,456725,42232,709299,480177,229122,709299,125300,2009
26165,39.8,31624,30247,134,446,8518,40232,12597,10092,2505,12597,111500,2009
27001,50.5,15871,15111,39,140,5026,39452,7542,6161,1381,7542,176200,2009
27003,36,326489,286276,11007,8864,86689,69407,118517,99512,19005,118517,226700,2009
27005,42.4,31832,28045,122,416,9077,46142,13354,10588,2766,13354,159800,2009
27007,32.5,43407,32751,252,720,10322,43678,15573,11574,3999,15573,137900,2009
27009,33,39460,37148,472,538,9547,50071,15257,10408,4849,15257,169500,2009
27011,48.2,5335,5225,32,27,1578,39973,2460,1919,541,2460,79200,2009
27013,29.5,59883,55057,1188,1292,13376,45902,23340,15581,7759,23340,160600,2009
27015,42.8,25881,24696,25,830,7297,48067,10947,8687,2260,10947,121300,2009
27017,40.7,33875,30513,435,465,9320,51552,13648,10964,2684,13648,159000,2009
27019,35.9,88208,80370,957,3320,24252,78436,31955,26443,5512,31955,284600,2009
27021,45.6,28654,24582,29,371,9106,41501,13192,11039,2153,13192,181300,2009
27023,43.2,12454,11553,50,335,3406,42441,5380,4043,1337,5380,90200,2009
27025,36.7,49771,46900,781,969,13287,65100,17885,15548,2337,17885,231100,2009
27027,32.5,54902,50413,446,1940,13813,47806,21295,15108,6187,21295,139800,2009
27029,42.8,8231,7235,28,90,2239,37744,3311,2588,723,3311,108300,2009
27031,48.6,5411,4794,12,61,1699,47933,2707,2023,684,2707,233300,2009
27033,43.1,11343,10342,54,501,3124,39878,4895,3905,990,4895,81100,2009
27035,41.9,61435,59251,282,564,17773,44075,26597,20607,5990,26597,186900,2009
27037,35.6,389434,332120,15496,17207,103942,73209,148204,117488,30716,148204,245300,2009
27039,36.5,19504,18330,37,836,5387,62269,7193,6298,895,7193,161000,2009
27041,42.5,35854,34958,38,329,10485,44918,16172,12204,3968,16172,172700,2009
27043,45.5,14834,13875,21,707,4323,40548,6545,5116,1429,6545,86700,2009
27045,43.1,20966,20543,36,159,5889,45454,8665,6858,1807,8665,132700,2009
27047,43.7,31211,28298,218,2275,8628,44018,13080,10487,2593,13080,111900,2009
27049,40.7,45605,43213,466,820,12723,55632,18533,14620,3913,18533,190900,2009
27051,46.2,5965,5789,16,79,1700,39975,2587,1984,603,2587,99400,2009
27053,35.8,1136224,853107,115503,68227,270909,61387,469770,311828,157942,469770,248600,2009
27055,42.8,19463,18939,50,151,5689,51945,7893,6488,1405,7893,144000,2009
27057,45.8,18675,17761,10,209,5494,43999,7853,6421,1432,7853,169600,2009
27059,36.3,38589,36812,171,626,10246,57496,14331,11935,2396,14331,208500,2009
27061,44.4,44364,41418,128,466,13209,43396,19398,15450,3948,19398,141600,2009
27063,44.3,10881,10306,21,288,2998,41797,4661,3687,974,4661,92400,2009
27065,41.5,16059,15373,75,186,4441,45382,6327,5280,1047,6327,163200,2009
27067,39.3,40950,36109,287,3932,11582,50381,16766,12647,4119,16766,154800,2009
27069,47.4,4523,4375,12,79,1264,47770,2068,1717,351,2068,60700,2009
27071,46,13396,12660,0,115,4016,39088,6414,5142,1272,6414,96400,2009
27073,47.7,7258,7091,29,76,2133,44753,3101,2563,538,3101,73900,2009
27075,46.9,10751,10277,42,39,3397,44433,5193,4152,1041,5193,139300,2009
27077,47.7,4068,3889,10,11,1321,44306,1816,1574,242,1816,125700,2009
27079,39.7,27768,25916,90,1353,7446,56489,10706,9108,1598,10706,181800,2009
27081,45.8,5832,5711,0,74,1690,41730,2695,2215,480,2695,75100,2009
27083,35.6,24910,22397,383,1368,6300,45842,10288,7061,3227,10288,132800,2009
27085,38.1,36879,34209,134,1869,10024,56615,14556,11601,2955,14556,169100,2009
27087,38.8,5051,2884,8,151,1306,38409,1964,1490,474,1964,86400,2009
27089,44,9452,8920,21,389,2912,46316,4171,3445,726,4171,78600,2009
27091,45.2,20448,19466,64,616,5864,42832,9130,6991,2139,9130,95700,2009
27093,41.2,23195,22131,29,710,6663,52031,9347,7659,1688,9347,166800,2009
27095,39.3,26071,23959,93,377,6669,45817,10143,8044,2099,10143,172400,2009
27097,39.6,32717,31858,6,279,9342,48582,13579,10882,2697,13579,158900,2009
27099,39.6,38119,33577,464,3043,10438,45274,15994,12212,3782,15994,106700,2009
27101,46.3,8529,8187,2,203,2497,45260,3596,2987,609,3596,86200,2009
27103,33.6,31694,29489,452,835,7889,55355,12079,8817,3262,12079,170000,2009
27105,38.7,20278,15319,395,3499,5452,42042,8159,5956,2203,8159,92400,2009
27107,45.1,6629,6072,4,293,1907,39709,2938,2332,606,2938,74600,2009
27109,35.7,139585,120733,5026,4175,36507,64840,55099,42514,12585,55099,172300,2009
27111,45.1,56912,54518,327,1151,16328,42821,24321,19280,5041,24321,152400,2009
27113,39,13750,12908,38,303,3754,44015,5793,4494,1299,5793,88300,2009
27115,41.4,28175,25902,318,604,7383,43618,10965,9030,1935,10965,163300,2009
27117,43.4,9303,8796,29,172,2635,38357,4040,3184,856,4040,78200,2009
27119,40.3,30693,28061,196,1560,8156,45076,12509,9228,3281,12509,106100,2009
27121,45.2,10979,10758,42,30,3251,47001,4831,3853,978,4831,145000,2009
27123,35.1,500436,361375,44276,31745,115556,52329,201224,128889,72335,201224,223200,2009
27125,42.8,4157,3969,0,56,1153,45833,1726,1435,291,1726,77000,2009
27127,43,15625,14244,63,286,4401,44034,6563,5214,1349,6563,86600,2009
27129,43,16101,14619,44,1179,4492,46588,6701,5272,1429,6701,93800,2009
27131,34.5,61865,53992,1049,4573,15106,57754,21505,16990,4515,21505,207000,2009
27133,42,9444,9000,43,209,2613,45826,3945,3132,813,3945,94200,2009
27135,39.4,16012,15092,32,112,4535,48974,6290,5140,1150,6290,94800,2009
27137,40.6,196820,183717,2445,1991,50477,44125,84879,61639,23240,84879,138200,2009
27139,34.2,125714,108974,2931,4828,32748,83503,43390,37819,5571,43390,280200,2009
27141,32.7,85211,79982,1113,1670,21774,71228,28466,24606,3860,28466,231000,2009
27143,39.5,15001,13618,13,1102,4253,50656,6040,4819,1221,6040,147300,2009
27145,33.3,146168,136575,2402,2802,35814,51559,54853,40153,14700,54853,173900,2009
27147,37.2,36273,32529,981,2000,9884,55810,13768,10930,2838,13768,156000,2009
27149,33.6,9635,8943,152,149,2262,45049,3777,2466,1311,3777,112100,2009
27151,42.5,10890,10021,352,385,2822,40677,4528,3278,1250,4528,93300,2009
27153,41.6,23968,22547,6,1011,7167,42604,10105,8363,1742,10105,137200,2009
27155,47.4,3684,3449,0,66,1013,38881,1694,1376,318,1694,67900,2009
27157,42.1,21831,20875,100,546,6211,51541,9098,7458,1640,9098,155300,2009
27159,43.3,13343,12876,143,159,3883,34212,5847,4465,1382,5847,106900,2009
27161,38.6,19241,17656,160,724,4856,49971,7282,5784,1498,7282,138500,2009
27163,37.2,225551,197611,6468,6255,61981,78714,84453,71728,12725,84453,268300,2009
27165,42,11019,8572,16,2128,2938,43535,4497,3569,928,4497,88300,2009
27167,43.5,6455,6140,5,156,1852,49327,2623,2186,437,2623,97800,2009
27169,33.5,49558,46598,357,775,11763,42941,19490,13555,5935,19490,157400,2009
27171,33.9,116527,109994,1135,2408,32724,67090,43384,36722,6662,43384,226400,2009
27173,42.9,10067,9419,110,290,2999,46292,4426,3416,1010,4426,89600,2009
28001,40.8,31475,13265,17633,374,8109,28868,12915,8778,4137,12915,72400,2009
28003,38.8,35583,30400,4094,781,9351,31826,13637,9978,3659,13637,83800,2009
28005,41.4,13293,7286,5822,72,3371,27728,5178,4215,963,5178,68400,2009
28007,38.7,19558,10969,8122,378,5066,30096,7526,5598,1928,7526,71100,2009
28009,38.8,7978,4958,2959,22,1960,28667,2898,2250,648,2898,61800,2009
28011,31.6,37266,11934,24389,582,8707,24920,13666,7497,6169,13666,74200,2009
28013,39.4,14533,9617,4280,590,4267,27078,6148,4201,1947,6148,61300,2009
28015,43.2,10301,6582,3522,81,2931,28100,4019,3302,717,4019,64400,2009
28017,36.8,18864,10166,7589,784,5127,29581,7418,5286,2132,7418,58700,2009
28019,39.9,9106,6092,2953,4,2460,30054,3712,2878,834,3712,70300,2009
28021,29.1,10910,1562,9287,10,2230,24104,3634,2649,985,3634,52500,2009
28023,39.8,17333,11006,6114,58,5266,31029,7096,5477,1619,7096,60200,2009
28025,36.8,20881,8621,11829,35,5703,30765,7998,5499,2499,7998,72700,2009
28027,31.1,27571,6534,20352,412,7001,25489,10037,5652,4385,10037,55900,2009
28029,35.1,29150,13496,14827,513,6625,35342,10012,7585,2427,10012,72400,2009
28031,35.5,20315,12586,7195,220,5428,30483,7447,6336,1111,7447,76700,2009
28033,34.3,148795,109557,28893,6189,41375,57995,53982,42432,11550,53982,148800,2009
28035,28.5,78650,47305,27726,1766,17699,33143,29666,16789,12877,29666,97600,2009
28037,40.6,8287,5088,3157,5,2060,34236,3065,2585,480,3065,77300,2009
28039,33.5,21926,19022,2160,543,5494,46849,7064,6004,1060,7064,88100,2009
28041,36,13699,9654,3694,126,3365,38252,4285,3795,490,4285,65400,2009
28043,37.4,23002,12879,9641,199,6359,31909,9291,6093,3198,9291,81700,2009
28045,41.3,41135,36048,2887,984,11593,44025,15812,11837,3975,15812,149900,2009
28047,35.1,180901,123097,40049,6985,45858,44570,67681,44171,23510,67681,133400,2009
28049,32.4,248782,78867,161919,3407,59258,38541,91222,55524,35698,91222,102200,2009
28051,30.2,20481,3699,16546,22,4662,21821,7082,5112,1970,7082,48000,2009
28053,32.5,9985,2380,7386,85,2481,22259,3727,2286,1441,3727,64300,2009
28055,32.2,2130,825,1305,0,483,20250,738,475,263,738,60300,2009
28057,38.6,23006,20899,1548,283,6797,37660,9115,7263,1852,9115,76100,2009
28059,36.6,131713,93493,29085,4591,35381,47767,48332,34981,13351,48332,120500,2009
28061,37.6,17944,8348,9402,43,4432,29628,6548,5565,983,6548,63200,2009
28063,38.2,8971,1188,7783,0,2171,21964,3162,2306,856,3162,67100,2009
28065,38.6,12721,5226,7150,27,3383,24679,5094,4133,961,5094,63900,2009
28067,36.1,66877,44557,17959,3351,18447,34269,25462,18637,6825,25462,75400,2009
28069,37.9,9998,3699,5829,41,2908,29833,3914,3037,877,3914,61600,2009
28071,26.4,43025,30598,10488,664,8284,40202,14835,9134,5701,14835,143400,2009
28073,32.8,47307,38419,7087,722,10710,48328,15171,11421,3750,15171,148100,2009
28075,35.4,77966,43680,31886,1313,20952,33354,30988,20105,10883,30988,79800,2009
28077,37.5,13258,8791,4325,115,3391,34643,4900,4146,754,4900,68200,2009
28079,32.5,22782,11845,8567,890,5477,32396,7335,5720,1615,7335,67200,2009
28081,35.6,80099,56475,21083,1395,20773,37894,29670,20645,9025,29670,105200,2009
28083,30.9,35033,9130,25361,286,8504,20490,12853,6565,6288,12853,60700,2009
28085,37.3,34315,23281,10525,272,9773,38276,13044,10005,3039,13044,77400,2009
28087,34.8,59499,32101,25347,1005,16376,37314,23460,15262,8198,23460,96300,2009
28089,34.8,89151,52303,33532,1536,22752,56938,33582,23581,10001,33582,171400,2009
28091,36,25527,16593,8552,133,6345,30699,9045,7111,1934,9045,76300,2009
28093,36,36394,17751,17522,646,8867,31831,12611,9820,2791,12611,80300,2009
28095,38.5,37089,24993,11331,329,11179,33116,15333,11770,3563,15333,76500,2009
28097,39.9,11412,6042,5187,39,3420,29243,4931,3724,1207,4931,67200,2009
28099,35.1,29949,18376,6228,571,7400,33445,10690,7894,2796,10690,70800,2009
28101,36.2,22403,14239,6723,320,6102,35527,8117,6518,1599,8117,69400,2009
28103,35.3,11814,3300,8252,20,2955,22974,4385,3301,1084,4385,50700,2009
28105,24.3,43630,25381,15739,644,9219,26449,17285,8452,8833,17285,109600,2009
28107,34.4,35148,17576,16773,488,8937,35355,12404,9484,2920,12404,73300,2009
28109,37.8,56113,46862,7131,1124,15650,38458,21465,16733,4732,21465,116700,2009
28111,38.8,12087,9127,2892,8,3589,34423,4722,4008,714,4722,70900,2009
28113,36.1,39606,19432,19337,398,9914,29981,14683,10724,3959,14683,83100,2009
28115,35.7,28775,23412,3856,947,7350,38909,9914,7821,2093,9914,81300,2009
28117,38,25594,21540,3325,271,7145,29250,9703,7702,2001,9703,67400,2009
28119,34.5,8821,2592,6156,49,2325,24491,3432,2216,1216,3432,44600,2009
28121,35.1,137817,105578,26549,2883,36498,53240,50855,39223,11632,50855,139000,2009
28123,34.6,29137,15100,11097,2812,7067,32114,10046,8036,2010,10046,61400,2009
28125,35.1,5184,1415,3757,9,1337,29495,2063,1379,684,2063,68100,2009
28127,36.5,27903,17462,10171,187,7384,34187,10324,7982,2342,10324,72900,2009
28129,37.3,15889,11817,3951,121,4620,36762,5958,5109,849,5958,74500,2009
28131,35.4,15734,12264,3115,250,4209,43524,5273,4117,1156,5273,96000,2009
28133,32.1,30604,7907,21912,562,6705,24333,9499,5278,4221,9499,62600,2009
28135,35.7,13201,5026,7626,484,3669,23557,5071,3708,1363,5071,45500,2009
28137,35.5,26888,17888,8157,368,7254,38194,9989,7683,2306,9989,93400,2009
28139,37.7,21439,16528,3405,1094,6010,29872,8247,6209,2038,8247,65500,2009
28141,42.1,19060,17638,638,606,5298,29740,7574,6020,1554,7574,71900,2009
28143,30.4,10406,2553,7348,335,2177,29420,3823,1806,2017,3823,74300,2009
28145,36.7,26939,21586,4003,934,7512,35955,10096,7706,2390,10096,79200,2009
28147,36.2,15304,8156,6783,235,3674,32475,5346,4486,860,5346,78700,2009
28149,35.7,48596,24449,22493,740,12731,38917,19272,12633,6639,19272,96900,2009
28151,33.9,55811,16689,37089,976,14384,27588,21191,11832,9359,21191,70500,2009
28153,36,20892,12571,7950,83,6431,30375,8659,7109,1550,8659,55300,2009
28155,39.7,9834,7553,1916,202,2652,31533,3718,2711,1007,3718,69700,2009
28157,35.4,10200,3020,7020,68,2615,25478,3703,2777,926,3703,52900,2009
28159,38,19543,10245,9064,50,5102,30406,7513,5941,1572,7513,71700,2009
28161,40.2,13646,8079,5453,106,3651,28578,5432,3922,1510,5432,64200,2009
28163,34.8,28296,10748,16431,603,6383,27404,9043,5752,3291,9043,70400,2009
29001,25.7,24801,23109,377,503,5348,30000,9630,5528,4102,9630,97600,2009
29003,39.9,16831,16155,110,232,4962,52330,6499,5092,1407,6499,124600,2009
29005,45.1,6078,5798,30,59,1702,39328,2649,1848,801,2649,71000,2009
29007,39,25754,22858,1930,331,6645,39028,9746,7256,2490,9746,82500,2009
29009,39.2,35905,31745,26,2960,9847,36411,14178,10511,3667,14178,101600,2009
29011,39.1,12695,12113,30,179,3736,41124,4949,3694,1255,4949,84600,2009
29013,39.9,16906,16149,124,285,4457,39071,6355,4764,1591,6355,99700,2009
29015,49.4,18458,17769,10,128,5779,34038,8105,6892,1213,8105,102000,2009
29017,41.2,12037,11646,35,97,3408,34878,4636,3717,919,4636,91700,2009
29019,29.2,151836,126587,11864,3830,36350,44787,63622,35981,27641,63622,148700,2009
29021,36.9,88476,79323,3227,3016,21486,41366,33082,22935,10147,33082,104700,2009
29023,39.6,41293,37358,2034,605,11116,33074,16821,11361,5460,16821,84200,2009
29025,41.5,9192,8881,29,112,2694,37792,3852,2709,1143,3852,98300,2009
29027,36.6,43192,39136,1909,619,11380,49425,15786,12294,3492,15786,116500,2009
29029,47,40150,38503,216,622,11214,43127,16108,13122,2986,16108,177500,2009
29031,36.4,72621,65338,4172,1021,19097,43639,28948,19732,9216,28948,130000,2009
29033,42,9816,9370,219,109,2953,38360,4156,3196,960,4156,67500,2009
29035,40.2,5894,5595,1,66,1486,24502,2395,1822,573,2395,78800,2009
29037,36.8,97203,88087,2838,3387,27456,60628,35957,28497,7460,35957,151400,2009
29039,44.4,13790,13128,0,222,4507,33503,6044,4615,1429,6044,95500,2009
29041,45.7,7777,7396,217,58,2227,41233,3303,2593,710,3303,75900,2009
29043,35.6,72551,68748,591,1622,20974,50830,27143,20457,6686,27143,144000,2009
29045,42.1,7178,7036,7,22,2062,39936,2994,2310,684,2994,70600,2009
29047,35.7,217596,188937,6524,10706,58767,57797,86431,62441,23990,86431,152100,2009
29049,40.2,20810,19793,109,573,5662,50761,8165,6329,1836,8165,145100,2009
29051,36.8,73737,62742,7199,1370,19259,52385,29034,19776,9258,29034,130700,2009
29053,36,17371,15312,1096,257,4274,41576,6242,4425,1817,6242,109400,2009
29055,38.8,23825,22908,59,388,6056,34813,8939,6672,2267,8939,97700,2009
29057,45,7503,7167,5,111,2162,32636,3225,2484,741,3225,75200,2009
29059,40.4,16579,15812,0,290,4476,34367,6141,4896,1245,6141,91600,2009
29061,39.1,8061,7862,14,94,2222,38640,3143,2326,817,3143,87500,2009
29063,38.7,12235,10518,1009,174,2452,43302,3862,2647,1215,3862,115600,2009
29065,42.3,15036,14404,173,168,4297,34292,6111,4619,1492,6111,81500,2009
29067,42.3,13470,13119,0,101,3282,30675,4851,4043,808,4851,88000,2009
29069,39.1,31528,26656,2906,1378,8796,29124,13253,8375,4878,13253,66300,2009
29071,38,99866,96241,1118,1095,27308,49860,38104,29115,8989,38104,143100,2009
29073,43.3,15327,14910,8,139,4454,40196,6525,5013,1512,6525,106800,2009
29075,44,6249,6080,29,53,1766,35539,2663,2015,648,2663,78400,2009
29077,35.2,262887,239534,6821,6761,67659,40271,111263,68465,42798,111263,122600,2009
29079,42.7,10088,9569,4,149,2707,35032,4370,3092,1278,4370,68900,2009
29081,43.4,8750,8459,11,135,2427,33598,3628,2758,870,3628,76000,2009
29083,43,22294,21245,264,310,6251,36250,9454,6750,2704,9454,99500,2009
29085,51.2,9022,7723,26,28,2809,28685,4120,3403,717,4120,83900,2009
29087,44.8,4937,4824,5,31,1563,39019,2287,1813,474,2287,74800,2009
29089,38.2,9859,8915,571,122,2470,39870,3749,2973,776,3749,92300,2009
29091,39.6,38561,36671,246,599,10593,32145,14969,10818,4151,14969,88700,2009
29093,40.3,10083,9576,257,97,2742,29904,4157,3009,1148,4157,77700,2009
29095,36.1,689651,456104,153164,52644,165506,46516,269515,174059,95456,269515,127700,2009
29097,34.4,114756,101342,1891,6629,28982,37294,43625,28753,14872,43625,90500,2009
29099,36.9,215386,205435,2353,3073,59045,56815,80143,67727,12416,80143,150900,2009
29101,28.4,51997,45827,2065,1844,12056,43656,18507,11756,6751,18507,129200,2009
29103,44.3,4040,3948,8,15,1086,33681,1750,1317,433,1750,60000,2009
29105,38,35046,33383,302,586,9947,35749,14239,10071,4168,14239,92600,2009
29107,40.4,32741,30845,684,498,9503,47811,13337,9936,3401,13337,118000,2009
29109,37.7,37351,34295,193,1972,9989,38232,14062,10484,3578,14062,93400,2009
29111,39.6,9951,9436,310,67,2700,39344,3882,2905,977,3882,79900,2009
29113,34.7,50926,48004,861,893,11943,53295,15700,12663,3037,15700,150400,2009
29115,43,12765,12186,183,160,3426,36767,5375,4065,1310,5375,67100,2009
29117,41.2,14143,13336,381,191,3870,38462,5792,3881,1911,5792,94400,2009
29119,35.3,22890,18198,95,3124,5861,36498,8057,5636,2421,8057,85200,2009
29121,42.8,15456,14635,378,179,4192,35578,6468,4987,1481,6468,83500,2009
29123,39.9,12226,11837,23,140,3417,32271,4857,3695,1162,4857,79300,2009
29125,41,8954,8750,95,78,2456,39241,3427,2823,604,3427,109500,2009
29127,38.5,28241,25903,1208,355,7568,38530,11462,7538,3924,11462,88400,2009
29129,45.4,3474,3415,16,19,1048,32591,1622,1236,386,1622,70800,2009
29131,39,24731,23845,174,309,6562,35732,9895,7405,2490,9895,105900,2009
29133,38.5,13498,10303,2588,248,3593,28966,5441,3365,2076,5441,64400,2009
29135,36.4,15081,13624,486,554,3844,47329,5260,4048,1212,5260,107400,2009
29137,43.3,9141,8546,260,80,2838,39262,3973,3050,923,3973,80800,2009
29139,42.7,11884,11257,279,124,3492,39511,4967,3811,1156,4967,105200,2009
29141,44.5,20608,19816,61,226,5779,36267,7978,6493,1485,7978,108800,2009
29143,39.8,17723,14629,2614,222,5439,32015,8082,5261,2821,8082,63800,2009
29145,38,55694,50026,332,1930,15232,41661,20744,15513,5231,20744,100700,2009
29147,28.1,22058,20832,416,375,4756,36510,8319,4867,3452,8319,93700,2009
29149,43.8,10321,9588,35,75,2870,24803,4310,3059,1251,4310,68200,2009
29151,38.9,13421,13117,143,99,3690,42210,5124,4383,741,5124,123200,2009
29153,47.5,9360,9017,11,85,2775,33264,3781,3194,587,3781,105400,2009
29155,36.1,18586,13261,4695,411,5141,28290,7607,4078,3529,7607,57300,2009
29157,38.9,18638,17993,80,212,5190,45863,7417,5840,1577,7417,114500,2009
29159,36.7,40789,35500,1168,2955,10131,36510,15593,11359,4234,15593,90500,2009
29161,36.1,42249,38781,867,763,10266,37322,16713,10800,5913,16713,109400,2009
29163,39.3,18514,16031,1453,536,4696,42969,6594,4683,1911,6594,100300,2009
29165,37.5,87461,76330,3763,3673,23584,65383,34684,23832,10852,34684,185900,2009
29167,36.1,29983,26888,137,520,7865,36633,11003,8017,2986,11003,107600,2009
29169,26.6,44684,33638,4809,3421,10006,42476,14410,8395,6015,14410,115100,2009
29171,41.2,4906,4727,13,97,1582,33992,2279,1744,535,2279,93100,2009
29173,42.3,9691,9396,60,63,2735,46875,3771,3051,720,3771,102600,2009
29175,37.6,25528,22683,1585,399,6545,34827,9534,6944,2590,9534,79100,2009
29177,38.9,23507,22333,373,328,6775,51556,9295,7379,1916,9295,123900,2009
29179,44.6,6367,6022,51,26,1882,33052,2849,2073,776,2849,74700,2009
29181,41,13523,12880,28,144,4151,29289,5577,4030,1547,5577,66200,2009
29183,36.5,342562,310086,13193,7847,93312,70077,127228,105267,21961,127228,193500,2009
29185,46.9,9379,8981,6,13,2858,33041,4139,3207,932,4139,79700,2009
29186,42.6,17758,17112,251,183,5146,49712,7000,5797,1203,7000,126800,2009
29187,37.3,62734,58542,2316,746,15174,38086,22815,16933,5882,22815,98000,2009
29189,39.2,994923,715441,210538,21763,264697,57502,403699,296232,107467,403699,175000,2009
29195,37.8,22749,19285,1253,1686,5857,40556,9026,6431,2595,9026,83500,2009
29197,42,4106,4048,16,2,1231,30683,2001,1408,593,2001,60700,2009
29199,42.5,4790,4742,0,16,1322,35548,2022,1567,455,2022,74300,2009
29201,38.1,40753,34866,4549,612,10910,37132,16046,11013,5033,16046,92100,2009
29203,40.4,8310,7782,0,72,2414,28474,3373,2622,751,3373,73000,2009
29205,41.9,6457,6252,14,95,1779,33275,2806,1954,852,2806,68600,2009
29207,40.3,29524,28255,457,333,8324,33684,12208,8519,3689,12208,79700,2009
29209,47,31186,26742,0,509,8886,40830,12211,9393,2818,12211,137300,2009
29211,39.7,6842,5680,6,1064,1676,30613,2711,1917,794,2711,65500,2009
29213,39.9,45732,42420,76,1693,13208,40103,19623,13056,6567,19623,124100,2009
29215,41.9,24477,22689,644,358,6455,30569,9383,6975,2408,9383,86600,2009
29217,38.5,20127,19233,52,255,5228,33161,8063,5632,2431,8063,82500,2009
29219,38.3,30249,28277,546,702,8511,49722,11559,8948,2611,11559,156500,2009
29221,37.6,24230,22788,548,261,6223,35510,8615,6848,1767,8615,83600,2009
29223,44.9,12593,12132,39,70,3620,28315,5595,4041,1554,5595,69500,2009
29225,36,35635,33780,419,611,9297,39478,12264,9164,3100,12264,118600,2009
29227,47.7,2058,2033,0,7,680,39479,900,737,163,900,59900,2009
29229,40.5,18082,17335,42,254,4893,27598,7242,5175,2067,7242,85100,2009
29510,34.5,355078,158907,170928,10123,70600,34227,143045,70814,72231,143045,119900,2009
30001,41.5,8887,8221,22,313,2389,37038,3553,2359,1194,3553,149200,2009
30003,31,12809,4118,0,688,2584,34891,3603,2414,1189,3603,80800,2009
30005,34.8,6515,3136,0,93,1722,37039,2420,1432,988,2420,70300,2009
30007,41.3,4602,4442,13,17,946,42860,1461,1165,296,1461,141000,2009
30009,45.9,9741,9301,7,228,2750,50676,3974,3010,964,3974,189800,2009
30011,51.5,1260,1246,0,4,412,35813,569,432,137,569,83100,2009
30013,38.5,81912,71970,1163,2686,21265,41964,32508,21932,10576,32508,135800,2009
30015,45.3,5223,4271,14,41,1484,38664,2098,1405,693,2098,103500,2009
30017,42.2,11129,10545,26,229,3151,38627,5025,3370,1655,5025,75600,2009
30019,49,1483,1395,0,4,466,34300,714,557,157,714,72400,2009
30021,42.4,8547,7969,51,155,2440,47706,3637,2611,1026,3637,89800,2009
30023,45.1,8876,8034,132,192,2458,33429,4032,2966,1066,4032,91700,2009
30025,44.5,2657,2602,0,23,793,53889,1200,901,299,1200,88000,2009
30027,46.5,11218,10679,92,99,3071,36568,4717,3268,1449,4717,97300,2009
30029,40,86657,81465,172,1476,20345,45258,30998,22854,8144,30998,223800,2009
30031,30,86532,81105,425,2149,19244,49343,32898,20353,12545,32898,266200,2009
30033,45.8,1135,1132,0,0,311,32880,513,384,129,513,69600,2009
30035,30.9,13411,4358,54,492,3251,41009,4300,2664,1636,4300,76900,2009
30037,46.4,873,854,0,0,243,36029,360,257,103,360,83200,2009
30039,47.7,2880,2728,0,11,683,35247,1118,863,255,1118,174400,2009
30041,34.8,16434,12222,64,390,4143,44833,6183,4194,1989,6183,104900,2009
30043,44.1,11105,10492,26,206,2685,56294,3657,3183,474,3657,202800,2009
30045,53.6,2077,2049,0,0,653,39900,980,770,210,980,85000,2009
30047,39.7,28239,19934,58,902,7370,39048,10775,7396,3379,10775,185800,2009
30049,40.4,60081,55992,185,1335,14375,50245,23589,17030,6559,23589,172700,2009
30051,43.7,2100,2094,0,0,550,39310,762,480,282,762,73200,2009
30053,47,18698,17644,83,379,5270,32644,8015,6187,1828,8015,136000,2009
30055,45.9,1747,1687,0,0,534,40903,762,595,167,762,72000,2009
30057,47.3,7314,7014,20,155,1808,42054,2963,2222,741,2963,229600,2009
30059,43.1,1628,1569,0,54,430,33365,695,452,243,695,88800,2009
30061,46.5,3898,3630,0,70,1058,36820,1543,1062,481,1543,161700,2009
30063,32.8,105637,96460,610,2590,23524,41220,41700,24719,16981,41700,225900,2009
30065,48,4413,4294,0,111,1315,33000,1794,1414,380,1794,105400,2009
30067,43.2,15935,15024,0,433,4193,39730,6623,4779,1844,6623,191200,2009
30069,45.5,512,481,7,8,122,38833,220,158,62,220,95000,2009
30071,48.2,3959,3397,0,66,1097,37080,1830,1419,411,1830,73400,2009
30073,42.3,5909,4727,44,77,1786,32790,2459,1644,815,2459,85500,2009
30075,42.9,1668,1601,0,23,503,39489,719,464,255,719,94400,2009
30077,42.7,7057,6314,56,194,1685,40329,2397,1756,641,2397,106300,2009
30079,55.9,1004,990,0,8,332,36618,508,442,66,508,69800,2009
30081,44.1,40060,37903,14,1056,9898,42654,14461,11201,3260,14461,222800,2009
30083,42.8,9128,8540,0,291,2858,49553,3943,2520,1423,3943,92400,2009
30085,31.3,10231,3728,0,87,2136,34731,3390,2186,1204,3390,59700,2009
30087,35,9152,5405,58,326,2354,43269,3204,2227,977,3204,88600,2009
30089,48.1,10950,9928,33,219,2962,31521,4315,3369,946,4315,165400,2009
30091,49.4,3568,3316,1,36,983,39091,1666,1238,428,1666,62600,2009
30093,41.5,32740,30269,67,1129,8369,37324,14383,9621,4762,14383,105700,2009
30095,44.6,8573,8105,45,254,2312,55401,3254,2512,742,3254,161700,2009
30097,47,3675,3459,0,116,878,43016,1287,995,292,1287,183000,2009
30099,45,6132,5836,15,109,1726,39360,2465,1848,617,2465,121100,2009
30101,41.3,5110,4819,35,107,1254,41322,1933,1294,639,1933,88900,2009
30103,40.4,912,850,0,35,241,43553,342,243,99,342,62300,2009
30105,45.8,6888,5898,43,68,1912,38559,3048,2246,802,3048,77300,2009
30107,51.3,2018,1937,0,0,525,30375,898,717,181,898,82400,2009
30109,47.8,922,859,7,14,275,32154,421,305,116,421,53200,2009
30111,37.7,140436,122747,1240,7105,35300,46967,56065,39033,17032,56065,159600,2009
31001,36.3,33024,29461,196,2266,8628,44524,12739,9000,3739,12739,93600,2009
31003,45,6729,6566,4,100,2006,35883,2855,2000,855,2855,65700,2009
31005,33.4,364,360,0,4,92,44750,139,86,53,139,97500,2009
31007,45.5,824,772,0,38,266,32833,366,226,140,366,94000,2009
31009,49.1,471,458,0,0,177,35694,219,113,106,219,58500,2009
31011,44.5,5531,5497,0,30,1638,43891,2437,1741,696,2437,72800,2009
31013,42.7,11031,9255,55,1114,3330,45000,4724,3160,1564,4724,89700,2009
31015,46.9,2120,2075,0,32,609,33060,1039,726,313,1039,44300,2009
31017,47.5,3178,3124,4,0,767,26676,1371,964,407,1371,55100,2009
31019,30.3,44877,41114,375,2519,10818,46300,17249,11317,5932,17249,121800,2009
31021,45.4,7047,6746,23,121,2029,43333,3060,2273,787,3060,82700,2009
31023,43.2,8416,8121,14,258,2350,45226,3545,2720,825,3545,85000,2009
31025,39.9,25495,24384,112,544,7137,62527,9680,7930,1750,9680,142200,2009
31027,43.4,8582,8436,4,60,2390,42430,3474,2740,734,3474,83800,2009
31029,46.4,3702,3498,0,192,1143,37192,1662,1320,342,1662,73800,2009
31031,42.9,5682,5230,5,25,1600,39089,2613,1628,985,2613,93300,2009
31033,41.3,9829,9063,0,541,2829,47115,4323,3071,1252,4323,89200,2009
31035,44.4,6334,5947,1,307,1810,39642,2705,2056,649,2705,69400,2009
31037,35.1,10100,6263,0,3767,2567,45919,3569,2932,637,3569,81300,2009
31039,43.3,9330,8403,0,825,2706,41900,3904,2879,1025,3904,89800,2009
31041,44.6,10894,10602,11,144,3091,42282,4612,3422,1190,4612,68600,2009
31043,32.2,20295,12590,22,6092,5469,44564,7408,5097,2311,7408,94600,2009
31045,28.7,8736,7846,175,262,1797,31052,3223,1985,1238,3223,86500,2009
31047,35.6,24789,16218,230,7831,5884,40842,8821,6389,2432,8821,81600,2009
31049,46,1988,1827,1,113,593,38933,925,707,218,925,67000,2009
31051,42.8,6224,5612,4,546,1662,42016,2393,1876,517,2393,77200,2009
31053,40.3,35774,32524,172,2426,9627,44904,14490,9873,4617,14490,111800,2009
31055,33.3,497939,371398,54058,47196,118520,50107,194381,123017,71364,194381,136500,2009
31057,49.1,1939,1841,0,87,597,38346,865,709,156,865,65300,2009
31059,45.2,6051,5720,92,162,1693,42464,2628,1907,721,2628,72400,2009
31061,46.2,3187,3144,0,13,925,35259,1366,1134,232,1366,50900,2009
31063,43.2,2643,2535,0,42,829,41676,1187,886,301,1187,72300,2009
31065,46.9,4681,4521,0,86,1407,38406,2222,1701,521,2222,52000,2009
31067,42.5,22935,22037,55,322,6001,41569,9423,6733,2690,9423,91500,2009
31069,51.8,1856,1777,0,48,588,33692,857,589,268,857,60100,2009
31071,47.9,1902,1853,0,45,574,35455,868,669,199,868,75000,2009
31073,46.4,1932,1866,4,50,578,43487,798,605,193,798,92800,2009
31075,46.2,608,602,0,2,207,37000,280,176,104,280,42700,2009
31077,43.3,2344,2276,21,8,616,38355,901,701,200,901,46200,2009
31079,35.5,55669,42808,724,10862,14642,46215,21302,14390,6912,21302,105400,2009
31081,41.4,9302,9054,13,145,2576,49618,3569,2760,809,3569,102200,2009
31083,47.9,3350,3280,0,38,998,39565,1537,1222,315,1537,66600,2009
31085,46.1,1044,980,0,51,335,39427,502,289,213,502,86200,2009
31087,47.9,2858,2765,8,62,879,36307,1247,975,272,1247,50800,2009
31089,45.5,10258,9970,19,174,2883,37625,4384,3086,1298,4384,79000,2009
31091,51.5,661,661,0,0,192,35547,325,251,74,325,63800,2009
31093,41.5,6459,6280,24,106,1885,44104,2736,2074,662,2736,89100,2009
31095,46.3,7502,7274,0,131,2096,38797,3339,2622,717,3339,75800,2009
31097,42.2,5103,4194,290,420,1280,43631,1981,1510,471,1981,76000,2009
31099,41,6550,6259,13,220,1914,49894,2706,2139,567,2706,96900,2009
31101,45.6,7934,7145,17,406,2367,40826,3673,2411,1262,3673,85900,2009
31103,45.4,863,815,0,43,270,34038,370,288,82,370,64700,2009
31105,45.9,3644,3388,0,170,1070,40233,1651,1116,535,1651,81400,2009
31107,45.5,8566,7623,32,127,2422,35349,3811,2841,970,3811,61300,2009
31109,31.5,274432,237965,8761,12878,67004,50217,108755,67107,41648,108755,143400,2009
31111,39.1,35481,32358,247,2178,9774,44667,14802,10104,4698,14802,103800,2009
31113,44.1,720,680,0,5,227,42857,352,231,121,352,68800,2009
31115,48,550,546,0,0,166,31364,220,168,52,220,80600,2009
31117,39.8,498,492,1,0,166,50833,210,127,83,210,77100,2009
31119,37.2,34727,29409,417,4157,8577,42911,13722,9459,4263,13722,97100,2009
31121,42.7,7672,7371,39,127,2205,46171,3145,2287,858,3145,77800,2009
31123,41,4980,4304,0,603,1531,36986,2150,1486,664,2150,75000,2009
31125,45.2,3552,3440,36,59,921,40729,1406,1044,362,1406,68200,2009
31127,42.8,6980,6684,44,133,1890,41852,2998,2087,911,2998,77100,2009
31129,47.3,4506,4358,44,17,1399,32076,2173,1662,511,2173,52300,2009
31131,42.4,15389,14474,4,650,4342,46160,6372,4682,1690,6372,109800,2009
31133,48,2682,2630,0,18,772,41471,1246,1017,229,1246,52600,2009
31135,44.4,2771,2702,0,45,815,46151,1233,941,292,1233,77200,2009
31137,42.8,9188,8761,1,400,2517,43602,3755,2802,953,3755,82400,2009
31139,41.5,7293,7106,27,92,2051,46579,2942,2244,698,2942,84000,2009
31141,38.6,31771,27793,0,3357,8459,48359,12547,9591,2956,12547,103100,2009
31143,44.9,5164,5007,0,117,1506,44104,2230,1683,547,2230,84500,2009
31145,42.6,10755,10186,19,388,3073,39674,4675,3148,1527,4675,74800,2009
31147,45.8,8358,7841,0,122,2382,36698,3971,3079,892,3971,59800,2009
31149,50.2,1494,1469,0,13,460,34620,703,558,145,703,58100,2009
31151,36.1,13836,11163,88,2169,3329,45893,4992,3376,1616,4992,94800,2009
31153,32.6,146340,125965,4814,8581,39707,65189,54778,38406,16372,54778,151500,2009
31155,41.1,20115,19422,15,392,5877,56495,7896,6464,1432,7896,133200,2009
31157,39,36483,28098,177,7040,9965,37643,15026,9916,5110,15026,93900,2009
31159,37,16575,15928,139,292,4388,54872,6483,4543,1940,6483,130500,2009
31161,46.2,5403,4540,0,142,1457,31003,2421,1587,834,2421,62200,2009
31163,47.6,2962,2886,0,56,956,36741,1424,1183,241,1424,52700,2009
31165,48.2,1218,1162,0,41,378,43313,529,380,149,529,104600,2009
31167,38,6360,6009,0,231,1692,45613,2328,1891,437,2328,85600,2009
31169,48.8,5150,5023,2,72,1456,36719,2304,1901,403,2304,58000,2009
31171,47.4,662,654,1,1,195,41000,314,230,84,314,67800,2009
31173,26.9,7252,2973,35,496,1652,40553,2173,1374,799,2173,63800,2009
31175,46.3,4221,4136,0,83,1189,34211,1952,1450,502,1952,63700,2009
31177,39.7,19724,18919,57,362,5243,60870,7307,5961,1346,7307,164600,2009
31179,24.9,9334,8723,59,291,2209,43956,3278,2216,1062,3278,102700,2009
31181,48.4,3555,3386,44,33,836,37386,1279,984,295,1279,56300,2009
31183,44.1,741,723,0,15,239,42955,326,235,91,326,60400,2009
31185,40.2,14084,13100,153,493,3933,47126,5766,4220,1546,5766,93500,2009
32001,36.7,24704,19235,396,2516,5789,53134,8766,5751,3015,8766,189800,2009
32003,34.4,1821507,943224,170711,508411,441698,56080,672907,396874,276033,672907,278500,2009
32005,46.6,45674,38917,107,4084,13518,63531,18645,14392,4253,18645,393600,2009
32007,33.9,46442,32453,506,10336,12177,63327,17298,11873,5425,17298,169500,2009
32009,54.5,849,682,0,102,216,44118,448,276,172,448,72500,2009
32011,38.9,1387,1253,0,72,370,61472,545,437,108,545,86900,2009
32013,36.7,17630,12449,20,3931,4267,55084,6380,4721,1659,6380,132700,2009
32015,36.5,5047,3303,81,1334,1394,54008,1834,1317,517,1834,99500,2009
32017,32.3,4523,3853,202,230,1060,42955,1480,1061,419,1480,131100,2009
32019,39.3,50931,39998,307,7413,10342,48513,14460,10794,3666,14460,198200,2009
32021,55,4724,3632,47,416,1341,30217,2497,2089,408,2497,95500,2009
32023,47.4,42934,34763,912,4986,9248,42192,13933,10473,3460,13933,168000,2009
32027,39,6329,4252,333,1325,1507,53042,1925,1276,649,1925,123600,2009
32029,45.4,4265,3534,0,275,1392,60925,1980,1698,282,1980,236600,2009
32031,36.1,404495,273679,9040,84204,98647,55525,156427,94476,61951,156427,319500,2009
32033,41.9,9060,6991,60,1119,2285,46148,3600,2673,927,3600,107500,2009
32510,40,55262,40166,743,10839,13527,52096,21053,13158,7895,21053,284500,2009
33001,43,61102,58885,286,647,16642,54565,23929,18485,5444,23929,230900,2009
33003,46.2,47591,46323,159,365,12207,50479,19035,15373,3662,19035,241300,2009
33005,40,77174,73912,366,984,19321,55719,29516,21786,7730,29516,193600,2009
33007,45.1,32217,31208,115,315,9306,42786,14322,10296,4026,14322,126100,2009
33009,39.6,85626,80578,687,1295,20596,52691,32313,22828,9485,32313,206300,2009
33011,37.8,402576,356641,7684,19769,102436,68513,150302,104104,46198,150302,271600,2009
33013,40,148156,141025,1156,2109,37969,62225,55760,40727,15033,55760,242400,2009
33015,40.5,296680,280119,1985,6041,79396,74842,113212,89268,23944,113212,313400,2009
33017,35.8,121656,114387,945,1843,29932,58363,45973,31002,14971,45973,228300,2009
33019,42.4,42641,41204,197,410,12089,50016,17839,12791,5048,17839,179700,2009
34001,39.2,270016,165480,42054,39322,67903,54934,102637,71400,31237,102637,263700,2009
34003,40.7,888546,575928,46943,128482,236314,81350,333412,226017,107395,333412,482400,2009
34005,39.1,446301,323485,70116,24268,116484,75383,165336,130269,35067,165336,264100,2009
34007,36.9,516937,326624,94186,62477,130720,60362,192095,134001,58094,192095,217300,2009
34009,46.3,97127,85772,5217,4318,30447,54441,46709,33943,12766,46709,344900,2009
34011,36,155266,83004,29886,36454,35035,50035,50773,34563,16210,50773,168400,2009
34013,35.8,771353,272774,306072,142969,184756,54176,278722,130131,148591,278722,394300,2009
34015,37.8,284552,235238,27227,10440,72932,71883,100680,81657,19023,100680,230900,2009
34017,34.4,593615,203611,72039,241075,137952,53475,230449,78261,152188,230449,381800,2009
34019,41.9,129517,114670,3494,5559,34273,102500,46786,40788,5998,46786,452100,2009
34021,36.9,363778,212436,69854,46694,86378,71767,127437,87225,40212,127437,311700,2009
34023,36.6,781957,420020,72462,133445,194670,76321,271722,183075,88647,271722,354600,2009
34025,40.3,641984,500022,47693,53932,162226,82013,231057,176245,54812,231057,429000,2009
34027,40.1,485828,373504,14624,51079,127502,96316,174940,134040,40900,174940,477200,2009
34029,42.5,565428,493541,17856,38573,150745,59939,220656,183734,36922,220656,298600,2009
34031,36,488793,233523,57378,168956,113325,54888,159616,89570,70046,159616,384000,2009
34033,39.7,65982,51130,9703,3620,17476,59452,25194,19107,6087,25194,187400,2009
34035,39,320712,212355,26203,38381,82523,96233,113514,90376,23138,113514,432900,2009
34037,40.3,151239,135648,2734,8583,41539,81488,55079,46550,8529,55079,324500,2009
34039,37.6,522050,251307,108689,130219,129444,66433,183687,114112,69575,183687,396100,2009
34041,40.3,109567,95156,3308,6942,29996,69767,42376,31824,10552,42376,310500,2009
35001,35,626822,271103,17482,286081,157038,46121,255627,164367,91260,255627,178900,2009
35003,59.6,3410,2675,2,596,1062,30413,1773,1585,188,1773,129400,2009
35005,35,62365,29053,384,30353,16108,36445,23102,16016,7086,23102,80800,2009
35006,35.5,27120,6372,105,9076,5776,36146,8040,5521,2519,8040,71800,2009
35007,45.5,13133,6492,25,6283,3437,39249,5776,3901,1875,5776,104500,2009
35009,30.4,44986,22768,3536,16232,12058,36621,17699,10620,7079,17699,89400,2009
35011,47.6,1934,1320,5,588,553,27821,899,699,200,899,66600,2009
35013,31,197819,60782,3309,128258,48268,35544,69544,45986,23558,69544,128500,2009
35015,37.3,51348,27441,659,21743,13527,44510,19423,14286,5137,19423,86100,2009
35017,44.6,29723,14466,120,14270,8456,35896,12022,9002,3020,12022,124800,2009
35019,37.4,4365,785,14,3388,1019,29085,1416,991,425,1416,79500,2009
35021,53.9,655,276,6,349,184,31042,307,278,29,307,65300,2009
35023,39.1,5001,2108,36,2764,1318,39020,1876,1255,621,1876,90500,2009
35025,31.5,58058,26654,2904,27430,15674,42816,21271,14923,6348,21271,81100,2009
35027,47.3,20888,13841,74,6122,4974,44079,8057,6306,1751,8057,151300,2009
35028,42.6,18431,14033,97,2674,5431,100423,7803,6073,1730,7803,287900,2009
35029,37.8,26724,9889,157,16108,6436,26661,9723,7063,2660,9723,85100,2009
35031,29.7,70388,8321,675,9897,12674,32615,18130,13505,4625,18130,70500,2009
35033,44.1,5020,699,1,4276,1290,33622,2136,1755,381,2136,111900,2009
35035,35.6,63206,33130,2761,21910,16938,38262,24477,16336,8141,24477,97400,2009
35037,45.1,9007,5032,58,3554,2347,29797,3852,2866,986,3852,68700,2009
35039,37.2,40674,5549,148,29355,9882,42514,13886,11142,2744,13886,143900,2009
35041,26.1,18854,10756,472,7027,4360,32169,6737,4148,2589,6737,82700,2009
35043,36.8,116811,57223,2562,37907,31063,56703,42891,34721,8170,42891,175000,2009
35045,32.4,122470,52493,976,21645,29200,45361,39264,29806,9458,39264,136800,2009
35047,38.7,28600,5490,258,22100,6553,30956,10852,7200,3652,10852,105000,2009
35049,40.6,143501,63119,984,72222,32521,52923,54604,39118,15486,54604,287700,2009
35051,51.5,12645,8477,24,3763,3073,25642,5486,4307,1179,5486,87400,2009
35053,34.9,18163,6731,169,8634,3960,32329,6243,4626,1617,6243,105700,2009
35055,43.8,31444,11579,74,17405,6938,35800,11978,8842,3136,11978,204100,2009
35057,38.7,16566,9196,73,6342,3697,35146,5618,4698,920,5618,91300,2009
35059,36.6,3755,2291,12,1433,1055,37415,1535,1110,425,1535,89700,2009
35061,36,70974,26800,978,39695,18109,42955,24583,19619,4964,24583,124700,2009
36001,38,298341,235266,33461,11794,70786,55350,122525,73507,49018,122525,192500,2009
36003,36.3,49391,47201,490,567,12198,40917,18646,13960,4686,18646,65100,2009
36005,32.6,1381529,176207,423086,706905,311354,33794,472913,101971,370942,472913,369600,2009
36007,39.9,195209,172522,7895,4969,48903,43467,80207,53629,26578,80207,95600,2009
36009,40.1,80349,74650,954,961,21433,41482,32639,23981,8658,32639,76000,2009
36011,40.3,79994,73501,2866,1767,20563,47414,31760,22745,9015,31760,95000,2009
36013,40,134078,121839,2455,6554,34934,40179,54457,38094,16363,54457,77800,2009
36015,40.3,88161,78569,4919,1893,22724,42420,35230,23978,11252,35230,84000,2009
36017,42,50956,48809,464,796,13763,43991,19992,15610,4382,19992,84900,2009
36019,37.8,81755,74962,2567,2232,19413,47786,30389,21643,8746,30389,112400,2009
36021,44,62217,55616,3052,1962,16369,54573,25359,18510,6849,25359,212200,2009
36023,35.8,48207,45580,740,837,11433,44853,17877,11759,6118,17877,91200,2009
36025,44.5,46194,43163,656,1319,12334,41656,19101,14389,4712,19101,126300,2009
36027,39.2,292187,224210,26462,25759,70509,68472,102856,73609,29247,102856,324400,2009
36029,40,914200,728232,119149,34497,232748,46609,380565,253085,127480,380565,112800,2009
36031,42.9,37927,34253,1157,895,10268,44930,15639,11190,4449,15639,146300,2009
36033,39.3,50374,41288,3458,2084,12609,40587,18795,13698,5097,18795,85200,2009
36035,41.8,55031,51630,886,1293,15165,41425,22551,16180,6371,22551,91300,2009
36037,41.1,58208,54131,1231,1216,15596,48197,23208,17079,6129,23208,98200,2009
36039,41.4,49071,42712,2906,2527,11452,46213,18211,13428,4783,18211,179100,2009
36041,49.9,5011,4820,32,13,1601,45242,2406,2053,353,2406,170700,2009
36043,41.3,62439,59889,484,883,16933,42048,25513,18293,7220,25513,86200,2009
36045,33.6,117595,102011,5420,5311,31033,43447,43938,26404,17534,43938,108900,2009
36047,34.2,2538140,929264,839805,497283,568213,42894,885197,272665,612532,885197,547200,2009
36049,40.2,26205,25342,187,264,7765,41719,11121,8475,2646,11121,95400,2009
36051,38.4,63162,58319,1655,1630,14791,51698,22664,17330,5334,22664,110400,2009
36053,38.6,69868,66199,1168,983,17474,51670,25881,19733,6148,25881,105400,2009
36055,38.2,731621,553804,101046,43129,179175,51105,286327,192577,93750,286327,126700,2009
36057,41.2,48632,42625,600,4355,12822,42716,19857,13954,5903,19857,91900,2009
36059,40.7,1354141,937436,142351,164701,334876,92450,435764,362098,73666,435764,490300,2009
36061,36.6,1620962,807538,216992,397003,300335,66818,742486,177072,565414,742486,800400,2009
36063,41,214613,189865,13677,3682,56488,45749,87854,62703,25151,87854,94900,2009
36065,40.3,231029,201449,12315,9227,59815,45433,92544,63098,29446,92544,97000,2009
36067,38.4,453846,372379,43841,13445,112968,50129,183481,121896,61585,183481,119600,2009
36069,41.5,104205,96361,2069,3031,27493,55300,41469,31192,10277,41469,125700,2009
36071,36,376548,265925,34281,59883,89903,69255,123349,87858,35491,123349,315000,2009
36073,39.7,42380,36895,2733,1799,10378,46418,15243,11602,3641,15243,84600,2009
36075,37.8,121588,116284,1073,1944,30891,45071,46566,34346,12220,46566,84900,2009
36077,39.9,62086,58012,1162,1455,15780,44057,25271,18009,7262,25271,123900,2009
36079,40.2,99111,83452,2091,10000,25819,88036,33864,28724,5140,33864,421200,2009
36081,37.4,2278860,707971,412431,599532,528428,54870,779776,361944,417832,779776,470500,2009
36083,39.1,155043,136349,6743,4392,38891,54221,61211,40704,20507,61211,162700,2009
36085,38.1,483168,324078,45361,72724,124604,71206,166783,118625,48158,166783,461000,2009
36087,37.5,297298,204903,32271,38500,70912,82368,94154,68576,25578,94154,481300,2009
36089,36.8,109742,102216,3039,2123,26938,41670,40819,29369,11450,40819,76800,2009
36091,39.6,216491,202323,3038,4425,56913,64705,84165,62939,21226,84165,211700,2009
36093,39.7,150474,120785,11960,6674,36646,54468,58188,40683,17505,58188,153300,2009
36095,40.9,31813,30121,389,704,8381,49695,12349,9554,2795,12349,133400,2009
36097,42.2,18896,17927,366,282,5275,44575,7612,5986,1626,7612,86600,2009
36099,40.3,34181,30767,1512,1031,8670,45571,12229,9513,2716,12229,87500,2009
36101,40.8,96674,91806,1418,1096,26204,42812,39397,28791,10606,39397,79500,2009
36103,39,1511028,1136925,104806,198965,362602,84530,478858,396766,82092,478858,430000,2009
36105,41,75924,58248,6042,8900,19703,48586,29389,20282,9107,29389,181000,2009
36107,41.3,50367,48292,209,694,14261,51011,20124,15981,4143,20124,94800,2009
36109,28.3,100583,81430,3244,3832,19779,46506,37807,20606,17201,37807,155000,2009
36111,40.6,181510,151810,9761,13237,45113,57485,69867,48189,21678,69867,239500,2009
36113,42.5,65743,62907,503,1060,17591,50168,27425,18991,8434,27425,169900,2009
36115,40.9,62486,58158,1784,1454,16456,46886,24400,17962,6438,24400,128400,2009
36117,40.6,91658,83828,3264,2850,25621,52351,36048,27726,8322,36048,105400,2009
36119,39.4,949050,576874,126634,177306,231869,79585,338527,213499,125028,338527,559800,2009
36121,40.2,41820,37497,2472,1368,10446,48943,15058,11711,3347,15058,93200,2009
36123,40.1,24526,23676,216,356,6162,44947,9112,6998,2114,9112,110900,2009
37001,37.4,144769,99010,25852,15296,39665,44172,57865,39852,18013,57865,133700,2009
37003,39.9,36278,32036,2039,1217,8876,41520,13139,10674,2465,13139,116400,2009
37005,45,10905,8957,77,1624,3150,32541,4793,3609,1184,4793,131400,2009
37007,39.2,25243,12244,12082,358,6377,33706,8892,6201,2691,8892,80000,2009
37009,44.6,25467,24105,115,898,7747,35312,11339,8939,2400,11339,138600,2009
37011,39.9,17903,16043,473,654,4562,34676,7067,5002,2065,7067,145000,2009
37013,43.5,45993,31031,12585,2000,13467,39817,19248,14350,4898,19248,99400,2009
37015,42.5,19187,6788,11993,218,5055,27487,7766,5730,2036,7766,74200,2009
37017,39.1,32412,17952,11236,1929,8358,30823,12769,8789,3980,12769,73100,2009
37019,46.1,98712,81219,9068,3694,29835,44321,44295,33794,10501,44295,183300,2009
37021,40.4,225869,194286,15583,9522,59397,43750,96465,65536,30929,96465,179700,2009
37023,40.1,88987,74124,5751,4548,23178,36061,33964,25090,8874,33964,103900,2009
37025,35.8,161473,119764,22579,13641,43636,54274,61504,45245,16259,61504,155900,2009
37027,40.1,79382,70731,3878,3146,21362,37308,30876,23189,7687,30876,106400,2009
37029,40.2,9375,7466,1551,90,2583,58480,3484,2832,652,3484,216600,2009
37031,44.8,63369,55754,4342,1452,17959,46982,27409,20541,6868,27409,198700,2009
37033,41.6,23228,14437,7917,608,5991,36414,8670,6548,2122,8670,93200,2009
37035,38.5,155157,122300,12133,13422,40075,43303,59297,43151,16146,59297,126800,2009
37037,40.6,61444,43713,8201,7511,16271,55333,23105,18121,4984,23105,184000,2009
37039,46.6,26203,24439,125,392,7825,37708,11015,8984,2031,11015,135800,2009
37041,41.9,14629,8899,5196,310,3705,37825,5661,3954,1707,5661,123400,2009
37043,49,10084,9657,244,147,3014,35089,4590,3773,817,4590,151600,2009
37045,39.3,98331,74253,20087,2096,27014,37889,37851,26368,11483,37851,100000,2009
37047,39.1,54050,33497,16417,1746,14738,32283,21000,14901,6099,21000,86700,2009
37049,36.8,96789,67235,22472,3675,27962,44298,39768,25337,14431,39768,144200,2009
37051,30,309316,159170,107698,18981,80280,42733,115669,66656,49013,115669,110300,2009
37053,39.9,23713,20974,1704,513,6803,55261,9303,7616,1687,9303,233100,2009
37055,43.3,33976,31060,1245,1178,9681,52173,15683,11146,4537,15683,343200,2009
37057,39.1,156033,129058,14290,8866,43551,44016,62113,45478,16635,62113,123300,2009
37059,40.9,40297,34463,2841,2495,11957,51110,15304,12821,2483,15304,155000,2009
37061,35.4,52358,27454,13424,10734,11630,33703,17779,12669,5110,17779,82200,2009
37063,33.1,256296,117384,92959,28999,61135,49928,103268,57688,45580,103268,173200,2009
37065,37.8,52586,20267,29469,2179,15051,30734,21921,13227,8694,21921,81100,2009
37067,37.1,346851,215325,86611,34632,88186,47438,136250,91130,45120,136250,146300,2009
37069,38.1,57201,36907,15161,3987,15212,43446,21033,16236,4797,21033,117300,2009
37071,37.8,202149,157338,28339,10944,54367,42110,77212,53906,23306,77212,115300,2009
37073,41.6,11555,7071,4145,131,3050,47217,4001,3251,750,4001,109800,2009
37075,42.1,7964,7106,21,145,2280,27786,3709,2840,869,3709,103700,2009
37077,37.5,55670,32372,18418,3608,13794,48186,19406,14607,4799,19406,127700,2009
37079,35.6,20402,9621,7817,2492,4700,38657,6603,4588,2015,6603,86100,2009
37081,36,464041,269406,142156,27592,117248,46100,186377,117528,68849,186377,149500,2009
37083,40.6,55118,22413,28731,728,14497,29681,21595,14128,7467,21595,84100,2009
37085,33.5,108885,72112,23230,9171,27961,42369,39356,26925,12431,39356,118500,2009
37087,44.6,56535,53680,680,1156,16725,39676,24875,18820,6055,24875,150900,2009
37089,44.6,100333,86618,3153,8487,28429,44899,42322,32449,9873,42322,175400,2009
37091,38.8,23281,8071,13839,478,5598,30958,8572,5642,2930,8572,80800,2009
37093,30.8,42410,18268,13837,4619,9833,41595,13493,10294,3199,13493,108600,2009
37095,40.7,5256,2917,2005,298,1142,40488,1806,1429,377,1806,94100,2009
37097,38.1,150346,119162,18414,8270,41196,48234,57650,42857,14793,57650,154100,2009
37099,37.1,36447,30253,820,912,9551,37672,15324,9951,5373,15324,156500,2009
37101,35.5,156888,112543,24290,17017,40667,49897,56255,41159,15096,56255,131500,2009
37103,42.4,10028,6157,3305,388,2741,33563,4019,2873,1146,4019,85700,2009
37105,38.1,57919,36229,11147,9119,14669,43330,20881,14941,5940,20881,129100,2009
37107,40.7,56831,30380,22701,2812,15683,32188,24697,14943,9754,24697,91500,2009
37109,38.9,72728,61155,4322,6042,20714,47859,27873,21190,6683,27873,136900,2009
37111,40,43587,38904,1533,1957,11202,37374,16949,12573,4376,16949,96500,2009
37113,47.5,32607,30541,449,982,9920,38351,14747,11497,3250,14747,167900,2009
37115,42.2,20227,19307,276,354,5600,37500,8144,6115,2029,8144,152100,2009
37117,42.6,23699,12229,10076,743,6820,32121,9753,6700,3053,9753,77800,2009
37119,33.7,861189,476421,245628,86641,220169,55587,352540,222017,130523,352540,180100,2009
37121,43.8,15690,14854,71,581,4392,33118,6585,4953,1632,6585,108700,2009
37123,38.4,27456,17121,5334,4167,6389,33223,9630,7252,2378,9630,81500,2009
37125,44.1,84280,65527,12388,4761,21770,46940,32100,24592,7508,32100,170700,2009
37127,39,92814,53118,33553,4239,24476,42909,36602,23455,13147,36602,115700,2009
37129,36.9,189463,148419,29292,6167,48008,47644,82156,50500,31656,82156,218300,2009
37131,44.4,20611,8223,11877,230,4776,29349,7959,5881,2078,7959,72300,2009
37133,23.9,165181,116513,27538,11602,41162,41725,55769,31097,24672,55769,127000,2009
37135,32.2,124503,90843,16660,7165,29327,49836,50010,29780,20230,50010,239500,2009
37137,46.5,12470,9229,2813,175,3832,37936,5405,4312,1093,5405,115500,2009
37139,34.9,40334,22811,15456,922,10170,44319,14341,9339,5002,14341,163000,2009
37141,40.5,49408,36464,9577,2628,13865,42760,19729,15776,3953,19729,130800,2009
37143,45.6,12367,8941,3298,128,3773,37798,5113,3812,1301,5113,145800,2009
37145,40.6,37301,25173,10181,1076,10276,44381,14910,10696,4214,14910,114900,2009
37147,30.5,151931,90368,50107,6616,36227,36732,63161,34185,28976,63161,120400,2009
37149,48.8,19107,17114,1048,788,5350,39246,8252,6486,1766,8252,168300,2009
37151,38.7,139443,114622,7795,14029,38200,39642,54238,39510,14728,54238,117100,2009
37153,37,45947,28173,14036,1996,12411,29403,18260,12829,5431,18260,67500,2009
37155,33.4,127686,36988,30328,10385,29877,28426,43530,29527,14003,43530,68100,2009
37157,41,92007,68456,17303,4549,26055,38160,37565,26826,10739,37565,100800,2009
37159,38.8,137387,104011,20682,8531,37360,45253,52989,38626,14363,52989,122900,2009
37161,41.1,63153,53735,6821,1424,17685,34881,26352,18820,7532,26352,98400,2009
37163,36.6,62996,33709,17402,9772,15933,34779,22624,15689,6935,22624,86700,2009
37165,36.3,36394,17901,13825,518,9359,31439,13233,8556,4677,13233,79400,2009
37167,39.2,59136,48334,6671,1942,15987,43491,22717,17160,5557,22717,121900,2009
37169,41.2,45916,42104,2249,1086,13314,39975,18100,14691,3409,18100,114700,2009
37171,40.5,72166,61736,2577,6526,19469,36511,28681,21460,7221,28681,99100,2009
37173,40.5,13367,8949,118,366,3688,33272,5608,4292,1316,5608,121900,2009
37175,47.3,29886,27344,1492,427,8364,38446,12613,9620,2993,12613,167200,2009
37177,43.3,4112,2330,1568,177,1291,30313,1744,1350,394,1744,107400,2009
37179,35.2,181852,137396,21835,17508,49042,60074,62005,49564,12441,62005,190000,2009
37181,36.9,42987,18707,20796,2689,11180,33874,16107,10781,5326,16107,94500,2009
37183,33.8,828759,540076,165505,68397,203106,64008,310280,206591,103689,310280,213200,2009
37185,42.6,19545,7446,10219,532,5030,27876,7594,5982,1612,7594,93400,2009
37187,42.8,12979,5873,6466,473,3287,32845,4936,3463,1473,4936,88100,2009
37189,27.8,44636,42043,569,874,9986,33801,18497,10449,8048,18497,199600,2009
37191,36,113290,66067,36176,7774,31328,40325,44851,28314,16537,44851,102800,2009
37193,40,66563,59270,2691,3461,18623,34154,26614,19888,6726,26614,105100,2009
37195,38.3,76765,39237,29554,6459,20377,38712,30399,18454,11945,30399,108800,2009
37197,41.2,37520,32445,1350,3287,10073,38105,14822,11557,3265,14822,104200,2009
37199,43.6,18336,17028,63,949,5301,34949,7412,5812,1600,7412,132500,2009
38001,49.5,2291,2203,0,0,623,35550,1001,690,311,1001,71800,2009
38003,43.9,10840,10445,38,88,3083,41911,4992,3388,1604,4992,78400,2009
38005,30.1,6889,3110,21,100,1665,30809,2362,1462,900,2362,42400,2009
38007,45.4,912,904,0,0,260,55192,380,320,60,380,85000,2009
38009,48,6427,6044,17,47,1932,39643,2862,2289,573,2862,70600,2009
38011,47,2944,2883,0,36,903,47232,1304,1007,297,1304,83500,2009
38013,50.9,2027,1982,0,11,644,49013,1013,834,179,1013,38600,2009
38015,36.6,77049,71126,314,1071,20320,52070,31717,22291,9426,31717,141700,2009
38017,30.4,137803,125881,2676,3194,34046,45891,61067,32704,28363,61067,144200,2009
38019,50.5,3905,3830,1,0,1263,47143,1760,1461,299,1760,55900,2009
38021,42,5341,5069,11,114,1313,36896,2188,1554,634,2188,66500,2009
38023,50.8,1863,1807,2,38,572,46953,898,738,160,898,52200,2009
38025,44.5,3318,2777,0,42,883,45270,1306,1111,195,1306,71300,2009
38027,44.7,2417,2234,31,25,661,38050,1051,835,216,1051,46100,2009
38029,49.6,3542,3511,7,3,1046,33947,1631,1297,334,1631,55300,2009
38031,46.6,3424,3393,0,20,1040,40801,1617,1227,390,1617,74000,2009
38033,44.5,1533,1498,0,6,417,29226,748,584,164,748,56600,2009
38035,26.6,66573,59988,1032,2057,14795,42360,26817,13932,12885,26817,131600,2009
38037,48.1,2525,2387,1,0,787,41875,1169,920,249,1169,56400,2009
38039,51.6,2310,2297,0,0,677,38952,1166,873,293,1166,53300,2009
38041,51.3,2407,2377,16,0,801,39018,1197,992,205,1197,51900,2009
38043,48.5,2298,2271,0,15,709,38438,1142,884,258,1142,58500,2009
38045,47.8,4085,4027,2,40,1236,41992,1895,1570,325,1895,58700,2009
38047,51.4,1946,1935,0,5,522,40917,788,643,145,788,53600,2009
38049,45.3,5275,5161,0,39,1446,37039,2579,1960,619,2579,64000,2009
38051,51.1,2754,2721,6,3,791,37500,1232,1021,211,1232,48100,2009
38053,41.8,5594,4199,29,95,1525,46330,2298,1576,722,2298,83300,2009
38055,48.8,8360,7597,14,94,2657,50679,3851,2991,860,3851,87300,2009
38057,45.3,7955,7556,49,31,2593,57640,3640,2966,674,3640,87300,2009
38059,39.6,25850,24277,77,268,7037,48791,10578,8239,2339,10578,103600,2009
38061,39.7,6540,4040,26,176,1792,46821,2559,1934,625,2559,59300,2009
38063,50.4,3234,3157,0,40,810,36336,1497,1232,265,1497,50300,2009
38065,49.1,1624,1560,0,11,557,61607,729,621,108,729,79400,2009
38067,45.6,7607,6954,8,326,2284,45457,3389,2667,722,3389,70100,2009
38069,47.6,4101,3778,3,64,1045,34668,1747,1264,483,1747,74000,2009
38071,42.5,11254,9945,21,123,3159,43009,4900,3245,1655,4900,85700,2009
38073,42.6,5670,5504,10,62,1627,43944,2432,1739,693,2432,84400,2009
38075,45.4,2291,2232,0,9,707,43137,1082,793,289,1082,58100,2009
38077,38.7,16563,15570,61,264,4107,45403,6677,4585,2092,6677,89100,2009
38079,29.1,13672,3313,50,94,3135,30921,4515,3139,1376,4515,58900,2009
38081,45.1,4058,3916,16,25,1168,47652,1820,1407,413,1820,72300,2009
38083,53.5,1320,1278,0,0,491,35968,686,566,120,686,50000,2009
38085,25.8,4144,707,0,30,768,29858,1028,478,550,1028,57700,2009
38087,44.9,703,692,1,6,212,42679,325,253,72,325,59800,2009
38089,37.6,22393,21467,82,329,6048,46422,9467,6769,2698,9467,104700,2009
38091,43.9,1929,1876,0,40,583,45037,855,668,187,855,60700,2009
38093,41.9,20550,19618,59,283,5307,42480,8760,5819,2941,8760,90000,2009
38095,48.1,2318,2188,9,15,694,42681,1142,835,307,1142,45000,2009
38097,41.7,7997,7612,30,225,2167,44385,3367,2555,812,3367,85600,2009
38099,44.6,11052,9749,15,1012,3004,42300,4885,3687,1198,4885,62500,2009
38101,32.5,56353,50674,1040,1716,15700,47683,23966,14974,8992,23966,111800,2009
38103,48.9,4251,4169,0,7,1309,38209,2138,1662,476,2138,55700,2009
38105,40.9,19644,17828,55,272,5715,52139,8820,6067,2753,8820,87300,2009
39001,38.1,28142,27224,100,214,7300,33850,10222,7428,2794,10222,95400,2009
39003,37.9,104946,87847,11772,1958,27750,43433,40961,28982,11979,40961,101700,2009
39005,38.1,54622,52673,357,458,14096,45556,19971,15785,4186,19971,129400,2009
39007,40.3,101375,92830,3079,3237,26655,41498,39039,28257,10782,39039,118000,2009
39009,24.4,63073,58272,1687,819,12102,30190,21898,12670,9228,21898,110500,2009
39011,39.4,46620,45085,170,399,13283,52185,18275,14291,3984,18275,122200,2009
39013,42.6,68372,63924,2659,348,19253,37753,28343,20883,7460,28343,82900,2009
39015,38.2,43823,42531,485,248,12003,45169,16237,12766,3471,16237,122100,2009
39017,35.4,356878,310628,23152,9695,91298,54344,130922,92727,38195,130922,157100,2009
39019,42.2,28752,27940,337,112,8010,42375,11336,9270,2066,11336,110400,2009
39021,39.3,39549,37357,853,411,11140,49335,15330,11509,3821,15330,126100,2009
39023,39.8,140419,121749,12052,2572,37052,43870,55575,39616,15959,55575,110300,2009
39025,37.3,193377,184412,2409,2462,52034,57217,71633,54576,17057,71633,160700,2009
39027,37.4,42820,40265,794,584,11688,47842,16411,11550,4861,16411,126800,2009
39029,41.3,108683,103277,2107,1445,29406,40551,41758,31687,10071,41758,97200,2009
39031,40.1,36215,34767,468,355,9635,40021,14157,10510,3647,14157,96000,2009
39033,40.9,44181,42683,287,482,12754,41575,18633,13454,5179,18633,93600,2009
39035,39.2,1296287,822990,370223,55305,322396,43145,542058,337974,204084,542058,135900,2009
39037,40.1,52196,50590,187,589,14604,45165,20633,16239,4394,20633,114600,2009
39039,39,38516,34133,530,3147,10927,45079,15319,12049,3270,15319,106400,2009
39041,36.2,159868,142027,5943,2921,45353,85054,58220,48575,9645,58220,248600,2009
39043,42.6,77400,66881,6467,1976,21468,46403,31755,23205,8550,31755,137300,2009
39045,37.1,140842,126869,8282,1858,38688,56955,51974,39996,11978,51974,166600,2009
39047,38.4,28205,26496,677,521,8024,40249,11655,7559,4096,11655,113600,2009
39049,33.1,1124073,796393,214573,45016,269061,49041,453580,264118,189462,453580,153700,2009
39051,39.2,42482,38726,162,2893,11932,50262,16193,13161,3032,16193,134700,2009
39053,38.7,30837,29084,919,123,8217,36675,11862,8616,3246,11862,95400,2009
39055,41.9,98143,94403,1426,836,25537,67596,33569,29326,4243,33569,231400,2009
39057,36.7,158389,137616,9802,3024,42357,57011,61825,42344,19481,61825,156000,2009
39059,40,40332,38365,506,360,11216,37193,16720,12121,4599,16720,90300,2009
39061,36.8,851867,598413,205471,16151,198184,48363,333773,207500,126273,333773,146100,2009
39063,37.5,74058,67905,932,2745,20864,48369,31649,22438,9211,31649,131000,2009
39065,34.2,31739,30563,219,321,7829,41423,11941,8420,3521,11941,103300,2009
39067,43.7,15430,14773,432,69,4048,35493,6252,4914,1338,6252,77600,2009
39069,38.5,28976,26370,222,1937,7929,49417,11347,9128,2219,11347,116900,2009
39071,37.4,42384,40538,492,323,11161,40138,15861,11862,3999,15861,105700,2009
39073,39.8,28857,27763,291,173,7796,40618,10938,8265,2673,10938,115400,2009
39075,29.2,41452,40718,94,330,9173,45171,11441,9100,2341,11441,153200,2009
39077,37.2,59997,55211,442,3221,16667,46898,23109,17122,5987,23109,119700,2009
39079,38.8,33342,32101,235,471,8979,34128,13196,9421,3775,13196,87800,2009
39081,43.8,68762,62992,3582,575,19214,37097,29481,21482,7999,29481,83600,2009
39083,38.2,58871,56776,465,589,15126,45525,21599,16599,5000,21599,129000,2009
39085,41.4,234634,215216,6034,7552,61887,54616,93121,72000,21121,93121,159100,2009
39087,39.3,62683,59926,1366,458,17023,34596,24661,18117,6544,24661,90200,2009
39089,38.5,156414,146714,4210,1675,42743,53200,59958,45043,14915,59958,150300,2009
39091,39.1,46430,44000,606,424,12667,47579,18463,13474,4989,18463,122200,2009
39093,38.8,302811,246536,23602,23312,78081,51981,111780,83617,28163,111780,145700,2009
39095,36.2,464956,342417,81710,25592,111553,42696,180029,119897,60132,180029,120700,2009
39097,38.1,41629,37631,2585,406,10167,53041,14533,10437,4096,14533,144200,2009
39099,42,241071,190076,37729,8670,65317,38977,100368,72619,27749,100368,95800,2009
39101,38.4,65593,59048,2695,1063,16875,40936,24838,17727,7111,24838,98500,2009
39103,39.2,169946,161664,2432,2330,47092,66458,62333,51635,10698,62333,182600,2009
39105,40.7,22898,22162,274,171,6418,33928,9539,7540,1999,9539,80000,2009
39107,38.1,40761,39504,84,617,11223,50685,15215,12370,2845,15215,123300,2009
39109,39.8,100982,95032,2228,1104,28180,51827,39597,28611,10986,39597,137900,2009
39111,44.2,14276,14011,20,46,4132,34621,5972,4719,1253,5972,86300,2009
39113,38.2,538299,401719,108330,10207,138436,43815,223859,144212,79647,223859,117700,2009
39115,42.7,14495,13435,470,86,4195,33601,6206,4929,1277,6206,86100,2009
39117,38.2,34435,33328,33,357,9247,48907,12234,10148,2086,12234,126800,2009
39119,38.8,85099,79291,2788,528,22089,39582,32405,23546,8859,32405,110800,2009
39121,35.7,14242,12943,1040,96,3345,42961,4612,3544,1068,4612,86300,2009
39123,44.4,41132,38575,457,1723,12329,53277,17861,14501,3360,17861,141200,2009
39125,40.1,19186,17962,128,697,5598,45716,7752,6366,1386,7752,87500,2009
39127,37.4,35080,34272,109,135,9068,42299,12678,9578,3100,12678,100800,2009
39129,37.9,53864,49572,2506,468,12951,48985,17885,13416,4469,17885,140900,2009
39131,37.9,27855,26621,241,223,8070,35412,10897,7596,3301,10897,95800,2009
39133,37,156001,144043,6032,1457,39645,50079,60135,41877,18258,60135,153200,2009
39135,40.6,41689,40607,124,241,11829,48743,16528,13046,3482,16528,119900,2009
39137,37.9,34529,32252,62,1884,9630,55630,12694,10805,1889,12694,128800,2009
39139,39.8,125791,109122,11592,1458,33727,42233,49595,35491,14104,49595,111600,2009
39141,38.2,75629,68271,3832,585,18615,41641,27126,20152,6974,27126,107300,2009
39143,39.7,60659,52975,1634,4871,16525,47699,23877,17874,6003,23877,116900,2009
39145,37.9,76310,71682,1948,594,20715,31445,30668,20932,9736,30668,82600,2009
39147,38.7,56711,52243,1213,2332,15597,43397,22453,16889,5564,22453,100800,2009
39149,37.1,48712,45564,920,638,13387,49323,18441,13738,4703,18441,124900,2009
39151,40.3,379468,337162,27013,4521,101185,44999,150562,106891,43671,150562,127100,2009
39153,39.1,544221,442590,75347,6776,142445,47776,221765,155308,66457,221765,139600,2009
39155,41.8,213350,189930,17153,2206,57568,42407,87790,65337,22453,87790,102000,2009
39157,40.3,91243,88194,822,1101,24129,42995,35580,26668,8912,35580,109100,2009
39159,36,47406,43791,1239,574,12852,69079,17309,13572,3737,17309,169400,2009
39161,39.2,28846,27601,165,596,8159,44526,11565,9453,2112,11565,88000,2009
39163,37.7,13274,12893,173,20,3501,33873,4928,3750,1178,4928,80500,2009
39165,36.8,203129,183842,6302,3684,54605,70939,70946,57040,13906,70946,192600,2009
39167,41.3,61461,59351,472,378,17071,40727,25166,18794,6372,25166,108100,2009
39169,37.6,113828,108403,1587,1429,30536,48474,42825,31936,10889,42825,134800,2009
39171,39.7,38204,35965,332,1330,10745,44734,15460,11724,3736,15460,99400,2009
39173,34.4,124975,114880,2058,4963,30717,52818,48242,33805,14437,48242,150800,2009
39175,40.2,22499,21601,33,489,6322,47683,9062,6866,2196,9062,105200,2009
40001,34.2,21822,10167,0,1030,5822,29798,7686,5702,1984,7686,73400,2009
40003,45,5571,4815,220,130,1449,39641,2093,1654,439,2093,46500,2009
40005,38.5,14424,10679,863,338,3179,30990,4989,3786,1203,4989,65700,2009
40007,42.4,5311,4253,3,871,1691,47753,2237,1608,629,2237,67600,2009
40009,35.2,20268,16800,489,1523,4968,41225,7467,4851,2616,7467,85300,2009
40011,36,12625,8461,1042,1646,2621,39068,4142,3212,930,4142,62700,2009
40013,36,39467,30213,649,1633,10066,35598,15207,10182,5025,15207,83500,2009
40015,37.4,29505,18022,1012,2692,7760,36989,10927,7771,3156,10927,62400,2009
40017,35.9,103588,85514,2634,5766,27967,59015,36863,29017,7846,36863,125100,2009
40019,38.5,47388,35664,3685,1907,12654,38132,18579,12906,5673,18579,83000,2009
40021,32.2,45241,24304,876,2917,10503,30635,16406,10497,5909,16406,89300,2009
40023,39.7,14987,10066,1544,345,4095,26403,6317,4270,2047,6317,63500,2009
40025,43.8,2652,2053,7,574,756,31655,1167,848,319,1167,48800,2009
40027,32.2,235855,184526,9881,13797,58904,51068,90223,60470,29753,90223,126500,2009
40029,39.8,5697,4071,17,193,1524,28911,2344,1659,685,2344,58900,2009
40031,31.2,112828,69730,19432,10863,29007,43024,41677,24645,17032,41677,93700,2009
40033,38.4,6351,5071,197,394,1833,42386,2654,1897,757,2654,70200,2009
40035,40.8,15079,10005,486,290,4028,39335,5604,4308,1296,5604,87200,2009
40037,39.8,68974,55501,1517,1799,18888,41260,26592,19974,6618,26592,94200,2009
40039,30.1,26012,19582,853,3093,6774,38537,10528,6432,4096,10528,83300,2009
40041,43,40076,27557,152,1098,11198,35937,15411,11936,3475,15411,90000,2009
40043,45.2,4391,3825,43,202,1279,36173,1866,1545,321,1866,73500,2009
40045,45.9,3855,3542,25,196,1106,40401,1653,1313,340,1653,64200,2009
40047,37.6,57700,48411,1572,3898,15631,40720,23466,16024,7442,23466,80300,2009
40049,39.7,27027,21934,817,1327,7434,35972,10186,7772,2414,10186,71300,2009
40051,37.1,50434,42692,1385,2024,13381,44415,18221,13962,4259,18221,99300,2009
40053,45.5,4483,4139,0,120,1476,43640,1950,1493,457,1950,57500,2009
40055,39,5800,4317,482,559,1338,34844,2012,1469,543,2012,53900,2009
40057,41.7,2876,1713,305,753,784,31531,1091,803,288,1091,47200,2009
40059,44.6,3340,2881,0,394,1129,41750,1508,1211,297,1508,60200,2009
40061,38.7,12154,9154,119,317,3038,34274,4574,3525,1049,4574,68000,2009
40063,40.7,13684,9526,685,467,3778,30856,5294,3893,1401,5294,64200,2009
40065,33.5,25831,17574,1752,5123,7430,40077,10466,6283,4183,10466,82200,2009
40067,40.8,6288,5023,49,573,1770,32783,2583,1944,639,2583,48500,2009
40069,39.3,10396,7633,338,359,2892,32848,4093,2980,1113,4093,63100,2009
40071,39.2,45958,36546,844,2782,12585,37803,18600,13178,5422,18600,72400,2009
40073,38.8,14219,11659,269,1489,3964,48811,5313,4311,1002,5313,95500,2009
40075,43.1,9392,7254,448,797,2621,32375,3994,2833,1161,3994,50600,2009
40077,37.8,10522,7470,22,265,2836,40550,4028,3040,988,4028,62500,2009
40079,36.9,49480,37285,1119,3278,13006,35963,18347,13409,4938,18347,70500,2009
40081,39.1,32135,27103,847,734,9255,40592,12330,9790,2540,12330,84800,2009
40083,37.3,37242,29768,3607,1560,9058,44387,12722,9927,2795,12722,106600,2009
40085,43,9072,7158,206,853,2613,39981,3537,2694,843,3537,74800,2009
40087,37.9,31676,26569,37,1955,8626,52538,11089,8980,2109,11089,108400,2009
40089,37.8,33451,22931,2863,1485,9216,31352,13847,9433,4414,13847,69900,2009
40091,45.3,19591,14010,672,365,5125,28305,7747,5952,1795,7747,69400,2009
40093,44.6,7175,6467,0,431,2285,43817,3153,2611,542,3153,73900,2009
40095,39.9,14760,10684,87,1920,3878,38624,5397,4004,1393,5397,75100,2009
40097,39.6,39666,27504,248,1002,11075,39463,15527,11698,3829,15527,86200,2009
40099,39.1,12729,9751,292,614,3664,39989,5332,4217,1115,5332,77800,2009
40101,37.5,70698,43750,8369,2979,17766,35169,26852,18312,8540,26852,81300,2009
40103,39.4,11011,9157,254,301,2993,37609,4531,3296,1235,4531,68600,2009
40105,39.7,10646,7371,316,215,3036,35893,4124,3205,919,4124,77900,2009
40107,39.4,11134,7214,1103,258,2998,31335,4305,3059,1246,4305,68200,2009
40109,33.9,700244,443781,98976,87767,175198,41862,282654,173108,109546,282654,112400,2009
40111,37.2,39230,26683,3558,1070,10973,35615,15435,10910,4525,15435,75900,2009
40113,40.1,45082,29491,4763,1345,12729,41630,17353,13788,3565,17353,94100,2009
40115,38.3,32148,22663,341,1382,8957,34160,13066,9674,3392,13066,74800,2009
40117,41.6,16440,13233,193,307,4538,40963,6185,4888,1297,6185,75500,2009
40119,26.1,78534,64860,2946,2272,15747,34255,27838,15630,12208,27838,110200,2009
40121,40.9,44514,33252,1785,1353,12285,38521,18288,13210,5078,18288,79800,2009
40123,34.8,36388,26262,881,1245,9320,36446,14511,9497,5014,14511,89000,2009
40125,36.6,68955,52749,2353,2400,17754,38836,24859,17642,7217,24859,88500,2009
40127,41.5,11618,8771,40,288,3098,27536,4759,3542,1217,4759,61900,2009
40129,43.6,3310,2843,33,153,999,50089,1356,1077,279,1356,79200,2009
40131,37.7,82890,64111,772,2721,22071,56438,28982,23448,5534,28982,133200,2009
40133,39.1,24132,16559,1195,753,6247,31760,9334,6462,2872,9334,62200,2009
40135,37.9,40886,27362,846,1293,10699,33424,14965,10806,4159,14965,75000,2009
40137,41.1,43056,36152,982,2348,12494,42563,17452,12891,4561,17452,77500,2009
40139,30.9,20395,11219,144,8379,5088,42634,7019,4696,2323,7019,74100,2009
40141,41.2,8090,5325,653,1566,2246,28368,3251,2390,861,3251,43800,2009
40143,34.8,585419,403218,61656,55879,149958,45264,236746,147229,89517,236746,120900,2009
40145,36.9,66969,51580,2702,2669,20407,52536,25702,20809,4893,25702,127600,2009
40147,40.7,49793,38375,1171,2348,13810,43779,20734,15451,5283,20734,95400,2009
40149,40,11573,10085,118,713,3044,41294,4475,3417,1058,4475,70200,2009
40151,36.9,8440,7536,264,287,2344,46074,3626,2428,1198,3626,75600,2009
40153,36.6,19430,16646,275,1428,5347,45995,7564,5450,2114,7564,90100,2009
41001,47.3,16027,14916,28,577,4786,38401,7046,4942,2104,7046,132400,2009
41003,31.9,81107,68567,854,4890,18729,46652,33052,18534,14518,33052,253000,2009
41005,39.4,375858,321188,3345,26795,97117,62030,140370,100239,40131,140370,323600,2009
41007,42.4,36927,32682,218,2294,9912,40426,16126,10004,6122,16126,239200,2009
41009,40.6,48612,44217,188,1861,13061,56903,18436,14430,4006,18436,212400,2009
41011,46.4,63230,56029,138,2947,16819,36754,27351,18347,9004,27351,187600,2009
41013,42,22473,20046,24,1638,6312,45987,8793,6526,2267,8793,216700,2009
41015,52.1,21553,19378,33,1011,6756,36175,10430,7497,2933,10430,267400,2009
41017,39.5,151879,135982,555,9409,42089,53913,61745,42695,19050,61745,308300,2009
41019,45.3,103385,93812,349,4244,28726,40324,42370,29933,12437,42370,180500,2009
41021,48,1623,1437,5,107,491,42115,816,563,253,816,98200,2009
41023,48.6,6928,6453,8,190,2217,35283,3318,2345,973,3318,121800,2009
41025,46.6,6777,5990,39,296,2093,38784,3160,2083,1077,3160,117000,2009
41027,37.1,21316,14739,88,5649,5556,49795,7890,5327,2563,7890,295900,2009
41029,41.5,198036,170591,950,17426,52311,44640,81381,52057,29324,81381,277000,2009
41031,36.3,20097,12439,73,4107,5550,40256,7729,5322,2407,7729,172600,2009
41033,46.3,80672,72491,241,4416,22409,37456,33844,23530,10314,33844,251700,2009
41035,40.2,66170,54685,264,6212,17811,41040,26761,18424,8337,26761,164300,2009
41037,46.7,7160,6218,51,535,2159,37500,3248,2166,1082,3248,114500,2009
41039,38.3,343774,296353,3305,21054,84457,42852,139593,85822,53771,139593,220800,2009
41041,47.8,45892,39322,138,3316,11648,38170,19888,13399,6489,19888,233500,2009
41043,39.1,112843,100501,426,6835,29625,45700,43277,29681,13596,43277,173400,2009
41045,35.8,30875,20568,321,8589,7067,39489,10270,6777,3493,10270,125700,2009
41047,34.6,309829,221433,2910,67827,77028,46453,111839,69901,41938,111839,198300,2009
41049,36,11394,7532,6,3438,2773,43581,3841,2722,1119,3841,105500,2009
41051,35.4,698599,517394,38087,71570,158515,49171,290080,164750,125330,290080,269900,2009
41053,38,74550,61383,347,8364,17587,50750,25572,18226,7346,25572,213600,2009
41055,45.1,1779,1623,0,134,560,35144,835,505,330,835,115300,2009
41057,47,24914,21966,106,1909,6909,38851,10873,7631,3242,10873,221000,2009
41059,36.1,72905,54259,521,13807,18612,45230,26399,17157,9242,26399,133100,2009
41061,39.5,24821,22622,54,829,6547,40542,9853,6532,3321,9853,146600,2009
41063,50.3,6828,6493,0,155,2029,41382,3148,2336,812,3148,164400,2009
41065,42.8,23732,19018,100,2919,6073,41307,9282,6209,3073,9282,181800,2009
41067,34.5,518002,374911,7390,75121,127171,62218,191390,120919,70471,191390,296500,2009
41069,55,1346,1297,0,13,378,32339,628,478,150,628,92400,2009
41071,35.9,95494,77433,630,12982,24061,51191,33562,23478,10084,33562,230300,2009
42001,39.4,101011,91701,1618,5656,27294,54899,37704,29134,8570,37704,190900,2009
42003,40.8,1222473,1004718,152534,16588,309681,46641,524584,351807,172777,524584,110300,2009
42005,43.8,68806,67218,610,411,19853,41075,29027,22193,6834,29027,87300,2009
42007,43.5,173277,158231,9943,1771,48624,45414,71632,54391,17241,71632,109700,2009
42009,42.5,49648,48489,184,374,14114,39827,20099,15886,4213,20099,110800,2009
42011,38.5,401488,320950,15486,55078,105420,54139,150225,111375,38850,150225,163700,2009
42013,41.6,125984,121488,1818,920,33850,40673,51772,37670,14102,51772,94600,2009
42015,42.4,61375,59545,321,494,16908,39242,24783,18464,6319,24783,97600,2009
42017,40.7,621241,550683,22075,21140,163388,74111,227204,177815,49389,227204,318200,2009
42019,40.4,182519,176208,1640,1651,50251,55373,71620,55643,15977,71620,152300,2009
42021,43.2,145219,136622,4715,1770,39475,38381,59623,44087,15536,59623,82300,2009
42023,44.9,5334,5216,4,35,1354,40288,2156,1559,597,2156,73000,2009
42025,42.8,62856,59428,907,1699,17483,47283,25433,20193,5240,25433,130000,2009
42027,27.3,144306,128347,4143,3276,29936,45959,51719,31356,20363,51719,167200,2009
42029,38.6,486301,410596,29527,24332,125050,83759,175312,137104,38208,175312,328900,2009
42031,39.8,39857,38757,395,212,10365,39083,15645,11328,4317,15645,92500,2009
42033,41.9,82482,78653,2147,758,22297,36470,33127,25344,7783,33127,80200,2009
42035,38.9,37063,35448,626,358,9868,39198,15111,10962,4149,15111,95800,2009
42037,39.3,64837,62067,646,1099,16844,41613,25526,18311,7215,25526,114300,2009
42039,40.6,88810,85024,1577,787,23553,38469,35024,26146,8878,35024,95100,2009
42041,39.7,227858,208179,6421,4823,59760,60400,90426,66226,24200,90426,169200,2009
42043,39.2,256400,187605,41962,14706,64679,51559,105259,69291,35968,105259,145800,2009
42045,38.3,555018,413658,97992,12493,135826,61605,204481,147561,56920,204481,224400,2009
42047,43.2,32594,32024,49,183,9321,43077,13931,11149,2782,13931,88900,2009
42049,38.2,279721,247756,16988,7871,70104,43456,107558,74979,32579,107558,107300,2009
42051,42,143925,135455,5209,720,39565,34018,58871,42263,16608,58871,81600,2009
42053,40.7,6811,5300,1161,301,1317,34110,1990,1678,312,1990,78900,2009
42055,39.8,141556,130316,4036,4610,39231,50557,56716,42160,14556,56716,166700,2009
42057,40.4,14808,14386,130,80,4001,44517,5651,4430,1221,5651,145000,2009
42059,40,39509,37075,1456,408,10227,38078,14530,11058,3472,14530,79100,2009
42061,40.7,45479,41884,2444,590,11371,41078,16688,12906,3782,16688,101000,2009
42063,38.4,87629,83964,1744,579,22495,38546,34632,24559,10073,34632,92700,2009
42065,42.5,44965,44103,90,272,12622,36917,18596,14329,4267,18596,77300,2009
42067,40.3,23107,22252,77,488,6405,42901,8796,6667,2129,8796,120300,2009
42069,41.5,209100,194890,3550,6239,55745,42801,86924,57576,29348,86924,129600,2009
42071,37.6,498918,434076,14498,36041,131470,54893,186301,131410,54891,186301,177700,2009
42073,42.6,90962,85248,3105,750,24904,42833,36311,28528,7783,36311,90400,2009
42075,40.6,127882,114639,1908,8961,34809,51547,50384,37659,12725,50384,149500,2009
42077,39.1,337077,256759,14291,51880,87774,53551,129889,91107,38782,129889,195700,2009
42079,42.2,311919,286578,7977,12362,83114,41830,131257,92404,38853,131257,108700,2009
42081,40.3,117043,108495,4945,1137,31954,41856,47982,33169,14813,47982,114100,2009
42083,40.6,43622,41355,810,638,11611,40080,17652,13061,4591,17652,71600,2009
42085,41.9,117098,107874,5962,1079,31570,42264,46714,35220,11494,46714,99000,2009
42087,41.3,45961,44883,223,360,12842,36369,18956,14053,4903,18956,90800,2009
42089,38.9,163925,121694,16395,18940,44516,57228,59497,47711,11786,59497,198600,2009
42091,39.9,776306,638087,61082,24869,202894,75728,298326,223098,75228,298326,294000,2009
42093,43,17776,16833,287,254,5084,47765,7405,5533,1872,7405,135700,2009
42095,39.8,293610,245713,10864,26650,76894,59070,109895,84012,25883,109895,214600,2009
42097,42.7,91286,86907,1799,1683,25240,38518,38647,28160,10487,38647,90100,2009
42099,40.1,45048,43815,260,444,12856,51497,17467,14130,3337,17467,135800,2009
42101,34.2,1531112,608294,641689,168922,311055,36669,566697,321629,245068,566697,128900,2009
42103,41.8,58335,49332,2860,4609,16790,56447,22940,19350,3590,22940,210900,2009
42105,43.2,17142,16579,86,147,4917,37044,7000,5275,1725,7000,87300,2009
42107,42.6,146870,138403,3513,2868,39942,41315,60835,46626,14209,60835,85500,2009
42109,38.7,38261,36900,381,542,9963,44702,14085,10605,3480,14085,117500,2009
42111,43.5,77710,74475,1801,769,21063,38109,30870,24396,6474,30870,88500,2009
42113,48,6219,5850,203,8,1627,37621,2500,2068,432,2500,119500,2009
42115,43.5,41116,40018,165,450,12081,41624,17326,13560,3766,17326,117500,2009
42117,41.6,40828,39680,200,301,11719,39812,16719,12553,4166,16719,98700,2009
42119,37.4,43424,37319,2343,1926,9560,44246,13748,10190,3558,13748,137200,2009
42121,43.4,54817,53000,603,420,15157,38475,22392,16509,5883,22392,75200,2009
42123,44.4,41025,40192,135,234,11568,40160,17729,13719,4010,17729,82200,2009
42125,42.7,206037,193979,6512,1847,55721,49354,83608,64931,18677,83608,124700,2009
42127,43.8,51233,47807,1078,1420,14158,44194,20610,16425,4185,20610,169600,2009
42129,44,363222,346158,7818,2623,101824,46760,151936,117335,34601,151936,121100,2009
42131,40.3,27882,26992,179,322,7922,44971,11217,8675,2542,11217,130200,2009
42133,39.5,419563,371108,19170,18704,115308,56271,163857,125995,37862,163857,166300,2009
44001,42.4,50022,47349,389,829,12696,69227,18884,13730,5154,18884,366900,2009
44003,41.4,169202,156146,2625,4702,43924,62007,68762,51263,17499,68762,249700,2009
44005,42.8,81693,73632,2783,2661,21574,65269,34096,22021,12075,34096,398400,2009
44007,36.4,629400,435592,43848,109836,146027,49130,233546,132078,101468,233546,263400,2009
44009,41.4,127064,117821,1268,2558,32792,69828,48939,37501,11438,48939,353200,2009
45001,40.1,25347,17561,7238,282,6743,33495,9636,7588,2048,9636,84600,2009
45003,39.4,152647,104967,38745,5449,41959,44534,60186,44954,15232,60186,111600,2009
45005,37,10459,2697,7219,474,2339,20551,3470,2092,1378,3470,63000,2009
45007,38.9,179914,143062,28658,3640,50457,43109,70597,52507,18090,70597,114800,2009
45009,38.4,15384,5586,9515,196,3529,30889,5375,3810,1565,5375,71600,2009
45011,37.6,22914,12182,10157,398,5934,35888,8412,6132,2280,8412,69600,2009
45013,39.7,147799,99726,29955,14400,40463,54131,58198,41709,16489,58198,291000,2009
45015,34.3,163328,106681,42244,6237,40779,49286,56203,39906,16297,56203,143000,2009
45017,44.2,14746,7693,6427,301,3801,37402,5967,4868,1099,5967,89700,2009
45019,34.9,345714,215767,106885,12937,82880,47770,139754,85750,54004,139754,231100,2009
45021,37.1,54175,40575,10944,1612,13609,34808,20545,14287,6258,20545,82100,2009
45023,39.3,32666,19251,12244,406,8805,31964,12891,9694,3197,12891,84500,2009
45025,38.6,42876,26622,14283,1411,10939,33968,16191,11977,4214,16191,78800,2009
45027,41.1,32863,15173,16483,831,8737,31761,12641,9577,3064,12641,80000,2009
45029,38.5,39128,21756,15835,886,10017,34135,14729,10868,3861,14729,91600,2009
45031,38.5,66771,36980,27648,914,17118,38753,25154,19040,6114,25154,79200,2009
45033,36,30777,14729,13965,908,7674,27588,11419,7318,4101,11419,59000,2009
45035,35.5,122442,83168,30751,3889,31428,54139,42675,31911,10764,42675,164100,2009
45037,38.5,25469,14354,10122,714,6448,44391,8852,6841,2011,8852,96800,2009
45039,40.7,23482,9547,13215,302,5066,32120,8275,6421,1854,8275,91600,2009
45041,36.9,132153,74249,52751,2096,34552,41142,49189,33707,15482,49189,102700,2009
45043,43.1,60235,37601,20272,1708,15434,42283,22092,16000,6092,22092,172900,2009
45045,36.7,430273,307697,76497,30579,110793,46671,166342,113128,53214,166342,143400,2009
45047,37.6,68631,42502,20955,3359,17331,39801,25659,18085,7574,25659,100900,2009
45049,36.8,20997,8599,11381,662,4885,34285,7111,5345,1766,7111,73200,2009
45051,41,248601,195687,35304,11125,68809,42642,106733,76372,30361,106733,165500,2009
45053,35,22250,8508,10294,2807,4944,36288,7253,5216,2037,7253,126600,2009
45055,39.8,58176,40548,15097,1505,16674,45035,22651,18258,4393,22651,109000,2009
45057,38.1,73725,50972,19002,2529,18083,38590,26006,19188,6818,26006,112100,2009
45059,39.6,69697,48814,17249,2387,18322,38816,26288,18886,7402,26288,87700,2009
45061,37.7,20074,6868,12281,738,4324,24847,6584,4529,2055,6584,63200,2009
45063,37.4,244348,193150,34570,9304,65950,51983,95936,72809,23127,95936,133200,2009
45065,48.1,10087,5049,4843,39,2744,34786,3799,2956,843,3799,118500,2009
45067,37.6,34023,13890,18873,1098,9248,29626,12904,8499,4405,12904,78000,2009
45069,36.2,28571,12036,14494,458,6562,26002,9964,6591,3373,9964,60100,2009
45071,38.5,37992,22682,11298,3247,9889,41080,14055,10410,3645,14055,94500,2009
45073,42.4,70507,61263,5656,2618,20554,41095,29802,23179,6623,29802,121000,2009
45075,37,90387,31983,55619,1309,22680,32132,34394,23625,10769,34394,77300,2009
45077,35.1,116092,101930,7665,3330,29982,41969,44601,31542,13059,44601,118600,2009
45079,32.6,359144,168255,161420,13868,83899,47969,137279,84457,52822,137279,143000,2009
45081,38.4,18947,11007,5010,2712,4644,41510,6484,5051,1433,6484,89800,2009
45083,37.6,276544,197336,56842,13744,73398,42349,106227,75840,30387,106227,111600,2009
45085,34.9,104441,50082,49036,2655,26793,37752,39197,26441,12756,39197,93800,2009
45087,41.3,27800,18560,8568,257,7770,33345,11462,8540,2922,11462,69800,2009
45089,39.1,34920,10990,23116,400,8159,25948,11755,7531,4224,11755,65900,2009
45091,36.6,209351,154938,39207,7929,55406,51332,78451,57168,21283,78451,152900,2009
46003,44.1,2878,2709,0,134,771,43209,1172,880,292,1172,63300,2009
46005,43.1,15845,14719,69,448,4461,42259,7248,4695,2553,7248,78500,2009
46007,35.6,3408,1165,0,36,840,36580,1111,655,456,1111,59900,2009
46009,43.1,7023,6436,103,103,1835,38750,2631,2176,455,2631,66600,2009
46011,25,29437,27804,139,344,6008,41043,11484,6480,5004,11484,128800,2009
46013,38.5,35016,32809,23,422,9142,45054,14972,10239,4733,14972,107300,2009
46015,39,5169,4511,1,5,1355,44570,2057,1453,604,2057,85300,2009
46017,23.4,2091,182,0,7,450,25714,526,170,356,526,62500,2009
46019,41.1,9418,8750,47,349,2575,36649,3864,2984,880,3864,104900,2009
46021,46.5,1450,1437,0,12,466,35764,681,544,137,681,36900,2009
46023,37.7,8999,5879,23,77,2407,35385,3344,2197,1147,3344,69100,2009
46025,46.2,3526,3455,4,54,1115,42604,1552,1276,276,1552,58800,2009
46027,24,13431,12224,85,190,2580,31952,5295,2725,2570,5295,109300,2009
46029,37.7,26129,24846,121,129,7223,41716,11358,7502,3856,11358,124400,2009
46031,29.4,4146,1326,14,144,876,29750,1206,660,546,1206,44600,2009
46033,49.4,7865,7255,0,221,2290,45775,3563,2733,830,3563,155400,2009
46035,37.6,18932,17834,56,188,4935,44242,7872,4999,2873,7872,107000,2009
46037,45.7,5637,4965,2,68,1494,33810,2453,1646,807,2453,58800,2009
46039,43,4238,4111,0,116,1249,46341,1820,1443,377,1820,86400,2009
46041,28.1,6007,1352,0,13,1403,36587,1891,1050,841,1891,67900,2009
46043,47.7,3050,2967,0,12,909,38963,1279,987,292,1279,55900,2009
46045,45.6,3981,3912,0,45,1155,46169,1663,1299,364,1663,61600,2009
46047,50.5,7240,6370,51,164,1662,38762,2967,1983,984,2967,97000,2009
46049,46,2276,2262,0,0,621,35924,1020,770,250,1020,49100,2009
46051,45.4,7165,7015,0,116,2117,40293,3319,2286,1033,3319,96400,2009
46053,48.8,4083,3688,0,27,1196,32808,1949,1487,462,1949,56400,2009
46055,50.1,1841,1690,8,10,513,46667,668,548,120,668,77000,2009
46057,37.8,5620,5467,47,57,1547,43227,2146,1833,313,2146,79300,2009
46059,48.7,3268,3264,0,4,942,45202,1381,989,392,1381,70900,2009
46061,39.5,3585,3559,0,6,976,45938,1293,1126,167,1293,86800,2009
46063,44.1,1205,1133,0,33,363,36912,494,358,136,494,63600,2009
46065,39.8,16856,14156,85,431,4445,51444,6907,4909,1998,6907,123500,2009
46067,46.2,7289,7120,16,47,2065,39066,3123,2397,726,3123,67000,2009
46069,44.9,1481,1311,15,0,430,36379,626,463,163,626,57700,2009
46071,28.3,2720,1316,0,128,718,32981,931,573,358,931,59600,2009
46073,49.3,1994,1942,0,13,631,39531,894,577,317,894,62300,2009
46075,38.2,1033,1013,0,0,304,43750,461,298,163,461,72900,2009
46077,47.1,5345,5213,0,49,1594,42822,2375,1876,499,2375,68800,2009
46079,40,11500,11068,57,152,3018,46241,4480,3318,1162,4480,106900,2009
46081,38.7,23159,21644,0,526,5903,38996,10400,6543,3857,10400,145900,2009
46083,32.1,37607,35984,103,537,8606,65992,11053,9182,1871,11053,159000,2009
46085,36.7,3855,2314,4,0,972,34132,1418,915,503,1418,63200,2009
46087,41.5,5697,5572,3,35,1558,43984,2226,1767,459,2226,91100,2009
46089,47.9,2515,2490,0,13,673,30690,1112,899,213,1112,42100,2009
46091,45.1,4266,3803,4,64,1187,40823,1828,1322,506,1828,74400,2009
46093,36,24126,21733,197,833,6993,41934,10113,6947,3166,10113,139300,2009
46095,34,2032,1017,0,10,495,34632,652,440,212,652,52200,2009
46097,46.6,2454,2425,0,5,756,41771,1125,902,223,1125,57500,2009
46099,34.6,175749,155395,4331,7187,44142,50671,68706,45750,22956,68706,139200,2009
46101,40.3,6460,5318,0,89,1854,51336,2631,2003,628,2631,98500,2009
46103,35.9,96903,81184,1169,3863,25202,46288,38385,25987,12398,38385,143100,2009
46105,47.1,2877,2772,0,7,876,34495,1342,920,422,1342,50800,2009
46107,50.6,2149,2068,0,26,660,38345,1049,804,245,1049,53900,2009
46109,39.4,9932,6382,8,191,2740,35462,3854,2731,1123,3854,71800,2009
46111,44.8,2458,2378,0,57,727,41597,1097,813,284,1097,63500,2009
46113,22.1,13593,847,0,799,2333,28808,2778,1359,1419,2778,30100,2009
46115,44,6673,6449,31,7,1803,44552,2908,2170,738,2908,59600,2009
46117,43.6,2775,2480,3,36,763,51089,1186,937,249,1186,107700,2009
46119,44.4,1363,1317,0,2,431,48098,647,483,164,647,75900,2009
46121,23.4,9997,1336,24,453,1812,26337,2534,1092,1442,2534,46500,2009
46123,44,5761,4885,45,0,1769,39044,2563,1938,625,2563,59700,2009
46125,43.8,8331,8124,0,59,2434,47950,3533,2723,810,3533,81500,2009
46127,40,13947,13034,70,293,3787,56720,5732,4296,1436,5732,123700,2009
46129,48.5,5312,4406,0,42,1598,37804,2280,1704,576,2280,60900,2009
46135,40.4,21771,20164,351,568,5761,45848,8686,6076,2610,8686,104400,2009
46137,26.9,2574,682,19,14,575,26833,760,428,332,760,62100,2009
47001,41.1,73382,66923,2965,1296,20175,42643,30851,22090,8761,30851,110500,2009
47003,35,44291,34115,2945,6039,10854,37917,15575,10492,5083,15575,111300,2009
47005,44.9,16130,15279,391,229,4715,33647,7271,5907,1364,7271,75100,2009
47007,41,12941,12052,526,190,2963,32439,4037,3124,913,4037,103000,2009
47009,40.6,119489,110791,3581,2084,32963,47218,46748,35883,10865,46748,150500,2009
47011,37.3,95184,85631,4100,3287,26421,39995,37675,25473,12202,37675,129400,2009
47013,40.1,40646,39319,83,514,10852,28988,15789,11508,4281,15789,81900,2009
47015,40.6,13505,12808,177,66,3742,35972,5221,3956,1265,5221,111700,2009
47017,40.8,28686,24655,3153,468,7799,35713,11575,8932,2643,11575,75200,2009
47019,40.1,58955,56197,914,805,15910,32424,23729,17239,6490,23729,90300,2009
47021,38.3,39042,36601,896,820,10731,51221,14468,11535,2933,14468,148700,2009
47023,36.8,16106,14017,1401,246,4451,37569,6081,4544,1537,6081,96300,2009
47025,40,31081,30087,259,257,8968,32212,12721,9974,2747,12721,86400,2009
47027,44.9,7937,7863,55,13,2541,32134,3583,2779,804,3583,79100,2009
47029,40.5,35406,33424,752,524,9512,30027,14247,10535,3712,14247,92500,2009
47031,39.4,51694,46959,1209,1797,14495,39456,20696,14929,5767,20696,113800,2009
47033,39.4,14408,11081,1900,1303,3905,35370,5475,3873,1602,5475,82900,2009
47035,46.9,52852,51149,217,818,14898,36346,20763,16562,4201,20763,124800,2009
47037,34.3,621465,377094,166704,49038,141440,45828,252172,148862,103310,252172,159900,2009
47039,43.8,11472,10507,296,389,3079,25333,4998,3666,1332,4998,68800,2009
47041,39.2,18624,16921,290,1097,4586,34067,6606,4981,1625,6606,95900,2009
47043,37.5,47140,42931,2062,1034,13085,44988,18393,13776,4617,18393,123200,2009
47045,38.7,37698,31001,5286,816,10625,36121,15128,9796,5332,15128,90100,2009
47047,39.9,36820,25244,10227,724,9773,54577,12558,10172,2386,12558,167100,2009
47049,41.2,17412,17044,32,142,4724,28407,6642,5087,1555,6642,87300,2009
47051,40.1,41021,37046,1319,963,11156,41345,16105,12401,3704,16105,108200,2009
47053,40.3,48586,37825,9219,820,13177,34050,20432,14381,6051,20432,84700,2009
47055,41.4,29075,24994,3367,327,8104,39228,11699,8842,2857,11699,99000,2009
47057,40.3,22549,21757,50,417,5910,32602,8483,7046,1437,8483,92800,2009
47059,40.9,65698,61964,1404,1438,19617,35995,27366,20216,7150,27366,99600,2009
47061,39.1,14262,12707,65,169,3911,26239,5455,4375,1080,5455,73500,2009
47063,38.1,61698,51253,2218,6824,17171,39507,24536,17312,7224,24536,115500,2009
47065,39,330941,244820,66014,9950,85813,45557,133211,89199,44012,133211,142500,2009
47067,40.7,6633,6492,14,21,2004,23413,2807,1966,841,2807,75400,2009
47069,38.3,27759,15865,10843,384,7031,32483,9540,7068,2472,9540,84600,2009
47071,42,26093,24349,848,384,7454,30558,10592,8103,2489,10592,85200,2009
47073,41,56957,54752,805,610,16557,34310,22777,17387,5390,22777,97000,2009
47075,37.6,19155,8667,9387,835,5389,30821,7617,4944,2673,7617,86500,2009
47077,38.8,26687,23795,1940,374,7806,39294,10634,8103,2531,10634,81100,2009
47079,43.3,31567,27917,2569,402,9472,36408,13544,10456,3088,13544,87000,2009
47081,38.2,23670,21914,1074,278,6017,37880,8247,6382,1865,8247,96300,2009
47083,41.7,8041,7397,204,229,2293,31858,3268,2448,820,3268,88900,2009
47085,40.9,18151,17084,493,238,5282,41957,7642,5884,1758,7642,98900,2009
47087,43.4,10896,10785,18,41,2947,30844,4447,3350,1097,4447,84600,2009
47089,39.1,50116,46951,1218,1247,13160,37951,19165,14651,4514,19165,116100,2009
47091,42.5,18019,17119,395,175,5009,29771,7290,5625,1665,7290,94400,2009
47093,37,423655,362521,37370,9899,109554,46233,177175,119078,58097,177175,147200,2009
47095,38.1,7404,4670,2400,119,1620,23441,2405,1408,997,2405,65400,2009
47097,36.1,26568,16611,9025,444,6505,31667,9516,6321,3195,9516,78100,2009
47099,38.6,40899,39032,689,603,10988,35662,15399,11988,3411,15399,90000,2009
47101,38.7,11466,10902,253,200,3049,31167,4334,3267,1067,4334,87000,2009
47103,40.7,32764,29100,2212,568,9242,42546,13092,10146,2946,13092,108000,2009
47105,44.4,45176,41948,405,1963,12998,49653,18076,14290,3786,18076,158200,2009
47107,40,52055,47346,2018,1410,14316,35860,20590,15228,5362,20590,102700,2009
47109,41.1,25436,23070,1595,349,7105,34279,10008,8085,1923,10008,81400,2009
47111,36.5,21708,20474,82,810,5840,32354,8216,6185,2031,8216,90100,2009
47113,35.7,96346,59237,31935,2899,25728,39743,38364,25632,12732,38364,110300,2009
47115,39.8,27960,26051,594,295,8431,38367,11918,8993,2925,11918,100100,2009
47117,37.9,29297,25290,2127,1376,8502,40318,11556,8570,2986,11556,104600,2009
47119,37.5,80190,64529,10085,4026,22104,45724,32090,23363,8727,32090,134800,2009
47121,39.3,11747,11290,191,175,3385,32096,4656,3576,1080,4656,106700,2009
47123,39,44602,41416,946,1298,11315,36308,16139,12314,3825,16139,100800,2009
47125,30.7,153491,107627,29673,8741,43238,48794,58943,38273,20670,58943,122700,2009
47127,42.2,6044,5720,85,46,1740,47216,2325,1966,359,2325,122000,2009
47129,39.6,19294,18394,464,208,5387,32928,7515,6223,1292,7515,73500,2009
47131,40.4,31610,27058,2980,1088,8990,37581,13199,9117,4082,13199,85300,2009
47133,40.6,20816,20235,223,28,6181,33323,8648,6880,1768,8648,89200,2009
47135,42.5,7694,7313,219,48,2014,32021,2977,2347,630,2977,67100,2009
47137,40.3,4803,4726,0,68,1473,24757,2060,1485,575,2060,106400,2009
47139,42,15735,15168,32,193,4474,32589,6679,5064,1615,6679,93100,2009
47141,35.4,69938,63487,1292,3518,17210,34705,26772,17268,9504,26772,120800,2009
47143,39.2,30633,28359,619,925,8206,34830,11747,8713,3034,11747,99100,2009
47145,43,53186,50014,1400,541,15417,41740,21663,16773,4890,21663,113900,2009
47147,36.4,63521,53402,5243,4052,16873,50160,23224,17675,5549,23224,144400,2009
47149,32.1,240181,189228,27401,12945,63571,53063,91128,63016,28112,91128,154000,2009
47151,36.6,21852,21313,0,275,5546,27027,8460,5890,2570,8460,72600,2009
47153,37.4,13377,11772,356,185,2879,37150,4211,3372,839,4211,97100,2009
47155,40.5,83448,78975,783,2017,22597,41774,31140,21949,9191,31140,151300,2009
47157,34.1,918186,379289,463335,41744,220774,44146,344095,212365,131730,344095,129800,2009
47159,38.9,18863,17649,429,378,5033,44430,6825,5415,1410,6825,109600,2009
47161,41.2,13078,12190,304,187,3486,37377,4986,3993,993,4986,95300,2009
47163,42.2,153314,145924,3058,1624,45539,39106,67284,50433,16851,67284,106600,2009
47165,37.8,151874,133851,10014,4645,42273,54708,57714,43162,14552,57714,164400,2009
47167,36.3,57543,44248,10905,1084,16443,51138,21323,16015,5308,21323,132100,2009
47169,39.3,7682,6562,700,224,2055,44764,2896,2345,551,2896,104100,2009
47171,44,17686,16878,136,531,4713,34686,7296,5410,1886,7296,101200,2009
47173,39.1,18927,18384,0,186,5473,31226,7718,6138,1580,7718,91400,2009
47175,41.7,5423,5329,35,7,1418,30359,2048,1641,407,2048,76000,2009
47177,38.3,39915,34681,1205,3252,9991,34261,14986,10833,4153,14986,87500,2009
47179,38.6,116750,106961,4558,2610,29761,41107,46676,32040,14636,46676,129700,2009
47181,39.6,16592,14945,1063,186,4053,31697,5822,4750,1072,5822,72800,2009
47183,37.9,33389,29346,2365,574,9314,33506,13860,9386,4474,13860,80000,2009
47185,40.6,24897,23697,257,380,6538,32678,9315,7189,2126,9315,91800,2009
47187,38.1,165526,144381,8144,6787,45941,88358,57490,47859,9631,57490,327900,2009
47189,38.4,106472,94367,7331,2610,29952,61179,40149,32809,7340,40149,180000,2009
48001,37.2,56575,35003,12465,7906,10651,39355,15497,11110,4387,15497,74300,2009
48003,34.1,13295,6498,82,6247,3907,47227,5119,4027,1092,5119,68900,2009
48005,35.4,82465,54138,11853,14747,21461,38862,30247,20895,9352,30247,77100,2009
48007,46,24499,17475,235,5546,6847,41172,9966,7458,2508,9966,128500,2009
48009,40.9,8936,8167,18,666,2540,51792,3348,2686,662,3348,97500,2009
48011,44.7,2014,1710,30,228,611,58516,769,632,137,769,86900,2009
48013,35.4,43524,16200,310,26350,10332,41178,13634,10221,3413,13634,80300,2009
48015,39.9,26567,18055,2596,5579,6619,51086,9028,7099,1929,9028,130300,2009
48017,32.8,6360,3240,220,2881,1674,35585,2313,1804,509,2313,59400,2009
48019,46.2,20137,16300,148,3304,5313,44244,7320,5983,1337,7320,142800,2009
48021,37.2,71928,43959,6009,20506,15980,50585,22018,17500,4518,22018,119000,2009
48023,45.9,3789,3175,109,461,1068,32569,1702,1179,523,1702,58600,2009
48025,33.8,32413,10563,3182,18013,6443,35759,9107,5823,3284,9107,67900,2009
48027,28.5,275594,147840,55120,54004,67852,46473,96378,55504,40874,96378,109100,2009
48029,32.4,1584817,507631,106046,911574,365720,45688,540332,339873,200459,540332,109700,2009
48031,41.2,9037,7031,230,1727,2406,50225,3459,2743,716,3459,170500,2009
48033,41.8,585,443,0,142,176,55200,256,160,96,256,52900,2009
48035,43.3,17720,14336,345,2673,4810,44244,6562,4924,1638,6562,83200,2009
48037,36.6,91841,61619,21255,5222,23293,40569,34159,22748,11411,34159,82600,2009
48039,34.7,292304,169104,30077,75396,77055,62570,100617,75912,24705,100617,135200,2009
48041,23.1,171382,107606,17607,35986,33746,34688,62350,28385,33965,62350,134300,2009
48043,36.3,9216,4734,120,3993,2053,34640,3995,2260,1735,3995,88100,2009
48045,43.7,1583,1137,13,397,481,31141,707,556,151,707,40100,2009
48047,37.6,7475,816,0,6628,1723,19425,2850,2015,835,2850,43900,2009
48049,39,38225,29032,1628,6974,9832,38531,14080,10139,3941,14080,70900,2009
48051,40.8,16634,11316,2234,2795,4786,39522,6757,5461,1296,6757,76200,2009
48053,44.7,43402,34382,803,7404,11242,46463,16061,12273,3788,16061,137600,2009
48055,35.8,36895,17313,2684,16222,8280,41387,11243,7799,3444,11243,98000,2009
48057,38.1,20384,9845,502,8969,5479,43305,7926,5715,2211,7926,80000,2009
48059,41,13300,11726,82,1100,3686,44470,5093,4258,835,5093,68000,2009
48061,29.1,383171,48251,1270,329499,93322,30034,116170,79286,36884,116170,71000,2009
48063,36.5,12489,7539,2088,2639,3301,33891,4422,2856,1566,4422,87200,2009
48065,41.7,6246,5433,48,555,1863,53425,2544,2105,439,2544,84600,2009
48067,43.2,29315,22503,5445,765,8772,36693,12313,8908,3405,12313,68300,2009
48069,35.7,7233,3099,157,3872,2228,34849,2772,2062,710,2772,64400,2009
48071,37.1,29198,20697,3342,4827,9158,60451,11615,9629,1986,11615,123200,2009
48073,37,48041,31402,7194,8655,11856,36571,16356,12186,4170,16356,66400,2009
48075,33.2,7530,4634,1050,1759,1780,34953,2432,1714,718,2432,49600,2009
48077,43.4,11102,10169,40,543,3511,51145,4583,3889,694,4583,74700,2009
48079,37.1,3080,1348,184,1504,945,34744,1273,936,337,1273,38100,2009
48081,48.1,3491,2700,27,682,871,33375,1456,1049,407,1456,50200,2009
48083,44.6,8538,6819,212,1299,2332,27538,3534,2523,1011,3534,57800,2009
48085,34.5,729514,488496,53316,100967,185887,80545,255800,181809,73991,255800,197400,2009
48087,36.4,2993,1666,188,1040,841,39524,1242,908,334,1242,48700,2009
48089,40.9,20554,12579,2926,4852,5168,39031,7727,5837,1890,7727,87400,2009
48091,40.8,104960,74821,1648,25911,28933,63544,38087,29555,8532,38087,171400,2009
48093,43.2,13517,9996,104,3194,3779,34068,5433,4273,1160,5433,78800,2009
48095,41.1,3610,1925,77,1571,746,45625,980,740,240,980,68800,2009
48097,37.8,38424,30772,1030,5354,10325,50030,14056,10122,3934,14056,106100,2009
48099,28.9,72617,44380,13892,9985,15637,45678,19854,11235,8619,19854,88800,2009
48101,44,1696,1016,245,313,461,32009,663,520,143,663,46000,2009
48103,37.2,3906,1918,108,1795,1196,43185,1489,1108,381,1489,48200,2009
48105,34.3,3784,1629,0,2155,1044,47143,1380,793,587,1380,55900,2009
48107,37.1,6312,2743,220,3257,1720,34485,2413,1689,724,2413,51800,2009
48109,32.6,2476,740,0,1736,511,38365,750,531,219,750,45700,2009
48111,33.4,6153,3794,150,2066,1483,40714,2060,1317,743,2060,66800,2009
48113,31.6,2383126,859443,475832,898767,545421,47059,832734,456160,376574,832734,128800,2009
48115,36.2,13831,5254,1115,7065,3273,33586,4540,3454,1086,4540,43400,2009
48117,30.7,18332,6298,197,11577,4587,38849,6086,3974,2112,6086,72500,2009
48119,40.7,5434,4574,375,280,1377,41103,2085,1670,415,2085,62400,2009
48121,32.4,611842,417471,44451,101497,142249,70002,202351,134893,67458,202351,170900,2009
48123,42.4,19821,11555,2186,5947,4958,37621,7233,5550,1683,7233,67400,2009
48125,41,2479,1504,74,851,579,28750,865,690,175,865,37200,2009
48127,33.5,9833,1393,48,8274,2807,24268,3519,2344,1175,3519,47200,2009
48129,38.8,3703,3086,185,320,1049,36250,1445,1072,373,1445,49200,2009
48131,36,12199,1306,138,10687,3053,26117,4455,3308,1147,4455,49700,2009
48133,39.6,18260,14848,574,2635,4699,33149,7126,5332,1794,7126,55900,2009
48135,30.7,128988,56821,5145,63976,32611,44322,46561,32283,14278,46561,67700,2009
48137,40.3,1908,939,0,969,459,34426,759,599,160,759,60300,2009
48139,34.1,142348,93794,13187,32099,36722,58809,46407,35459,10948,46407,134100,2009
48141,30.7,729396,101747,18338,593297,179896,35249,234366,150411,83955,234366,95200,2009
48143,29.1,35454,27997,351,6212,7989,37729,13121,8022,5099,13121,107000,2009
48145,38.4,17048,9212,4365,3204,3948,30502,5916,4133,1783,5916,60300,2009
48147,39.9,32884,27092,2434,2496,8278,42423,11344,8274,3070,11344,78000,2009
48149,45.7,22620,17143,1453,3717,6499,44031,9390,7349,2041,9390,118400,2009
48151,45.1,4028,2779,161,1058,1252,37601,1777,1321,456,1777,52900,2009
48153,39.4,6683,3080,241,3250,2226,31588,2851,1981,870,2851,61800,2009
48155,42,1324,1003,50,256,412,24861,592,386,206,592,29600,2009
48157,34.6,508099,202228,104535,118630,116586,80638,140542,115487,25055,140542,168600,2009
48159,40.5,10915,8729,642,1459,2496,42189,3564,2829,735,3564,92900,2009
48161,38.2,18936,13152,3405,2127,4414,44303,6844,5063,1781,6844,84300,2009
48163,32.4,16136,3634,477,11966,3473,34531,4661,3222,1439,4661,47800,2009
48165,30.7,14840,8494,204,5803,3695,47808,4942,3602,1340,4942,67700,2009
48167,36.7,282440,170704,40220,58960,73289,54398,107133,72472,34661,107133,132500,2009
48169,33.8,4743,1758,97,2839,895,31200,1202,827,375,1202,62600,2009
48171,49,23488,18899,31,4258,6632,52403,9363,7261,2102,9363,186400,2009
48173,38.4,1408,891,50,467,389,54000,480,338,142,480,88800,2009
48175,43.5,7006,4066,265,2510,2052,50486,2862,2400,462,2862,91700,2009
48177,36,19510,9024,1573,8794,5001,37103,7113,4808,2305,7113,74400,2009
48179,39,21791,15468,1230,4248,6045,36788,8377,6346,2031,8377,59200,2009
48181,38.4,117913,94952,6630,11522,31197,45171,44694,31441,13253,44694,95300,2009
48183,35.1,116901,75195,23197,15203,30197,42499,44561,28426,16135,44561,104300,2009
48185,39,25621,15957,4437,4764,5424,39403,7633,5842,1791,7633,89300,2009
48187,36.6,112267,63573,6520,39036,28744,59375,37734,29380,8354,37734,136000,2009
48189,32.6,35535,14310,1836,18721,8977,34820,11998,7593,4405,11998,71800,2009
48191,41.5,3455,1991,272,1085,932,29032,1414,985,429,1414,38900,2009
48193,44.7,8051,7243,0,763,2070,37796,3090,2482,608,3090,81700,2009
48195,37.3,5246,2925,11,2235,1389,46799,1873,1450,423,1873,62100,2009
48197,42.2,4112,2807,555,690,1195,36385,1584,1257,327,1584,44300,2009
48199,37.7,51804,45336,3540,2085,14074,52515,18721,14566,4155,18721,88100,2009
48201,31.8,3909790,1428577,708007,1502324,931057,50569,1358313,781746,576567,1358313,130100,2009
48203,37.1,63528,42630,14501,5437,16589,41966,22903,17242,5661,22903,86900,2009
48205,40,5089,3712,397,916,1042,57083,1459,1076,383,1459,125000,2009
48207,46.8,5185,3682,215,1241,1794,32139,2496,1917,579,2496,36400,2009
48209,28.1,141371,86106,5922,45781,28642,52409,45028,29190,15838,45028,164200,2009
48211,43.5,3363,2746,0,516,1153,60435,1522,1249,273,1522,94800,2009
48213,41.6,78775,64614,5019,7562,21803,38632,30394,23556,6838,30394,82700,2009
48215,27.4,702697,62303,3299,627878,172294,30076,208599,147150,61449,208599,69800,2009
48217,38.6,35279,25995,2262,6329,8716,38159,12446,9523,2923,12446,83300,2009
48219,33.9,22359,11824,539,9450,6223,45384,8237,6002,2235,8237,66300,2009
48221,44.1,49360,42604,310,4842,12713,52870,17493,13860,3633,17493,141000,2009
48223,38.1,33864,26130,2666,4514,9222,39966,12686,8930,3756,12686,91000,2009
48225,41.3,22612,14220,5770,2199,5577,31911,8052,5911,2141,8052,65400,2009
48227,36.8,32324,16753,1118,13427,7983,36931,11500,7784,3716,11500,54300,2009
48229,39,3169,816,18,2311,808,28292,1055,848,207,1055,43700,2009
48231,36.3,82204,63175,7283,9469,20270,42894,29273,20831,8442,29273,88800,2009
48233,37.7,21681,16139,534,4100,6249,41703,8751,7071,1680,8751,55700,2009
48235,41.1,1678,1077,68,524,486,43536,655,541,114,655,71900,2009
48237,39.6,8691,7057,388,946,2068,43409,2992,2391,601,2992,66000,2009
48239,39.5,14121,8967,1152,3934,3761,48509,5121,3852,1269,5121,77200,2009
48241,39.5,34431,26151,5842,1647,9782,37020,13561,10730,2831,13561,72900,2009
48243,48.5,2192,1355,0,793,703,39550,983,765,218,983,106100,2009
48245,35.6,242676,115664,82801,33676,61780,41420,92822,59442,33380,92822,84400,2009
48247,32,4973,256,1,4611,1310,33635,1595,1098,497,1595,38600,2009
48249,33.3,40876,8632,281,31478,10104,32816,13425,9706,3719,13425,63800,2009
48251,35.8,150077,116986,5277,23841,37081,53444,48389,37245,11144,48389,109700,2009
48253,36.8,19223,11920,2472,4461,4170,40947,6156,4844,1312,6156,48400,2009
48255,38.4,15060,5812,1580,7402,3461,35101,4687,3094,1593,4687,67000,2009
48257,34.5,95993,67749,9951,15701,22595,55857,28415,21825,6590,28415,125100,2009
48259,42.1,31294,24292,282,6219,8887,68389,11635,8949,2686,11635,227500,2009
48261,30.5,336,95,0,241,102,25417,141,47,94,141,79400,2009
48263,47.8,703,592,6,90,192,38092,387,298,89,387,57000,2009
48265,46.1,47410,34914,720,10769,13540,43371,18697,13856,4841,18697,126600,2009
48267,48.1,4485,3167,9,1231,1230,42188,1850,1346,504,1850,91000,2009
48269,36.7,233,199,0,19,75,48182,94,28,66,94,87100,2009
48271,47.8,3245,1581,37,1597,803,24024,1233,1002,231,1233,46600,2009
48273,27.6,30637,7650,1088,20931,7152,34652,11043,6340,4703,11043,70600,2009
48275,46.8,3465,2192,300,898,1072,31926,1670,1190,480,1670,39900,2009
48277,38.8,48993,38458,6298,2596,13671,37029,18927,13076,5851,18927,77800,2009
48279,37.1,13741,6235,627,6708,3680,35716,4983,3773,1210,4983,51400,2009
48281,39.1,20471,15790,562,3389,4797,44301,6706,4896,1810,6706,112700,2009
48283,31.9,5891,1092,159,4516,1280,31838,1706,1170,536,1706,29500,2009
48285,44,18632,14515,1315,2690,5299,41696,7719,6056,1663,7719,81200,2009
48287,38.6,16203,10728,1783,3464,4188,45161,5860,4468,1392,5860,106600,2009
48289,44.5,16518,12881,1576,1852,4586,38067,6480,5280,1200,6480,79300,2009
48291,35.2,74941,53189,9133,11101,17772,44730,24285,18697,5588,24285,77900,2009
48293,39.5,22367,14050,4294,3843,5462,39119,7697,6016,1681,7697,72600,2009
48295,40.3,2994,2025,4,885,852,48646,1192,905,287,1192,67200,2009
48297,41.1,11271,6218,282,4658,2812,41652,4201,3139,1062,4201,78600,2009
48299,53.1,18150,16326,40,1418,5642,42381,8629,6652,1977,8629,132000,2009
48301,47.7,81,65,0,0,37,81328,41,21,20,41,79200,2009
48303,29.3,262985,156602,18410,80346,64840,40467,102238,59936,42302,102238,97700,2009
48305,38.6,5841,2831,78,2724,1780,39148,2241,1643,598,2241,55300,2009
48307,42.5,7893,5266,115,2360,2134,36495,3263,2380,883,3263,71200,2009
48309,31.3,228369,139407,33366,49189,53736,40038,81851,49324,32527,81851,97200,2009
48311,41.5,938,518,0,409,217,40550,343,277,66,343,81100,2009
48313,34,13202,7636,2917,2554,2663,33952,3692,2895,797,3692,82700,2009
48315,46.1,10570,7645,2169,344,3330,30385,4989,3978,1011,4989,55800,2009
48317,43.3,4447,2661,136,1547,1419,37463,1882,1414,468,1882,77100,2009
48319,46.4,3890,3250,14,556,1011,37847,1488,1197,291,1488,130300,2009
48321,36.5,37008,17803,4123,13442,10294,40307,14049,9874,4175,14049,74200,2009
48323,28.8,51300,1843,6,48499,11037,30123,13659,9707,3952,13659,75600,2009
48325,37.1,43654,21220,1142,20637,10366,46348,13484,10837,2647,13484,93100,2009
48327,47.1,2132,1433,5,684,604,31016,889,656,233,889,60700,2009
48329,33.4,126287,70003,8126,45141,33632,52611,46629,32271,14358,46629,109600,2009
48331,39,24780,16418,2430,5390,6764,37565,9566,6814,2752,9566,81100,2009
48333,47.3,5003,3907,5,1058,1305,34019,1861,1508,353,1861,91700,2009
48335,36.6,9275,5131,981,3050,2124,43009,2802,2216,586,2802,56300,2009
48337,42.6,19557,17491,20,1480,5458,41677,8059,6296,1763,8059,78500,2009
48339,35.4,411726,307399,18329,71766,106393,64971,139258,106410,32848,139258,152200,2009
48341,30.9,20106,8774,218,10602,5032,41862,6695,4578,2117,6695,75500,2009
48343,42.2,12852,8932,2906,737,3448,37173,5183,4053,1130,5183,75100,2009
48345,44.2,1175,1072,20,83,293,33250,482,345,137,482,48900,2009
48347,27.7,62608,41400,10161,9541,14056,32487,22667,13626,9041,22667,85700,2009
48349,35.4,48847,29409,7711,10716,11495,39555,16363,11636,4727,16363,77700,2009
48351,40.4,13827,10055,2904,601,3723,36611,5473,4495,978,5473,56100,2009
48353,37.7,14719,9021,782,4691,4005,37481,5945,3875,2070,5945,49500,2009
48355,34.1,319703,110298,12679,188946,80577,42356,116896,71822,45074,116896,96600,2009
48357,31.6,9454,5083,27,4085,2507,48662,3337,2372,965,3337,77800,2009
48359,40.9,2089,1700,63,237,557,48214,772,536,236,772,78800,2009
48361,37.8,82521,69029,7263,4044,24110,45608,32790,24952,7838,32790,78700,2009
48363,39.2,27451,21569,832,4558,7297,39300,10474,6819,3655,10474,75000,2009
48365,40.3,23107,17170,3988,1423,6396,41309,8714,6952,1762,8714,74600,2009
48367,37.6,108324,92521,2346,10478,26925,61415,35055,27980,7075,35055,138900,2009
48369,34.8,9398,3911,52,5252,2621,36698,3284,2300,984,3284,87100,2009
48371,34,15901,4741,624,10210,3954,34466,5353,3684,1669,5353,45000,2009
48373,44.1,46326,34387,5312,5081,11022,32026,16937,13423,3514,16937,64600,2009
48375,32.2,120797,63940,11349,39635,28137,34827,42704,25675,17029,42704,77900,2009
48377,39.2,7536,1213,0,6273,1779,29492,2800,2127,673,2800,54900,2009
48379,43.7,11104,9613,333,943,2770,40873,3783,3132,651,3783,84600,2009
48381,34.6,112802,90080,2209,16429,28806,54311,42438,29619,12819,42438,125900,2009
48383,32.6,2982,975,113,1894,937,51619,1200,905,295,1200,56100,2009
48385,49,2966,2322,0,624,769,29796,1144,896,248,1144,73300,2009
48387,43.7,13076,9866,2065,715,3627,38053,5297,3572,1725,5297,53800,2009
48389,38.2,11100,2593,189,8073,2781,33569,3911,2935,976,3911,29400,2009
48391,43.1,7364,3376,477,3393,2115,39914,2797,2126,671,2797,65400,2009
48393,43.2,913,842,0,48,311,59097,373,266,107,373,102100,2009
48395,39.4,15830,9352,3381,2713,4471,37941,6166,4266,1900,6166,73900,2009
48397,34.9,72814,54407,4176,11460,19100,80193,23113,19610,3503,23113,183200,2009
48399,43.1,10376,6640,188,3402,2875,37980,4038,3009,1029,4038,56900,2009
48401,39.3,48444,33297,8763,5599,12973,44071,17621,13657,3964,17621,86000,2009
48403,49,10177,8842,993,265,3131,32139,4284,3577,707,4284,60500,2009
48405,46.4,8693,5887,2223,463,2537,26660,3798,2856,942,3798,65600,2009
48407,41.5,24645,19344,2954,1874,6051,42043,8401,7013,1388,8401,73100,2009
48409,34.1,68392,29541,1460,35911,18067,43748,23678,15954,7724,23678,88700,2009
48411,39.6,5904,4201,64,1475,1464,35549,2090,1586,504,2090,70500,2009
48413,38.3,2862,1379,31,1414,896,52872,1127,781,346,1127,67500,2009
48415,36.4,15994,9415,930,5373,4334,39665,5966,4213,1753,5966,64600,2009
48417,40.9,3084,2628,15,396,807,44429,1227,967,260,1227,63300,2009
48419,36.9,26358,17256,4762,3979,7266,31866,10014,7551,2463,10014,60800,2009
48421,33.3,2905,1845,8,1031,797,40231,1035,754,281,1035,70600,2009
48423,35.7,197631,127426,35586,30130,48076,45447,69245,48304,20941,69245,113500,2009
48425,37.5,7730,6359,24,1261,1743,48566,2602,1995,607,2602,137200,2009
48427,26,60936,634,28,60099,12463,21512,14869,11523,3346,14869,52400,2009
48429,40,9474,7258,301,1722,2359,34663,3658,2679,979,3658,59600,2009
48431,42.1,1114,749,0,361,331,38750,449,343,106,449,58800,2009
48433,45,1381,1172,79,117,397,46121,578,440,138,578,53400,2009
48435,37.3,4270,1904,68,2272,1087,54557,1509,1058,451,1509,67600,2009
48437,35.2,7609,4138,369,2827,1779,35060,2707,1848,859,2707,58500,2009
48439,32.8,1704943,932550,231983,431580,418156,54647,605708,383418,222290,605708,131500,2009
48441,32.1,126587,87361,7909,26288,32440,40363,48968,29906,19062,48968,82400,2009
48443,38.8,810,400,0,390,236,35900,400,261,139,400,51400,2009
48445,36.4,12154,5587,666,5758,2913,34310,4341,2791,1550,4341,58600,2009
48447,50.4,1630,1457,0,134,503,34239,738,591,147,738,46400,2009
48449,32.1,29111,15014,2829,10732,7677,39750,10101,6892,3209,10101,87300,2009
48451,33.5,106643,63085,3957,36561,27537,40753,41326,27695,13631,41326,83300,2009
48453,31.3,966761,504248,79213,313678,218034,54044,380211,202552,177659,380211,191700,2009
48455,45.3,14005,11252,1642,960,3694,36519,5319,4318,1001,5319,72500,2009
48457,39.6,20340,16594,2697,618,5785,33548,8217,6544,1673,8217,74500,2009
48459,39.8,37635,31377,3523,1892,10256,42256,13925,10657,3268,13925,82800,2009
48461,36.8,3046,1372,132,1482,758,42940,1037,789,248,1037,33200,2009
48463,34,26623,8198,125,17923,6628,32331,8664,6397,2267,8664,63500,2009
48465,32.4,47533,9082,703,37147,11226,34150,14660,10032,4628,14660,77300,2009
48467,41.4,51874,44359,1804,4848,14088,42271,19192,15045,4147,19192,91400,2009
48469,35.7,86206,43380,4884,36004,22777,45859,31479,21001,10478,31479,92000,2009
48471,34.9,63928,37780,14764,9927,11633,34214,19329,11418,7911,19329,97500,2009
48473,31.5,35552,17250,9097,8533,9179,43865,12481,8251,4230,12481,109300,2009
48475,36.2,10297,4784,382,4798,2772,40514,3897,3018,879,3897,41300,2009
48477,38.8,32152,21951,5721,3816,8355,43791,12222,8379,3843,12222,132800,2009
48479,26.5,231035,10647,539,218219,52063,35964,62552,40590,21962,62552,99000,2009
48481,36.7,40919,20180,5718,14456,10562,42695,14998,10619,4379,14998,81900,2009
48483,41.5,4763,3466,194,954,1449,40603,2087,1563,524,2087,61700,2009
48485,33.1,128464,89838,13472,18960,32837,42999,49168,31216,17952,49168,85000,2009
48487,35.9,13725,8675,1370,3463,3625,36338,5230,3291,1939,5230,55200,2009
48489,31.2,20364,2242,374,17619,4457,22747,5693,3921,1772,5693,42300,2009
48491,34.1,372438,250021,22056,77631,91894,69406,124032,91053,32979,124032,168500,2009
48493,38.5,39033,22780,882,14743,9281,59347,11658,9783,1875,11658,114100,2009
48495,36,6583,3053,60,3314,1720,40074,2587,2092,495,2587,37400,2009
48497,37.3,57615,47035,763,8391,14036,55703,18149,14888,3261,18149,116200,2009
48499,44,42104,35698,2180,3266,10723,39480,14670,11875,2795,14670,90000,2009
48501,33.4,7453,3335,106,4012,2268,48235,2736,2226,510,2736,57500,2009
48503,41.3,17701,14483,210,2515,5215,38195,7559,5338,2221,7559,66100,2009
48505,29.2,13561,1497,42,11957,3623,20525,4578,3168,1410,4578,39800,2009
48507,31.1,11620,1181,0,10439,2686,22964,3460,2222,1238,3460,34300,2009
49001,31.8,6139,5619,0,520,1545,39362,2043,1655,388,2043,143100,2009
49003,30.4,47897,42585,125,3689,12682,54670,15391,12466,2925,15391,154200,2009
49005,23.8,109347,95108,621,9502,24226,46091,32465,20906,11559,32465,171900,2009
49007,35.7,19536,16734,189,2215,5317,41056,7754,5497,2257,7754,97600,2009
49009,37.9,779,709,0,53,207,38021,335,210,125,335,158300,2009
49011,28.6,286502,249947,3211,21018,70771,65892,87074,68637,18437,87074,214300,2009
49013,29.3,16327,14342,25,805,4756,51504,5867,4428,1439,5867,145100,2009
49015,32.6,10408,9452,5,674,2872,47446,3690,2976,714,3690,95900,2009
49017,39.3,4488,4161,0,75,1443,44861,1934,1659,275,1934,124600,2009
49019,39.3,9407,8108,27,683,2227,37206,3647,2672,975,3647,180600,2009
49021,24.4,42752,37731,75,2603,10739,41707,14304,8939,5365,14304,204400,2009
49023,29.2,9563,9024,0,329,2527,50360,3038,2453,585,3038,156300,2009
49025,43.7,6447,6034,1,206,1975,41313,2746,2092,654,2746,181100,2009
49027,33.6,12007,10164,64,1470,3118,42289,3954,3137,817,3954,117600,2009
49029,32.4,8381,8066,0,105,2260,70043,2619,2342,277,2619,240700,2009
49031,41.5,1516,1405,20,75,392,37000,520,464,56,520,135700,2009
49033,40.1,2067,2000,1,9,644,50899,783,686,97,783,131100,2009
49035,30.4,1000299,762748,13358,155128,233711,56948,329748,229018,100730,329748,227000,2009
49037,28.5,14429,5555,0,769,3235,36209,4354,3371,983,4354,100500,2009
49039,27.9,24742,21711,97,2083,5293,41931,6830,5630,1200,6830,136300,2009
49041,31.7,19603,18164,35,754,5021,44411,6443,5290,1153,6443,140200,2009
49043,35.7,35644,30351,141,4168,9436,83380,12750,9825,2925,12750,457500,2009
49045,29.2,54473,45883,583,5645,13373,60236,16854,12938,3916,16854,174100,2009
49047,29,29014,24311,26,1429,7681,57735,9784,7482,2302,9784,169800,2009
49049,23.2,504990,434882,2443,46401,104476,56752,129730,90806,38924,129730,227500,2009
49051,31.6,20318,18037,74,1754,5320,62030,6624,5205,1419,6624,298200,2009
49053,31.8,130258,114528,797,10013,34422,48728,44309,31997,12312,44309,240800,2009
49055,40.8,2502,2400,4,95,700,45040,952,737,215,952,167700,2009
49057,30.5,221981,176962,3200,34261,55621,53471,75021,55611,19410,75021,160800,2009
50001,39.6,36659,35049,245,520,9203,55427,13722,10388,3334,13722,210100,2009
50003,44,36466,34993,86,527,10181,46265,15600,11252,4348,15600,189800,2009
50005,41.5,30356,29293,121,294,7955,41897,12362,8649,3713,12362,148900,2009
50007,35.6,150924,139507,2094,2702,35719,59634,59479,40020,19459,59479,246000,2009
50009,43.9,6436,6196,67,38,1817,40046,2741,2252,489,2741,119000,2009
50011,38.4,47861,45584,283,454,12708,52279,18228,13675,4553,18228,194500,2009
50013,44.5,7575,7342,14,42,2228,56202,3128,2575,553,3128,227300,2009
50015,39.4,25253,24284,185,254,6234,51037,9854,7048,2806,9854,206100,2009
50017,42.3,28977,28012,48,307,7582,51011,11414,9206,2208,11414,176500,2009
50019,42.8,27265,26209,125,302,7083,40605,10532,8118,2414,10532,140400,2009
50021,43,63306,61260,362,703,16406,46153,25999,18296,7703,25999,164800,2009
50023,41.2,58788,56157,332,925,15064,54227,24275,17359,6916,24275,190500,2009
50025,43.6,43627,41476,291,686,11452,46465,18643,12949,5694,18643,199300,2009
50027,44.5,56921,54691,252,680,15738,51066,24398,17923,6475,24398,207100,2009
51001,41.5,38522,23508,11076,3393,9767,40343,14757,11192,3565,14757,145600,2009
51003,36.6,92866,74730,8785,3397,23328,64306,36894,23945,12949,36894,336100,2009
51005,44.1,16397,15109,1040,34,5027,42005,7136,5825,1311,7136,103800,2009
51007,41.5,12581,9321,2772,368,3409,48897,4865,3926,939,4865,170000,2009
51009,40.5,32185,24678,6053,452,8823,45947,12688,9818,2870,12688,136500,2009
51011,42.2,14218,10867,3234,40,4078,47412,5728,4454,1274,5728,119900,2009
51013,33.4,206405,132101,16527,34484,39202,93806,90303,43550,46753,90303,565100,2009
51015,41.3,70991,65613,2999,1334,20209,49364,27529,22011,5518,27529,176800,2009
51017,45.2,4636,4429,110,49,1454,46250,1989,1655,334,1989,126900,2009
51019,42.5,65916,59461,4047,768,19724,54527,26876,22501,4375,26876,174200,2009
51021,44.6,6792,6465,179,17,1986,42231,2585,2190,395,2585,86900,2009
51023,43.1,32231,29853,1542,337,9514,59823,12672,11015,1657,12672,189900,2009
51025,39.7,17786,7385,10249,82,4096,36202,6149,4247,1902,6149,92000,2009
51027,42.1,23584,22504,559,49,6522,27538,9521,7454,2067,9521,63200,2009
51029,43.6,15932,9643,5978,124,3341,38128,4954,3818,1136,4954,109500,2009
51031,40.1,52542,43011,7456,627,14942,43324,22045,16392,5653,22045,127500,2009
51033,38.6,26917,17462,7617,932,7013,56829,10058,8274,1784,10058,218300,2009
51035,44,29137,27939,336,416,8698,34794,12556,9585,2971,12556,92800,2009
51036,45.8,7146,3160,3238,57,1753,49747,2712,2363,349,2712,145600,2009
51037,42.1,12222,8058,4006,54,3236,37591,4662,3585,1077,4662,94300,2009
51041,36.3,298009,204199,61755,16364,82765,71661,109706,86675,23031,109706,225400,2009
51043,42.3,14359,12668,861,506,3667,68768,5487,4165,1322,5487,349600,2009
51045,43.4,5055,4969,2,27,1551,48845,2170,1796,374,2170,147500,2009
51047,36.5,44923,32943,7043,3278,12422,64359,16590,12120,4470,16590,319500,2009
51049,40.4,9536,5861,3202,202,2632,38430,3950,3045,905,3950,141600,2009
51051,41.8,16099,15687,176,59,4361,28296,6465,5199,1266,6465,67000,2009
51053,40.2,25787,16685,8195,402,6878,51556,9617,7453,2164,9617,152000,2009
51057,43.7,10813,6204,4228,132,3251,46678,4601,3443,1158,4601,182000,2009
51059,37.1,1012751,591788,91450,141343,256133,104259,368239,266520,101719,368239,520500,2009
51061,39.8,66330,54781,5506,3520,16648,82872,22705,18066,4639,22705,394800,2009
51063,43.1,14756,13977,271,337,4098,40539,6009,4651,1358,6009,127100,2009
51065,39.9,25162,19912,4427,489,6684,62163,9276,7830,1446,9276,236200,2009
51067,42.4,51023,44786,4709,967,15499,45578,21315,17050,4265,21315,151500,2009
51069,37.8,72120,63364,2820,3913,20103,62291,27224,21309,5915,27224,255900,2009
51071,41.7,17193,16599,254,128,4651,39963,6939,5266,1673,6939,90800,2009
51073,41.5,38229,32484,3781,933,11066,56830,14589,11949,2640,14589,212300,2009
51075,42.8,20429,13527,6142,270,4688,75581,6052,5599,453,6052,307600,2009
51077,45.7,16056,15118,493,397,4813,31707,7500,5965,1535,7500,84300,2009
51079,37.7,17890,15735,1399,479,4948,54153,6741,5539,1202,6741,215000,2009
51081,39.6,11916,4455,7218,168,2463,40917,3536,2617,919,3536,82500,2009
51083,43.9,35460,21390,13036,594,9849,34318,14656,11131,3525,14656,89600,2009
51085,39.8,98602,84763,9478,1544,27973,76926,35854,30216,5638,35854,269300,2009
51087,37,289171,179752,77151,10707,74765,59807,117318,79068,38250,117318,223500,2009
51089,42.1,55480,38658,12243,3639,16015,34437,23237,17836,5401,23237,88100,2009
51091,50.8,2399,2350,0,13,811,43537,1147,894,253,1147,163800,2009
51093,41.5,34705,24790,8652,588,10489,62573,13755,11269,2486,13755,237700,2009
51095,43.6,60864,48587,8216,1802,18465,71988,25133,19284,5849,25133,334100,2009
51097,43.5,6806,4429,2259,68,1931,43766,2829,2295,534,2829,155700,2009
51099,34.6,22286,16737,3822,703,5856,73941,7934,5799,2135,7934,307600,2009
51101,38.1,15492,11824,2953,234,4318,64682,5660,4860,800,5660,193800,2009
51103,53.7,11408,8099,3142,70,3711,44485,5328,4158,1170,5328,236700,2009
51105,39.7,25001,23991,727,173,6652,29889,9644,7046,2598,9644,73300,2009
51107,34.2,277465,187127,20798,28026,66309,112021,91028,74708,16320,91028,508300,2009
51109,41,31661,24717,5747,402,9222,51775,12958,10031,2927,12958,202300,2009
51111,41.8,12908,7571,4768,403,3009,35963,4623,3408,1215,4623,98700,2009
51113,42.8,13571,11591,1412,325,3933,52964,5279,3953,1326,5279,245800,2009
51115,48.6,9011,7803,872,139,2754,49318,3826,3272,554,3826,201400,2009
51117,44,31987,18941,11949,673,8229,34741,12532,9334,3198,12532,103300,2009
51119,49.8,10626,8451,1853,134,3394,50181,4535,3720,815,4535,242800,2009
51121,24.4,89109,77832,3591,1897,17877,41815,32827,18333,14494,32827,177600,2009
51125,45.6,15204,12460,2068,453,4278,44326,6526,5051,1475,6526,161200,2009
51127,41.2,17137,13795,2811,143,4993,69478,6434,5668,766,6434,240800,2009
51131,43.6,13422,7288,4946,817,3614,36450,5258,3606,1652,5258,211700,2009
51133,52.7,12890,9351,3223,182,3855,50522,5740,4904,836,5740,234600,2009
51135,41.4,15790,8824,6105,474,4184,40776,5798,3984,1814,5798,120700,2009
51137,41.8,32140,26307,4326,896,9077,55416,12572,9859,2713,12572,246500,2009
51139,41.7,24026,22789,504,362,6535,42359,9620,7115,2505,9620,159400,2009
51141,44.4,18755,16947,1126,477,5244,36895,7631,6217,1414,7631,99400,2009
51143,42.4,61156,45110,14025,1231,18220,39765,25727,20429,5298,25727,99100,2009
51145,39,27334,21220,5464,342,6617,75118,8124,7288,836,8124,281400,2009
51147,31.4,21581,13493,7510,228,4213,36242,6642,4202,2440,6642,139300,2009
51149,33.8,36364,20058,12404,2413,8688,66049,10875,7708,3167,10875,196300,2009
51153,33,360910,189650,68371,66648,95134,88850,123757,92508,31249,123757,393300,2009
51155,42.7,34910,31695,2150,431,9627,38234,14698,10490,4208,14698,108600,2009
51157,45.3,7171,6453,405,91,2208,58500,3076,2160,916,3076,393800,2009
51159,42.3,9070,5693,2924,300,1941,42212,2989,2479,510,2989,137700,2009
51161,41.8,89905,80443,4554,1699,25078,57800,37329,28631,8698,37329,177100,2009
51163,44.1,21311,19988,901,95,6290,43311,9277,6784,2493,9277,179100,2009
51165,39,73570,67858,1255,3484,21358,51232,28912,21509,7403,28912,184500,2009
51167,42.9,28921,28224,350,61,8687,31770,12148,9225,2923,12148,82400,2009
51169,44.2,22771,21963,247,148,6865,33325,10056,7741,2315,10056,82500,2009
51171,42.4,40325,36608,783,2160,11402,50436,16745,11951,4794,16745,212100,2009
51173,42,31996,30577,511,396,8935,36103,13171,9691,3480,13171,85500,2009
51175,39.3,18177,10496,7325,87,4843,47285,6729,5191,1538,6729,150300,2009
51177,35,118512,87924,17303,7538,31761,77225,40690,32856,7834,40690,311600,2009
51179,33.9,120436,84391,19738,9601,32293,90586,39577,31453,8124,39577,364900,2009
51181,43,7026,3547,3349,67,1699,53320,2632,1931,701,2632,166900,2009
51183,38.9,12051,4566,7118,134,2442,37492,4033,2624,1409,4033,111200,2009
51185,42.6,44307,42020,1224,76,13097,35830,18049,13487,4562,18049,76200,2009
51187,38.6,36087,32211,1810,1089,9202,59630,13638,10291,3347,13638,255900,2009
51191,42.3,52547,50578,636,517,15870,40431,22477,16746,5731,22477,118500,2009
51193,45,17303,11138,4840,871,4765,50151,7357,5631,1726,7357,184400,2009
51195,38,41715,38506,2232,420,11165,32324,16170,11313,4857,16170,73600,2009
51197,42.3,28517,26977,1062,261,7974,38490,11507,8718,2789,11507,99800,2009
51199,39.1,61269,46317,8387,2548,17841,79189,22745,17643,5102,22745,316100,2009
51510,35.2,142131,81046,29746,19746,28063,80186,62860,29340,33520,62860,489300,2009
51515,40.4,6291,4160,1604,358,1773,31796,2811,1751,1060,2811,124700,2009
51520,43.2,17526,15899,1085,90,4787,31797,8044,5273,2771,8044,89600,2009
51530,39.3,6285,5736,352,97,1909,40913,2692,1688,1004,2692,126000,2009
51540,27.9,41393,28672,8231,1467,7099,38369,17037,7532,9505,17037,265300,2009
51550,35.9,219425,137774,64440,6667,60004,66932,78925,58985,19940,78925,263100,2009
51570,40.7,17707,14348,1991,545,4563,49734,7219,4827,2392,7219,169900,2009
51580,42.6,6171,5019,863,83,1705,35758,2734,1865,869,2734,63400,2009
51590,42.9,44978,22847,20371,999,11761,29482,20210,10946,9264,20210,88800,2009
51595,42.2,5605,1869,3489,203,1428,33412,2463,1211,1252,2463,96700,2009
51600,39.6,23369,14666,1244,3181,5521,96232,8433,6221,2212,8433,493800,2009
51610,41,11233,8410,553,1053,2630,113313,4130,2958,1172,4130,655600,2009
51620,39.8,8728,3817,4669,39,2478,32060,3595,1882,1713,3595,178600,2009
51630,29.4,22314,15061,4584,1723,4050,43154,8903,3535,5368,8903,324200,2009
51640,48.1,6806,5801,436,530,1608,22105,3378,2097,1281,3378,82300,2009
51650,34,145903,65782,67794,5649,33438,48122,54561,31691,22870,54561,179800,2009
51660,22.4,43983,32704,2686,6046,7165,33587,14359,5461,8898,14359,196800,2009
51670,35,22933,12747,8748,962,5455,38892,9022,4492,4530,9022,121900,2009
51678,21.8,6909,5656,367,421,977,32847,2027,994,1033,2027,245600,2009
51680,33,71357,47382,20084,1356,15322,37281,26617,15794,10823,26617,130900,2009
51683,32.7,35559,19475,4006,9685,8631,72150,11643,8003,3640,11643,344400,2009
51685,30.9,11633,5882,1241,3531,2912,69087,3786,2928,858,3786,326600,2009
51690,43.4,14660,7679,6088,681,3672,31729,5957,3571,2386,5957,80600,2009
51700,31.9,192635,93899,77484,9953,48201,48124,74229,39262,34967,74229,189500,2009
51710,29.2,236071,108448,102080,11507,51434,41739,85327,39879,45448,85327,197100,2009
51720,41.3,3688,3401,185,0,907,32500,1742,967,775,1742,78600,2009
51730,38.5,32845,5817,25297,986,7127,35874,12386,6438,5948,12386,109800,2009
51735,42.4,11775,10857,84,200,3594,84688,4444,3863,581,4444,304400,2009
51740,33.3,100674,43056,51346,2522,24902,44410,39094,24039,15055,39094,169800,2009
51750,21.8,16062,13745,1326,263,2426,29589,5583,2657,2926,5583,141200,2009
51760,33.8,200976,79751,102850,9654,38853,37735,81230,38393,42837,81230,192400,2009
51770,39,93271,62932,24413,2527,22944,35811,42187,24469,17718,42187,121200,2009
51775,39.7,25139,22526,1691,325,6396,47746,9812,6832,2980,9812,157800,2009
51790,42.3,23645,19949,2671,371,5551,42713,9909,6126,3783,9909,155200,2009
51800,36.7,81062,43527,32820,2034,22728,63657,29993,22428,7565,29993,243900,2009
51810,34.1,434922,289661,81467,25098,111329,63370,162519,108543,53976,162519,268600,2009
51820,39.5,21699,17666,2262,1165,5268,40809,8729,5309,3420,8729,159700,2009
51830,21.9,12330,9469,1537,415,1840,41236,3830,1921,1909,3830,311200,2009
51840,37.4,25977,19106,2786,3025,5569,44708,10012,5038,4974,10012,262400,2009
53001,29.6,17029,7312,27,9339,4394,39679,5423,3628,1795,5423,120700,2009
53003,42.3,21198,19796,0,544,5600,40643,8661,6128,2533,8661,148600,2009
53005,36.3,161077,125548,2086,25677,40779,55253,58394,41492,16902,58394,162700,2009
53007,39.4,70668,52109,210,16240,18053,47009,25981,17652,8329,25981,224700,2009
53009,48.1,70208,60440,567,3258,19575,44342,30260,21996,8264,30260,231600,2009
53011,35.8,416205,349462,6754,27480,105948,58095,151312,104020,47292,151312,258600,2009
53013,47.7,3984,3590,0,197,1136,40774,1788,1277,511,1788,135200,2009
53015,38.8,99874,87568,522,6523,26277,46379,38497,26014,12483,38497,183500,2009
53017,36.5,36145,25826,128,9045,9704,47408,13252,9674,3578,13252,184300,2009
53019,44.8,7444,5675,20,249,1762,36096,2492,1825,667,2492,133500,2009
53021,28.2,69757,31599,1223,34338,15472,45337,20217,13617,6600,20217,142000,2009
53023,48.3,2129,1937,0,150,621,40135,920,656,264,920,113500,2009
53025,31.8,83612,50452,770,29762,20370,42149,27963,17794,10169,27963,131900,2009
53027,40.4,71117,59437,456,5150,17991,41618,28009,18726,9283,28009,151100,2009
53029,42.7,80723,69360,1244,3364,21686,56138,31092,23670,7422,31092,295500,2009
53031,52,29223,26402,169,803,8112,46183,13215,10078,3137,13215,296800,2009
53033,36.8,1858788,1275155,106596,140188,446678,67246,767486,467037,300449,767486,398600,2009
53035,39.2,238825,195312,6070,11590,62408,59358,91917,63957,27960,91917,278600,2009
53037,29.9,38428,33151,146,2595,9008,41025,15618,9014,6604,15618,246100,2009
53039,44.4,20066,16916,44,1854,5526,37656,8249,5728,2521,8249,186900,2009
53041,40.7,73459,64677,360,5545,19283,44661,28297,20794,7503,28297,179400,2009
53043,46.4,10243,9464,28,279,3130,43665,4504,3469,1035,4504,130400,2009
53045,43.1,56341,47535,691,3691,13571,49081,20194,15978,4216,20194,208200,2009
53047,41.8,39706,27878,151,6517,10357,38299,15046,10440,4606,15046,146800,2009
53049,49.6,21341,18317,70,1469,6067,39045,9498,7019,2479,9498,160300,2009
53051,46,12736,11599,23,141,3435,36864,5101,3976,1125,5101,186200,2009
53053,35.2,774339,568234,50799,59097,195602,56773,291323,184959,106364,291323,262400,2009
53055,52,15295,14210,55,497,4501,51392,7357,5471,1886,7357,487500,2009
53057,39.3,116152,92253,740,16889,29815,53094,43713,30845,12868,43713,266100,2009
53059,42.6,10666,9509,15,597,2951,46943,4283,3279,1004,4283,225700,2009
53061,36.4,673709,526820,13943,47385,176262,64780,259142,176389,82753,259142,330400,2009
53063,36.4,454927,400901,6997,17665,115242,46207,181768,119068,62700,181768,179000,2009
53065,43.6,41733,36825,204,1092,11110,41859,15720,12531,3189,15720,168300,2009
53067,38,239248,193499,6579,14224,62623,59453,94040,64229,29811,94040,248700,2009
53069,50.7,3975,3705,0,110,1068,39226,1699,1260,439,1699,195200,2009
53071,36.1,57795,44052,798,10506,13731,44282,20724,13008,7716,20724,182700,2009
53073,35.8,192886,162000,1839,12967,45682,47812,75775,47258,28517,75775,288500,2009
53075,23.6,41793,34810,875,1709,8120,32403,15581,7276,8305,15581,168500,2009
53077,32.1,232911,119823,2034,95099,56726,41854,77816,50437,27379,77816,143200,2009
54001,41.6,15522,14981,80,60,4271,30875,6107,4470,1637,6107,76700,2009
54003,36.4,99058,87293,5443,3165,25871,52250,38157,28850,9307,38157,187100,2009
54005,40.1,25000,24410,314,192,7298,38828,10565,8182,2383,10565,75400,2009
54007,41.8,14554,14159,116,63,3965,30174,6138,4861,1277,6138,73600,2009
54009,43.7,23801,23059,298,70,6797,40537,10006,7608,2398,10006,84200,2009
54011,37.7,94552,86863,4287,916,24454,33062,40671,25994,14677,40671,94400,2009
54013,44.1,7209,6787,32,0,2164,27367,3135,2462,673,3135,66500,2009
54015,40.6,10061,9820,49,0,2708,31148,3834,2961,873,3834,69400,2009
54017,42.3,7238,7029,0,45,1982,30725,2839,2380,459,2839,73500,2009
54019,40.8,46240,42653,2482,374,12807,32579,18887,14359,4528,18887,67500,2009
54021,39.2,6889,5323,860,335,1365,24544,2207,1448,759,2207,69000,2009
54023,43.6,11789,11492,70,90,3618,34259,5209,4199,1010,5209,99600,2009
54025,43.8,34610,32607,1176,316,10088,32635,15503,11474,4029,15503,90500,2009
54027,41,22400,21583,160,176,5780,34571,8851,6596,2255,8851,132300,2009
54029,44.4,30215,28769,663,283,9045,39280,13429,9798,3631,13429,84700,2009
54031,40.9,13488,13018,172,251,3108,34625,4795,3815,980,4795,125500,2009
54033,40.2,68363,65082,952,807,19378,39395,28210,20626,7584,28210,90200,2009
54035,41.2,28140,27592,9,119,8218,42662,11251,8922,2329,11251,99000,2009
54037,38.3,50791,44212,3469,1910,13695,63612,19491,14860,4631,19491,259400,2009
54039,41.5,191624,168713,11643,2846,52075,41478,83590,58878,24712,83590,96700,2009
54041,41.9,17215,16761,122,33,4383,32655,6820,4909,1911,6820,86100,2009
54043,39.2,22211,21825,39,40,6608,29291,8807,6683,2124,8807,66100,2009
54045,40.5,35553,33802,978,224,11242,34214,15261,10931,4330,15261,76000,2009
54047,42.6,22971,19997,2761,113,6339,21360,9492,7372,2120,9492,30500,2009
54049,40.4,56568,53105,2015,566,15298,35209,23166,17101,6065,23166,84500,2009
54051,43.2,33205,32342,166,263,9536,34330,14155,10814,3341,14155,77400,2009
54053,41.6,25536,24913,194,31,7212,34737,10715,8427,2288,10715,78000,2009
54055,41.4,61451,56418,3515,386,16426,31478,25632,18862,6770,25632,71200,2009
54057,40.5,26960,25620,768,221,7946,37681,11306,8692,2614,11306,108600,2009
54059,39.3,26562,25405,880,6,8023,29804,11591,8646,2945,11591,65500,2009
54061,29.1,87864,79793,2983,1364,17416,37544,31661,19320,12341,31661,136800,2009
54063,43.5,13606,13229,98,49,3891,38706,5534,4740,794,5534,87700,2009
54065,43.1,16303,15816,62,176,4293,39040,6857,5311,1546,6857,159600,2009
54067,42.4,26084,25961,11,92,7668,38064,10247,8455,1792,10247,74300,2009
54069,43.1,44365,41353,1578,319,11929,37862,19797,13839,5958,19797,89600,2009
54071,47.3,7577,7170,253,19,2432,35705,3717,2827,890,3717,104900,2009
54073,41.2,7459,7237,128,0,1732,40093,2597,2060,537,2597,92400,2009
54075,45.5,8599,8389,66,64,2526,32237,3600,2830,770,3600,95100,2009
54077,41.5,30178,28680,848,309,8479,37142,11946,9815,2131,11946,82100,2009
54079,40.1,54881,53181,603,356,16068,51186,21282,18253,3029,21282,128200,2009
54081,40.6,78686,69756,6373,920,21575,38023,32221,24256,7965,32221,87200,2009
54083,41.9,28377,27506,295,144,7584,34103,11261,8539,2722,11261,90600,2009
54085,42.7,10306,10058,3,42,2933,35211,4092,3207,885,4092,75100,2009
54087,41.6,15123,14744,0,126,4007,27155,6149,4672,1477,6149,75700,2009
54089,43.5,13217,12452,477,140,3242,26859,5201,4197,1004,5201,71300,2009
54091,42.2,16188,15743,151,108,4457,37639,6302,4959,1343,6302,74300,2009
54093,45.3,6861,6858,3,0,2015,31306,3001,2350,651,3001,84000,2009
54095,44.2,8970,8854,12,6,2625,33579,3789,3027,762,3789,80900,2009
54097,40.2,23566,22910,114,162,6598,34275,9644,7465,2179,9644,97500,2009
54099,39.9,41496,40608,145,269,12174,34814,16966,13101,3865,16966,83400,2009
54101,43.3,9510,9346,0,68,2882,28691,4216,3344,872,4216,56600,2009
54103,43.4,16507,16175,90,75,4941,36021,7071,5607,1464,7071,80100,2009
54105,41.7,5696,5561,0,0,1768,33668,2532,2019,513,2532,61800,2009
54107,41.2,86557,83018,724,809,24497,39530,37034,26857,10177,37034,99300,2009
54109,42.4,23651,23069,229,56,7224,32141,9882,8161,1721,9882,58200,2009
55001,46.6,20400,18641,637,606,6149,38726,9080,7507,1573,9080,125500,2009
55003,39.2,16307,13784,62,317,4278,37245,6882,4887,1995,6882,100300,2009
55005,42.4,45612,43744,240,639,12921,42928,19618,14312,5306,19618,129700,2009
55007,46.8,14938,13033,66,156,4744,43210,6794,5342,1452,6794,159200,2009
55009,35.6,242881,209579,4066,14603,63023,52535,96037,64177,31860,96037,157600,2009
55011,42.6,13683,13282,10,152,3860,44950,5810,4639,1171,5810,125500,2009
55013,47.9,16111,14811,99,190,5041,40870,7465,6102,1363,7465,155400,2009
55015,37.2,44407,41670,256,989,13308,61655,17721,14656,3065,17721,150600,2009
55017,39.1,59872,57871,285,519,16651,49096,23581,17781,5800,23581,143600,2009
55019,37.8,33493,32239,103,657,8810,42876,12701,10209,2492,12701,108600,2009
55021,40.9,54949,52259,617,1137,15513,55155,22534,17063,5471,22534,173100,2009
55023,42.7,16845,16107,359,181,4792,41040,7043,5512,1531,7043,111700,2009
55025,33.8,476381,402227,20283,22888,110926,59546,193033,118700,74333,193033,226900,2009
55027,39.6,87597,80754,2434,3041,23686,52658,33972,25018,8954,33972,153700,2009
55029,48.1,27901,26962,113,366,8976,46581,13449,10315,3134,13449,189200,2009
55031,39.6,43954,41290,325,475,11599,43026,18423,13105,5318,18423,124000,2009
55033,32.4,42416,40160,135,454,10012,48253,15655,11151,4504,15655,148300,2009
55035,32.2,97422,90947,834,1294,23385,45178,38970,25004,13966,38970,145900,2009
55037,47.3,4721,4643,0,13,1421,38250,2106,1802,304,2106,115000,2009
55039,39.2,99336,92580,1011,3331,26846,51768,39894,29222,10672,39894,138300,2009
55041,43.6,9764,8166,162,171,2807,36425,4304,3203,1101,4304,117300,2009
55043,38,48969,47347,534,388,12203,43111,19045,14143,4902,19045,116600,2009
55045,40.9,35631,34350,239,573,9869,52082,14379,11234,3145,14379,145700,2009
55047,44.1,18646,17755,114,545,5440,48230,8074,6092,1982,8074,133700,2009
55049,40.4,23513,22897,104,191,6683,54298,9593,7464,2129,9593,153500,2009
55051,48.7,6267,6087,0,87,1965,34401,3098,2365,733,3098,102800,2009
55053,39.8,19775,17373,462,554,5438,45484,7745,5852,1893,7745,118200,2009
55055,38,79868,73559,331,4517,21616,55379,30925,22406,8519,30925,177800,2009
55057,42.3,26493,24478,219,556,7624,45746,10993,8546,2447,10993,115100,2009
55059,35.9,162740,132583,9279,15420,40715,55055,60213,41321,18892,60213,180700,2009
55061,40.6,20398,19756,10,326,5746,54711,8271,6749,1522,8271,138700,2009
55063,34.4,111491,103295,1300,1271,26670,48543,44883,29800,15083,44883,144600,2009
55065,41.9,15883,15466,56,217,4462,47306,6538,5145,1393,6538,114600,2009
55067,44.4,20255,19505,80,256,6099,40140,8740,7128,1612,8740,107700,2009
55069,43.1,29632,28576,18,365,8863,46770,12800,9836,2964,12800,125700,2009
55071,41.9,80802,75412,536,2039,22403,49026,34009,26230,7779,34009,123500,2009
55073,38.9,129803,119227,594,1709,36558,53150,52977,40042,12935,52977,135800,2009
55075,44.6,42366,40978,111,435,12049,40553,18815,14504,4311,18815,109800,2009
55077,45.9,14884,14256,53,300,4556,43195,6702,5380,1322,6702,137400,2009
55078,31.2,4537,551,24,381,1169,31372,1511,1081,430,1511,74300,2009
55079,33.8,953864,554836,237341,109570,217015,43848,375265,205736,169529,375265,162900,2009
55081,38,43016,40335,320,1271,11686,47243,17408,12777,4631,17408,121500,2009
55083,42.7,37278,35995,165,375,11441,48372,16084,13383,2701,16084,142500,2009
55085,46.9,36257,34983,144,350,11220,44977,17116,13273,3843,17116,171100,2009
55087,36.6,173607,158579,1328,4734,45819,55763,68107,49784,18323,68107,149600,2009
55089,42.3,85554,80523,1126,1620,24109,74237,33655,26471,7184,33655,249400,2009
55091,41.8,7361,7236,30,54,2016,48991,2923,2280,643,2923,137900,2009
55093,33.9,39708,38307,70,442,10033,59421,14538,10980,3558,14538,203200,2009
55095,41.5,44147,42565,157,455,12656,50444,18052,14790,3262,18052,169000,2009
55097,35,68434,64077,257,1316,17282,50978,26945,18899,8046,26945,140800,2009
55099,46.8,14564,14124,41,146,4365,40542,6940,5460,1480,6940,106500,2009
55101,37.9,199147,153199,20392,20007,51195,54203,74975,53128,21847,74975,171700,2009
55103,42.2,17991,17442,18,230,5075,43422,7518,5622,1896,7518,119200,2009
55105,37.3,158829,137930,7183,9647,42251,49894,62400,46088,16312,62400,135000,2009
55107,44.2,14472,14007,102,147,4247,37724,6484,4936,1548,6484,107300,2009
55109,36,80550,76908,615,1102,22735,67748,31327,24281,7046,31327,224500,2009
55111,40,58239,55275,352,1479,16491,49630,24813,18074,6739,24813,161100,2009
55113,45.8,16909,13611,12,289,5322,37583,7996,5809,2187,7996,167800,2009
55115,41.7,41066,36693,164,795,11836,45376,17066,13240,3826,17066,123100,2009
55117,39.2,114122,100721,1515,5639,30660,52848,46209,33662,12547,46209,148000,2009
55119,41.2,19324,18810,20,206,5399,44098,8013,6541,1472,8013,117400,2009
55121,41.2,27675,26585,88,611,7747,46409,11514,8722,2792,11514,129800,2009
55123,41.1,28988,28339,67,313,8002,41545,12034,9428,2606,12034,126100,2009
55125,49.7,21846,19192,68,294,7079,42318,10503,8333,2170,10503,193700,2009
55127,37.4,100069,88436,711,8853,25107,53910,39045,27781,11264,39045,192900,2009
55129,46.4,16583,15902,157,185,4943,41518,7406,5997,1409,7406,148300,2009
55131,39.6,128046,121658,1014,2529,36658,64694,50716,39836,10880,50716,224200,2009
55133,41.1,378848,347301,5133,13172,106525,74466,148248,115214,33034,148248,256400,2009
55135,42.3,51914,49984,92,1000,14054,47374,21255,16348,4907,21255,133900,2009
55137,43.8,24660,22493,461,1282,7127,43137,10380,8321,2059,10380,133600,2009
55139,36.9,161386,148560,2371,4831,40498,50554,65746,44921,20825,65746,139200,2009
55141,41.9,74023,70176,327,991,20871,47594,31448,24089,7359,31448,113700,2009
56001,24.5,32985,28436,308,2590,6897,40116,14193,7252,6941,14193,182500,2009
56003,41.9,11372,10133,6,882,3292,44612,4588,3380,1208,4588,108500,2009
56005,31.7,40290,36683,221,2125,10207,74757,13797,10668,3129,13797,189700,2009
56007,40.4,15347,12470,99,2228,4249,50963,6156,4502,1654,6156,117500,2009
56009,38.8,12959,11804,14,778,3613,55240,5284,3803,1481,5284,154500,2009
56011,43.9,6338,6244,0,74,1797,48591,2524,1920,604,2524,141800,2009
56013,38.2,37432,27117,216,2108,9756,43872,14489,10511,3978,14489,141600,2009
56015,43.9,12137,10777,27,1094,3119,39665,5146,3651,1495,5146,117300,2009
56017,49,4523,4364,0,60,1427,45714,2246,1469,777,2246,101300,2009
56019,44.1,8084,7754,0,256,2007,42849,3251,2393,858,3251,188200,2009
56021,36,86892,70492,2710,9849,22631,51465,33871,23438,10433,33871,162500,2009
56023,37.7,16185,15257,4,591,4798,57446,6475,4851,1624,6475,182000,2009
56025,36.3,71817,64204,602,4298,18266,50382,27997,19543,8454,27997,161200,2009
56027,45.9,2306,2061,21,132,616,43580,971,659,312,971,106700,2009
56029,43.8,27193,25387,39,1176,7726,43851,11832,8208,3624,11832,171600,2009
56031,45.7,8344,7658,0,528,2390,38954,3835,2895,940,3835,115100,2009
56033,42.4,28062,26225,5,845,7317,45861,12295,8294,4001,12295,204000,2009
56035,40.1,7801,7326,3,327,1776,74224,2564,1937,627,2564,243100,2009
56037,33.5,39140,32777,247,4570,11150,67210,15495,11519,3976,15495,155300,2009
56039,34.7,20067,17113,36,2474,4077,67073,7734,4540,3194,7734,704700,2009
56041,33.8,20119,18041,6,1515,5308,56407,7251,5469,1782,7251,158800,2009
56043,42.5,7791,6488,67,1099,2237,47778,3358,2455,903,3358,125700,2009
56045,43.6,6765,6341,3,184,2062,53267,2917,2228,689,2917,107100,2009
72001,34.4,18472,200,0,18224,3947,12103,5032,3686,1346,5032,83500,2009
72003,35.2,45597,1780,177,43525,10412,13797,13015,10437,2578,13015,86800,2009
72005,36.1,67187,1088,44,65671,14786,13814,19629,13692,5937,19629,100000,2009
72007,35.7,31341,382,0,30959,7433,15242,9160,6662,2498,9160,82800,2009
72009,35.2,27119,197,8,26914,6621,15179,8287,6395,1892,8287,88800,2009
72011,36.7,30098,320,22,29708,6813,14435,8828,7169,1659,8828,91000,2009
72013,36.9,102429,702,20,101622,23588,16158,31304,23549,7755,31304,92400,2009
72015,34.6,18997,198,33,18688,4517,14887,6197,4786,1411,6197,83200,2009
72017,33.5,23029,81,10,22919,6130,15708,7761,6031,1730,7761,102900,2009
72019,30.4,30389,111,0,30242,7182,13770,8891,6993,1898,8891,80800,2009
72021,36.5,220606,2160,363,217208,54414,25760,71275,53533,17742,71275,136600,2009
72023,37.8,52969,546,19,52323,12072,16124,16506,13125,3381,16506,99800,2009
72025,36.8,142926,1571,88,141057,36925,22425,47375,35592,11783,47375,124300,2009
72027,35,39310,98,42,39038,8292,14375,10439,8011,2428,10439,83200,2009
72029,33,47174,92,38,46991,10525,22292,13442,10925,2517,13442,111000,2009
72031,36.8,187439,1877,324,184653,45541,28391,61494,45765,15729,61494,146500,2009
72033,33.4,26561,113,71,26304,7338,17298,9502,6049,3453,9502,114700,2009
72035,36.5,47293,285,45,46956,11274,18845,15517,10980,4537,15517,97900,2009
72037,33.4,17863,139,47,17658,3392,16897,4704,3811,893,4704,96500,2009
72039,33.6,20615,57,0,20527,4814,13976,5796,4339,1457,5796,91600,2009
72041,34.2,47899,365,0,47459,10640,19930,13196,9896,3300,13196,106400,2009
72043,33.6,39544,242,10,39272,9801,14145,12344,9739,2605,12344,75700,2009
72045,33.9,19378,158,0,19220,5131,12054,6293,4483,1810,6293,77400,2009
72047,32.9,38808,438,0,38327,8756,12590,10900,8564,2336,10900,83200,2009
72049,38.3,2114,128,9,1970,423,20399,665,528,137,665,116900,2009
72051,34.5,36293,385,0,35798,8959,23531,11672,9869,1803,11672,128500,2009
72053,35.5,42127,391,51,41543,9478,19532,12995,9681,3314,12995,98700,2009
72054,33.5,15629,0,0,15629,2963,15769,3871,3143,728,3871,100000,2009
72055,34.7,22773,379,0,22394,4937,12107,6487,4454,2033,6487,71800,2009
72057,33.7,45248,207,0,44998,10731,17223,14302,10346,3956,14302,83700,2009
72059,34.3,23686,223,15,23433,5424,13843,6661,5356,1305,6661,69300,2009
72061,38,102742,1364,264,101050,24643,33622,33845,26018,7827,33845,202000,2009
72063,34.2,42927,304,49,42574,10276,27915,12495,10631,1864,12495,129900,2009
72065,34.9,43059,156,0,42852,9913,14698,12352,9493,2859,12352,91600,2009
72067,40,17524,191,34,17236,4559,19644,6146,4497,1649,6146,88200,2009
72069,36,60682,619,26,59812,13798,17773,18772,14402,4370,18772,104700,2009
72071,36.6,47716,273,0,47346,10429,12903,13821,9163,4658,13821,94400,2009
72073,32,18263,162,0,18101,3898,15830,4775,3418,1357,4775,84700,2009
72075,32.7,52947,135,0,52772,11524,16654,15017,11586,3431,15017,92800,2009
72077,32.8,40658,304,0,40296,9165,16968,11746,9165,2581,11746,105600,2009
72079,37.2,27826,182,20,27616,6772,14657,8729,6441,2288,8729,84400,2009
72081,35.9,37589,573,0,36723,8146,12227,10213,7470,2743,10213,88500,2009
72083,34.7,12093,45,0,12048,2940,14088,3547,2532,1015,3547,82600,2009
72085,33.6,39253,183,10,38921,8496,16987,11394,8913,2481,11394,112500,2009
72087,30.4,33678,59,21,33571,6789,19156,8857,7096,1761,8857,98000,2009
72089,35,20508,93,9,20388,4900,22097,6505,5206,1299,6505,107100,2009
72091,35,49393,330,0,49063,10914,16003,15002,10722,4280,15002,104000,2009
72093,34.1,6321,0,16,6305,1161,11185,1575,1142,433,1575,74200,2009
72095,36.3,12669,84,15,12570,2896,15035,3928,3146,782,3928,83400,2009
72097,37.3,93697,1148,221,91951,22521,13538,32336,20213,12123,32336,87600,2009
72099,33.9,44266,334,6,43852,9492,12282,11583,9520,2063,11583,90100,2009
72101,30.5,32630,199,55,32376,7562,12960,8700,7019,1681,8700,94500,2009
72103,33.5,24279,521,44,23675,5982,15493,7985,6539,1446,7985,91700,2009
72105,33.3,29946,274,0,29654,7068,14270,8221,6456,1765,8221,80000,2009
72107,32,24782,127,0,24591,5283,13395,6511,4839,1672,6511,81600,2009
72109,36.5,20001,171,91,19682,4772,13780,6407,5285,1122,6407,77500,2009
72111,31.2,29284,200,49,29021,6112,14771,7283,5811,1472,7283,71400,2009
72113,34.8,180312,1306,167,178694,41545,16774,56214,39041,17173,56214,95000,2009
72115,34,27878,128,9,27707,5792,12045,7660,4681,2979,7660,92700,2009
72117,40.1,16381,1046,190,15131,3803,15232,5225,4189,1036,5225,111300,2009
72119,34.5,56294,281,63,55915,12463,21430,16091,13024,3067,16091,112100,2009
72121,36.1,27572,451,0,27121,6648,15943,8731,6758,1973,8731,85900,2009
72123,33.7,32112,115,32,31884,7532,13192,10004,7170,2834,10004,82500,2009
72125,38.3,37599,574,55,36970,8840,14588,12091,8886,3205,12091,82300,2009
72127,37.7,424652,5200,1449,416969,95835,23749,149302,85417,63885,149302,161800,2009
72129,34.7,44358,311,0,43944,9916,16885,12947,9618,3329,12947,105500,2009
72131,37.1,47584,456,8,47120,10291,11863,13107,9903,3204,13107,89900,2009
72133,31.5,22809,30,0,22779,5838,16965,7528,5675,1853,7528,93700,2009
72135,31.8,79734,567,19,78986,17796,24831,21252,18449,2803,21252,129200,2009
72137,34.3,94862,452,67,94052,22494,23655,30214,23855,6359,30214,117700,2009
72139,35,85675,881,51,84551,19009,31095,25019,18802,6217,25019,156500,2009
72141,35.8,34543,991,0,33149,7780,13367,9944,6651,3293,9944,83400,2009
72143,34.1,39547,565,41,38859,9325,17040,11989,9966,2023,11989,103700,2009
72145,34.7,64580,893,7,63574,15006,16924,18680,15856,2824,18680,103900,2009
72147,39.1,9240,377,52,8802,1966,14910,3020,2470,550,3020,109900,2009
72149,30.8,30054,85,24,29926,6098,14961,7314,5726,1588,7314,83600,2009
72151,34.2,40463,79,0,40278,9429,16327,11824,9102,2722,11824,85400,2009
72153,35.7,48214,606,34,47558,11223,13741,14498,10497,4001,14498,83500,2009
01001,36.2,53155,41223,9473,1233,14347,53255,19718,15285,4433,19718,133900,2010
01003,41,175791,147801,16488,6848,50195,50147,69476,53309,16167,69476,177200,2010
01005,38,27699,13077,12871,1273,6668,33219,9795,6665,3130,9795,88200,2010
01007,38.3,22610,18904,3450,134,5497,41770,7441,6170,1271,7441,81200,2010
01009,38.3,56692,50737,655,4246,15378,45549,20605,16897,3708,20605,113700,2010
01011,38.7,10923,2418,8101,180,2434,31602,3732,2871,861,3732,66300,2010
01013,39.7,20895,11435,8969,58,5450,30659,8019,5530,2489,8019,70200,2010
01015,38.1,117149,86996,23686,3555,31201,38407,46421,32818,13603,46421,98200,2010
01017,40.1,34579,20138,13527,524,9381,31467,13681,9764,3917,13681,82200,2010
01019,43.9,25700,23676,1202,321,8319,40690,11352,8802,2550,11352,97100,2010
01021,37.2,43121,35475,3962,2806,12273,39486,16563,12435,4128,16563,103700,2010
01023,43.2,14111,7812,6060,52,3638,31076,5296,4534,762,5296,63400,2010
01025,38.9,26255,14243,10966,238,6011,27439,9144,7316,1828,9144,73300,2010
01027,41.3,14040,11280,2160,360,4349,35595,5851,4260,1591,5851,82900,2010
01029,40.1,14823,13780,606,214,3927,36077,5397,4041,1356,5397,87900,2010
01031,37.9,48349,35316,8325,2712,13286,42253,18928,13192,5736,18928,116700,2010
01033,41.6,54446,43572,8707,1081,15392,39610,22165,16293,5872,22165,94700,2010
01035,43.4,13382,6930,6189,42,3214,26944,4861,3966,895,4861,72500,2010
01037,43.8,11470,7517,3874,14,3057,35560,4561,3819,742,4561,73100,2010
01039,42.1,37608,31685,4837,501,10073,33852,14663,10857,3806,14663,85700,2010
01041,39.5,13928,10021,2901,179,3768,35140,5641,3827,1814,5641,71900,2010
01043,39.5,79941,74469,671,3170,22395,38567,31263,23361,7902,31263,102200,2010
01045,35.8,49730,35461,9624,2606,13542,43353,19545,11958,7587,19545,93900,2010
01047,36.8,44066,13161,30256,312,10665,26029,16795,10509,6286,16795,70300,2010
01049,37,70038,58127,1032,8574,19089,35065,25937,20103,5834,25937,84400,2010
01051,37.3,77650,58445,15514,1965,20832,53128,27762,21545,6217,27762,136500,2010
01053,38.3,37996,23517,11918,722,9440,31927,13804,10152,3652,13804,83800,2010
01055,40,104066,83090,15487,3204,28868,36422,41584,30348,11236,41584,98200,2010
01057,42.4,17472,14999,1954,184,5101,34560,7164,5442,1722,7164,71500,2010
01059,38.5,31383,25497,1272,4134,8925,33942,12367,8557,3810,12367,78200,2010
01061,42.2,26541,22544,2694,850,7373,34140,10720,7677,3043,10720,77200,2010
01063,41.9,9255,1663,7444,97,2210,22222,3522,2505,1017,3522,71500,2010
01065,39.1,16168,6401,9570,57,3789,29299,5843,4342,1501,5843,70600,2010
01067,42.4,17148,11490,4984,334,4801,38379,6656,5450,1206,6656,89700,2010
01069,38,99029,68671,25112,2608,26126,41022,38035,25642,12393,38035,116300,2010
01071,41.4,53386,48197,1786,1212,14902,36312,21173,16226,4947,21173,86300,2010
01073,37,656912,345119,273605,22577,168529,45244,260441,173937,86504,260441,138300,2010
01075,42.2,14743,12665,1804,174,4149,33887,5944,4464,1480,5944,68200,2010
01077,39.7,91762,78884,9198,1872,25330,39345,37713,27521,10192,37713,107400,2010
01079,40.2,34235,26359,3811,598,10208,40516,13412,10558,2854,13412,97600,2010
01081,28.8,135010,94891,30634,4062,32036,40894,54016,34686,19330,54016,139500,2010
01083,38.5,78614,62528,9953,3917,21771,46682,30028,23140,6888,30028,122300,2010
01085,39.7,11731,2964,8538,106,3037,29714,4205,3170,1035,4205,64000,2010
01087,35.8,21699,3248,17936,139,4999,27544,7969,5422,2547,7969,79200,2010
01089,37.1,323080,216630,75517,13034,83887,55851,126564,89162,37402,126564,155600,2010
01091,40.1,21296,9740,11293,72,5639,32940,8494,6241,2253,8494,79000,2010
01093,42,30792,28563,892,587,9062,32769,12744,9665,3079,12744,74700,2010
01095,38,90867,77468,1421,9891,24291,37661,34433,24955,9478,34433,101300,2010
01097,36.3,408620,243844,140639,8854,104324,40996,153302,104815,48487,153302,120700,2010
01099,39.7,23329,12902,9466,248,6291,30235,9191,6784,2407,9191,80400,2010
01101,34.6,228018,91145,122152,7177,57424,43725,88772,56083,32689,88772,121000,2010
01103,38.5,117632,92587,13649,7987,32767,44349,46375,33909,12466,46375,115300,2010
01105,35.2,10684,3156,7264,124,2869,25950,3828,2595,1233,3828,61000,2010
01107,40.7,19917,11135,8400,225,5350,28280,8008,5936,2072,8008,81100,2010
01109,31.7,32147,18549,11661,705,7951,29181,13013,7323,5690,13013,93900,2010
01111,40,22817,17216,4716,563,5909,34593,8529,6474,2055,8529,88100,2010
01113,36.4,51663,27222,21241,1734,12781,32481,20174,12562,7612,20174,93300,2010
01115,38.2,80658,70691,6889,1586,21906,48837,29574,24320,5254,29574,126500,2010
01117,36.5,187880,153241,19108,9750,51786,68380,71759,57844,13915,71759,193900,2010
01119,36.9,13871,3340,10197,101,3093,25338,4952,3381,1571,4952,66300,2010
01121,38.6,82347,53398,26142,1567,21985,36948,31151,22728,8423,31151,87000,2010
01123,41.2,41534,28992,11071,887,11417,36904,16282,11931,4351,16282,91300,2010
01125,31.2,188331,123138,55806,5214,43115,42311,69175,43816,25359,69175,148400,2010
01127,40.5,67612,61302,3966,1237,18314,37191,25800,20036,5764,25800,83600,2010
01129,39.4,17556,11442,4360,132,4822,36431,6672,5537,1135,6672,85200,2010
01131,36.7,12012,3205,8754,33,2616,23491,3732,2865,867,3732,54200,2010
01133,42.6,24687,23482,20,618,6929,33685,9478,6992,2486,9478,83700,2010
02013,38.5,3703,211,379,573,165,54375,267,158,109,267,121600,2010
02016,42,6259,1489,669,1178,300,72917,521,189,332,521,163400,2010
02020,33,284267,181868,14532,20983,70125,73004,104315,64368,39947,104315,269500,2010
02050,25.8,16838,1896,44,227,3158,52214,4291,2632,1659,4291,153400,2010
02060,38.9,1049,483,0,31,288,84000,410,232,178,410,171100,2010
02068,42.4,1144,999,19,9,226,72500,428,260,168,428,174000,2010
02070,28.9,4817,911,11,101,974,60800,1408,855,553,1408,199100,2010
02090,30.8,94439,70247,3970,5382,23642,66598,34596,20696,13900,34596,206800,2010
02100,49.6,1658,1337,3,43,461,47981,744,554,190,744,205400,2010
02105,45.7,2029,874,4,106,673,43750,1004,643,361,1004,184200,2010
02110,38.6,30975,21099,231,1647,7790,75517,12005,7687,4318,12005,291600,2010
02122,40.6,53917,44889,275,1670,14658,57454,22303,16208,6095,22303,193000,2010
02130,38.3,13396,8999,22,581,3594,61695,5629,3329,2300,5629,242500,2010
02150,33.5,13349,7079,125,1025,3123,60776,4409,2608,1801,4409,182100,2010
02164,18,1626,310,16,23,367,40909,492,369,123,492,156400,2010
02170,34.7,84147,70246,744,3136,21304,67703,29361,23264,6097,29361,212000,2010
02180,27.7,9315,1517,105,105,1849,53899,2693,1514,1179,2693,144600,2010
02185,26.1,8852,951,37,332,1519,68517,1976,955,1021,1976,135800,2010
02188,25.7,7477,888,17,97,1385,55217,1802,967,835,1802,129000,2010
02195,42.8,3841,2788,0,28,987,62317,1559,1196,363,1559,195300,2010
02198,39.5,5507,2738,9,123,1590,45728,2386,1647,739,2386,152100,2010
02220,40,8894,5720,22,439,2448,62024,3729,2085,1644,3729,309800,2010
02230,37.2,1140,998,24,41,261,73500,386,228,158,386,253700,2010
02240,35.9,6935,5473,151,212,1711,59596,2485,1621,864,2485,168700,2010
02261,39,9606,6962,76,83,2642,60383,3941,2828,1113,3941,165800,2010
02270,21.5,7398,246,9,30,1387,37955,1728,1119,609,1728,80300,2010
02275,42.1,2338,1593,21,73,651,50389,996,784,212,996,163700,2010
02282,38.6,638,201,0,30,170,65750,257,157,100,257,151900,2010
02290,35.1,5635,1226,4,85,1236,33712,2127,1469,658,2127,99500,2010
04001,31.5,70312,13992,179,4210,13259,30184,18859,14391,4468,18859,80900,2010
04003,39.7,129268,76305,4659,41087,33545,44876,48935,33776,15159,48935,154900,2010
04005,30.8,131824,72977,1356,17334,29748,49510,45478,27835,17643,45478,257700,2010
04007,46.9,53272,35251,136,9344,12841,37580,19704,15433,4271,19704,156100,2010
04009,31.5,36030,18971,760,10727,8141,41683,10822,7793,3029,10822,119500,2010
04011,35.2,8318,4072,12,3821,2353,48696,3327,1560,1767,3327,65800,2010
04012,52.5,20549,12933,197,4649,6469,32147,10158,7656,2502,10158,100000,2010
04013,34.1,3751410,2241236,170462,1087987,913798,55054,1382002,916515,465487,1382002,238600,2010
04015,46.3,199177,159512,1682,28650,53407,39785,80361,57459,22902,80361,170600,2010
04017,33.8,107060,46664,836,11235,26005,39774,35366,25644,9722,35366,134300,2010
04019,37.3,964462,543052,31012,324303,237380,45521,381880,246584,135296,381880,198300,2010
04021,35.7,329297,191872,13363,95091,86265,51310,118826,92296,26530,118826,164000,2010
04023,35.2,46051,7734,35,37762,9303,36519,12078,8575,3503,12078,148200,2010
04025,48.1,209260,172544,1061,27422,56321,43290,89109,64562,24547,89109,231000,2010
04027,33.9,190526,69916,3110,111052,53470,40340,69563,48434,21129,69563,142400,2010
05001,42,19321,13846,4712,428,5159,37230,8202,5282,2920,8202,78900,2010
05003,38.6,22126,15057,5736,963,6221,34934,8901,6448,2453,8901,62100,2010
05005,50.1,41388,39712,29,699,12400,35606,18744,14367,4377,18744,118400,2010
05007,34.4,209911,163235,2211,31060,57600,50434,78947,55347,23600,78947,155000,2010
05009,40.6,36710,35022,63,674,9812,36977,14317,10414,3903,14317,105700,2010
05011,40.1,11638,6832,3362,1331,3489,29908,4877,3426,1451,4877,64800,2010
05013,40.4,5529,4060,1178,193,1508,32450,2123,1744,379,2123,51700,2010
05015,43.7,26971,22754,137,3286,7894,34235,11437,7951,3486,11437,119500,2010
05017,41.9,12102,4868,6587,481,3058,21676,4705,3277,1428,4705,50700,2010
05019,33.1,23083,16316,5322,884,5201,31968,8348,5646,2702,8348,78900,2010
05021,43,16297,15803,18,187,4400,29066,6787,5019,1768,6787,59800,2010
05023,46,25692,24623,144,481,7682,35753,10755,8383,2372,10755,110000,2010
05025,39.1,8769,7422,1109,136,2464,36957,3309,2582,727,3309,66900,2010
05027,36.9,24756,14733,9123,492,6605,35148,9895,6903,2992,9895,76700,2010
05029,39.6,21059,17353,2507,737,5393,32700,8235,6245,1990,8235,82100,2010
05031,33.3,93329,75626,11533,3878,24571,39233,35864,21964,13900,35864,107300,2010
05033,37.3,60778,52979,783,3521,17448,40197,22882,16698,6184,22882,98800,2010
05035,33.3,50673,23332,25018,1036,13304,33716,18717,10892,7825,18717,101100,2010
05037,38.4,18144,13478,4164,249,4745,37021,6638,4690,1948,6638,75800,2010
05039,41.7,8280,4503,3587,171,2168,29602,3160,2227,933,3160,59200,2010
05041,38.3,13351,6341,6230,533,3575,29051,5302,3131,2171,5302,55500,2010
05043,36.8,18546,12608,5304,437,4938,32558,7383,4987,2396,7383,73100,2010
05045,31.5,108375,90116,10818,3923,27791,45287,40928,27158,13770,40928,127500,2010
05047,41.4,18176,17071,50,379,4633,32064,6741,5311,1430,6741,81400,2010
05049,46.7,12263,11841,0,100,3271,30598,4823,3838,985,4823,78200,2010
05051,44,95290,80420,7681,4317,25731,36844,40146,28157,11989,40146,126900,2010
05053,39.2,17657,16596,496,344,5286,51589,6761,5426,1335,6761,96600,2010
05055,37.3,41318,39482,273,853,11442,38209,16154,10616,5538,16154,88900,2010
05057,37.1,22747,12929,6869,2581,6417,35708,8715,5960,2755,8715,68100,2010
05059,39.6,32671,27612,3307,859,8199,37150,11942,9070,2872,11942,77400,2010
05061,38.8,13778,9348,2894,1240,3753,34554,5158,3590,1568,5158,71800,2010
05063,38.7,35994,32576,735,1841,10473,34625,14799,10778,4021,14799,82400,2010
05065,47,13636,12969,209,179,4049,31673,5762,4590,1172,5762,76900,2010
05067,40,18015,14232,2984,397,4326,27615,6391,4458,1933,6391,60100,2010
05069,36.5,78447,33267,41870,1223,18463,35998,28048,18065,9983,28048,76200,2010
05071,37.1,25180,21250,404,2870,6215,30592,9350,6435,2915,9350,83400,2010
05073,42.7,7764,4667,2929,109,1864,27515,2775,2199,576,2775,49600,2010
05075,39.7,17340,16782,46,158,4652,30288,6768,4550,2218,6768,57600,2010
05077,40.1,10709,4434,5909,172,2215,30494,3516,2330,1186,3516,54200,2010
05079,36.2,14203,9284,4303,368,2941,35737,4057,2813,1244,4057,71900,2010
05081,41.2,13145,9733,2783,223,3616,33416,5405,3850,1555,5405,73100,2010
05083,41.3,22580,20905,160,541,5981,37551,8323,6585,1738,8323,78200,2010
05085,35.3,65846,58059,4161,2040,18249,50757,24136,17960,6176,24136,117900,2010
05087,38.5,15507,14331,48,672,4206,36502,5762,4341,1421,5762,97700,2010
05089,48.7,16779,16091,0,221,5082,34109,7239,5905,1334,7239,91600,2010
05091,37.2,43048,30552,10410,1049,11665,40307,16577,10996,5581,16577,86400,2010
05093,34.6,46815,28560,15797,1615,12185,33407,17202,10310,6892,17202,68700,2010
05095,43.2,8492,4780,3451,123,2267,29964,3453,2120,1333,3453,55600,2010
05097,46,9490,8832,7,311,2716,35705,3753,3107,646,3753,75300,2010
05099,39.9,9149,5920,2995,42,2566,38375,3782,2696,1086,3782,62300,2010
05101,44.8,8394,7978,28,37,2520,27441,3555,2833,722,3555,77700,2010
05103,42,26293,14816,10511,414,7179,31259,10714,7475,3239,10714,61900,2010
05105,41.2,10435,9802,261,199,2954,43635,3952,3229,723,3952,80200,2010
05107,36,22412,7819,14204,277,5741,27361,8325,4551,3774,8325,60200,2010
05109,39.1,11286,9961,394,656,3058,32806,4137,3094,1043,4137,79400,2010
05111,39.3,24703,22037,1713,531,6424,32267,9545,6340,3205,9545,64900,2010
05113,43.2,20490,18537,42,1072,5777,32525,8156,6315,1841,8156,79300,2010
05115,35.1,60460,53090,1810,3602,15930,39841,22535,15717,6818,22535,99500,2010
05117,43.5,8839,7539,1181,27,2510,35346,3563,2585,978,3563,74200,2010
05119,35.7,377060,213217,130198,19220,97400,45121,155160,93672,61488,155160,134300,2010
05121,42,18049,17320,114,219,5051,30222,7255,5559,1696,7255,68500,2010
05123,36.8,28302,12060,14617,1184,6100,27019,9086,5337,3749,9086,66100,2010
05125,38.6,102439,92168,4319,3388,28365,51502,39103,30367,8736,39103,130100,2010
05127,41,11226,9661,0,753,3180,36417,4341,3262,1079,4341,69500,2010
05129,45.2,8227,7861,0,56,2285,28811,3457,2593,864,3457,69500,2010
05131,36.5,123847,91555,7501,14117,32464,39482,48572,30817,17755,48572,108000,2010
05133,34.2,16636,10419,686,4782,4336,34383,5849,4338,1511,5849,73100,2010
05135,46.1,17432,16630,47,248,4682,31135,7189,5807,1382,7189,78000,2010
05137,46.5,12321,12063,0,152,3326,30380,4966,3995,971,4966,89000,2010
05139,39.8,42180,26315,13823,1306,11523,36464,16787,11956,4831,16787,71200,2010
05141,46.1,17237,16282,135,405,4701,31960,7065,5548,1517,7065,79200,2010
05143,30.6,197192,148783,5878,28588,48626,42303,75564,42508,33056,75564,154900,2010
05145,36.1,74957,67561,2956,2608,20761,39178,29049,20033,9016,29049,92700,2010
05147,42.9,7505,5182,2197,28,2195,27186,3323,2044,1279,3323,55100,2010
05149,37.9,21895,17007,259,3951,5786,36606,7912,5546,2366,7912,75300,2010
06001,36.2,1477980,519461,183122,323307,340190,69384,532026,293277,238749,532026,590900,2010
06003,40.9,1176,746,0,63,260,63478,410,301,109,410,453600,2010
06005,47.2,38327,30784,705,4566,10019,54758,14715,11372,3343,14715,341400,2010
06007,37.2,218635,166463,3012,29512,52377,43170,85465,52321,33144,85465,265400,2010
06009,48.5,45994,38615,467,4595,13368,54971,18794,14816,3978,18794,350800,2010
06011,34,21165,8899,187,11136,5080,48016,6972,4490,2482,6972,275400,2010
06013,38.1,1024809,505611,90756,239836,259502,78385,368087,255807,112280,368087,548200,2010
06015,37.9,28471,18757,944,4896,6062,36118,9906,6031,3875,9906,240900,2010
06017,42.6,179053,144672,1104,20641,49338,70000,68394,52353,16041,68394,445700,2010
06019,30.4,908830,308759,43673,446727,205821,46430,283836,156132,127704,283836,257000,2010
06021,35.1,27935,16033,197,9989,7233,43074,9660,6518,3142,9660,244200,2010
06023,37.1,133058,104123,1414,12251,31668,40089,54276,31240,23036,54276,324700,2010
06025,31.6,168052,24627,5413,132679,38146,38685,47304,26779,20525,47304,192600,2010
06027,45,18434,12442,176,3310,4838,44808,7982,5109,2873,7982,290000,2010
06029,30.6,815693,327013,44029,388756,185559,47089,248057,152284,95773,248057,217100,2010
06031,30.8,151122,55385,10931,74726,31777,48684,40606,22738,17868,40606,220400,2010
06033,44.1,64371,48392,1367,10505,16075,39491,25180,16902,8278,25180,265400,2010
06035,37.2,35081,23606,2849,5974,6859,50317,10276,6545,3731,10276,217300,2010
06037,34.3,9758256,2772785,826481,4599258,2170227,55476,3217889,1552091,1665798,3217889,508800,2010
06039,33.2,147738,58687,5318,76719,32768,46039,42089,26535,15554,42089,276000,2010
06041,44,248601,184583,7054,35829,62241,89268,102727,65720,37007,102727,868000,2010
06043,47.9,18290,15252,99,1699,5089,49098,7724,5410,2314,7724,278500,2010
06045,41.2,87487,61160,619,18468,21644,43759,34374,21601,12773,34374,410600,2010
06047,29.3,250699,82907,8902,134778,57613,43844,73586,41135,32451,73586,241000,2010
06049,45.4,9605,7610,96,1261,2583,34588,3977,2790,1187,3977,158600,2010
06051,36.5,13905,9644,102,3484,3131,55087,5283,2978,2305,5283,481300,2010
06053,32.8,407435,139535,12089,218868,89606,59271,124963,66731,58232,124963,566300,2010
06055,39.4,134051,78109,2848,41074,32917,67389,49179,31996,17183,49179,571500,2010
06057,46.8,98186,85681,370,7913,27918,57121,41255,30531,10724,41255,444100,2010
06059,35.7,2965525,1349803,45009,973899,699333,74344,984503,599032,385471,984503,607900,2010
06061,39.8,336477,259985,4220,41206,92254,74447,129153,94206,34947,129153,427600,2010
06063,48.5,20392,17511,198,1593,6174,44000,10090,6615,3475,10090,289100,2010
06065,33.4,2109464,863965,124715,933529,493115,57768,666906,467086,199820,666906,325300,2010
06067,34.6,1395144,693823,139229,289636,333019,56439,508499,302429,206070,508499,324200,2010
06069,33.7,54492,21377,493,29835,13377,65771,16812,10807,6005,16812,542300,2010
06071,31.2,2005287,695292,170492,960138,456427,55845,596125,388167,207958,596125,319000,2010
06073,34.5,3022468,1500807,145787,940777,703747,63069,1061789,593945,467844,1061789,486000,2010
06075,38.3,789172,332062,47867,116075,150329,71304,335956,126028,209928,335956,785200,2010
06077,32.3,673613,251081,46449,253771,158997,54341,212905,131357,81548,212905,318600,2010
06079,39,265577,191596,5357,52751,64250,57365,102434,62880,39554,102434,513900,2010
06081,39,704327,308979,19410,172151,172517,85648,255758,156149,99609,255758,784800,2010
06083,33.6,416051,207440,7205,170439,91108,60078,141793,76757,65036,141793,576500,2010
06085,35.8,1739396,636231,41704,456367,421343,86850,596747,353399,243348,596747,701000,2010
06087,36.6,256901,156672,2380,79100,58957,65253,93802,55878,37924,93802,648700,2010
06089,41.3,176906,146929,1451,14162,45805,43944,69100,45574,23526,69100,267600,2010
06091,50.8,3366,3042,37,264,869,52950,1437,1151,286,1437,323300,2010
06093,46.5,44690,35854,575,4454,12276,36981,20097,13098,6999,20097,237400,2010
06095,36.5,410042,171126,59514,94832,99907,68409,139011,91447,47564,139011,389800,2010
06097,39.5,474047,320480,6629,112084,116699,63274,184033,114787,69246,184033,524400,2010
06099,32.5,509682,245803,13230,206983,122255,51094,163841,101826,62015,163841,285200,2010
06101,34.2,93420,48648,1452,25945,23311,50944,31373,19380,11993,31373,262200,2010
06103,39.2,62575,45764,374,13017,15890,38137,23510,15316,8194,23510,221400,2010
06105,48.5,13701,11482,54,892,3722,38725,5889,4328,1561,5889,268200,2010
06107,29.4,429404,146711,5362,253058,99932,43851,126664,75081,51583,126664,211200,2010
06109,46.6,56074,45999,1238,5740,14229,47462,22192,15580,6612,22192,332500,2010
06111,36,809080,405113,13043,315604,195579,75348,264305,175452,88853,264305,568700,2010
06113,30.1,196418,100763,4408,57963,42850,57077,69386,37548,31838,69386,391300,2010
06115,31.5,71160,42363,1749,17072,17142,46807,23750,14214,9536,23750,224200,2010
08001,32.2,425330,231115,12210,156489,104899,54666,147951,101137,46814,147951,196100,2010
08003,32.6,15293,7634,67,6822,3642,35935,5798,3664,2134,5798,131100,2010
08005,35.5,552860,357351,52262,97559,143369,58719,218909,144347,74562,218909,232300,2010
08007,36.7,12136,9745,71,2063,2572,56068,3377,2799,578,3377,304400,2010
08009,47.2,3833,3367,33,307,1056,36017,1682,1260,422,1682,72700,2010
08011,40.2,6125,3665,356,1757,1303,36412,1935,1305,630,1935,69400,2010
08013,35.3,290177,231746,2116,37374,68953,64839,117629,75189,42440,117629,353300,2010
08014,36.7,52872,42315,453,5685,13529,75590,20116,14963,5153,20116,270500,2010
08015,46.3,17540,15218,329,1575,4699,42941,7396,5689,1707,7396,248100,2010
08017,41.6,2194,1956,0,203,524,47125,829,667,162,829,80700,2010
08019,44.7,9088,8408,0,386,2534,60426,4164,3387,777,4164,280000,2010
08021,38.6,8220,3420,36,4497,2324,33627,3121,2364,757,3121,112200,2010
08023,45.6,3536,1138,10,2200,891,24388,1454,1085,369,1454,105200,2010
08025,38.3,5897,3597,553,1575,789,38189,1163,861,302,1163,81400,2010
08027,51.7,3899,3584,5,183,1191,39909,1850,1489,361,1850,218400,2010
08029,45.1,30533,25480,231,4120,8748,40451,12700,9431,3269,12700,193900,2010
08031,33.8,578087,299378,58217,185463,122497,45501,254181,133552,120629,254181,240900,2010
08033,43.5,2027,1903,0,47,596,43058,799,626,173,799,136200,2010
08035,35.8,273440,234188,3086,19892,77198,99198,98725,81496,17229,98725,338700,2010
08037,33.4,50793,34677,97,14706,11216,71337,18183,11869,6314,18183,530900,2010
08039,42.8,22712,20615,170,1247,6506,78958,8135,7430,705,8135,346400,2010
08041,34.3,599988,436599,33552,86710,153625,56268,227151,151369,75782,227151,216800,2010
08043,42.7,46941,34067,2632,7629,11403,37847,16817,12881,3936,16817,152800,2010
08045,34.4,54761,38758,42,14377,14066,64902,19970,13473,6497,19970,341600,2010
08047,43.8,5126,4674,99,216,1316,58036,2530,1817,713,2530,316400,2010
08049,40.4,14526,13182,43,1002,3094,60433,5330,4099,1231,5330,269100,2010
08051,33,15136,13553,38,1104,3316,49356,6216,3674,2542,6216,335100,2010
08053,57.6,489,452,0,36,155,74659,255,213,42,255,275000,2010
08055,49.7,6948,3829,142,2303,1883,30058,3154,2273,881,3154,154900,2010
08057,46.5,1464,1348,0,95,498,37222,690,499,191,690,144300,2010
08059,39.7,528614,425683,5081,72625,143736,66075,217018,156081,60937,217018,259300,2010
08061,46.2,1643,1553,0,41,461,40089,706,470,236,706,62200,2010
08063,39.7,8156,6323,229,1412,2038,41678,3010,2085,925,3010,102300,2010
08065,34.6,7039,3982,91,2752,1536,41103,2725,1824,901,2725,168200,2010
08067,38,50149,40454,238,5790,13108,56422,20512,14176,6336,20512,343400,2010
08069,35,291162,247341,1943,29712,74324,56447,117415,79218,38197,117415,246000,2010
08071,43.9,15675,8523,81,6369,4057,38134,6420,4461,1959,6420,142300,2010
08073,41.4,5476,4405,326,609,1222,41616,1919,1359,560,1919,103700,2010
08075,38.4,22278,18144,387,3344,5548,40961,8146,5560,2586,8146,119900,2010
08077,38.1,142284,119251,739,18045,37953,52067,57123,41320,15803,57123,221000,2010
08079,58.4,1020,972,0,13,302,53438,440,380,60,440,258300,2010
08081,36.2,13519,11307,0,1789,3785,53587,5360,4025,1335,5360,166300,2010
08083,42,25279,19157,0,2699,7695,44103,11027,8027,3000,11027,191500,2010
08085,41.9,40266,31565,161,7485,11405,46590,16335,12187,4148,16335,201700,2010
08087,36.4,27911,17516,605,9232,7160,43111,10407,7005,3402,10407,136200,2010
08089,40.8,18830,10720,185,7420,5125,34142,7620,5034,2586,7620,93800,2010
08091,46.2,4319,3985,0,220,1232,58393,1702,1264,438,1702,405800,2010
08093,44.9,16286,14986,80,753,4619,64098,7070,6218,852,7070,245800,2010
08095,40.9,4394,3471,14,793,1227,44084,1867,1369,498,1867,111600,2010
08097,42.7,16389,14525,12,1345,3922,64502,7417,4635,2782,7417,670200,2010
08099,35.9,12734,8255,9,4363,3270,33969,4905,3270,1635,4905,83000,2010
08101,38.4,156244,85494,2471,63535,40247,40699,61418,42914,18504,61418,140700,2010
08103,37.6,6494,5695,2,534,1701,57992,2621,1941,680,2621,193300,2010
08105,39.9,11926,6802,22,4885,2455,39871,3630,2864,766,3630,129300,2010
08107,38.9,22924,20988,20,1369,6502,60876,10146,7518,2628,10146,422300,2010
08109,42.4,6161,3290,11,2573,1745,30430,2684,1832,852,2684,120500,2010
08111,43.8,752,612,0,120,162,43783,411,223,188,411,252000,2010
08113,38.4,7299,6469,0,562,1759,66399,3228,2077,1151,3228,493000,2010
08115,50.4,2412,2122,0,211,648,37625,1007,733,274,1007,83100,2010
08117,36.2,27105,22718,108,3532,5852,68750,10553,7437,3116,10553,465700,2010
08119,45.9,22821,20831,75,1149,6565,58080,9004,7821,1183,9004,226000,2010
08121,43.1,4773,4181,0,424,1487,39735,2186,1493,693,2186,114300,2010
08123,32.7,242860,165179,1699,68111,62004,55596,86776,62224,24552,86776,195700,2010
08125,36.7,9896,7815,15,1888,2764,42114,3941,2717,1224,3941,116200,2010
09001,39.1,905342,612055,91809,144440,230561,81268,331782,234419,97363,331782,477700,2010
09003,39.5,887976,598255,107134,128860,227223,62590,347625,231066,116559,347625,247400,2010
09005,43.4,189916,174253,2046,7875,52663,69639,76688,60345,16343,76688,285800,2010
09007,42.3,164774,142835,7059,7317,44674,74906,66975,50796,16179,66975,307400,2010
09009,38.7,856688,589137,99141,120521,217115,61114,330785,216131,114654,330785,273300,2010
09011,39.8,272360,216124,13919,21332,70842,65419,106590,74246,32344,106590,268900,2010
09013,37.6,151073,133151,3883,6155,38347,77175,54452,41615,12837,54452,266100,2010
09015,38.9,117708,101195,1947,10611,30228,59370,44321,31366,12955,44321,230100,2010
10001,36.1,156918,104319,35574,8496,40711,53183,57396,41836,15560,57396,207500,2010
10003,36.8,533514,336039,122219,43336,132830,62474,198499,141546,56953,198499,252800,2010
10005,44.6,190846,145300,24118,15083,51255,51046,75744,60623,15121,75744,243700,2010
11001,34.3,584400,194910,305427,51301,109171,58526,257317,111879,145438,257317,443300,2010
12001,29.7,244247,157835,47952,19579,52162,40644,97540,53526,44014,97540,189600,2010
12003,36.1,26548,21871,3505,581,6487,47276,8309,6334,1975,8309,137900,2010
12005,38.7,166798,133079,17017,7527,44480,47770,68807,45433,23374,68807,175500,2010
12007,39.3,28750,21170,5812,1015,6396,41126,8931,6905,2026,8931,120500,2010
12009,44.6,540583,424096,51420,40925,145109,49523,220871,168706,52165,220871,186900,2010
12011,39.2,1734139,790073,436318,415627,420639,51694,668898,463511,205387,668898,247500,2010
12013,38.4,14372,11183,2052,700,3327,31699,4765,3520,1245,4765,89000,2010
12015,54.8,159385,137771,8267,8765,48044,45037,71991,58377,13614,71991,184900,2010
12017,53.5,140686,126698,3866,6171,39799,37933,59974,50720,9254,59974,141800,2010
12019,37.5,186076,145615,17309,13395,51790,61185,67493,52847,14646,67493,189700,2010
12021,45.8,316931,210889,20016,79741,81135,58106,119517,91397,28120,119517,357400,2010
12023,39.5,66964,50244,11611,3161,15944,38214,24177,17289,6888,24177,134300,2010
12027,37,34557,19446,4476,10046,7360,35979,10656,8367,2289,10656,114100,2010
12029,44.5,16196,14742,989,322,3147,32312,4909,4004,905,4909,98200,2010
12031,35.4,854848,491961,246844,60227,208156,49463,330276,208357,121919,330276,175900,2010
12033,37.3,297940,199627,65315,13385,73374,43573,113313,76351,36962,113313,148600,2010
12035,47.2,91806,70917,9672,7621,26102,48090,36182,29330,6852,36182,219100,2010
12037,43.6,11470,9201,1467,633,3142,36490,4699,3083,1616,4699,177000,2010
12039,38.2,46031,15469,25741,4154,10700,35728,16303,11551,4752,16303,104500,2010
12041,39.5,16683,14753,714,731,4304,37039,5976,4812,1164,5976,112700,2010
12043,43,12617,8392,1104,2480,2749,39429,4165,3384,781,4165,106900,2010
12045,42.5,15879,11854,3107,633,3737,39178,5347,4125,1222,5347,131900,2010
12047,37.5,14696,8043,5270,1178,3087,37613,4532,3355,1177,4532,75700,2010
12049,33.4,27521,13547,2189,11377,6003,37466,7694,5748,1946,7694,111000,2010
12051,31.7,39030,14119,5523,18621,8542,37298,11200,7745,3455,11200,117300,2010
12053,47,170337,141271,8075,16500,49091,42011,70254,58570,11684,70254,156400,2010
12055,50.7,98807,70924,8814,16185,26774,34946,40374,32267,8107,40374,122000,2010
12057,35.8,1200236,663069,187176,286394,295936,49536,462447,292728,169719,462447,198900,2010
12059,41.5,19992,17749,902,485,4493,32247,6768,5434,1334,6768,87100,2010
12061,48.1,135518,106127,11485,14264,37314,47341,57560,44186,13374,57560,198200,2010
12063,40.2,49334,33076,12794,2028,11190,38257,16767,12939,3828,16767,97700,2010
12065,44.7,14583,8507,5263,467,3648,41359,5233,4042,1191,5233,127600,2010
12067,35.1,8506,7027,650,731,1638,46445,2307,1860,447,2307,162200,2010
12069,45.2,291671,219925,26860,33115,82282,46477,117544,92476,25068,117544,178400,2010
12071,44.6,606165,436429,46553,106696,162925,50014,245751,183928,61823,245751,210600,2010
12073,29.3,270409,162573,80394,14276,60454,44490,109314,60588,48726,109314,196700,2010
12075,43.9,40415,32901,3580,2775,10945,35737,15814,12061,3753,15814,112100,2010
12077,37,8230,6729,903,436,1444,40777,2008,1556,452,2008,90700,2010
12079,40.2,19300,10613,7355,843,4953,37459,6776,5010,1766,6776,96400,2010
12081,45,318619,237358,26729,44460,84447,47812,131200,97217,33983,131200,214000,2010
12083,46.7,326833,245572,38234,33360,91513,40339,133966,105672,28294,133966,150700,2010
12085,48.9,144322,117175,7443,16280,37254,53210,59203,47063,12140,59203,254900,2010
12086,37.7,2445374,389318,431777,1565410,571889,43605,827556,480532,347024,827556,269600,2010
12087,45.7,73065,52904,4392,14324,17369,53821,29791,19210,10581,29791,503900,2010
12089,42.2,71099,62409,4822,2188,20076,58712,27255,21639,5616,27255,213600,2010
12091,37.6,182076,141597,16512,11733,48826,54242,72442,48772,23670,72442,204400,2010
12093,39,39883,26546,3072,9138,9865,38339,13642,10461,3181,13642,136700,2010
12095,33.4,1116094,526565,219037,287760,265806,50138,406002,243095,162907,406002,228600,2010
12097,35.2,258531,110117,23898,112439,69804,46328,92526,61517,31009,92526,199200,2010
12099,43.1,1299356,801575,213649,233557,324849,53242,523150,384995,138155,523150,261900,2010
12101,43.4,456514,371884,17913,49360,123584,44228,184813,145614,39199,184813,157400,2010
12103,45.6,918263,715513,91194,68009,229952,45258,405649,285487,120162,405649,185700,2010
12105,39.4,590116,389097,82842,97811,157222,43946,223689,161208,62481,223689,141900,2010
12107,42.4,74715,54663,12127,6333,19653,34645,29168,22686,6482,29168,109300,2010
12109,41.8,180624,155228,9771,8797,48341,62663,70324,54234,16090,70324,294100,2010
12111,41.9,269659,169412,48191,42416,71678,45196,103103,78340,24763,103103,177200,2010
12113,38.7,147838,126573,7141,6061,41111,55129,54860,42560,12300,54860,182300,2010
12115,51.7,376200,321994,16426,27759,103782,49388,169009,130833,38176,169009,235100,2010
12117,37.7,417330,282481,42123,67555,103419,58971,152682,108894,43788,152682,241000,2010
12119,61.4,85891,70172,8886,5436,27190,43079,38589,34463,4126,38589,184000,2010
12121,42.3,40675,31922,4226,3289,10456,36352,14983,11389,3594,14983,111600,2010
12123,40,22000,16256,4628,511,5526,37408,7724,6616,1108,7724,87800,2010
12125,38,15375,10960,3372,670,2612,41794,3521,2446,1075,3521,115100,2010
12127,44.4,496053,377031,48983,52754,126653,44400,200346,152160,48186,200346,186300,2010
12129,39.2,29368,23837,3841,913,7522,53301,10540,8816,1724,10540,143500,2010
12131,42,53366,45555,2992,2483,15185,47273,22916,17265,5651,22916,199800,2010
12133,41.2,24125,19027,3306,728,5683,36216,8753,7023,1730,8753,103800,2010
13001,39,18050,12786,3510,1465,4835,36155,7145,5186,1959,7145,83600,2010
13003,33.4,8332,4760,1636,1868,2025,33834,2758,1987,771,2758,54900,2010
13005,35.8,10969,8391,1862,650,2677,31429,3873,2573,1300,3873,71300,2010
13007,37.2,3657,1472,2162,0,925,27462,1342,887,455,1342,66400,2010
13009,34.4,46905,25329,19776,945,9950,37237,15902,9630,6272,15902,112500,2010
13011,37.5,17840,16032,478,991,4738,40455,6463,4904,1559,6463,146800,2010
13013,32.9,66359,50233,7495,5330,17215,48958,23045,17669,5376,23045,138900,2010
13015,36.1,97423,78332,9746,6963,25960,49216,34301,24825,9476,34301,146800,2010
13017,37.2,17631,10207,6321,1026,4459,30134,6582,4106,2476,6582,73100,2010
13019,37.3,18708,15524,2207,786,5095,32202,7293,5249,2044,7293,76200,2010
13021,35.5,154810,67072,78510,4085,35963,38798,57222,33459,23763,57222,118100,2010
13023,39.2,12937,8851,3824,23,2971,35661,4268,2943,1325,4268,71000,2010
13025,37.2,17650,16482,793,199,4911,37343,6629,5656,973,6629,68500,2010
13027,38.8,16338,9490,5856,777,4648,41309,6303,4680,1623,6303,93000,2010
13029,35.5,29039,22669,3782,1212,8115,63244,10466,7763,2703,10466,187400,2010
13031,25.9,67298,44590,18043,2240,14378,34327,24245,13469,10776,24245,135500,2010
13033,35.2,23083,10788,11911,169,5197,33155,7686,5510,2176,7686,77000,2010
13035,37.5,23401,15998,6534,559,5915,52257,7789,5973,1816,7789,142900,2010
13037,36.6,6488,2177,3953,334,1111,30522,1746,1233,513,1746,61700,2010
13039,31.2,49293,35276,9474,2448,13002,49230,17834,12004,5830,17834,161900,2010
13043,37.6,10715,6758,2577,1167,2793,35828,3735,2462,1273,3735,76700,2010
13045,33.2,109227,80664,19606,6266,27962,45559,39421,26806,12615,39421,139900,2010
13047,38,62951,58357,1343,1455,17605,46544,24098,18246,5852,24098,132600,2010
13049,36.8,12310,8103,3804,302,2507,40850,3720,2822,898,3720,73400,2010
13051,34.3,256428,130455,103965,12510,62377,44928,100450,58989,41461,100450,177100,2010
13053,25.4,11702,7136,2610,1435,1977,51089,2537,795,1742,2537,91900,2010
13055,38.1,25985,21734,3025,975,6351,32419,8870,6397,2473,8870,80400,2010
13057,35.7,206283,169218,11055,18739,57106,66320,74339,59946,14393,74339,201900,2010
13059,25.8,115070,66578,30230,11358,21230,34253,41980,19258,22722,41980,161400,2010
13061,42.3,2981,689,2275,3,732,26250,1115,800,315,1115,58500,2010
13063,31.1,260156,41084,166529,33271,57635,43311,86546,51088,35458,86546,127800,2010
13065,35.9,6841,4576,2164,40,1697,31963,2520,1828,692,2520,76700,2010
13067,34.9,677402,391386,161285,79465,174158,65522,256741,178606,78135,256741,211000,2010
13069,34.5,41647,25255,11265,4136,10676,35202,14539,10191,4348,14539,77700,2010
13071,34.5,44712,26698,10116,7095,11562,32902,15695,9691,6004,15695,84300,2010
13073,36.8,117858,88022,17187,5357,32602,66333,41722,33743,7979,41722,168700,2010
13075,36,16976,10982,4859,978,4405,31390,6417,4667,1750,6417,80000,2010
13077,36.1,121528,89289,21118,7496,33824,61550,44137,33461,10676,44137,177900,2010
13079,39.4,12821,9292,2983,269,3462,37062,4671,3779,892,4671,92400,2010
13081,37.7,23182,12090,10071,695,6058,29960,8835,5171,3664,8835,93900,2010
13083,38.7,16595,15792,91,274,4613,39760,6262,4998,1264,6262,123400,2010
13085,40.7,21758,20344,13,795,6193,51128,8163,6438,1725,8163,201400,2010
13087,36.3,27920,14820,11497,1299,7049,33297,10532,6939,3593,10532,98900,2010
13089,33.9,685371,204025,373275,63555,156041,51349,264837,155105,109732,264837,190000,2010
13091,37.7,21402,14111,6450,625,5000,33580,7821,5561,2260,7821,75500,2010
13093,40.3,14283,6195,7294,764,3161,31038,4856,3248,1608,4856,66000,2010
13095,32.9,94514,28848,61992,2062,23029,32435,36072,17481,18591,36072,100300,2010
13097,34.5,127800,66488,47302,9664,33017,55852,44747,31977,12770,44747,157300,2010
13099,38.2,11286,5376,5785,30,2762,26928,4077,2705,1372,4077,75000,2010
13101,28.8,3973,2626,98,1193,1061,32390,1297,918,379,1297,73800,2010
13103,35,50513,41183,6641,1408,13845,56903,17480,13030,4450,17480,153500,2010
13105,39.9,20421,13135,6063,918,5491,30543,7733,5496,2237,7733,81400,2010
13107,36.4,22348,13558,7487,975,5825,30205,8265,5545,2720,8265,77800,2010
13109,36.7,10966,6254,3343,1215,2708,40796,4022,2799,1223,4022,91500,2010
13111,47.2,23337,22440,0,375,7278,34145,10524,8498,2026,10524,172400,2010
13113,41.4,105344,73361,19892,6002,29839,82216,37683,31833,5850,37683,252700,2010
13115,37.2,95810,71329,13288,8365,24356,41066,34977,23471,11506,34977,118300,2010
13117,36.3,163885,134331,4073,14519,44368,87605,55380,48070,7310,55380,276700,2010
13119,39.4,22121,19093,1872,738,6122,36739,8691,6249,2442,8691,124300,2010
13121,34,886982,372016,385767,67052,200227,56709,357463,200119,157344,357463,253100,2010
13123,41,28076,24921,29,2600,8024,36741,11741,8315,3426,11741,137600,2010
13125,37.4,3007,2686,265,6,883,37149,1188,854,334,1188,69500,2010
13127,39.1,77632,50919,19961,4586,20371,50337,30617,19757,10860,30617,180900,2010
13129,35.3,54059,43529,2159,7282,13703,40916,19229,13285,5944,19229,123200,2010
13131,36.7,24738,14738,7276,2276,6614,32247,9477,6125,3352,9477,90800,2010
13133,44.8,15844,8690,6190,771,4417,38513,6064,4559,1505,6064,124300,2010
13135,33.3,778022,364496,169286,147356,196717,63219,260375,187819,72556,260375,194200,2010
13137,36.2,42212,34178,1578,4957,11033,40192,15046,11144,3902,15046,144600,2010
13139,34.1,175001,112923,12341,44480,45172,50876,60173,41502,18671,60173,175200,2010
13141,40.9,9649,1347,8217,51,1763,22283,2907,2194,713,2907,73800,2010
13143,38,28574,26186,1217,363,7691,38996,10579,7779,2800,10579,109000,2010
13145,41.5,30807,23752,5400,824,8837,67018,11056,9784,1272,11056,196000,2010
13147,41.9,25024,19169,4860,697,6807,36109,9492,7262,2230,9492,129900,2010
13149,39.2,11720,10107,1220,108,3113,42685,4287,3159,1128,4287,95300,2010
13151,34.8,193717,107824,65735,10515,50806,63923,66327,53165,13162,66327,171500,2010
13153,34.4,134880,83601,37097,7717,34908,55098,50199,34023,16176,50199,132500,2010
13155,37.3,9642,6796,2570,248,2474,38376,3339,2630,709,3339,77500,2010
13157,36,58347,48956,4021,3357,15870,51506,20917,15736,5181,20917,166000,2010
13159,38.1,13695,9921,3085,461,3683,42081,4998,3522,1476,4998,121800,2010
13161,36.5,14558,10828,2280,1329,4154,32928,5567,3953,1614,5567,74000,2010
13163,38.1,16919,6988,9440,428,4254,29268,6281,4454,1827,6281,74500,2010
13165,40.1,8400,4820,3026,463,2059,27686,3125,2369,756,3125,69700,2010
13167,40.3,9967,6155,3629,83,2303,27607,3334,2332,1002,3334,64000,2010
13169,38.9,28292,20553,7083,280,7799,50717,10238,8271,1967,10238,135200,2010
13171,37.7,17837,11696,5517,325,4502,37536,6377,4244,2133,6377,114100,2010
13173,33.4,9404,6462,2368,388,2717,37522,3308,2070,1238,3308,81300,2010
13175,37.8,48034,28917,17100,1039,12215,38280,17669,11949,5720,17669,88800,2010
13177,35.6,27998,21445,4879,560,7300,59811,9555,7428,2127,9555,145300,2010
13179,27.3,63854,27578,26550,6070,16679,42674,22626,11498,11128,22626,120300,2010
13181,43.8,8111,5289,2576,43,2425,36399,3435,2711,724,3435,98100,2010
13183,29.8,13142,7897,3467,1502,3176,41186,4553,2875,1678,4553,75700,2010
13185,30.1,104916,59660,36903,4656,25490,39096,38358,22665,15693,38358,128800,2010
13187,35.5,28875,26468,368,1375,7395,43394,10863,7653,3210,10863,170400,2010
13189,37.6,21719,12351,8665,469,5866,35414,8283,5382,2901,8283,93600,2010
13191,42.9,13817,8379,5060,237,3825,39075,5687,4247,1440,5687,103400,2010
13193,37,14553,4780,8916,464,2975,27950,4735,3072,1663,4735,69000,2010
13195,38.7,27798,24046,2243,1002,7305,41343,9430,7246,2184,9430,128100,2010
13197,40.6,8403,4824,2822,503,1910,31581,3171,2360,811,3171,75900,2010
13199,38.9,22425,12722,9154,336,5877,37845,8453,6125,2328,8453,95600,2010
13201,39,6128,4246,1730,35,1811,33196,2577,1801,776,2577,80200,2010
13205,37.2,23697,11031,11365,948,5613,36198,8170,5340,2830,8170,76800,2010
13207,40,25864,18511,6395,525,6863,48297,9206,7361,1845,9206,152400,2010
13209,35.6,9138,6163,2466,409,2329,35182,3294,2347,947,3294,80300,2010
13211,40.6,17741,12629,4412,448,4868,45817,6529,4887,1642,6529,169400,2010
13213,35.4,39925,34020,256,5030,10326,38226,14248,10329,3919,14248,98300,2010
13215,33.5,187629,83762,83806,11307,46802,41331,72124,40690,31434,72124,131900,2010
13217,33.9,96833,52663,36739,4254,25669,52361,33536,25501,8035,33536,148600,2010
13219,38.9,31508,27361,1668,1311,8918,74352,11155,9225,1930,11155,228700,2010
13221,40.5,14556,11207,2597,491,3236,39319,4701,3765,936,4701,134400,2010
13223,33.2,134875,102655,21783,6488,36848,62348,46440,37894,8546,46440,149600,2010
13225,34.3,26883,12377,12215,1734,6392,41014,9016,6218,2798,9016,113900,2010
13227,40.8,29155,27521,349,819,8202,49945,11268,9059,2209,11268,170600,2010
13229,38.4,18205,15479,1819,769,4929,37062,6771,5186,1585,6771,75400,2010
13231,37.9,17411,14965,1902,199,4893,53213,5957,4953,1004,5957,153300,2010
13233,36.5,41095,30511,5174,4633,10743,38646,14623,10310,4313,14623,108300,2010
13235,40.8,11632,7677,3798,157,2788,36262,4188,3026,1162,4188,79000,2010
13237,43.7,20925,13856,5794,1138,6110,41529,8467,6768,1699,8467,157600,2010
13239,39.1,2528,1083,1395,29,664,28912,1015,715,300,1015,66700,2010
13241,44.9,16266,14537,184,1171,4499,34406,7148,5216,1932,7148,175700,2010
13243,36.8,7724,2772,4689,18,1955,26194,2952,1920,1032,2952,64300,2010
13245,33.3,198170,76588,105233,7764,46726,37882,74199,42292,31907,74199,99300,2010
13247,36.6,83135,37238,35446,7564,21049,55779,28561,19673,8888,28561,169900,2010
13249,37,4755,3153,1098,199,1132,35096,1690,1123,567,1690,91300,2010
13251,38.5,14799,7948,6483,55,3206,32155,4709,3644,1065,4709,76800,2010
13253,43.1,8797,5518,3075,60,2222,32666,3147,2469,678,3147,72900,2010
13255,36.6,63304,38903,20710,2272,16221,41100,23105,14917,8188,23105,124400,2010
13257,40,25876,21759,2919,627,6494,34938,9307,6703,2604,9307,108100,2010
13259,42.6,5831,2093,3656,36,1413,30954,2248,1548,700,2248,49500,2010
13261,33.7,32865,13622,16776,1564,7406,32430,11508,7254,4254,11508,86300,2010
13263,43.1,6920,2637,4213,0,1861,33873,2682,2135,547,2682,85900,2010
13265,40.6,2041,797,1169,36,482,22188,741,526,215,741,67200,2010
13267,35.8,24263,14557,7012,2368,5582,38522,7750,5280,2470,7750,80700,2010
13269,37.3,8875,5075,3560,153,2523,25237,3430,2546,884,3430,61500,2010
13271,39.3,16052,8208,5852,1827,3479,23876,5681,3502,2179,5681,58900,2010
13273,37.6,9647,3436,5938,123,2394,27909,3457,2094,1363,3457,75100,2010
13275,39.1,44451,26007,16479,1228,11528,35797,17399,10747,6652,17399,137200,2010
13277,34.3,39823,23524,11515,3930,10376,36847,14442,9373,5069,14442,109500,2010
13279,35.2,27151,16692,6747,3014,6812,31635,10077,6313,3764,10077,86000,2010
13281,49.3,10430,10064,73,160,3187,39540,4758,4118,640,4758,194600,2010
13283,36.9,6835,4431,2254,15,1710,36467,2496,1627,869,2496,69000,2010
13285,35.8,65652,40129,21828,2023,16848,41770,23690,15389,8301,23690,130300,2010
13287,36.6,9025,4934,3783,249,2236,30763,3096,1993,1103,3096,83100,2010
13289,41.2,9385,5244,3998,78,1984,26521,3070,2488,582,3070,65500,2010
13291,49.2,21083,20102,159,360,6805,41298,9471,7392,2079,9471,197000,2010
13293,39.1,27308,18702,7617,575,7341,34509,10502,7334,3168,10502,93700,2010
13295,39,67845,62536,2701,1119,18698,38723,25901,19179,6722,25901,108100,2010
13297,37,81491,64429,12800,2516,22555,51721,29147,22161,6986,29147,164900,2010
13299,37.3,36006,23672,10364,1186,8706,35517,13053,8690,4363,13053,78000,2010
13301,43.3,5936,2194,3728,5,1583,31043,2357,1669,688,2357,61100,2010
13303,37.9,21112,9341,11181,343,4987,31382,7167,5145,2022,7167,77500,2010
13305,37.6,29705,21667,5995,1592,7488,37340,10362,7252,3110,10362,86800,2010
13307,40.4,2727,1508,935,138,726,25708,1107,842,265,1107,62800,2010
13309,36.2,7093,3948,3041,49,1178,35422,1664,1256,408,1664,65000,2010
13311,42.9,26498,24903,565,619,8777,41756,12063,9166,2897,12063,171000,2010
13313,33.8,99910,62894,3704,30918,25004,42345,34292,23418,10874,34292,130000,2010
13315,39.5,9041,5445,3330,97,1737,30784,2619,2199,420,2619,56900,2010
13317,43,10580,5498,4609,311,2495,28022,3999,2861,1138,3999,84700,2010
13319,40.2,9685,5576,3821,176,2420,37902,3511,2870,641,3511,71200,2010
13321,39.2,21712,15025,6043,333,5688,38670,7940,5629,2311,7940,85400,2010
15001,40.7,180362,56815,947,20338,42884,54996,64382,42591,21791,64382,361400,2010
15003,37.5,936984,181104,17461,74077,215363,70093,304827,175554,129273,304827,559000,2010
15005,62.5,74,26,0,0,8,41806,67,0,67,67,NA,2010
15007,40.4,65460,20040,446,6150,15329,62531,21710,14107,7603,21710,583200,2010
15009,38.9,150711,48631,805,14868,34941,63989,51281,30167,21114,51281,614600,2010
16001,34.4,380718,331637,3770,25791,97586,55835,145584,101384,44200,145584,214500,2010
16003,46.1,3942,3584,2,37,1221,36004,1700,1366,334,1700,205100,2010
16005,30.9,80701,70108,483,5242,20255,44848,29860,21267,8593,29860,135500,2010
16007,41.2,6026,5715,17,177,1959,43374,2538,2054,484,2538,135900,2010
16009,43.8,9302,7960,68,211,2850,37500,3840,2849,991,3840,123000,2010
16011,31.4,44496,33705,162,7290,11061,44128,14319,11447,2872,14319,125300,2010
16013,39.5,21329,16871,12,3937,5774,61854,9125,6232,2893,9125,473600,2010
16015,46.3,7122,6644,0,206,2111,48789,3024,2322,702,3024,186700,2010
16017,44.8,40711,38538,58,957,12364,41943,18206,13569,4637,18206,236300,2010
16019,31.5,100213,86452,466,10501,26272,50445,35358,26203,9155,35358,153400,2010
16021,42.3,10792,9932,0,390,2912,37712,4186,3453,733,4186,174600,2010
16023,46.4,2842,2715,0,110,799,39413,1149,953,196,1149,108500,2010
16025,37.7,1216,965,5,168,341,44145,427,310,117,427,226100,2010
16027,31,182723,134027,745,41879,46369,43218,62008,44286,17722,62008,151300,2010
16029,38.4,6900,6448,0,278,2088,44958,2726,2160,566,2726,116000,2010
16031,32.4,22109,16285,18,5209,5675,39866,7550,5179,2371,7550,114600,2010
16033,42.3,857,441,0,416,263,40909,334,259,75,334,82800,2010
16035,48.1,8766,8093,27,227,2497,41835,3656,2859,797,3656,124800,2010
16037,41,4277,4105,0,94,1159,41910,1918,1537,381,1918,127600,2010
16039,29.5,26669,20139,548,3943,7240,43089,9522,6426,3096,9522,142600,2010
16041,31.5,12497,11471,33,756,3301,45682,4080,3300,780,4080,165300,2010
16043,32.7,13062,11162,0,1553,3414,42523,4504,3677,827,4504,125200,2010
16045,41.7,16778,14946,0,1302,4636,42794,6512,5173,1339,6512,161700,2010
16047,35.7,15140,10843,14,3882,3793,37228,5512,4008,1504,5512,127500,2010
16049,47.2,15947,14754,21,379,4484,34536,6596,4999,1597,6596,140900,2010
16051,30.1,24523,21523,14,2434,6495,51579,7781,6369,1412,7781,154000,2010
16053,31.7,21282,14716,78,6028,5231,39188,7229,4667,2562,7229,135200,2010
16055,38.5,134851,124587,337,4888,37898,46336,54560,38598,15962,54560,220000,2010
16057,27.9,36645,33355,308,1273,8561,36974,14635,7908,6727,14635,183800,2010
16059,47.8,7861,7467,48,154,2265,36411,3545,2580,965,3545,174900,2010
16061,47.6,3761,3365,0,113,974,35808,1644,1194,450,1644,112100,2010
16063,34.3,5021,3708,50,1186,1298,45714,1814,1367,447,1814,124600,2010
16065,22.5,36413,33257,157,2009,7441,35461,9868,5129,4739,9868,169700,2010
16067,35.8,19524,12931,0,6013,5049,40350,6751,5180,1571,6751,98400,2010
16069,40.6,38886,34605,129,1137,10359,44395,16163,10924,5239,16163,159600,2010
16071,39,4212,4006,0,54,1136,44599,1556,1264,292,1556,120400,2010
16073,35.3,11389,7879,16,2779,3019,33441,4016,2722,1294,4016,133500,2010
16075,36.9,22451,18411,6,3190,6179,43559,8303,6188,2115,8303,134800,2010
16077,34.5,7633,5170,0,2075,2101,40843,2598,1903,695,2598,121900,2010
16079,45.6,12917,12105,14,336,3602,36654,5776,4122,1654,5776,145000,2010
16081,33.6,9413,7715,0,1391,2610,53364,3786,2261,1525,3786,294800,2010
16083,34.5,74929,62794,330,9477,19308,42455,27626,18768,8858,27626,148400,2010
16085,45.1,9846,9436,0,310,2992,50851,4388,3410,978,4388,287100,2010
16087,42.9,10105,8176,19,1555,2882,36542,4010,3018,992,4010,140200,2010
17001,40.4,67030,62572,2262,843,17658,43824,27149,20036,7113,27149,98400,2010
17003,41.8,8449,5160,3011,88,2043,28833,3316,2369,947,3316,58200,2010
17005,39.3,17904,16767,454,483,4457,51946,6255,5078,1177,6255,106500,2010
17007,35.8,53567,40723,1248,10407,13810,61210,17908,14784,3124,17908,174400,2010
17009,37.6,6897,5111,1282,459,1408,38696,2139,1595,544,2139,80100,2010
17011,41.9,35083,31753,252,2541,9893,45692,14580,10959,3621,14580,102000,2010
17013,43.5,5118,5022,8,17,1330,44891,2045,1607,438,2045,101900,2010
17015,45.7,15615,14854,149,360,4805,44805,7010,5346,1664,7010,98500,2010
17017,38.7,13648,11101,364,2015,3494,41544,5057,3612,1445,5057,77300,2010
17019,28.6,197867,142196,24558,9769,43123,45262,77851,43527,34324,77851,145200,2010
17021,41.3,34936,33426,572,468,9239,41712,14135,10600,3535,14135,80500,2010
17023,41.6,16545,16157,40,149,4641,43597,6747,5202,1545,6747,84100,2010
17025,41.6,13927,13546,44,129,3474,38016,5615,4291,1324,5615,72700,2010
17027,39.2,37395,34520,1352,963,10000,55278,13999,11193,2806,13999,124200,2010
17029,31.4,53568,49285,2029,1181,12194,36457,20906,13061,7845,20906,89500,2010
17031,35.1,5172848,2294644,1289020,1202937,1203421,53942,1936481,1169991,766490,1936481,265800,2010
17033,42.2,19864,18280,500,337,5237,41434,7819,6286,1533,7819,70400,2010
17035,40.3,11073,10843,46,53,2949,42101,4172,3323,849,4172,81300,2010
17037,29,104026,83910,6189,9924,23580,54002,37825,23723,14102,37825,192300,2010
17039,41.4,16672,16003,105,306,4653,45347,6811,5178,1633,6811,96200,2010
17041,37.6,20012,18486,54,1133,5361,46941,7572,5926,1646,7572,93000,2010
17043,37.4,911481,650827,39432,116326,237829,76581,335453,255354,80099,335453,316900,2010
17045,42.9,18776,18302,152,171,5100,39904,7877,5988,1889,7877,74200,2010
17047,42.5,6707,6545,45,0,1804,40430,2788,2155,633,2788,61400,2010
17049,38.7,34232,33135,35,524,9066,49509,13462,10639,2823,13462,106500,2010
17051,40,22007,21405,48,247,5563,41269,8176,6499,1677,8176,73200,2010
17053,41.5,14113,13556,165,269,3713,48667,5638,4457,1181,5638,90700,2010
17055,41.4,39528,38331,100,480,10573,34381,16228,12737,3491,16228,61100,2010
17057,42.3,37205,34590,1166,917,9804,41268,14673,11510,3163,14673,79000,2010
17059,43.2,5773,5618,39,15,1613,38003,2377,1879,498,2377,56600,2010
17061,41.4,13983,13605,49,105,3930,41450,5789,4535,1254,5789,72000,2010
17063,36.2,48744,43605,557,3779,12978,64297,17961,13794,4167,17961,193300,2010
17065,42.3,8453,8275,10,87,2510,35032,3503,2932,571,3503,67500,2010
17067,44,19227,18762,46,114,5423,42857,8012,6404,1608,8012,80200,2010
17069,43.3,4402,4154,28,40,1109,27578,1868,1439,429,1868,63300,2010
17071,46.2,7462,7152,8,34,2122,43450,3246,2545,701,3246,77600,2010
17073,41.6,50477,46425,762,2277,14132,49164,20433,15790,4643,20433,108800,2010
17075,42.7,30068,27840,253,1554,8429,47323,11835,9019,2816,11835,101100,2010
17077,28.4,59864,45869,8484,2297,12156,32169,23773,12939,10834,23773,96100,2010
17079,42.6,9752,9573,0,61,2843,46546,4004,3291,713,4004,77900,2010
17081,40.3,39202,34295,3178,806,10249,41161,15364,11523,3841,15364,85800,2010
17083,39.3,22932,22257,168,215,6240,53470,8626,6810,1816,8626,118200,2010
17085,46.6,22728,21775,66,600,6722,50279,10001,7813,2188,10001,138000,2010
17087,40.3,12710,10542,1716,321,3141,41619,4396,3509,887,4396,94700,2010
17089,34.2,502628,304830,26986,147410,127448,67767,168980,131189,37791,168980,245000,2010
17091,36.5,112100,83166,16945,9247,28243,50484,40943,28417,12526,40943,148400,2010
17093,32.7,105602,79658,4657,16064,28274,79897,35687,30614,5073,35687,248300,2010
17095,41.4,52932,45335,3921,2445,13791,39545,21863,15072,6791,21863,80600,2010
17097,36.1,697179,463059,45198,133163,178072,78948,239246,187452,51794,239246,287300,2010
17099,40.5,113789,101095,1540,8572,30965,51705,45326,34593,10733,45326,125500,2010
17101,39,16849,14667,1476,452,4195,38771,6300,4554,1746,6300,67900,2010
17103,40.8,36100,32098,1435,1691,9347,48502,13731,10178,3553,13731,113400,2010
17105,40.2,39010,35124,1831,1435,9761,50500,14630,11084,3546,14630,101700,2010
17107,39.2,30440,26137,3056,836,7183,48999,10981,8178,2803,10981,95100,2010
17109,29.2,32730,29220,1447,850,7137,33702,12923,8067,4856,12923,85100,2010
17111,37.1,306050,258403,2947,33271,81687,76482,108106,90930,17176,108106,249700,2010
17113,31.7,166706,138304,11622,6808,39223,57642,63145,43117,20028,63145,151700,2010
17115,40.5,110719,87708,17259,1976,28514,44337,44947,31959,12988,44947,90500,2010
17117,41.5,47980,46593,148,453,13296,47178,19371,15192,4179,19371,93400,2010
17119,38.2,268005,233222,21249,6844,71492,51941,106867,79569,27298,106867,122600,2010
17121,40.8,39722,36718,1086,591,10952,38974,16148,12047,4101,16148,71400,2010
17123,43.7,12763,12267,38,262,3266,49116,5160,4231,929,5160,102700,2010
17125,42.5,14921,14563,23,108,4367,42461,6475,5208,1267,6475,81400,2010
17127,41.8,15425,13923,666,286,4137,41077,6293,5050,1243,6293,81800,2010
17129,42.3,12702,12577,3,103,3676,56230,5056,4172,884,5056,113500,2010
17131,43,16551,16071,60,255,5152,50909,6862,5486,1376,6862,102800,2010
17133,40.1,32431,31546,39,421,9413,68253,12391,10119,2272,12391,197400,2010
17135,41.4,30230,28466,999,429,7847,40864,11698,9099,2599,11698,78100,2010
17137,40.3,35755,32231,2042,693,9192,44645,14003,9852,4151,14003,93300,2010
17139,41.3,14723,14413,22,112,4019,46364,5627,4436,1191,5627,89700,2010
17141,40,53578,47791,267,4502,14676,55733,20669,15626,5043,20669,152400,2010
17143,36.5,185108,136535,32210,6523,46548,49747,75011,51140,23871,75011,119000,2010
17145,39.2,22488,19615,1891,638,5343,40696,8268,6481,1787,8268,76900,2010
17147,42.4,16708,16290,44,142,4773,55752,6555,5358,1197,6555,119100,2010
17149,42.3,16580,15971,201,144,4549,40205,6648,5253,1395,6648,76000,2010
17151,46.5,4426,4098,150,110,1280,39672,1847,1440,407,1847,88300,2010
17153,41.7,6262,4002,2003,89,1739,31173,2529,1871,658,2529,48800,2010
17155,44.6,5982,5627,55,218,1737,56458,2535,2026,509,2535,123600,2010
17157,40.6,33567,29087,3298,808,8351,45020,11999,9440,2559,11999,86900,2010
17159,42.4,16166,15633,155,60,4487,41917,6675,5234,1441,6675,76000,2010
17161,39.7,147524,113109,12763,16212,38063,46226,60454,43214,17240,60454,111700,2010
17163,36.7,266727,169596,80018,8315,69078,48562,103084,69787,33297,103084,122400,2010
17165,41.8,25171,23276,844,377,6999,35644,10583,7679,2904,10583,69400,2010
17167,39,195288,162721,21984,3326,51150,52232,81968,57820,24148,81968,118900,2010
17169,42.6,7527,7185,8,91,2117,43686,3008,2371,637,3008,74900,2010
17171,42.5,5374,5334,0,21,1448,49462,2140,1633,507,2140,82100,2010
17173,43.1,22362,21916,74,147,6040,44627,9035,7182,1853,9035,84500,2010
17175,41.6,6086,5913,8,71,1700,49195,2411,1969,442,2411,87500,2010
17177,43,47791,41049,4100,1314,12805,43304,19645,14230,5415,19645,103300,2010
17179,39.5,133863,127549,1078,2355,37202,54232,53727,41865,11862,53727,125700,2010
17181,43,17959,16668,211,788,5060,39760,7062,5355,1707,7062,84200,2010
17183,39.1,82033,66411,10390,3292,20659,39456,32236,22994,9242,32236,76500,2010
17185,40.9,12141,11707,157,129,3454,46026,4901,3927,974,4901,77400,2010
17187,39.9,17745,15852,233,1248,4483,41636,6878,4985,1893,6878,83300,2010
17189,41.8,14841,14399,105,162,4273,51440,6057,5038,1019,6057,103100,2010
17191,42.6,16846,16448,84,143,4889,39207,7212,5446,1766,7212,65100,2010
17193,44.4,14800,14397,61,137,4393,39728,6464,5162,1302,6464,62900,2010
17195,41.2,58750,50829,768,6185,16000,45266,23599,17899,5700,23599,98100,2010
17197,34.9,667977,457845,70382,99581,170617,75906,220135,187125,33010,220135,240500,2010
17199,40.2,65579,60375,2306,1274,17392,40579,26324,19365,6959,26324,87600,2010
17201,37.9,293972,216266,34946,30455,75014,47198,112466,78845,33621,112466,128100,2010
17203,39.4,38226,36965,209,493,10760,65890,14192,11818,2374,14192,151500,2010
18001,34.2,34162,32343,118,1337,8886,43317,12243,9589,2654,12243,111700,2010
18003,35.2,351332,271833,40698,21629,89926,48714,135807,95908,39899,135807,113200,2010
18005,37.7,75855,66756,1287,4235,20814,52742,29856,21643,8213,29856,133100,2010
18007,39.5,8820,8288,98,354,2337,46318,3558,2801,757,3558,85200,2010
18009,41.8,12960,12615,14,106,3610,41989,5389,4208,1181,5389,77600,2010
18011,38,54796,51525,493,1216,15663,68594,20801,16449,4352,20801,174300,2010
18013,45.5,15271,14771,71,143,4237,50139,5913,5010,903,5913,158500,2010
18015,39.8,20135,19193,106,642,5677,48055,8033,6393,1640,8033,107400,2010
18017,38.4,39058,33104,640,4503,10405,42587,14981,11325,3656,14981,82400,2010
18019,37.7,107381,92261,7334,4679,28684,47368,43255,30802,12453,43255,125800,2010
18021,39.6,26983,26254,48,281,7531,44666,10262,8122,2140,10262,87100,2010
18023,37.3,33270,28679,174,4089,8335,48416,11906,8739,3167,11906,98700,2010
18025,40.4,10825,10505,143,64,3055,37988,4344,3639,705,4344,86300,2010
18027,35.4,31045,29228,110,1229,7650,44592,11016,8765,2251,11016,97200,2010
18029,39.6,49580,48064,267,531,13537,56789,18311,14141,4170,18311,160300,2010
18031,37.4,25584,24726,92,366,7244,46894,9952,7154,2798,9952,118500,2010
18033,37.1,41968,40177,42,1038,11289,46722,15930,12758,3172,15930,112300,2010
18035,34.7,117344,103705,6541,2103,28341,38066,46212,30704,15508,46212,92400,2010
18037,39.6,41809,38728,543,2310,11271,52871,15900,12591,3309,15900,129600,2010
18039,34.4,196855,153266,10814,26625,50376,47258,70035,50922,19113,70035,128000,2010
18041,40.2,24367,23472,277,234,6720,37038,9864,7302,2562,9864,84900,2010
18043,38.6,73594,66009,3437,1885,20530,52422,28966,21160,7806,28966,147100,2010
18045,41.5,17329,16737,56,314,4793,42817,6952,5505,1447,6952,87600,2010
18047,39.6,23194,22741,0,169,6243,51649,8347,6564,1783,8347,144500,2010
18049,40,20684,19330,266,830,6020,40372,8451,6353,2098,8451,93900,2010
18051,40.1,33386,31687,657,455,8517,46872,13001,10101,2900,13001,99100,2010
18053,39.1,70176,61002,5105,2433,17600,38985,26711,18845,7866,26711,83100,2010
18055,41.2,33084,32278,84,324,8958,41103,13137,10267,2870,13137,87500,2010
18057,35.3,261244,227742,8089,8453,72599,81947,95835,76715,19120,95835,211200,2010
18059,38.4,68011,64089,1256,1168,19447,61052,25416,20341,5075,25416,159200,2010
18061,39.3,38616,37318,65,586,10714,51272,14317,12062,2255,14317,124200,2010
18063,36.5,140028,125330,6282,3856,39081,67180,50936,41983,8953,50936,161100,2010
18065,40.9,48921,46562,819,705,13121,41087,18971,14504,4467,18971,95200,2010
18067,39.7,83326,72921,5769,2194,23419,45003,34330,24187,10143,34330,108300,2010
18069,38.6,37321,35918,23,633,9969,45964,14224,11339,2885,14224,96700,2010
18071,37.9,41902,38671,188,2209,12137,43980,16753,12330,4423,16753,113700,2010
18073,37.5,33055,30825,248,1592,9218,55093,12230,9633,2597,12230,142200,2010
18075,38.7,21441,20544,22,551,5763,39886,8288,6547,1741,8288,81300,2010
18077,39.4,32393,30481,453,710,8325,42707,12667,9095,3572,12667,106800,2010
18079,37.6,28470,27367,86,524,7856,43755,11007,8080,2927,11007,92200,2010
18081,36.4,135994,126153,1791,3849,36569,61629,51080,38715,12365,51080,143400,2010
18083,38.4,38425,36209,943,611,9702,39523,14856,10365,4491,14856,84700,2010
18085,37.2,76982,69413,557,5456,22098,50217,30555,23460,7095,30555,134600,2010
18087,30.4,36996,34331,25,1324,9591,47792,12171,10094,2077,12171,148200,2010
18089,36.9,494417,277053,124491,78573,123409,48723,182952,129759,53193,182952,135400,2010
18091,39.2,110937,90852,11891,5627,28581,46014,42090,31751,10339,42090,119800,2010
18093,41,46192,44567,210,584,13051,40380,18679,14687,3992,18679,97400,2010
18095,39,131444,113978,9237,3845,33572,43256,51436,37780,13656,51436,96300,2010
18097,34,890976,544252,232035,74758,211289,43541,357081,210098,146983,357081,122200,2010
18099,37.7,46976,42136,224,3854,12755,50141,17631,13797,3834,17631,123400,2010
18101,42.1,10324,10125,1,62,2863,43406,4113,3446,667,4113,84100,2010
18103,39.9,37307,33796,1513,912,9513,39485,13506,10348,3158,13506,86100,2010
18105,27.5,134442,116505,4484,3782,26849,38137,51388,28360,23028,51388,146700,2010
18107,39,38138,35638,210,1503,10202,47694,14503,10668,3835,14503,107100,2010
18109,39.1,68654,66624,172,840,19111,55427,24925,19969,4956,24925,141200,2010
18111,42,14300,13416,43,611,3943,50721,5446,4462,984,5446,109600,2010
18113,36.5,47513,40770,133,4429,12825,45818,17498,13549,3949,17498,112600,2010
18115,41.8,6067,5883,51,86,1890,50966,2495,1878,617,2495,134200,2010
18117,39.8,19820,19165,248,181,5464,37120,7866,6091,1775,7866,90500,2010
18119,41.4,21737,21155,99,199,5758,44285,8371,6875,1496,8371,95700,2010
18121,41,17394,16597,406,182,4373,40512,6437,5312,1125,6437,91600,2010
18123,40,19316,18455,527,171,5206,45108,7687,6008,1679,7687,93600,2010
18125,41.9,12955,12677,25,162,3805,41222,5293,4462,831,5293,80700,2010
18127,38.1,162026,140958,4165,12718,42763,60889,61370,47833,13537,61370,164500,2010
18129,40.7,26100,25198,265,249,7378,57530,10035,8510,1525,10035,120500,2010
18131,41.5,13596,13025,22,277,3780,44016,5105,4023,1082,5105,97900,2010
18133,37.3,38048,35309,1450,607,9129,48992,12785,9965,2820,12785,119800,2010
18135,40.2,26262,25030,43,713,7328,40990,10369,7982,2387,10369,80100,2010
18137,38.8,28570,27686,92,427,7666,48093,10717,8385,2332,10717,138200,2010
18139,39.7,17568,17035,166,167,5014,46685,6684,4949,1735,6684,106800,2010
18141,35.9,266522,203409,32511,18404,64970,44644,100540,71879,28661,100540,116300,2010
18143,38.2,24109,23432,115,312,6651,39588,9271,7042,2229,9271,96600,2010
18145,39.7,44237,41556,253,1485,12232,52292,17196,12777,4419,17196,126400,2010
18147,41.7,20977,20168,104,447,5854,52105,8102,6763,1339,8102,111600,2010
18149,40.2,23343,22227,96,686,6459,37480,8992,7180,1812,8992,98200,2010
18151,39,34092,30773,180,964,9900,47479,13944,11013,2931,13944,121700,2010
18153,39.1,21520,20263,907,246,5316,44184,8033,6195,1838,8033,77000,2010
18155,40.4,10393,10226,0,111,2735,44503,4060,3293,767,4060,119800,2010
18157,27.4,168635,137112,6049,12047,37149,42632,64093,35756,28337,64093,128900,2010
18159,41.8,16132,15773,0,295,4668,51485,6651,5221,1430,6651,113500,2010
18161,38.7,7463,7241,5,104,2206,43257,2933,2318,615,2933,112600,2010
18163,37.4,178298,153025,15865,3538,45633,42396,73973,48130,25843,73973,111700,2010
18165,41.2,16412,16053,18,120,4437,41904,6639,5197,1442,6639,77000,2010
18167,36.1,107151,93511,7016,2359,25068,38508,40490,26662,13828,40490,89900,2010
18169,40.8,33225,31757,225,665,9083,43157,13055,10179,2876,13055,96400,2010
18171,41.8,8563,8378,0,26,2477,49238,3304,2568,736,3304,102600,2010
18173,39.6,58393,54914,507,910,16841,62354,22093,18508,3585,22093,140200,2010
18175,38.2,28226,27473,112,273,7784,39722,10810,8564,2246,10810,100200,2010
18177,40.1,69187,61872,3177,1741,18825,41123,27953,19181,8772,27953,99700,2010
18179,40,27744,26738,175,542,7815,47202,10728,8371,2357,10728,110100,2010
18181,41.9,24734,22620,89,1641,7332,45891,10065,7806,2259,10065,111000,2010
18183,38.8,32991,31894,97,492,8996,52129,13246,11021,2225,13246,123500,2010
19001,44.8,7779,7595,7,52,2166,45202,3409,2583,826,3409,93800,2010
19003,45.7,4127,3992,11,93,1111,40368,1764,1393,371,1764,81200,2010
19005,43.4,14331,13527,28,701,3838,46623,5807,4628,1179,5807,105200,2010
19007,43.4,13029,12620,107,156,3561,34689,5573,4151,1422,5573,72400,2010
19009,46,6186,6064,0,73,1701,42717,2700,2157,543,2700,72900,2010
19011,40,26098,25350,106,253,7610,54726,10200,8249,1951,10200,128900,2010
19013,34.7,129252,109285,11238,4512,32409,44178,51822,35733,16089,51822,118600,2010
19015,40.2,26424,25418,231,469,7211,49578,10801,8137,2664,10801,115800,2010
19017,38.8,24185,23419,147,205,6693,55676,9397,7713,1684,9397,132800,2010
19019,38.4,21026,20420,136,218,5965,51961,8212,6399,1813,8212,113400,2010
19021,36.9,19980,14042,439,4263,4986,43182,7551,5235,2316,7551,87600,2010
19023,43.4,14892,14580,33,122,4255,47702,6059,4979,1080,6059,90900,2010
19025,47.5,9846,9475,112,90,2960,41611,4316,3439,877,4316,70700,2010
19027,42.2,20805,20147,0,292,5609,47507,8661,6496,2165,8661,106700,2010
19029,44.6,13969,13535,100,200,3949,40820,6000,4263,1737,6000,82600,2010
19031,42.1,18414,17840,8,247,5243,54321,7547,6000,1547,7547,125900,2010
19033,42.7,44324,41069,390,1672,11856,44741,19839,14197,5642,19839,107900,2010
19035,46.9,12086,11585,20,227,3273,44635,5373,4064,1309,5373,77500,2010
19037,43.8,12499,12136,0,212,3582,41372,5328,4504,824,5328,93800,2010
19039,40.9,9218,8242,114,761,2403,45596,3511,2739,772,3511,92400,2010
19041,42.6,16718,15924,54,425,4818,43542,7459,5268,2191,7459,98500,2010
19043,44,18202,17615,24,259,5084,45873,7684,5942,1742,7684,96500,2010
19045,41.1,49274,45829,1206,1203,13220,46170,20074,15104,4970,20074,106100,2010
19047,38.9,16951,13177,110,3542,4386,44377,6475,5147,1328,6475,81500,2010
19049,34.3,61714,55054,761,3766,16615,67037,23973,18604,5369,23973,176600,2010
19051,39.6,8687,8636,8,15,2251,46597,3122,2582,540,3122,101400,2010
19053,38.7,8508,8020,65,301,2152,37138,3248,2218,1030,3248,69300,2010
19055,40.9,17857,17518,2,49,4940,47078,7336,5921,1415,7336,113700,2010
19057,41.5,40266,36204,1872,1080,11027,41937,16862,12402,4460,16862,90400,2010
19059,46.8,16665,16267,86,153,5153,50174,8103,6348,1755,8103,153000,2010
19061,38.2,92547,86583,1390,1746,24605,48573,36787,27493,9294,36787,136800,2010
19063,40.7,10389,9457,92,639,2822,42286,4286,3284,1002,4286,78600,2010
19065,42.4,20992,20141,227,343,5619,41055,8474,6648,1826,8474,81200,2010
19067,43.3,16394,15577,245,287,4397,39467,6779,5048,1731,6779,89200,2010
19069,43.3,10697,9407,22,1054,2790,44863,4189,3105,1084,4189,82500,2010
19071,44.5,7528,7207,38,165,2099,47225,3119,2431,688,3119,92800,2010
19073,44.9,9448,9271,4,150,2674,43286,4168,3178,990,4168,80400,2010
19075,42.5,12401,12146,3,112,3589,56184,5042,4070,972,5042,111000,2010
19077,44.2,11040,10687,39,180,3221,50090,4669,3693,976,4669,94600,2010
19079,40.9,15874,14667,70,643,4256,46188,6603,5065,1538,6603,90500,2010
19081,44.1,11505,10924,14,367,3459,47318,4774,3941,833,4774,81200,2010
19083,43.5,17685,16626,225,567,4776,44694,7353,5426,1927,7353,85600,2010
19085,42,15073,14690,13,160,4351,51303,6096,4843,1253,6096,111400,2010
19087,39.1,20263,18371,140,728,5311,41983,7657,5651,2006,7657,96400,2010
19089,41.3,9610,9367,9,102,2551,46068,4021,3197,824,4021,90300,2010
19091,44.2,9905,9417,0,280,2803,45282,4289,3261,1028,4289,81600,2010
19093,44.2,7172,6974,0,92,2021,44521,3123,2361,762,3123,74300,2010
19095,41.8,16353,15853,51,232,4711,56053,6657,5185,1472,6657,128400,2010
19097,42.9,19942,19377,40,191,5721,42489,8381,6567,1814,8381,106100,2010
19099,41.4,37050,35528,470,557,10168,46396,15036,11042,3994,15036,114600,2010
19101,44.9,16643,14612,198,394,4234,44167,6826,4943,1883,6826,92400,2010
19103,28.8,126994,106995,5345,5572,27318,51380,50985,30758,20227,50985,177000,2010
19105,42.4,20708,19768,383,238,5456,47955,8093,6406,1687,8093,106900,2010
19107,42.7,10614,10397,13,82,2965,42698,4571,3663,908,4571,74700,2010
19109,46.2,15748,15346,37,160,4382,48277,6661,5475,1186,6661,84700,2010
19111,41.9,35991,33036,998,1104,9624,42444,14234,10542,3692,14234,78900,2010
19113,36.5,207765,186843,7684,5078,53906,53674,85447,62272,23175,85447,136400,2010
19115,38.3,11683,9606,43,1733,3083,50457,4280,3427,853,4280,87400,2010
19117,42.9,9116,8936,4,77,2463,43005,3668,2769,899,3668,85200,2010
19119,38.7,11564,11279,18,158,3192,49506,4365,3576,789,4365,97900,2010
19121,39.3,15488,15048,44,167,4215,53183,5753,4686,1067,5753,145400,2010
19123,39,22382,21296,284,347,6188,45025,8988,6753,2235,8988,95200,2010
19125,38.7,33378,31980,169,510,9062,53370,12522,9543,2979,12522,137300,2010
19127,39.4,40131,32188,642,6303,10207,45232,15517,11630,3887,15517,99600,2010
19129,41.1,15157,14507,31,323,4100,59481,5581,4602,979,5581,144200,2010
19131,43.5,10801,10603,56,89,2942,48506,4328,3603,725,4328,99200,2010
19133,46.2,9346,9020,15,98,2685,41398,4200,3003,1197,4200,71300,2010
19135,43.1,7918,7650,31,60,2387,43245,3384,2648,736,3384,80100,2010
19137,43.9,10901,10429,25,279,2973,38624,4519,3361,1158,4519,80800,2010
19139,38,42501,34777,444,6360,11351,51025,16481,12810,3671,16481,120300,2010
19141,44.4,14419,13690,48,433,3943,44018,6022,4633,1389,6022,83000,2010
19143,42,6576,6107,83,320,1788,43889,2724,2059,665,2724,70200,2010
19145,43.5,16095,14959,457,413,4333,40778,6396,4733,1663,6396,81900,2010
19147,42.4,9508,9348,0,112,2441,42800,3979,2969,1010,3979,74500,2010
19149,41.5,24933,23772,55,646,7099,56379,9804,7924,1880,9804,119400,2010
19151,47,7509,7254,22,130,2005,42105,3317,2662,655,3317,56100,2010
19153,34.8,419301,342889,23402,29509,108817,56094,168352,119130,49222,168352,149700,2010
19155,38.2,91928,83146,1201,5415,24789,48728,36325,25891,10434,36325,126100,2010
19157,41.6,19012,17846,238,405,4858,50998,7650,5981,1669,7650,108900,2010
19159,45.1,5169,5010,0,58,1426,42336,2072,1642,430,2072,83300,2010
19161,45.9,10480,10185,91,162,2960,42986,4535,3665,870,4535,76800,2010
19163,37.4,162184,135897,11067,8535,42097,49964,66318,46663,19655,66318,134600,2010
19165,44.7,12328,12218,0,36,3459,44085,5070,3946,1124,5070,103100,2010
19167,32.7,33377,30273,307,2443,8533,51557,11522,9373,2149,11522,119900,2010
19169,26.4,87594,76616,2053,2425,18575,48248,34227,18743,15484,34227,156000,2010
19171,41.7,17952,15202,103,1174,4999,46288,7058,5501,1557,7058,96500,2010
19173,44.5,6402,5972,28,329,1771,40300,2687,2162,525,2687,67000,2010
19175,41.4,12409,11936,189,183,3466,40879,5326,3829,1497,5326,88100,2010
19177,43.8,7645,7456,18,36,2135,40073,3098,2427,671,3098,67600,2010
19179,39.8,35553,31452,334,2912,9666,40093,14764,11296,3468,14764,74800,2010
19181,38,45346,43585,263,816,12436,62034,17008,13457,3551,17008,150900,2010
19183,41.1,21626,20156,83,1003,5973,50710,8767,6750,2017,8767,118600,2010
19185,45.7,6404,6247,0,0,1781,35425,2742,2172,570,2742,60500,2010
19187,39.9,38286,34613,1468,1348,9761,40806,15936,10959,4977,15936,85600,2010
19189,43.5,10962,10398,54,303,3100,41871,4711,3518,1193,4711,90900,2010
19191,39.2,21031,20193,168,347,5374,50693,7869,5943,1926,7869,147600,2010
19193,35.4,101217,79593,2338,12879,25721,44343,38739,26576,12163,38739,94700,2010
19195,44,7628,7445,15,136,2255,49673,3279,2626,653,3279,95200,2010
19197,44,13384,12040,0,1086,3577,44035,5545,4128,1417,5545,72700,2010
20001,40.2,13473,12420,193,388,3809,41546,5575,4350,1225,5575,64400,2010
20003,41.7,8084,7758,0,8,2362,40428,3188,2675,513,3188,87300,2010
20005,36.1,16889,15113,1026,422,4107,44175,6220,4127,2093,6220,89200,2010
20007,45.5,4900,4657,21,95,1474,38875,2304,1640,664,2304,52500,2010
20009,40,27499,23228,351,3377,7647,43763,11472,8504,2968,11472,71000,2010
20011,37.8,15097,13917,407,321,4011,38045,5833,4355,1478,5833,76400,2010
20013,41.7,10019,8471,120,303,2673,37525,4080,2854,1226,4080,74800,2010
20015,37.1,64853,59251,822,2389,17953,56290,23987,18670,5317,23987,121200,2010
20017,43.8,2834,2673,21,86,803,40372,1175,960,215,1175,86100,2010
20019,47.5,3736,3366,54,85,1022,35848,1554,1221,333,1554,49800,2010
20021,39.7,21740,19496,109,470,5622,38154,8362,6606,1756,8362,69100,2010
20023,48.8,2783,2643,0,115,762,31186,1269,956,313,1269,67100,2010
20025,44,2231,2064,0,106,599,37931,954,702,252,954,59100,2010
20027,43.9,8531,8197,72,138,2368,42490,3561,2612,949,3561,86500,2010
20029,42.7,9538,9252,12,207,2517,35838,3970,3098,872,3970,63400,2010
20031,43.3,8587,8177,60,146,2463,47171,3445,2651,794,3445,98500,2010
20033,50.6,1865,1702,0,79,501,34808,832,690,142,832,42500,2010
20035,38.5,36140,29992,1076,3006,8955,40749,13583,9809,3774,13583,76900,2010
20037,32.8,38985,34869,717,1680,9119,35286,15484,10056,5428,15484,83900,2010
20039,51.4,3015,2914,0,32,938,35383,1517,1103,414,1517,57300,2010
20041,41.8,19643,18279,78,742,5302,46457,7559,5585,1974,7559,97400,2010
20043,38.7,7957,7327,233,146,2055,43410,3123,2348,775,3123,84600,2010
20045,27.7,109052,89625,3879,5344,23335,45831,42943,22987,19956,42943,176500,2010
20047,43.5,3052,2497,14,421,974,39226,1389,1045,344,1389,54600,2010
20049,48,2930,2736,5,76,952,33455,1340,1085,255,1340,52700,2010
20051,31.8,28039,25957,212,1140,6691,44543,11721,7389,4332,11721,123800,2010
20053,42.9,6476,5730,238,263,1611,42200,2564,2010,554,2564,67400,2010
20055,30.2,36139,17315,715,16512,8921,50454,11974,8595,3379,11974,102100,2010
20057,30.8,32727,15159,449,15920,7859,46621,11010,7516,3494,11010,82700,2010
20059,37.7,25841,23826,227,907,7129,49459,10197,7350,2847,10197,117100,2010
20061,28.3,30537,18394,5596,3640,8189,45559,11379,5677,5702,11379,118600,2010
20063,48.1,2721,2640,7,55,850,41295,1182,960,222,1182,66500,2010
20065,47.5,2663,2416,106,40,676,43980,1157,931,226,1157,71200,2010
20067,32.9,7744,4320,0,3168,2095,55514,2723,1991,732,2723,85500,2010
20069,35.4,5870,5029,0,773,1581,52824,2051,1546,505,2051,100000,2010
20071,45,1294,1052,38,173,373,55972,507,374,133,507,67800,2010
20073,45.7,6824,6405,5,175,1899,37180,3020,2219,801,3020,52400,2010
20075,33,2643,1998,0,638,795,36297,1125,835,290,1125,73300,2010
20077,44.6,6033,5604,40,220,1791,38168,2647,1871,776,2647,61400,2010
20079,38.7,34150,29089,524,3536,9006,46604,13252,9805,3447,13252,103300,2010
20081,33.2,4196,2988,48,1070,979,45859,1381,1050,331,1381,88100,2010
20083,43.3,1955,1804,0,104,538,41127,787,636,151,787,63700,2010
20085,40.8,13360,11508,135,403,3987,51759,5205,4071,1134,5205,114800,2010
20087,42.2,19059,18142,56,346,5721,56886,7512,6397,1115,7512,136200,2010
20089,50.7,3151,3032,5,66,971,37759,1455,1111,344,1455,45500,2010
20091,36.1,531228,441649,20822,35102,143509,73733,210278,151234,59044,210278,209900,2010
20093,35.2,3966,2713,17,1069,1023,46435,1433,1062,371,1433,85900,2010
20095,44.8,7949,7585,17,160,2355,44510,3464,2734,730,3464,77100,2010
20097,41,2671,2482,0,119,730,37292,994,728,266,994,75000,2010
20099,40.3,21791,18745,920,894,6045,39049,8952,6404,2548,8952,64600,2010
20101,44.8,1725,1530,0,98,481,42311,757,556,201,757,55100,2010
20103,37.1,74611,60161,6642,4049,18682,61107,25778,17881,7897,25778,166700,2010
20105,46.8,3308,3182,0,71,937,41071,1444,1171,273,1444,64300,2010
20107,43.9,9782,9354,10,152,3091,44379,4306,3655,651,4306,98800,2010
20109,44.8,2774,2628,4,18,784,39375,1334,1018,316,1334,66600,2010
20111,31.9,34974,25634,746,6992,8300,36921,13752,8186,5566,13752,91200,2010
20113,41,29178,27343,177,938,8410,53026,11715,8925,2790,11715,115300,2010
20115,44.2,12689,12042,111,249,3658,45713,5063,4237,826,5063,80500,2010
20117,44.8,10147,9789,89,159,2818,43125,4291,3269,1022,4291,74700,2010
20119,38.3,4523,3762,46,610,1241,46658,1767,1382,385,1767,80800,2010
20121,39.7,32116,30165,330,802,9133,60539,11931,9531,2400,11931,165500,2010
20123,45.1,6383,6206,9,73,1745,44247,2692,2044,648,2692,68500,2010
20125,40.2,35453,29018,1963,1703,9735,40603,14564,10459,4105,14564,68100,2010
20127,45.9,5946,5607,0,169,1648,42083,2604,2020,584,2604,76400,2010
20129,37,3244,2485,28,557,959,42273,1278,911,367,1278,64600,2010
20131,42.7,10253,9946,26,103,2717,46134,3955,3127,828,3955,85800,2010
20133,40,16538,14263,308,649,4372,36702,6742,5206,1536,6742,71100,2010
20135,47.9,3120,2854,0,177,933,47639,1369,1131,238,1369,47100,2010
20137,43.2,5692,5189,191,146,1251,32016,2221,1510,711,2221,51200,2010
20139,42.2,16426,15717,98,294,5020,48594,6739,5325,1414,6739,96400,2010
20141,47.2,3906,3795,5,56,1060,34797,1726,1352,374,1726,39700,2010
20143,42.3,6107,5867,25,112,1718,50814,2311,1891,420,2311,83800,2010
20145,44.2,6913,5354,453,792,1776,40048,2520,1787,733,2520,63200,2010
20147,45.1,5601,5347,21,25,1567,44381,2337,1866,471,2337,57400,2010
20149,36.1,20781,19104,190,829,5616,53430,7764,6285,1479,7764,138600,2010
20151,42.4,9670,8881,169,425,2525,43583,3979,2800,1179,3979,74500,2010
20153,50.4,2594,2477,13,71,754,39797,1186,883,303,1186,57600,2010
20155,40,64054,55536,1945,4865,16993,41431,25876,18524,7352,25876,87500,2010
20157,50.6,5069,4941,1,25,1503,38286,2377,1928,449,2377,47800,2010
20159,39.3,10128,8802,70,850,2670,43164,4011,3030,981,4011,62600,2010
20161,24.1,69035,55494,4019,4206,13329,39257,24838,10866,13972,24838,154800,2010
20163,43.9,5241,5050,12,94,1551,37861,2401,1864,537,2401,62900,2010
20165,48.6,3290,3157,23,20,995,39435,1592,1269,323,1592,50500,2010
20167,45.9,6915,6594,0,94,2004,36135,3245,2443,802,3245,63300,2010
20169,38,54982,45509,1791,4960,14155,45162,21932,14873,7059,21932,114000,2010
20171,42.2,4832,4164,0,587,1546,58341,2129,1741,388,2129,100100,2010
20173,34.4,486123,345670,42773,58723,125002,47848,190832,127710,63122,190832,117300,2010
20175,29.1,22588,8540,795,12191,5484,41373,7472,4812,2660,7472,82100,2010
20177,38.2,175537,134204,14990,17844,46676,47464,73066,48838,24228,73066,115300,2010
20179,46,2578,2456,16,79,695,46739,1104,858,246,1104,81600,2010
20181,41.9,6002,5216,33,582,1700,41570,2567,1846,721,2567,79300,2010
20183,49.9,3934,3798,0,74,1315,39836,1830,1484,346,1830,58400,2010
20185,45.1,4433,3864,19,417,1127,39375,1860,1504,356,1860,50200,2010
20187,38,2197,1337,9,825,541,49612,731,547,184,731,77500,2010
20189,34.5,5533,3732,18,1635,1593,50517,2061,1421,640,2061,78200,2010
20191,39.1,24257,22260,291,1038,6244,49582,9280,7179,2101,9280,82400,2010
20193,37,7757,7273,48,294,1801,47033,3039,1979,1060,3039,83900,2010
20195,49.8,2979,2896,0,40,861,39655,1276,1050,226,1276,69700,2010
20197,41.7,7004,6642,52,176,1999,52133,2750,2289,461,2750,99400,2010
20199,48.2,1440,1344,4,75,377,43953,584,487,97,584,65300,2010
20201,46.1,5851,5638,9,129,1565,39698,2496,1966,530,2496,53600,2010
20203,40,2244,1698,31,503,609,44318,856,685,171,856,76800,2010
20205,44.1,9598,9082,2,197,2717,39301,3872,2950,922,3872,58500,2010
20207,48.5,3352,3191,0,79,899,30385,1574,1162,412,1574,47800,2010
20209,33.1,155462,68958,40408,38512,36416,38503,57207,36151,21056,57207,97600,2010
21001,38.5,18542,17451,648,139,5004,29834,7272,5438,1834,7272,80000,2010
21003,37.8,19688,18958,225,246,5526,35247,7811,5843,1968,7811,89500,2010
21005,38,21080,20026,523,271,6148,55506,8319,6345,1974,8319,131900,2010
21007,41.1,8225,7754,246,92,2408,41228,3363,2800,563,3363,78100,2010
21009,40.2,41685,38332,1880,981,11722,38374,16727,11753,4974,16727,96400,2010
21011,38.4,11565,11115,260,75,3088,30458,4338,3498,840,4338,70100,2010
21013,40.5,28793,27411,752,246,7575,24724,10902,7481,3421,10902,64500,2010
21015,35.1,114723,103867,2919,3884,30519,66549,41612,31777,9835,41612,175900,2010
21017,40.1,19947,17166,1407,1150,5548,40849,8132,4994,3138,8132,137700,2010
21019,41.4,49330,46325,1543,381,13036,38802,19542,13516,6026,19542,93200,2010
21021,39.2,28245,24495,1790,786,7543,40720,10787,7444,3343,10787,126700,2010
21023,40.3,8479,8322,26,95,2244,38481,3177,2497,680,3177,87500,2010
21025,40.5,14202,13894,60,106,3338,19906,5257,3770,1487,5257,50900,2010
21027,42,19893,18978,520,169,5423,37395,7474,5935,1539,7474,80800,2010
21029,37.4,72515,69789,450,998,20418,51526,27266,22177,5089,27266,143000,2010
21031,39.8,12763,12228,7,267,3603,33703,5175,4110,1065,5175,77700,2010
21033,42.4,12934,11923,685,123,3418,35289,5261,4037,1224,5261,72300,2010
21035,34.2,36763,33421,1347,836,9108,39194,14844,10147,4697,14844,105300,2010
21037,37.2,89016,83421,2020,1415,22457,51482,35300,25516,9784,35300,146300,2010
21039,43.6,5126,4927,24,72,1510,33909,2062,1733,329,2062,67400,2010
21041,37.1,10703,9564,107,680,2984,43440,4222,2758,1464,4222,109700,2010
21043,39,27821,27109,181,194,7510,32424,10577,8237,2340,10577,74500,2010
21045,39.9,15939,15495,18,324,4215,26592,6012,5116,896,6012,71000,2010
21047,28.7,72678,49553,15434,4405,18746,37061,25923,14649,11274,25923,95500,2010
21049,39.3,35305,32237,1854,829,10365,46575,14535,9480,5055,14535,134500,2010
21051,37.3,22197,20621,1110,238,4492,20175,6520,5133,1387,6520,51200,2010
21053,41.1,10161,9786,83,182,2847,23788,4184,3138,1046,4184,62700,2010
21055,42.2,9313,9070,39,53,2452,34623,3749,2959,790,3749,69300,2010
21057,42.9,6931,6580,253,47,1765,28135,2660,2091,569,2660,67700,2010
21059,38.6,95398,86412,4595,2233,25205,42821,37644,26200,11444,37644,106400,2010
21061,40.8,12086,11693,281,42,3506,35808,4752,3573,1179,4752,84600,2010
21063,39.3,7493,7140,305,38,1781,22097,2546,2034,512,2546,66100,2010
21065,39.6,14733,14113,101,58,3930,28324,5604,4163,1441,5604,70300,2010
21067,33.5,288045,213771,40974,17865,69746,47469,120917,68771,52146,120917,159200,2010
21069,39.9,14318,13845,80,242,3992,31236,5568,4338,1230,5568,82700,2010
21071,39.5,39949,38978,325,250,10731,27907,15542,11185,4357,15542,66700,2010
21073,39,49067,41177,5045,1274,12751,47976,20878,13506,7372,20878,138900,2010
21075,42.5,6858,5041,1625,85,2065,31965,2931,1879,1052,2931,55300,2010
21077,39.4,8428,7854,94,292,1963,41310,2971,2180,791,2971,105500,2010
21079,41.2,16842,15927,384,367,4527,37095,6294,4848,1446,6294,109200,2010
21081,34.8,24604,23580,152,502,6898,42475,8906,6269,2637,8906,117900,2010
21083,40.1,36958,32726,1423,1902,10180,35277,14679,11195,3484,14679,83900,2010
21085,39.3,25540,24737,93,141,6752,33965,9902,7589,2313,9902,83700,2010
21087,43.1,11377,10813,289,142,3230,36575,4435,3305,1130,4435,75400,2010
21089,41.4,36962,35862,204,326,10062,42377,14374,11504,2870,14374,88400,2010
21091,39.3,8555,8286,58,98,2361,44892,3234,2677,557,3234,85500,2010
21093,35.3,100876,79403,11552,4716,27171,47540,37426,24650,12776,37426,131900,2010
21095,40.6,29688,28365,690,240,7413,26582,10700,7604,3096,10700,52500,2010
21097,40.3,18761,17782,539,331,4778,40582,7275,4958,2317,7275,112800,2010
21099,39.9,18201,16775,1105,127,4882,30969,7050,5301,1749,7050,80200,2010
21101,39,45943,40677,3403,821,12466,40438,18499,12508,5991,18499,101200,2010
21103,40.5,15474,14310,403,441,4148,43612,5917,4340,1577,5917,123900,2010
21105,43.7,4949,4323,500,24,1254,31836,2057,1655,402,2057,63600,2010
21107,40.1,46886,42135,2796,724,12856,39312,18401,13294,5107,18401,77200,2010
21109,38.5,13560,13369,0,82,4038,21928,5728,4351,1377,5728,64700,2010
21111,37.7,729452,522257,148648,28293,185069,45352,300561,194488,106073,300561,145900,2010
21113,35.2,47073,43129,1468,1257,13137,47494,17482,11537,5945,17482,150200,2010
21115,38.9,23325,22870,48,78,6702,30820,9151,6582,2569,9151,71400,2010
21117,36,158034,142995,7276,3750,40238,53213,61912,42867,19045,61912,145200,2010
21119,41.2,16587,16418,37,57,4339,29451,6012,4500,1512,6012,60200,2010
21121,38.5,31765,30754,727,175,8379,21493,12573,8386,4187,12573,65000,2010
21123,39.1,14080,13070,476,335,3562,38891,5005,3877,1128,5005,97200,2010
21125,37.4,58155,56109,490,714,15849,36787,21714,16110,5604,21714,96100,2010
21127,39,15841,15524,17,73,3958,28865,5647,3992,1655,5647,65800,2010
21129,41.5,7865,7688,102,29,1929,25129,2750,2049,701,2750,57300,2010
21131,39.7,11470,11303,5,5,2951,26857,4450,3261,1189,4450,54600,2010
21133,40.4,24462,24058,132,117,6686,31283,9586,7226,2360,9586,51500,2010
21135,39.9,13968,13739,77,28,3717,28376,5030,4240,790,5030,55800,2010
21137,39,24779,23507,576,355,6764,32314,9983,7585,2398,9983,83000,2010
21139,44.3,9514,9255,71,102,2624,39075,3605,2943,662,3605,76800,2010
21141,40.4,26838,23998,1538,1068,7521,34647,10697,7942,2755,10697,87500,2010
21143,46,8367,7627,633,63,2335,42079,3272,2651,621,3272,84900,2010
21145,41.3,65217,55052,6601,1326,18188,41630,27541,19059,8482,27541,107500,2010
21147,36.7,18122,16609,704,297,4599,22643,6351,4844,1507,6351,62400,2010
21149,41,9635,9386,63,104,2687,39115,3736,2842,894,3736,71900,2010
21151,33,81580,74093,2474,1715,20053,41894,30756,19063,11693,30756,141100,2010
21153,38.6,13294,13078,8,35,3245,22779,4671,3651,1020,4671,46200,2010
21155,37.8,19619,17122,1760,434,4678,37488,7135,5697,1438,7135,97000,2010
21157,43.3,31386,30610,124,314,9212,43326,12795,10481,2314,12795,96900,2010
21159,36.7,13138,12519,264,161,3135,25173,4337,3100,1237,4337,67800,2010
21161,40.1,17362,15631,1241,244,4758,40523,6674,4731,1943,6674,98500,2010
21163,34.8,28907,26223,1207,869,7346,43800,10043,7211,2832,10043,107700,2010
21165,43.3,6427,6331,37,29,1566,29740,2345,1944,401,2345,67100,2010
21167,41.4,21272,19659,857,422,5959,47955,8464,6329,2135,8464,129400,2010
21169,41,10130,9785,139,119,2809,34732,3991,3155,836,3991,73400,2010
21171,41.7,11089,10448,233,274,2835,28439,4347,3306,1041,4347,67600,2010
21173,37.3,25908,24258,873,571,6939,36034,10066,6912,3154,10066,98100,2010
21175,38.7,14055,13300,630,86,3092,30229,4433,3327,1106,4433,72700,2010
21177,40.3,31541,29393,1350,319,8929,36750,12364,9823,2541,12364,75700,2010
21179,36.9,42523,38786,2084,814,11625,44783,16173,12437,3736,16173,116800,2010
21181,38.7,7136,6940,76,98,2013,40259,2741,2096,645,2741,79800,2010
21183,38.7,23837,22682,189,661,6031,36050,8770,6813,1957,8770,78000,2010
21185,38.1,58784,52824,2665,1859,15818,79417,19280,16416,2864,19280,234400,2010
21187,39.2,10928,10492,178,202,3269,46238,4679,3514,1165,4679,102000,2010
21189,40.3,4742,4742,0,0,1071,19351,1487,1178,309,1487,68500,2010
21191,38.3,14894,14538,62,36,3830,44670,5326,4068,1258,5326,101200,2010
21193,39.7,28739,27685,410,200,7510,29547,10816,7837,2979,10816,55900,2010
21195,39.9,65309,63761,161,494,19182,32563,27022,20351,6671,27022,64700,2010
21197,38.6,12786,12458,165,75,3409,31815,4701,3287,1414,4701,80700,2010
21199,40.7,62062,59095,625,1191,17665,32771,25872,19058,6814,25872,95500,2010
21201,37.4,2278,2278,0,0,477,27254,852,623,229,852,64500,2010
21203,40,17075,16755,111,36,4641,26946,6475,5094,1381,6475,72300,2010
21205,31.9,23075,22032,141,271,5563,31604,8285,5834,2451,8285,90400,2010
21207,41.1,17445,16670,125,444,4894,29980,7466,5829,1637,7466,81400,2010
21209,35,44868,39773,2412,1624,12788,58028,17242,11872,5370,17242,158700,2010
21211,38,40899,33368,3080,3430,11012,55296,15051,11070,3981,15051,169500,2010
21213,37.8,17214,14846,1759,106,4726,41323,6667,4679,1988,6667,113700,2010
21215,38.3,16582,15859,465,104,4689,59326,6086,5364,722,6086,167300,2010
21217,40.7,24247,22176,1218,411,6561,35378,9628,6624,3004,9628,96600,2010
21219,36.5,12307,10703,1019,418,3383,36989,4640,3357,1283,4640,79700,2010
21221,43.7,14117,12381,1151,115,4379,41825,6074,4763,1311,6074,98300,2010
21223,38.5,8872,8478,31,187,2565,47798,3390,2675,715,3390,119900,2010
21225,37.6,15077,12742,1819,240,3930,39515,5639,4398,1241,5639,78600,2010
21227,32.6,109775,90213,10065,4762,26879,43954,41979,26033,15946,41979,135400,2010
21229,39.4,11593,10296,802,347,3302,43090,4463,3701,762,4463,107800,2010
21231,40.1,20716,19560,419,496,6029,25993,8604,6295,2309,8604,70600,2010
21233,40.3,13734,12409,646,507,3644,39635,4992,4008,984,4992,66200,2010
21235,37.3,36006,34821,189,328,9125,28122,13102,9198,3904,13102,64400,2010
21237,40.4,7315,7291,0,0,1691,20910,2493,1891,602,2493,54400,2010
21239,40.8,24523,21367,1278,1427,6980,56537,10001,7283,2718,10001,180800,2010
22001,35.4,61139,48118,10991,1009,16143,37261,21984,15338,6646,21984,86700,2010
22003,37.2,25816,18120,5805,912,6012,36926,8388,6043,2345,8388,76500,2010
22005,34.2,102501,73462,22585,4495,27263,63716,35640,28810,6830,35640,164200,2010
22007,38.4,23487,15414,7160,456,6124,45235,8467,7130,1337,8467,86500,2010
22009,38.3,42013,27883,12406,656,11055,31412,15767,10943,4824,15767,82100,2010
22011,36.5,35000,28312,4471,975,9583,45202,12787,9912,2875,12787,83400,2010
22013,40.9,14546,8012,6155,62,3838,31870,5689,4222,1467,5689,62700,2010
22015,34.6,113837,79286,24464,6224,29211,51020,43186,29121,14065,43186,130400,2010
22017,36.4,253048,122602,117944,5711,61035,37181,97293,61744,35549,97293,113300,2010
22019,35.9,189134,132574,46663,4494,49405,43758,71601,51455,20146,71601,109400,2010
22021,39.3,10188,8062,1768,185,2382,37423,3651,2683,968,3651,67800,2010
22023,37.9,7280,7053,44,45,2078,59555,2663,2249,414,2663,122700,2010
22025,37.6,10465,7049,2996,285,2825,36398,3794,2966,828,3794,67900,2010
22027,40.4,17160,8150,8769,88,3945,32292,5890,4311,1579,5890,61200,2010
22029,38.4,20502,11650,8318,212,5036,30062,7570,5362,2208,7570,72700,2010
22031,39.5,26465,14912,10264,618,6949,38007,10121,7751,2370,10121,80300,2010
22033,32.6,435815,208548,195279,14354,103965,46179,166543,102541,64002,166543,156100,2010
22035,33.3,7964,2103,5692,127,1663,24038,2426,1349,1077,2426,44400,2010
22037,39.7,20417,10723,9185,157,4681,35335,6662,5437,1225,6662,101500,2010
22039,35.4,34419,23474,9676,729,8481,34057,12304,8503,3801,12304,76100,2010
22041,38.6,20727,13814,6622,64,5484,32311,7844,5696,2148,7844,72100,2010
22043,36.6,21675,17044,3321,819,5296,40092,7407,5788,1619,7407,83000,2010
22045,35.3,73395,45102,23252,2163,19074,41783,26194,18356,7838,26194,98100,2010
22047,37.2,33513,15975,16632,610,7811,42215,11118,8437,2681,11118,88700,2010
22049,39.5,16078,10832,4902,197,4252,40674,5967,4073,1894,5967,73600,2010
22051,38.6,431019,248917,110909,47912,107255,48175,162881,105455,57426,162881,175100,2010
22053,37.1,31500,24760,5129,552,8392,42907,11786,8960,2826,11786,83700,2010
22055,33.4,215581,146639,55360,7491,53472,47559,83810,54353,29457,83810,151600,2010
22057,36.3,95428,75146,12642,3237,24974,47492,34108,26268,7840,34108,115500,2010
22059,37.8,14680,12362,1765,281,3911,37572,5245,4426,819,5245,72800,2010
22061,27.6,45797,25034,18308,1124,9843,35247,16248,9508,6740,16248,110700,2010
22063,34.2,122798,111361,6160,3294,32052,54708,42962,34528,8434,42962,142400,2010
22065,34.6,12286,4456,7483,179,2523,26441,3973,2350,1623,3973,71400,2010
22067,37.7,28388,14695,13229,270,7076,31781,10282,7342,2940,10282,71200,2010
22069,32.5,39274,21046,16072,777,9574,30326,14847,9116,5731,14847,90500,2010
22071,35.8,295285,91146,175500,15066,64138,37468,116638,57548,59090,116638,184100,2010
22073,34.1,152207,91816,54796,2694,37691,39823,56192,35475,20717,56192,112400,2010
22075,35.8,22710,15515,4917,1000,5738,54730,7718,5511,2207,7718,203100,2010
22077,41.6,22837,13689,8528,396,5922,41177,8859,7040,1819,8859,108600,2010
22079,37,130800,81816,41537,3268,33030,40658,48127,32537,15590,48127,110500,2010
22081,37.3,9181,5302,3714,25,2379,34723,3203,2517,686,3203,72200,2010
22083,38.2,20692,12618,7591,301,5355,37682,7417,5053,2364,7417,70000,2010
22085,40.6,24119,16772,3941,773,6540,35395,9446,7365,2081,9446,74600,2010
22087,34.6,27739,19358,4483,2591,7300,39200,10295,6767,3528,10295,132400,2010
22089,36.6,52645,34936,13971,2480,14718,60961,18460,15055,3405,18460,170200,2010
22091,38.3,11125,4978,5989,79,2782,27393,4072,3207,865,4072,82400,2010
22093,38.6,22096,10578,11217,212,5921,51725,7455,6250,1205,7455,116600,2010
22095,34.8,46728,19407,24207,2157,11759,47666,15772,12294,3478,15772,146700,2010
22097,36.8,84309,46905,34929,1304,20902,31813,30082,21407,8675,30082,82100,2010
22099,35.9,51721,33695,15971,1004,13504,41302,18931,15062,3869,18931,84300,2010
22101,37.2,54348,31608,17274,2485,14273,40431,20054,14067,5987,20054,85500,2010
22103,38.8,228894,185981,25745,9976,61398,60866,84536,67962,16574,84536,201800,2010
22105,33.3,118190,76979,35224,3711,29412,38957,42558,29177,13381,42558,133400,2010
22107,39.8,5430,2213,3129,62,1560,27157,2165,1302,863,2165,72400,2010
22109,35.1,111131,77097,20958,3874,27699,48437,38078,28184,9894,38078,118100,2010
22111,40.5,22750,15478,6166,807,6126,38930,8309,6729,1580,8309,79700,2010
22113,36.3,57280,46011,8138,1364,15866,42693,21786,16490,5296,21786,93300,2010
22115,29.8,50451,36562,7126,3466,13240,42554,18032,10158,7874,18032,85400,2010
22117,38.6,46578,30654,14540,818,11942,30363,17292,12863,4429,17292,84400,2010
22119,39.8,41238,26214,13736,664,11473,35999,16565,11186,5379,16565,76400,2010
22121,35.4,23274,13684,8429,504,5906,47298,8386,6171,2215,8386,126500,2010
22123,38.2,11689,9383,1650,489,2814,33901,4061,2994,1067,4061,76600,2010
22125,40.9,15681,7953,7202,202,3048,43411,4116,2927,1189,4116,161400,2010
22127,39.1,15477,10234,4733,218,3617,32039,5462,4191,1271,5462,59500,2010
23001,39.4,107882,100204,1715,1678,28250,44470,44040,29923,14117,44040,155700,2010
23003,44.4,72412,68993,400,761,19604,36574,30672,22116,8556,30672,85900,2010
23005,40.3,279994,258435,6670,4899,71799,55658,116616,79898,36718,116616,248400,2010
23007,41.8,30657,29683,65,311,8218,39831,12498,9335,3163,12498,128700,2010
23009,45.2,54309,52237,147,641,15033,47533,23300,17704,5596,23300,201600,2010
23011,41.8,121925,116652,844,1533,32298,45973,50869,36844,14025,50869,148100,2010
23013,45.7,40111,38809,108,371,10756,45264,16945,13170,3775,16945,203800,2010
23015,47.2,34719,33725,80,289,10102,47678,15365,13161,2204,15365,206200,2010
23017,43.6,57867,55820,291,626,15170,39748,23276,18415,4861,23276,146500,2010
23019,39.4,152934,145175,961,1658,39470,42658,62282,43936,18346,62282,133600,2010
23021,47,17555,16929,12,75,5278,34016,8037,6262,1775,8037,100800,2010
23023,42.8,35688,34035,305,520,9674,55486,14721,11262,3459,14721,193100,2010
23025,43.2,52261,50545,166,458,14536,36647,21892,16866,5026,21892,109500,2010
23027,43.3,38740,37531,139,360,10508,41312,16136,12799,3337,16136,150300,2010
23029,45,33154,30405,134,471,8973,34859,14177,10797,3380,14177,102300,2010
23031,42.1,197457,189194,1131,2392,54464,55008,80299,60419,19880,80299,233300,2010
24001,40.9,74638,66473,5226,1091,17734,37747,28777,20371,8406,28777,116800,2010
24003,38.1,527020,388267,76575,28930,136705,83456,195999,148426,47573,195999,370100,2010
24005,38.9,799195,513781,199991,30286,203275,63959,315542,211526,104016,315542,269900,2010
24009,39.1,87891,70495,11816,2404,23208,90838,30313,25754,4559,30313,392900,2010
24011,37.8,32805,25734,4327,1661,8673,58799,11828,8962,2866,11828,228100,2010
24013,39.9,167208,153067,5416,4085,44863,81621,59412,49854,9558,59412,350900,2010
24015,38,100139,88288,5515,3089,26410,64886,36182,27046,9136,36182,261200,2010
24017,36.6,143912,73268,55713,5959,37943,88825,49898,40454,9444,49898,355800,2010
24019,43.1,32287,21530,8856,1024,9166,45151,13347,9496,3851,13347,205000,2010
24021,37.9,229205,181041,18318,15554,60517,81686,83455,64112,19343,83455,349500,2010
24023,41.9,30145,29391,92,194,8502,45760,12284,9523,2761,12284,169400,2010
24025,38.7,242888,194666,29441,7996,65094,77010,89421,72944,16477,89421,298800,2010
24027,37.7,279366,171694,46125,15275,75220,103273,102271,76443,25828,102271,456200,2010
24029,44.7,20018,15577,3084,822,5151,50141,7735,5550,2185,7735,281100,2010
24031,38.2,947230,482754,156096,151842,242950,93373,353177,244815,108362,353177,482900,2010
24033,34.6,854722,135276,545084,119265,198515,71260,301906,194047,107859,301906,327600,2010
24035,41.9,46945,41200,3352,1267,12922,81096,17188,14580,2608,17188,375700,2010
24037,35.7,102086,78872,14027,3623,26621,80053,36253,26418,9835,36253,327800,2010
24039,36.3,26411,13995,10603,793,5278,42443,8327,5580,2747,8327,155900,2010
24041,46.5,37361,29755,4865,1800,10754,63017,15603,11886,3717,15603,352400,2010
24043,39.1,146329,123314,13577,4657,37817,52994,55419,36741,18678,55419,238000,2010
24045,35.7,96951,65803,22814,4044,23411,50752,36302,23669,12633,36302,195100,2010
24047,47.5,51133,41358,7194,1473,14750,55487,22016,17310,4706,22016,289100,2010
24510,34.5,620538,173972,397143,22812,127920,39386,238392,118655,119737,238392,160400,2010
25001,48.7,217483,201262,4081,4540,61766,60317,98164,78880,19284,98164,392700,2010
25003,43.8,131528,119939,3416,4154,33202,48907,55623,38332,17291,55623,207800,2010
25005,39.2,546433,472344,16446,30682,142126,54955,210789,135015,75774,210789,306600,2010
25007,44.3,16155,14100,545,103,3697,62407,5530,4485,1045,5530,681300,2010
25009,40,735642,568426,19238,114147,186912,64153,282913,185135,97778,282913,372400,2010
25011,43.3,71523,66397,704,2142,18999,52002,30447,21311,9136,30447,222000,2010
25013,38.3,462270,319423,36393,90655,114476,47724,177725,112045,65680,177725,200500,2010
25015,36.1,157326,136469,3427,7105,34684,59505,58612,39833,18779,58612,262200,2010
25017,38.3,1479491,1156265,61545,90880,366038,77377,572847,366303,206544,572847,420800,2010
25019,39.1,10069,8345,676,580,2400,83347,3623,2657,966,3623,1000001,2010
25021,40.2,662077,541748,34216,20183,168233,81027,255180,179764,75416,255180,408100,2010
25023,40.5,490784,417310,37843,15105,126730,73131,178983,139396,39587,178983,360700,2010
25025,31.6,704460,343495,144735,134399,139420,50597,283954,103662,180292,283954,384500,2010
25027,38.6,791855,648334,27643,70300,201905,64152,298162,201656,96506,298162,282800,2010
26001,54.3,11238,10926,25,104,3089,34858,4608,4157,451,4608,119300,2010
26003,46.4,9604,8294,780,112,2420,38262,3688,3013,675,3688,111500,2010
26005,38.1,111385,99899,1401,7370,31010,50240,42078,35006,7072,42078,149400,2010
26007,44.7,29958,29017,158,319,8767,36695,13357,10762,2595,13357,104800,2010
26009,46.3,23975,22971,70,370,7052,43123,10043,8490,1553,10043,156500,2010
26011,45.7,16487,15708,244,215,4527,36689,6686,5595,1091,6686,99000,2010
26013,42.3,8882,6629,599,121,2284,40541,3336,2520,816,3336,86500,2010
26015,39.9,59576,56915,275,1336,16985,51869,22843,19306,3537,22843,147300,2010
26017,41.2,108156,98971,1494,4902,29799,44659,44345,35382,8963,44345,107800,2010
26019,44.7,17705,16841,42,291,4909,44718,7366,6330,1036,7366,160200,2010
26021,40.3,157232,120250,24062,6682,41557,42625,62612,45564,17048,62612,135600,2010
26023,39.1,46083,41795,1331,1909,11340,42133,16350,13174,3176,16350,111800,2010
26025,38.4,137112,110146,14635,5969,35859,42568,53925,38891,15034,53925,110300,2010
26027,41.4,52429,45972,2657,1606,14729,45177,20201,16718,3483,20201,133700,2010
26029,44.2,26228,24902,105,389,8020,48704,11355,9434,1921,11355,162600,2010
26031,45.7,26699,24931,49,254,7882,37903,11790,9537,2253,11790,123400,2010
26033,39.1,39078,28052,1976,630,9340,40194,14836,10601,4235,14836,103100,2010
26035,44.7,31162,29812,88,482,8651,34399,13145,10509,2636,13145,92500,2010
26037,37.9,74235,67814,1259,2714,20652,58016,28321,23373,4948,28321,167700,2010
26039,46.1,14325,13424,288,159,3993,39665,5761,4856,905,5761,108000,2010
26041,44.5,37403,35274,58,354,10726,41951,16339,13088,3251,16339,100600,2010
26043,44.6,26584,25727,68,272,7544,42586,11414,9173,2241,11414,87800,2010
26045,39.3,108002,92426,6119,4904,29044,54885,43358,32631,10727,43358,152700,2010
26047,41.9,32806,30323,175,465,9032,49235,13833,10570,3263,13833,182900,2010
26049,37.6,433054,316816,86980,12701,110911,43483,168984,121352,47632,168984,118000,2010
26051,46.5,26076,25272,69,295,7907,37936,11321,9669,1652,11321,117700,2010
26053,46.2,16471,15070,497,254,4496,33673,7302,5519,1783,7302,69200,2010
26055,40.5,86061,80604,955,1872,22743,50647,34578,26665,7913,34578,174300,2010
26057,38,42612,37437,1259,2232,10433,40114,14718,11519,3199,14718,93600,2010
26059,39.7,47033,45170,241,832,12500,42989,17506,14343,3163,17506,116500,2010
26061,33.1,36192,33923,303,447,8117,34174,13991,9788,4203,13991,86100,2010
26063,45.7,33642,32401,14,638,9306,40038,14419,11991,2428,14419,104900,2010
26065,30.9,281365,205906,30902,19802,63198,45808,108723,67053,41670,108723,137900,2010
26067,35.9,64651,57513,2625,2676,16257,46454,22645,17907,4738,22645,123700,2010
26069,49.7,26422,25263,160,431,7408,36861,11202,9564,1638,11202,102300,2010
26071,50.7,12057,11580,115,124,3192,33734,5386,4573,813,5386,75700,2010
26073,25.1,69451,60971,1701,2193,13896,36880,24804,14726,10078,24804,128000,2010
26075,39,161569,139140,12742,4764,41508,46117,60612,46049,14563,60612,130000,2010
26077,33.9,247246,199326,26473,9324,59986,44794,99456,64812,34644,99456,145900,2010
26079,42.5,17400,16743,83,189,4777,39350,7232,6041,1191,7232,105900,2010
26081,34,599432,458850,55922,55968,152710,49532,227177,161947,65230,227177,147600,2010
26083,50.6,2122,2085,5,9,583,38872,957,825,132,957,81800,2010
26085,48,11625,9947,1069,211,2576,31205,4078,3444,634,4078,92900,2010
26087,40.3,89944,83833,958,3622,25045,55005,32937,27788,5149,32937,165200,2010
26089,48.9,21757,19806,10,804,6808,56527,9349,8018,1331,9349,241200,2010
26091,39.4,100911,88657,2325,7557,26584,48618,37831,30198,7633,37831,140400,2010
26093,39.9,181350,172972,749,3398,51113,72129,67265,58636,8629,67265,216400,2010
26095,42.4,6685,5390,686,168,1616,40041,2473,1978,495,2473,86000,2010
26097,47.1,11281,8658,257,135,3196,39339,4927,4000,927,4927,126100,2010
26099,39.3,837490,714839,62230,18518,220466,53996,330322,261291,69031,330322,157000,2010
26101,45.9,24951,22732,708,655,6959,40853,10747,8636,2111,10747,124000,2010
26103,39.6,66514,62069,1013,813,16294,45130,25638,18764,6874,25638,125100,2010
26105,44.5,28715,26667,156,1115,8448,40039,12320,9566,2754,12320,121600,2010
26107,33.6,42730,39584,1154,763,10034,35887,16081,11802,4279,16081,119200,2010
26109,45.3,24245,22924,52,289,7231,41332,10841,8801,2040,10841,97300,2010
26111,39.3,83626,78032,862,1744,23062,51103,33562,25710,7852,33562,132800,2010
26113,41.8,14962,14365,34,240,4136,40376,5809,4809,1000,5809,112300,2010
26115,39.2,152784,141611,2896,4518,42178,55366,58298,47048,11250,58298,161800,2010
26117,38.6,63553,58911,1499,1950,16397,39775,23133,18549,4584,23133,112700,2010
26119,51.7,9920,9620,0,90,2895,34447,4335,3760,575,4335,103200,2010
26121,37.5,173223,134610,24507,7958,45366,40670,65778,49798,15980,65778,112800,2010
26123,39.6,48962,44733,577,2583,13522,43218,18952,15733,3219,18952,115800,2010
26125,39.5,1201113,914905,152021,40155,319254,66390,481040,358624,122416,481040,204300,2010
26127,41,27029,22749,121,3502,7063,39543,9974,8301,1673,9974,115400,2010
26129,46.6,21862,21062,26,278,5669,35968,8255,6954,1301,8255,105900,2010
26131,51.8,6976,6722,25,76,2092,35269,3410,2912,498,3410,75300,2010
26133,41.2,23681,22719,93,341,6368,38341,8955,7308,1647,8955,101100,2010
26135,48.9,8884,8617,4,79,2608,32346,4052,3371,681,4052,93100,2010
26137,42.1,24445,23518,2,298,6639,45531,9753,7982,1771,9753,122300,2010
26139,34,261376,224553,2909,22010,68045,55095,92526,74718,17808,92526,161200,2010
26141,50.5,13697,13301,14,102,4193,37383,6332,5614,718,6332,108700,2010
26143,51.8,24932,24107,41,272,7350,33542,11449,9686,1763,11449,107400,2010
26145,39,202336,143201,37369,15354,51118,42954,76764,57189,19575,76764,110000,2010
26147,40.2,165719,153135,3980,4667,44897,49120,64606,50968,13638,64606,150300,2010
26149,38,61848,54794,1717,3863,15860,44392,22478,17533,4945,22478,116200,2010
26151,41.4,44010,41772,165,1393,11990,40818,17156,14278,2878,17156,115600,2010
26153,47.5,8640,7560,140,27,2469,36925,3621,3172,449,3621,87700,2010
26155,39.4,71621,68327,409,1689,19774,46453,27639,21814,5825,27639,129300,2010
26157,40.7,56543,53377,654,1562,15718,42198,21787,18135,3652,21787,112200,2010
26159,39.4,76585,63556,3202,7339,20439,44435,29096,23339,5757,29096,125600,2010
26161,32.8,343947,250013,41903,13122,79138,59065,134161,84487,49674,134161,216200,2010
26163,36.5,1870362,924710,763504,92931,441506,42241,690943,464603,226340,690943,121100,2010
26165,39.9,32653,31234,133,541,8724,39997,12721,10034,2687,12721,111500,2010
27001,50.7,16325,15539,14,136,5252,40226,7903,6409,1494,7903,177900,2010
27003,36.4,327544,282195,12466,11090,86980,69028,120026,99496,20530,120026,223100,2010
27005,42.4,32274,28412,126,458,9109,46056,13345,10567,2778,13345,166800,2010
27007,33,43781,32681,319,517,10957,43394,16759,12175,4584,16759,143800,2010
27009,33.7,38148,35781,584,675,9868,50848,14986,10583,4403,14986,170800,2010
27011,48.4,5324,5207,17,61,1564,42870,2366,1895,471,2366,81900,2010
27013,29.7,62719,57338,1514,1573,13902,47871,23889,16040,7849,23889,163500,2010
27015,42.7,26030,24825,22,792,7041,47696,10798,8608,2190,10798,122400,2010
27017,40.1,34958,31195,573,509,9449,52858,13724,11044,2680,13724,163500,2010
27019,35.9,88668,80692,956,3345,24468,80280,32202,26912,5290,32202,287100,2010
27021,45.6,28648,24502,48,389,8959,42445,12944,10793,2151,12944,184900,2010
27023,42.8,12426,11436,66,556,3222,43956,5193,3860,1333,5193,94400,2010
27025,37.6,52844,50026,735,923,14202,64726,19328,16733,2595,19328,230600,2010
27027,32.1,57089,51854,746,2100,14339,50057,21684,15437,6247,21684,146100,2010
27029,42.1,8593,7491,85,118,2520,39310,3698,2871,827,3698,113300,2010
27031,49.5,5211,4578,15,80,1633,49162,2607,1911,696,2607,247100,2010
27033,43.6,11712,10547,37,624,3223,40292,4912,3909,1003,4912,81800,2010
27035,42.4,61836,59415,438,704,17877,44659,26913,20554,6359,26913,187000,2010
27037,36.1,393380,328204,17008,21794,105767,72850,151122,118257,32865,151122,243700,2010
27039,36.3,19829,18610,35,841,5454,64438,7301,6355,946,7301,163700,2010
27041,42.9,35909,34951,182,349,10356,46789,16070,12233,3837,16070,182600,2010
27043,45.3,14819,13846,29,700,4082,41631,6301,5096,1205,6301,87000,2010
27045,42.6,20978,20509,37,167,5810,45888,8546,6814,1732,8546,133900,2010
27047,44.1,31387,28065,165,2565,8690,43090,13186,10598,2588,13186,111800,2010
27049,41.1,45930,43070,507,1212,13042,56366,18758,14750,4008,18758,192900,2010
27051,45.8,6082,5903,27,85,1769,41697,2663,2088,575,2663,102700,2010
27053,35.9,1136522,827721,128975,72157,274240,61328,473856,308814,165042,473856,247900,2010
27055,42.9,19226,18719,45,117,5411,50855,7770,6348,1422,7770,149200,2010
27057,46.3,20205,19004,21,304,6067,45066,8616,7080,1536,8616,175500,2010
27059,36.7,37682,35872,217,612,10131,57260,13988,11632,2356,13988,203700,2010
27061,44.5,44835,41852,150,453,12996,45621,18998,15499,3499,18998,146800,2010
27063,44,10403,9859,13,231,2980,46869,4531,3560,971,4531,100300,2010
27065,41.3,16379,15754,91,188,4507,45672,6439,5348,1091,6439,162800,2010
27067,39.2,41869,36038,797,4464,11646,49512,17069,12929,4140,17069,157400,2010
27069,47.6,4620,4486,15,40,1243,47568,1954,1681,273,1954,64200,2010
27071,46,13461,12690,0,146,3809,39571,6246,4768,1478,6246,99800,2010
27073,47.9,7343,7142,27,90,2194,45550,3137,2626,511,3137,77100,2010
27075,47.7,10900,10489,0,111,3327,46765,5181,4137,1044,5181,142000,2010
27077,48.1,4147,3970,40,15,1333,46080,1784,1562,222,1784,135500,2010
27079,39.4,27719,25793,112,1398,7580,57477,10758,9017,1741,10758,191900,2010
27081,45.7,5935,5800,0,77,1662,44672,2587,2171,416,2587,76300,2010
27083,34.7,25606,22636,431,1495,6257,46872,10263,7000,3263,10263,136300,2010
27085,38.6,36789,34161,88,1844,10198,58544,14510,11586,2924,14510,169400,2010
27087,36.3,5359,2811,26,111,1355,38523,1994,1489,505,1994,86500,2010
27089,43.7,9580,9079,55,316,2872,48565,4141,3445,696,4141,84600,2010
27091,44.7,20865,19825,75,669,5843,43960,8982,7009,1973,8982,96200,2010
27093,40.8,23371,22305,26,684,6788,51173,9394,7668,1726,9394,165600,2010
27095,39,26075,23717,93,385,6882,45273,10538,8158,2380,10538,167600,2010
27097,40.1,33093,32117,58,389,9209,47085,13496,10852,2644,13496,159500,2010
27099,39.4,38855,33413,730,3619,10252,44497,16018,11971,4047,16018,108600,2010
27101,46.9,8779,8415,3,195,2620,45657,3831,3192,639,3831,90000,2010
27103,33,32271,29688,601,1110,8018,57540,12150,9026,3124,12150,169700,2010
27105,37.5,21030,14808,615,4266,5503,43040,8065,5901,2164,8065,97200,2010
27107,44.9,6865,6321,13,253,1873,41784,2889,2281,608,2889,79300,2010
27109,36,141244,119097,6366,5624,37314,64090,56066,42920,13146,56066,174000,2010
27111,45.3,57539,54690,429,1458,16744,43478,24691,19410,5281,24691,158600,2010
27113,39.5,13862,12913,61,336,3589,44926,5720,4431,1289,5720,91600,2010
27115,41.5,29413,26825,460,693,7764,43938,11600,9476,2124,11600,162400,2010
27117,42.8,9570,8932,46,274,2638,40589,3926,3014,912,3926,85100,2010
27119,40.4,31336,28372,272,1701,8268,47233,12509,9130,3379,12509,115800,2010
27121,45.1,11064,10811,45,83,3221,47196,4824,3765,1059,4824,148700,2010
27123,34.7,503113,344291,51652,34742,117612,51915,203382,126570,76812,203382,222700,2010
27125,42.6,4094,3905,21,86,1190,47835,1751,1461,290,1751,80800,2010
27127,42.6,16069,14321,101,328,4417,44181,6661,5215,1446,6661,88300,2010
27129,43.3,16007,14666,96,1000,4413,47623,6539,5186,1353,6539,97100,2010
27131,34.3,63087,54000,1756,4872,15403,58771,22213,17123,5090,22213,210400,2010
27133,40.5,9606,9193,53,171,2603,45411,3885,3082,803,3885,99200,2010
27135,39.9,15864,14966,52,128,4482,49400,6331,5093,1238,6331,96200,2010
27137,40.7,199472,184844,2647,2422,51606,44941,86561,62807,23754,86561,140400,2010
27139,34.4,126139,107817,3290,5379,33402,82190,43814,37937,5877,43814,274300,2010
27141,33.4,86823,80814,1552,1872,22085,71704,29224,24929,4295,29224,226300,2010
27143,40,15219,13863,24,1004,4194,51449,6117,5009,1108,6117,148500,2010
27145,33.1,147927,135237,3774,3777,36970,51779,56365,41118,15247,56365,174500,2010
27147,38,36434,32634,935,2136,9960,55321,14138,11155,2983,14138,156300,2010
27149,35,9711,8998,109,273,2196,47055,3725,2539,1186,3725,120300,2010
27151,44.2,9946,9248,299,313,2588,41486,4190,3083,1107,4190,97600,2010
27153,41.4,24804,23175,63,1109,7148,42927,10065,8334,1731,10065,139400,2010
27155,46.6,3657,3426,0,67,1000,41287,1636,1314,322,1636,69200,2010
27157,42.4,21743,20822,146,540,6061,51112,8799,7204,1595,8799,157300,2010
27159,43.5,13809,13256,116,180,3877,34686,5959,4552,1407,5959,113800,2010
27161,39.5,19168,17444,228,894,5008,50552,7284,5846,1438,7284,141400,2010
27163,37.6,232536,200808,6919,7564,63343,79109,86315,72835,13480,86315,264800,2010
27165,42.3,11212,8635,14,2203,2837,44228,4399,3493,906,4399,89300,2010
27167,43.1,6636,6374,14,132,1973,48692,2779,2307,472,2779,102800,2010
27169,32.5,51304,47931,363,1122,11815,44217,19414,13886,5528,19414,159200,2010
27171,34.1,120764,113439,1241,2804,33143,67963,44413,37815,6598,44413,222300,2010
27173,42.8,10514,9737,81,327,2983,50288,4213,3350,863,4213,97100,2010
28001,39.4,32659,12976,19216,199,7511,27096,12354,8286,4068,12354,77500,2010
28003,39.3,36708,31218,4095,922,9438,32342,13685,10029,3656,13685,85700,2010
28005,42,13318,7605,5603,34,3231,27615,4993,4065,928,4993,72300,2010
28007,39.1,19545,10944,8213,293,4887,28508,7286,5496,1790,7286,72200,2010
28009,39,8652,5248,3315,30,2181,29202,3303,2611,692,3303,79100,2010
28011,33.6,35063,11474,22966,188,8249,26005,12666,7112,5554,12666,77800,2010
28013,38.9,14945,9885,4237,689,3991,28484,5835,4015,1820,5835,60700,2010
28015,40.6,10608,6814,3671,11,2947,29290,3989,3246,743,3989,65400,2010
28017,37.4,17689,9443,7362,563,4562,30092,6775,4857,1918,6775,59800,2010
28019,41.6,8680,5869,2775,2,2345,30994,3593,2762,831,3593,72800,2010
28021,32.8,9928,1473,8404,8,1964,24150,3308,2614,694,3308,53500,2010
28023,39.3,16808,10753,5906,39,4955,29103,6787,5296,1491,6787,59900,2010
28025,37.5,20883,8467,12058,60,5830,31727,7857,5614,2243,7857,74500,2010
28027,32.2,26681,6203,19751,297,6343,24726,9351,5331,4020,9351,53400,2010
28029,36.1,29521,13537,15002,696,6835,36637,10275,8037,2238,10275,73200,2010
28031,36.8,19557,12267,6704,289,5193,32456,7257,6071,1186,7257,81600,2010
28033,34.8,154715,112013,29454,7087,42788,59418,55768,43239,12529,55768,152300,2010
28035,30.8,74290,44224,26416,2365,17246,34448,28115,16368,11747,28115,110400,2010
28037,40.7,8130,5211,2871,4,2059,33324,2995,2569,426,2995,70000,2010
28039,35.4,22061,19478,1877,466,6012,45492,7858,6522,1336,7858,92400,2010
28041,35.8,14009,10128,3531,176,3528,40828,4181,3732,449,4181,72600,2010
28043,38.5,22169,12583,9140,197,6252,32901,8945,5857,3088,8945,85900,2010
28045,40.8,42408,36647,2955,1400,11610,44494,15818,11926,3892,15818,150700,2010
28047,35.8,181791,124006,39135,8611,45215,45668,66990,44542,22448,66990,142700,2010
28049,32.8,246067,72386,166660,3465,58051,39215,88201,53755,34446,88201,105000,2010
28051,31.9,19597,3246,16153,15,4284,21375,6739,4841,1898,6739,46900,2010
28053,34.8,9610,2274,7181,155,2325,25131,3364,2098,1266,3364,60100,2010
28055,36.2,1893,752,1141,0,355,21360,587,383,204,587,62000,2010
28057,38.4,23329,21321,1436,262,6746,37588,8907,7116,1791,8907,80000,2010
28059,37,137082,97108,29603,5485,35346,47906,49137,35713,13424,49137,125500,2010
28061,39.4,17383,8026,9059,87,4463,30177,6817,5700,1117,6817,67100,2010
28063,41,7970,1095,6865,0,1945,24304,2831,2123,708,2831,67000,2010
28065,39.7,12666,4959,7478,53,3397,25986,4904,4009,895,4904,58800,2010
28067,37,67144,44469,18640,3045,17994,36017,25060,18478,6582,25060,79500,2010
28069,37.7,10470,3781,6212,66,2590,25649,3793,2898,895,3793,61700,2010
28071,26.8,45859,32503,10922,1038,9080,39080,16418,9831,6587,16418,149800,2010
28073,33.4,52559,41020,9138,1077,13691,48048,20345,14265,6080,20345,157200,2010
28075,36.6,79405,43591,32998,1409,20601,33926,30231,19956,10275,30231,83200,2010
28077,38.2,13016,8603,4168,203,3531,35593,4983,4067,916,4983,71500,2010
28079,32.9,23547,11695,9527,930,5485,31986,7500,5895,1605,7500,70100,2010
28081,35.7,81446,56514,21831,1862,22651,39049,31508,21895,9613,31508,107100,2010
28083,32.4,33109,8424,23304,740,7238,22020,11271,5779,5492,11271,63400,2010
28085,37.4,34622,23589,10384,364,9832,38405,13269,10281,2988,13269,80000,2010
28087,36,59482,31933,25697,959,15656,37607,23067,15277,7790,23067,104200,2010
28089,35.4,91987,52050,35080,2451,23997,59585,34708,24201,10507,34708,181100,2010
28091,37,26758,17470,8956,114,6830,31332,9651,7747,1904,9651,79600,2010
28093,38.1,37002,17953,17636,984,9135,34183,12738,9870,2868,12738,84800,2010
28095,38.8,37282,25186,11312,354,11039,35685,14725,11598,3127,14725,79500,2010
28097,39.8,11138,5897,5123,41,3103,31488,4347,3306,1041,4347,68400,2010
28099,35.3,29545,17958,6117,532,7341,34905,10597,8070,2527,10597,69200,2010
28101,37.6,21828,13735,6646,298,5951,36154,7989,6416,1573,7989,67100,2010
28103,37,11747,3271,8227,43,2863,22178,4169,3082,1087,4169,55900,2010
28105,25.1,46529,27157,16994,708,9626,30320,17933,9135,8798,17933,106900,2010
28107,35.8,34782,17145,16944,498,8744,34030,12325,9401,2924,12325,75000,2010
28109,38.4,55923,46339,6931,1544,15133,40038,20628,16082,4546,20628,121700,2010
28111,38.6,12243,9490,2632,0,3616,38887,4753,3965,788,4753,71500,2010
28113,37,40284,18843,20365,493,10018,30779,14785,10785,4000,14785,82000,2010
28115,35.9,29523,23534,3955,1545,7502,38420,10200,7916,2284,10200,84000,2010
28117,38.3,25411,21397,3384,207,6943,31262,9570,7596,1974,9570,70800,2010
28119,37.6,8551,2539,5991,0,2099,24169,3173,2187,986,3173,46200,2010
28121,35.7,138523,106368,25992,3416,37189,54028,51774,39261,12513,51774,142400,2010
28123,35.3,28180,14544,10852,2650,6811,35765,9811,7891,1920,9811,63800,2010
28125,37.5,4797,1265,3512,16,1059,30129,1651,1106,545,1651,65300,2010
28127,37.6,27575,17299,9624,390,7516,36739,10343,7921,2422,10343,75100,2010
28129,38.4,16443,12327,3920,144,4487,37176,6052,5254,798,6052,72600,2010
28131,35.9,16923,13168,3301,223,4786,43728,5995,4643,1352,5995,105400,2010
28133,33.2,30504,7838,22033,391,5931,25012,8534,4885,3649,8534,63300,2010
28135,35.7,15270,5638,8790,721,3346,24668,4739,3439,1300,4739,51600,2010
28137,36,28198,18715,8465,562,7121,41102,9950,7540,2410,9950,100500,2010
28139,38.1,21993,17367,3332,844,6408,32109,8591,6454,2137,8591,71100,2010
28141,42.1,19535,18271,616,506,5537,30211,7709,6149,1560,7709,73200,2010
28143,31.2,10817,2572,7893,221,2246,29994,4039,2105,1934,4039,73000,2010
28145,37.3,26922,21669,3713,1033,7624,35928,10163,7717,2446,10163,78600,2010
28147,36.6,15530,8164,7060,201,3728,33054,5476,4600,876,5476,83800,2010
28149,37.5,48890,24580,22589,922,12636,40404,19267,12958,6309,19267,99700,2010
28151,34.8,52455,14631,36520,560,12723,27797,19039,10702,8337,19039,72800,2010
28153,37.2,20971,12533,8071,215,6079,31081,8375,6867,1508,8375,60500,2010
28155,39.4,10139,7912,1921,123,2844,34107,3892,2728,1164,3892,72500,2010
28157,36.8,10070,2927,7056,58,2397,28066,3464,2598,866,3464,55400,2010
28159,38.9,19378,10164,9070,67,5005,30738,7360,5837,1523,7360,71900,2010
28161,39.9,12869,7769,4962,87,3427,29911,4981,3610,1371,4981,61700,2010
28163,34.8,28402,10764,16302,831,6001,27356,8640,5506,3134,8640,70500,2010
29001,28.5,25315,23535,418,534,5631,31176,9584,5853,3731,9584,97800,2010
29003,41,17006,16388,67,241,4963,52720,6633,5216,1417,6633,125500,2010
29005,45.8,5811,5659,1,23,1635,42375,2474,1792,682,2474,69500,2010
29007,38.3,25684,22824,1771,621,6596,40935,9532,7291,2241,9532,84700,2010
29009,40.3,35753,31787,24,2677,9826,36143,14256,10683,3573,14256,101600,2010
29011,39.7,12634,11989,27,186,3607,39573,4984,3779,1205,4984,84000,2010
29013,40.7,17132,16423,110,250,4592,38882,6605,4939,1666,6605,102000,2010
29015,50.6,18975,18248,7,174,5769,33305,8273,6947,1326,8273,97500,2010
29017,41.9,12445,12129,29,90,3408,33938,4807,3785,1022,4807,92800,2010
29019,29.5,158067,128853,13701,4646,36273,45786,63420,36519,26901,63420,153900,2010
29021,37.1,88195,76971,3841,4126,21651,42393,33913,23024,10889,33913,107800,2010
29023,40.4,42437,38270,2200,732,11226,33525,17071,11462,5609,17071,87700,2010
29025,41.2,9380,9046,61,126,2703,39439,3759,2805,954,3759,97600,2010
29027,37.2,43769,39755,1918,765,11832,49544,16643,12553,4090,16643,122700,2010
29029,47.8,43157,41232,216,958,12938,44617,18349,14914,3435,18349,187200,2010
29031,36.3,74283,65780,4899,1428,19794,44479,29624,19971,9653,29624,132500,2010
29033,42,9485,9093,142,112,2715,41619,3868,3025,843,3868,72600,2010
29035,41.5,6141,5864,18,89,1538,28408,2435,1880,555,2435,88100,2010
29037,37.4,97598,87894,3007,3700,27908,60097,36399,29139,7260,36399,152900,2010
29039,44.5,14091,13561,0,177,4323,32800,6135,4678,1457,6135,92300,2010
29041,45.1,7871,7578,174,52,2167,41558,3145,2518,627,3145,76500,2010
29043,36,74156,69997,550,1839,21942,51135,28385,21480,6905,28385,146800,2010
29045,42.3,7169,7016,8,27,1885,38133,2811,2136,675,2811,68700,2010
29047,36,215015,182831,7430,12026,58236,58559,86034,62431,23603,86034,153900,2010
29049,40.8,20682,19612,221,361,5743,51915,8091,6182,1909,8091,150200,2010
29051,36.8,74767,62686,8006,1726,19008,53877,29111,19799,9312,29111,136300,2010
29053,37.7,17583,15679,1059,233,4290,42586,6397,4627,1770,6397,112400,2010
29055,39.7,24640,23792,60,351,6352,34506,9467,7085,2382,9467,105400,2010
29057,45.1,7929,7552,6,108,2165,32714,3276,2538,738,3276,73000,2010
29059,41.4,16813,16117,0,231,4695,38101,6444,5271,1173,6444,96800,2010
29061,40,8359,8151,21,83,2310,39925,3288,2457,831,3288,99100,2010
29063,39.7,12872,11028,1162,199,2626,43267,3961,2685,1276,3961,115100,2010
29065,42.6,15497,14898,105,149,4259,36118,6124,4771,1353,6124,84100,2010
29067,42.9,13689,13431,0,107,3359,30968,4913,4031,882,4913,87800,2010
29069,39.2,32140,26834,3225,1628,8469,29375,12885,8037,4848,12885,67300,2010
29071,38.5,100737,96904,1122,1374,27684,49120,38556,29623,8933,38556,147200,2010
29073,44,15334,14935,9,131,4310,40837,6470,5116,1354,6470,111900,2010
29075,42.4,6760,6626,13,60,1741,35556,2670,2046,624,2670,79500,2010
29077,35.6,270190,243255,7463,7722,68592,41059,112993,69828,43165,112993,125500,2010
29079,42.7,10214,9822,42,146,2634,35239,4259,2998,1261,4259,71700,2010
29081,43.5,8941,8668,0,115,2312,35000,3534,2658,876,3534,77700,2010
29083,43.3,22373,21367,117,368,6247,35706,9459,6933,2526,9459,103300,2010
29085,51.9,9579,9250,7,8,2964,28097,4478,3761,717,4478,89900,2010
29087,45.4,4944,4816,3,14,1526,40261,2219,1733,486,2219,74600,2010
29089,39,10120,9211,545,130,2599,42067,3856,3024,832,3856,98300,2010
29091,39,39763,37872,129,709,10975,35282,15404,11096,4308,15404,94200,2010
29093,41.9,10670,10212,149,68,2779,29803,4287,3121,1166,4287,77200,2010
29095,36.1,666997,426329,159309,52461,166811,46252,271192,171266,99926,271192,129900,2010
29097,35.1,115029,99855,2035,7376,29413,37894,44505,29254,15251,44505,93400,2010
29099,37.1,216262,206731,1739,3313,58851,56756,80083,67175,12908,80083,154700,2010
29101,29.6,52041,45990,2139,1674,12614,44985,19184,12383,6801,19184,133100,2010
29103,44.1,4134,4032,17,23,1108,33029,1746,1307,439,1746,56500,2010
29105,38.5,35357,33527,302,741,10160,37294,14352,10168,4184,14352,93000,2010
29107,40.2,33313,31077,760,737,9386,48257,13394,9910,3484,13394,121000,2010
29109,38.6,38373,35129,153,2216,10773,38350,15043,10906,4137,15043,94700,2010
29111,39.2,10235,9617,301,61,2668,40399,3764,2867,897,3764,79400,2010
29113,35.1,51333,48325,837,1036,13511,52897,18061,14817,3244,18061,155600,2010
29115,42.6,12824,12385,162,153,3280,37706,5062,3796,1266,5062,66800,2010
29117,41.3,14961,14186,399,171,3644,39683,5688,3786,1902,5688,92700,2010
29119,36.4,23016,18770,142,2583,5667,36619,8016,5633,2383,8016,86800,2010
29121,42,15539,14747,339,150,4206,36429,6348,4858,1490,6348,84200,2010
29123,40.1,12269,11873,14,181,3287,33456,4757,3678,1079,4757,83400,2010
29125,41.9,9203,8908,61,168,2607,40185,3615,2966,649,3615,112500,2010
29127,38.6,28579,26091,1394,418,7601,40859,11384,7664,3720,11384,91200,2010
29129,43.9,3731,3630,6,48,1065,34008,1554,1176,378,1554,69600,2010
29131,40.2,24805,23885,155,347,6782,35838,10410,7835,2575,10410,108200,2010
29133,38.9,14143,10438,2987,529,3422,29586,5287,3319,1968,5287,67400,2010
29135,36.8,15468,14050,538,558,3932,47162,5475,4288,1187,5475,111900,2010
29137,43.2,9078,8583,243,96,2665,38750,3835,2931,904,3835,79100,2010
29139,42.2,12247,11672,153,160,3462,39369,4869,3739,1130,4869,107300,2010
29141,46.2,20631,19736,153,325,6118,36696,8414,6874,1540,8414,114400,2010
29143,39.8,18847,15337,2963,223,5118,32895,7719,4966,2753,7719,67100,2010
29145,38.4,57561,50895,392,2360,15870,41163,21618,16134,5484,21618,103400,2010
29147,28.3,23031,21673,404,399,4790,38621,8341,5053,3288,8341,94900,2010
29149,45,10739,10250,22,78,2967,26144,4470,3349,1121,4470,69200,2010
29151,39.6,13768,13543,79,86,3779,45746,5301,4485,816,5301,120400,2010
29153,47.9,9688,9362,5,106,2890,31960,3964,3265,699,3964,107000,2010
29155,36.3,18587,12954,5174,323,4605,30120,7026,3944,3082,7026,61200,2010
29157,39.1,18919,18286,54,248,5290,45713,7691,6003,1688,7691,122400,2010
29159,37,41587,36444,1157,2883,10641,37658,16288,11644,4644,16288,93200,2010
29161,34.1,44473,40370,1039,942,10628,40260,16726,10960,5766,16726,114700,2010
29163,40.1,18590,16509,1321,347,4790,42082,6721,4812,1909,6721,97900,2010
29165,38.2,86894,74171,4512,4101,23793,65948,35065,23735,11330,35065,185100,2010
29167,37.7,30729,27677,123,587,8200,35831,11718,8440,3278,11718,112300,2010
29169,26.6,49114,35799,5682,4215,10146,43155,15412,8661,6751,15412,120200,2010
29171,39.4,5040,4812,6,180,1574,34545,2224,1647,577,2224,98200,2010
29173,43.7,10127,9820,34,97,3031,45194,4139,3386,753,4139,106800,2010
29175,37.8,25495,22857,1513,420,6138,36458,9070,6673,2397,9070,81100,2010
29177,39.6,23667,22555,299,417,6612,53343,9196,7240,1956,9196,126100,2010
29179,44.5,6698,6418,84,29,1814,32059,2878,2124,754,2878,76300,2010
29181,41.6,14057,13815,4,141,4058,29369,5558,4077,1481,5558,68100,2010
29183,36.6,350606,314755,14340,9150,95336,70331,130973,107345,23628,130973,197300,2010
29185,47.6,9757,9359,4,12,2925,32217,4320,3493,827,4320,82800,2010
29186,42.9,18205,17665,169,145,5238,46911,7369,6152,1217,7369,124700,2010
29187,38.1,64239,59766,2717,811,15962,38589,24122,17761,6361,24122,101800,2010
29189,39.4,999454,698072,226964,23308,264290,57561,404777,293482,111295,404777,179300,2010
29195,38,23126,19423,1343,1778,5752,38818,8939,6239,2700,8939,84000,2010
29197,40.9,4361,4314,13,0,1279,31358,2097,1499,598,2097,55900,2010
29199,42.2,4831,4776,0,34,1327,39722,1980,1568,412,1980,75000,2010
29201,38.6,39370,33484,4511,701,10810,37716,15520,10795,4725,15520,95000,2010
29203,41.9,8404,7978,19,84,2510,30766,3402,2652,750,3402,72100,2010
29205,42.6,6439,6259,9,78,1745,35012,2705,1898,807,2705,69400,2010
29207,40.5,30089,29034,355,351,8369,35932,12130,8568,3562,12130,80800,2010
29209,48.5,32003,27221,0,517,9882,41351,13529,10281,3248,13529,139900,2010
29211,40.3,6728,5491,21,1085,1712,30459,2642,1864,778,2642,68700,2010
29213,40.7,49324,45251,49,2214,13722,39026,20281,13727,6554,20281,132100,2010
29215,42.2,25662,23774,859,401,6575,31552,9523,7071,2452,9523,92100,2010
29217,40.1,20917,19986,36,315,5499,34387,8329,5830,2499,8329,82600,2010
29219,39,31635,29427,549,887,8867,50231,12122,9504,2618,12122,161000,2010
29221,39.5,24981,23777,556,242,6476,35901,9070,7301,1769,9070,82400,2010
29223,45.5,13433,12999,0,63,3822,30621,5838,4277,1561,5838,72200,2010
29225,37.1,35678,34007,385,583,9791,40889,12928,9901,3027,12928,120500,2010
29227,47,2188,2169,0,10,722,38220,977,754,223,977,57600,2010
29229,40.8,18731,18070,42,209,5222,29636,7499,5365,2134,7499,89300,2010
29510,34,318809,133205,158511,10365,68112,33652,140439,66261,74178,140439,122200,2010
30001,42.5,9132,8490,18,294,2538,38264,3918,2536,1382,3918,169700,2010
30003,31,12663,3953,0,491,2600,36550,3584,2387,1197,3584,89700,2010
30005,35.3,6472,3145,0,54,1634,37034,2338,1483,855,2338,73100,2010
30007,42.6,5287,4969,27,15,1234,44667,1878,1478,400,1878,159700,2010
30009,46.7,9994,9598,23,167,2794,49010,4149,3026,1123,4149,200700,2010
30011,51,1289,1267,0,6,398,35703,580,435,145,580,66200,2010
30013,39.2,80562,70631,1003,2720,21965,42389,33164,22164,11000,33164,146600,2010
30015,41.5,5765,4420,12,93,1573,41064,2170,1439,731,2170,107000,2010
30017,41.8,11548,10914,86,216,3052,38913,5168,3388,1780,5168,86700,2010
30019,49.2,1649,1565,0,5,509,38125,773,633,140,773,77300,2010
30021,42.7,8933,8487,46,155,2573,50752,3715,2750,965,3715,100300,2010
30023,46.2,9270,8550,74,216,2541,35310,4136,3007,1129,4136,102600,2010
30025,43.5,2813,2726,0,50,776,52529,1193,909,284,1193,86700,2010
30027,46.9,11513,11027,141,159,3161,37607,4966,3563,1403,4966,104100,2010
30029,40.5,89215,83983,104,2083,24367,44998,36348,26002,10346,36348,231800,2010
30031,31.8,87676,81979,318,2385,21061,50136,35753,22286,13467,35753,277300,2010
30033,46.5,1224,1220,0,0,333,42955,506,402,104,506,68800,2010
30035,31.4,13251,4130,10,232,3069,38075,4253,2509,1744,4253,73600,2010
30037,49.7,810,792,0,0,206,35726,334,254,80,334,90900,2010
30039,50.7,3044,2936,0,20,898,36052,1461,1116,345,1461,169900,2010
30041,35.6,16007,11741,95,377,4099,43606,6086,4150,1936,6086,109000,2010
30043,45.6,11166,10514,36,205,3163,56695,4428,3787,641,4428,225300,2010
30045,52.6,1967,1924,0,11,545,41473,867,668,199,867,101500,2010
30047,40.9,28493,19655,50,995,7949,37274,12015,8162,3853,12015,201900,2010
30049,40.7,61643,57209,247,1526,15921,50238,26075,18987,7088,26075,185500,2010
30051,45.9,2261,2232,25,0,581,40212,816,512,304,816,71400,2010
30053,48.4,19507,18456,36,422,6014,30823,9237,7062,2175,9237,148500,2010
30055,46.4,1714,1671,0,0,488,48167,694,539,155,694,82800,2010
30057,48.7,7588,7272,31,140,2239,42998,3813,2629,1184,3813,240100,2010
30059,43.2,2024,1897,0,121,481,31577,767,491,276,767,96500,2010
30061,47.8,4193,3928,42,88,1161,37256,1760,1170,590,1760,159400,2010
30063,33.9,107288,98063,376,2780,25485,42887,44172,26826,17346,44172,233700,2010
30065,49.5,4339,4181,0,102,1487,37033,2035,1560,475,2035,112200,2010
30067,44.6,15752,15052,0,289,4423,38830,6983,4913,2070,6983,207300,2010
30069,41.6,598,498,42,18,193,36875,283,194,89,283,106800,2010
30071,47.6,4206,3638,0,40,1101,36453,1816,1377,439,1816,79100,2010
30073,42.5,6145,5008,46,74,1583,36419,2311,1616,695,2311,86200,2010
30075,46,1659,1555,0,39,484,37685,688,457,231,688,99700,2010
30077,44.5,7077,6476,34,140,1707,39851,2397,1787,610,2397,114600,2010
30079,55.5,1089,1064,0,4,338,34896,497,432,65,497,69400,2010
30081,45.1,40013,37669,16,1164,11486,43000,16643,12971,3672,16643,235500,2010
30083,42.3,9498,8898,8,255,2782,52516,4072,2705,1367,4072,106500,2010
30085,32,10273,3780,0,132,2111,37451,3374,2148,1226,3374,61700,2010
30087,37.3,9134,5487,78,268,2332,44776,3225,2272,953,3225,102900,2010
30089,48.8,11366,10342,21,198,3437,30622,5119,4020,1099,5119,172500,2010
30091,50,3505,3288,2,17,953,39578,1674,1259,415,1674,68400,2010
30093,41.8,33797,31248,43,1209,8482,37986,14847,9773,5074,14847,117200,2010
30095,45,8934,8543,19,186,2727,57227,3752,2816,936,3752,170100,2010
30097,45.4,3717,3540,0,74,984,43723,1510,1228,282,1510,184100,2010
30099,45.3,6105,5818,0,99,1766,39516,2458,1861,597,2458,133700,2010
30101,41.9,5143,4777,26,117,1282,42949,1992,1258,734,1992,97900,2010
30103,45.4,848,722,0,97,219,37969,319,216,103,319,66200,2010
30105,45.1,7345,6368,58,106,1969,42050,3152,2381,771,3152,81400,2010
30107,51.1,2118,2096,0,0,552,30321,929,725,204,929,85000,2010
30109,48.4,1067,992,7,22,277,40417,389,308,81,389,60000,2010
30111,38.3,144050,127384,801,6584,38047,48641,59746,41996,17750,59746,168800,2010
31001,37.5,31126,27819,161,2247,8269,44443,12403,8734,3669,12403,95000,2010
31003,45.2,6742,6517,12,147,2008,37058,2792,2011,781,2792,67000,2010
31005,39.4,426,420,0,5,121,43250,178,113,65,178,76100,2010
31007,46.4,720,671,0,37,217,34063,320,212,108,320,76900,2010
31009,48.4,539,504,0,0,197,39000,242,158,84,242,57600,2010
31011,45,5553,5529,0,18,1579,40703,2382,1776,606,2382,71100,2010
31013,40.9,11372,9674,44,1075,3278,44404,4793,3231,1562,4793,90600,2010
31015,47,2107,2026,0,73,597,34906,932,700,232,932,52100,2010
31017,48.1,3192,3138,4,0,754,28038,1340,942,398,1340,56400,2010
31019,32,45437,40883,310,3132,11000,47120,17268,11304,5964,17268,128600,2010
31021,45.9,6964,6649,57,113,2019,43817,2951,2194,757,2951,83100,2010
31023,44,8382,8142,37,183,2262,44595,3451,2598,853,3451,87800,2010
31025,40.7,25246,24184,63,569,6973,62039,9610,7941,1669,9610,142800,2010
31027,43.3,8906,8728,2,103,2266,40497,3419,2769,650,3419,85100,2010
31029,44.8,3927,3553,0,364,1155,38314,1710,1297,413,1710,82600,2010
31031,43.9,5783,5256,4,66,1628,43431,2505,1652,853,2505,95300,2010
31033,41.3,10049,9199,0,525,2832,49493,4348,3047,1301,4348,94200,2010
31035,43.1,6554,6023,5,391,1820,42909,2621,2024,597,2621,73700,2010
31037,35.3,10201,6243,123,3689,2614,48133,3706,2995,711,3706,85400,2010
31039,43.4,9243,8408,0,689,2746,44278,3841,2882,959,3841,88000,2010
31041,44.7,11001,10652,7,192,3222,42364,4585,3534,1051,4585,71500,2010
31043,33,20674,12111,487,6816,5521,43729,7281,4892,2389,7281,97800,2010
31045,32.9,9149,8113,170,300,1980,34937,3594,2273,1321,3594,91800,2010
31047,36,24245,15812,619,7405,6092,41830,8908,6395,2513,8908,83400,2010
31049,49.3,1963,1844,1,83,616,37148,931,729,202,931,65600,2010
31051,40.1,6000,5352,5,547,1700,42388,2389,1841,548,2389,75200,2010
31053,40.1,36621,32585,181,3186,9896,42849,14994,10005,4989,14994,110500,2010
31055,33.6,505545,368909,56341,52838,123927,51878,198410,127698,70712,198410,141400,2010
31057,48.9,1963,1850,0,101,577,37031,879,695,184,879,63400,2010
31059,45.4,5953,5669,69,151,1710,43167,2572,1988,584,2572,75100,2010
31061,47.9,3229,3166,0,23,890,37220,1385,1113,272,1385,50400,2010
31063,43,2808,2667,0,54,769,42009,1156,874,282,1156,73600,2010
31065,46.8,4942,4768,0,109,1389,37938,2149,1686,463,2149,55700,2010
31067,42.8,22591,21717,35,383,6060,43311,9219,6703,2516,9219,97800,2010
31069,51.3,2060,1929,0,108,646,32962,969,662,307,969,58700,2010
31071,47.3,2081,2014,0,59,617,38709,875,695,180,875,73900,2010
31073,45.4,2058,1958,12,75,573,41442,801,615,186,801,94900,2010
31075,46.6,661,650,0,9,207,39261,293,184,109,293,41100,2010
31077,42.3,2542,2519,6,4,660,41181,965,798,167,965,52100,2010
31079,35.7,56899,42657,980,12044,14831,46138,21878,14633,7245,21878,107700,2010
31081,41.7,9160,8904,12,165,2523,50702,3464,2667,797,3464,108600,2010
31083,48,3460,3389,0,44,1023,44656,1547,1271,276,1547,69900,2010
31085,46.4,1025,975,0,42,312,45595,440,309,131,440,84500,2010
31087,48.3,2925,2839,12,22,884,35549,1280,979,301,1280,48700,2010
31089,45.4,10479,10112,20,233,2889,43452,4244,3211,1033,4244,82300,2010
31091,51.4,690,684,0,0,200,38750,320,271,49,320,67800,2010
31093,42.6,6302,6110,26,104,1865,45453,2681,2099,582,2681,89300,2010
31095,46.1,7708,7421,0,157,2099,42665,3279,2625,654,3279,74400,2010
31097,43.1,5211,4374,311,453,1240,42083,1980,1493,487,1980,76400,2010
31099,42.5,6552,6256,14,196,1909,54518,2630,2087,543,2630,101100,2010
31101,46,8356,7750,9,402,2499,42898,3735,2725,1010,3735,88200,2010
31103,53.9,740,721,0,15,227,32000,346,290,56,346,57500,2010
31105,45.7,3814,3489,0,194,1067,42010,1662,1177,485,1662,76800,2010
31107,45.8,8762,7815,62,144,2501,36798,3847,2900,947,3847,67000,2010
31109,32.4,279428,238202,9158,15246,69373,50849,111933,69500,42433,111933,145400,2010
31111,39.1,36167,32826,274,2451,9826,45181,15038,10273,4765,15038,109100,2010
31113,45.1,682,655,0,0,219,45192,320,218,102,320,72200,2010
31115,47,635,609,0,20,170,34219,242,206,36,242,58900,2010
31117,36.6,489,477,0,0,166,50625,204,120,84,204,74400,2010
31119,36.8,34720,29184,370,4226,8618,44089,13663,9282,4381,13663,100500,2010
31121,42.1,7784,7397,36,271,2247,46116,3145,2304,841,3145,78900,2010
31123,43.3,5071,4309,0,648,1463,37717,2136,1447,689,2136,79800,2010
31125,44.7,3755,3636,26,72,1014,41610,1528,1161,367,1528,60200,2010
31127,41.7,7249,6991,63,114,1906,42534,3024,2154,870,3024,78200,2010
31129,48.6,4583,4429,45,12,1356,31761,2060,1641,419,2060,54200,2010
31131,42.9,15741,14646,25,776,4314,47493,6335,4683,1652,6335,114000,2010
31133,48.6,2767,2690,0,34,843,41969,1309,1024,285,1309,55100,2010
31135,42.6,2983,2876,0,96,840,47000,1240,909,331,1240,77100,2010
31137,42,9234,8797,3,409,2498,45221,3832,2859,973,3832,90200,2010
31139,41.9,7308,7152,5,91,2116,48318,2917,2408,509,2917,87800,2010
31141,38.3,31675,27268,0,3787,8432,49523,12378,9129,3249,12378,108100,2010
31143,44.7,5412,5219,0,123,1618,48444,2230,1674,556,2230,86400,2010
31145,42.9,11069,10444,44,397,3027,41927,4658,3243,1415,4658,77300,2010
31147,47.1,8455,7944,0,123,2266,35165,3862,2947,915,3862,63700,2010
31149,48.7,1651,1632,0,19,467,39159,713,607,106,713,57300,2010
31151,35.9,14098,11059,98,2484,3421,45469,5020,3355,1665,5020,95100,2010
31153,32.7,152180,128212,5880,10342,41869,68280,56512,40915,15597,56512,158600,2010
31155,41.6,20543,19813,11,393,5931,57699,7985,6612,1373,7985,137500,2010
31157,39,36569,27827,159,7357,9792,39004,14902,9754,5148,14902,95900,2010
31159,37.8,16628,16026,132,256,4455,55877,6394,4677,1717,6394,136400,2010
31161,46.3,5538,4650,0,159,1493,33608,2434,1702,732,2434,63300,2010
31163,47.2,3144,3033,0,55,886,38631,1362,1154,208,1362,53200,2010
31165,48.9,1340,1299,0,9,395,42386,598,429,169,598,109300,2010
31167,39.4,6207,5840,0,249,1805,47713,2419,1888,531,2419,87800,2010
31169,48.3,5262,5122,4,94,1450,39159,2247,1856,391,2247,61900,2010
31171,47,756,731,1,1,214,48250,332,256,76,332,71100,2010
31173,28.9,6907,2701,39,207,1545,39048,2054,1348,706,2054,67100,2010
31175,47,4284,4205,0,69,1252,38588,1913,1480,433,1913,72900,2010
31177,40.2,20148,19396,77,393,5266,61940,7431,6055,1376,7431,167200,2010
31179,28.3,9573,8940,44,351,2193,45000,3316,2322,994,3316,102400,2010
31181,47.4,3815,3621,44,40,967,38015,1478,1119,359,1478,58700,2010
31183,45.8,751,735,0,9,221,37222,336,229,107,336,66100,2010
31185,40.6,13886,13018,121,504,3860,47689,5771,4397,1374,5771,92300,2010
32001,38.4,24946,19253,364,2869,5592,51597,8801,5676,3125,8801,188300,2010
32003,35.1,1895521,941814,187833,533916,457592,56258,695701,405047,290654,695701,257300,2010
32005,46.6,47042,39506,83,4858,13479,60721,19183,14613,4570,19183,375800,2010
32007,33.6,47707,33238,317,10626,12243,67038,17324,12313,5011,17324,178200,2010
32009,58,892,749,0,93,224,39712,507,328,179,507,77300,2010
32011,40.5,1724,1544,0,89,435,61400,724,529,195,724,87400,2010
32013,36.6,15986,11246,65,3675,4153,55656,6087,4407,1680,6087,138100,2010
32015,36.8,5545,3972,60,1249,1525,66525,1945,1402,543,1945,103400,2010
32017,35.5,5060,4349,182,220,1284,44695,1759,1257,502,1759,151900,2010
32019,39.6,51515,40654,447,7456,12549,48433,17766,12828,4938,17766,185000,2010
32021,50.6,4812,3537,112,408,1392,35446,2331,1820,511,2331,114200,2010
32023,47.4,43878,34987,998,5759,12125,41181,17943,12887,5056,17943,161700,2010
32027,40,6703,4600,320,1414,1478,56491,1980,1395,585,1980,134500,2010
32029,46.4,4016,3425,0,264,1350,61525,1826,1647,179,1826,239200,2010
32031,36.6,412844,276600,9430,88667,101661,55658,160797,96853,63944,160797,295700,2010
32033,41.8,9765,7554,56,1193,2260,48545,3480,2667,813,3480,117500,2010
32510,41.1,55375,39966,746,11141,13558,52067,21467,13381,8086,21467,270500,2010
33001,43.6,60142,57657,302,766,16894,54929,24942,19173,5769,24942,232300,2010
33003,46.8,47772,46338,57,508,13113,49897,19955,16093,3862,19955,240800,2010
33005,40.1,77445,73984,356,1132,19452,53828,30087,21514,8573,30087,201800,2010
33007,45.3,33445,32245,198,390,9469,41534,14915,10657,4258,14915,131400,2010
33009,40.4,88356,82031,745,1632,21727,53075,34312,24300,10012,34312,210600,2010
33011,38.5,399555,352839,7297,19875,104907,69321,153120,105611,47509,153120,269900,2010
33013,40.4,146785,138873,1342,2335,38336,63012,56948,41020,15928,56948,243600,2010
33015,41.4,294638,277937,1902,6036,80138,75825,114722,90156,24566,114722,306800,2010
33017,36.5,122158,113763,1039,2152,29642,57809,46576,31280,15296,46576,229100,2010
33019,43.3,43643,42016,163,512,12450,50689,18227,13433,4794,18227,181800,2010
34001,39.4,273162,162414,41719,43558,67256,54766,101645,71885,29760,101645,264400,2010
34003,40.8,896482,576334,45393,134482,237272,81708,333874,225252,108622,333874,482300,2010
34005,39.6,447861,320691,70462,26900,116359,76258,165284,130578,34706,165284,270200,2010
34007,37.2,513574,315573,93395,68693,129833,60976,190670,132908,57762,190670,223700,2010
34009,46.4,97684,85447,4614,5445,29903,54292,45420,33769,11651,45420,337300,2010
34011,36.5,155456,80444,29190,39495,35210,50651,50825,34261,16564,50825,175500,2010
34013,36,780872,266895,310938,151266,182826,55125,277426,130969,146457,277426,395700,2010
34015,38.2,285223,233364,26785,12513,74505,72664,102632,83046,19586,102632,236900,2010
34017,34.1,622123,196143,72996,260494,144724,55275,237726,81643,156083,237726,383900,2010
34019,42.4,128458,113471,3122,6232,34201,100980,47182,40367,6815,47182,446700,2010
34021,37.4,364445,204601,71179,51230,87385,71217,129213,87700,41513,129213,309300,2010
34023,36.9,798882,409985,70179,140389,199920,77615,277398,185819,91579,277398,356000,2010
34025,40.6,628112,487545,45411,56476,161623,82265,232513,176366,56147,232513,424800,2010
34027,40.5,489811,372899,14411,52897,130223,96747,178638,136806,41832,178638,474700,2010
34029,42.4,569374,493120,16725,43602,151398,59620,222396,183327,39069,222396,294100,2010
34031,36,496204,230630,56893,177190,113488,54944,161428,89195,72233,161428,382600,2010
34033,40.4,65982,51046,8986,4091,17268,59441,25117,18649,6468,25117,196600,2010
34035,39.7,319347,205667,26636,39224,83357,97440,114431,91186,23245,114431,431200,2010
34037,40.6,149996,133998,2499,9151,42236,83089,55842,47360,8482,55842,322400,2010
34039,37.8,529547,248067,109812,137737,129916,66791,184808,113665,71143,184808,397200,2010
34041,40.7,108982,94277,3691,7111,29747,71364,41601,31528,10073,41601,307300,2010
35001,35.7,646881,275813,16264,302480,159338,47481,259165,167303,91862,259165,188800,2010
35003,58.6,3652,2821,4,639,1076,31914,1824,1571,253,1824,129400,2010
35005,35.2,64268,29227,382,32344,16384,37524,23479,16260,7219,23479,86200,2010
35006,36,27179,5992,62,9763,5734,37361,8089,5528,2561,8089,74800,2010
35007,45.6,13827,7000,31,6374,3495,39216,5768,3927,1841,5768,103100,2010
35009,31.7,46924,24376,3042,17843,11606,38090,17318,10628,6690,17318,98500,2010
35011,49.4,1772,1165,7,594,516,30643,784,623,161,784,71100,2010
35013,32.2,201670,61493,2965,131663,50020,36657,71748,47015,24733,71748,137200,2010
35015,37.4,52665,28053,543,22555,13411,46583,19320,14431,4889,19320,90700,2010
35017,45.4,29706,14530,95,14199,8348,36591,12531,9650,2881,12531,125000,2010
35019,40.9,4698,1018,53,3397,979,28488,1492,1156,336,1492,74500,2010
35021,41.3,943,555,7,357,197,33750,321,293,28,321,70300,2010
35023,37.4,4964,1972,85,2855,1254,36733,1705,1179,526,1705,90800,2010
35025,31.6,62503,28132,2730,30570,15596,43910,21255,15098,6157,21255,87500,2010
35027,48.4,20502,13734,29,5952,5362,43750,8629,6687,1942,8629,166600,2010
35028,43.5,18091,13988,60,2567,5248,103643,7566,5840,1726,7566,297100,2010
35029,38.1,25252,9363,189,15187,6190,27997,9204,6401,2803,9204,91700,2010
35031,29.9,70663,7489,399,9393,12389,31335,17631,12945,4686,17631,69300,2010
35033,44.2,4923,757,2,4141,1117,37784,1815,1517,298,1815,107500,2010
35035,36.5,62782,33670,2168,21313,16809,39615,24031,16234,7797,24031,104500,2010
35037,44.4,9002,4906,49,3658,2263,28773,3840,2844,996,3840,65200,2010
35039,38.6,40195,5506,194,28607,10483,41437,14934,11918,3016,14934,136300,2010
35041,29.9,19372,11370,207,7464,4604,37762,6794,4279,2515,6794,94800,2010
35043,37.4,124263,59709,2484,42527,32686,57158,44860,36476,8384,44860,184400,2010
35045,32.3,127517,54270,781,23493,30952,46189,41767,30863,10904,41767,149400,2010
35047,39.8,29321,5678,272,22489,7063,32213,11786,7876,3910,11786,112200,2010
35049,42.2,141702,62947,910,71031,35757,52696,60144,42824,17320,60144,291700,2010
35051,53.6,11938,8483,34,3191,2450,25583,4747,3716,1031,4747,92800,2010
35053,36.5,17964,6881,80,8587,3826,33284,5996,4438,1558,5996,108400,2010
35055,44.1,32574,11891,93,18112,7586,35441,13146,9624,3522,13146,212400,2010
35057,40.7,16467,9310,97,6281,3911,37117,5849,4809,1040,5849,92300,2010
35059,42.3,4388,2719,61,1522,1193,39975,1739,1281,458,1739,91900,2010
35061,36.9,74554,27289,954,42754,19529,42044,26835,21351,5484,26835,129900,2010
36001,38.1,304032,234051,35445,13958,71275,56090,124391,73254,51137,124391,202500,2010
36003,37.1,49105,46966,471,670,12587,41305,18987,14350,4637,18987,66100,2010
36005,32.6,1365725,156489,417404,718204,310610,34264,472464,97786,374678,472464,386200,2010
36007,39.8,200804,174633,8380,6385,49615,44457,80806,53830,26976,80806,99500,2010
36009,40.3,80776,74535,994,1344,21281,42466,32666,23963,8703,32666,77000,2010
36011,40.7,80431,73730,3097,1893,20864,48415,32038,23011,9027,32038,98400,2010
36013,40.3,135263,121523,2649,7670,34870,40639,55044,38428,16616,55044,79600,2010
36015,40.6,88708,78096,5125,2194,22962,44502,35418,24121,11297,35418,85900,2010
36017,42.2,51045,48935,297,968,13765,43943,19989,15432,4557,19989,88200,2010
36019,38.1,82380,75098,2877,2167,19636,47489,31056,21843,9213,31056,117800,2010
36021,44.2,63241,56085,2900,2367,16799,55546,25686,18804,6882,25686,221900,2010
36023,35.8,49452,46480,634,1077,11247,45338,17901,11862,6039,17901,95100,2010
36025,44.6,48220,45026,693,1561,13172,42967,20110,15257,4853,20110,126700,2010
36027,39.4,296152,223771,26720,28792,73644,69838,106952,75478,31474,106952,323300,2010
36029,40,921202,721497,120094,39332,231113,47372,378080,250238,127842,378080,117700,2010
36031,43.6,39416,36658,984,1013,10452,45216,16098,11756,4342,16098,148100,2010
36033,39,51697,42628,3321,1702,12719,42050,19115,13879,5236,19115,88800,2010
36035,42,55497,52190,979,1289,15660,43240,23006,16050,6956,23006,95200,2010
36037,40.9,59952,55220,1266,1530,15883,49750,23790,17544,6246,23790,101400,2010
36039,42.9,49410,43117,2846,2490,11557,46235,18502,13620,4882,18502,180500,2010
36041,50.4,4908,4738,27,40,1532,49557,2381,1948,433,2381,172300,2010
36043,42.2,64332,61709,500,1018,17396,42318,26291,18814,7477,26291,87600,2010
36045,32.6,115069,98634,5365,6039,30650,43410,44109,25234,18875,44109,116800,2010
36047,34.1,2466782,878857,808265,487197,581345,43567,903991,274203,629788,903991,562400,2010
36049,39.9,27017,26158,192,323,7524,42846,10761,8372,2389,10761,100700,2010
36051,38.9,65441,60468,1561,1785,15959,51690,24135,18267,5868,24135,112300,2010
36053,38.5,72887,68610,1166,1321,18328,53345,26851,20442,6409,26851,111700,2010
36055,38.1,741274,545990,106166,50294,182823,51303,291195,194272,96923,291195,130400,2010
36057,40.6,49945,42945,723,5211,13068,42603,20320,14040,6280,20320,95000,2010
36059,40.7,1329083,891002,138961,182003,340122,93613,442833,363366,79467,442833,487900,2010
36061,36.3,1583345,756591,209206,406972,300147,64971,732204,167031,565173,732204,825200,2010
36063,41.2,216064,189607,14523,4457,56556,45964,88152,62521,25631,88152,97600,2010
36065,40.4,234533,200945,12649,10220,59553,46708,92058,62515,29543,92058,101900,2010
36067,38.3,463704,371570,47742,17294,113910,50676,183542,121046,62496,183542,124400,2010
36069,41.6,106298,97952,2165,3405,28292,56468,42952,32431,10521,42952,129600,2010
36071,36.2,370201,258131,33230,62575,90356,69523,124379,88633,35746,124379,312100,2010
36073,40.2,43169,37954,2440,1758,10608,48063,15736,12071,3665,15736,86400,2010
36075,38,122220,116560,927,2444,30215,45333,45749,33687,12062,45749,88000,2010
36077,39.8,62604,58250,1141,1886,15713,45268,24926,18074,6852,24926,129000,2010
36079,40.9,99545,83603,1876,10674,26540,89218,34907,29543,5364,34907,418100,2010
36081,37.1,2199169,628881,395338,593140,527510,55291,774311,352110,422201,774311,479300,2010
36083,39.1,158629,137191,7413,5622,39454,54152,63518,41351,22167,63518,171200,2010
36085,38.1,463450,303035,43876,75602,122677,71084,164279,115527,48752,164279,461700,2010
36087,36.8,305461,203056,34837,44607,74012,82534,97557,69300,28257,97557,476900,2010
36089,36.9,111778,103937,2922,2219,28089,42303,42019,30144,11875,42019,79600,2010
36091,40,217264,202314,2859,4963,57809,65100,86658,63926,22732,86658,221100,2010
36093,39.7,153268,120230,13728,8033,36696,55188,58583,40565,18018,58583,160200,2010
36095,41.3,32789,30906,393,891,8566,50864,12989,10055,2934,12989,139000,2010
36097,42.5,18566,17850,222,216,5121,47404,7482,5918,1564,7482,86700,2010
36099,40.5,35309,32113,1497,977,8985,46707,13118,10158,2960,13118,88900,2010
36101,41,98724,93554,1563,1346,26701,43867,40558,29580,10978,40558,83000,2010
36103,39.2,1482548,1082249,102867,227467,374930,84506,495289,403093,92196,495289,424200,2010
36105,41.2,77625,58619,6098,9916,19797,48103,29722,20073,9649,29722,186900,2010
36107,42,51377,49387,208,718,14515,51948,20402,16316,4086,20402,98200,2010
36109,29.6,100612,81243,3513,4112,19798,48655,38446,21157,17289,38446,162100,2010
36111,41.2,182782,150751,9905,15065,45201,57584,70691,49203,21488,70691,242100,2010
36113,43.1,65707,62781,573,1173,18338,51619,28533,19557,8976,28533,183000,2010
36115,41.2,63088,58889,1709,1460,16769,48327,24603,18204,6399,24603,137000,2010
36117,40.8,93654,85504,3214,3268,26049,52562,36619,27928,8691,36619,107400,2010
36119,39.7,939406,553405,125664,192932,237402,79619,345795,216753,129042,345795,556900,2010
36121,40.1,42367,37708,2601,1242,10676,50075,15453,11789,3664,15453,97300,2010
36123,39.9,25250,24332,223,389,6672,46822,9544,7465,2079,9544,114200,2010
37001,38,147072,100158,26481,15356,39987,44167,59000,40155,18845,59000,137100,2010
37003,40.3,36797,32405,1862,1499,8929,40014,13419,10728,2691,13419,119400,2010
37005,45.4,11084,9889,69,1021,3080,30845,4971,3678,1293,4971,133100,2010
37007,40,26785,12379,13239,364,6567,34745,9535,6772,2763,9535,78400,2010
37009,44.6,26787,25451,30,1179,7902,34538,11848,9379,2469,11848,145700,2010
37011,41.7,17951,15196,584,710,4625,34918,7194,5235,1959,7194,155100,2010
37013,43.5,47185,31367,12244,2893,14131,40653,20059,14728,5331,20059,107000,2010
37015,43.3,20890,7348,12926,279,5483,29110,8160,6277,1883,8160,77400,2010
37017,39.9,34629,19052,11994,2238,9003,30471,13974,9647,4327,13974,77300,2010
37019,46.6,101994,82766,11404,4988,31003,45806,45409,35183,10226,45409,190500,2010
37021,40.6,233249,198392,15158,12768,60886,44190,99309,67126,32183,99309,188300,2010
37023,40.3,90557,75394,6024,4432,24168,37139,34888,25859,9029,34888,108800,2010
37025,36.3,169990,124012,24570,15066,45065,53928,63680,46708,16972,63680,164100,2010
37027,40.5,82162,72996,3797,3573,21667,37261,31296,23645,7651,31296,106900,2010
37029,40.2,9719,7818,1485,86,2541,61091,3442,2930,512,3442,221900,2010
37031,45.1,65068,57068,3799,2102,18524,46155,28632,21043,7589,28632,207500,2010
37033,42.8,23848,14605,8072,743,6345,36927,8788,6605,2183,8788,97500,2010
37035,38.9,153149,120480,12392,12436,40086,43484,59251,42547,16704,59251,130300,2010
37037,42.7,61426,43845,8314,7623,17465,56038,24877,19687,5190,24877,193900,2010
37039,47.4,27317,25276,174,681,8325,38144,11497,9569,1928,11497,146100,2010
37041,42.3,14859,9084,5035,419,3842,36761,5904,4039,1865,5904,137000,2010
37043,49.1,10418,9964,230,134,2958,35109,4510,3756,754,4510,163000,2010
37045,39.8,97786,72962,20298,2619,26735,38208,37679,25976,11703,37679,103300,2010
37047,39.6,56856,34685,17342,2398,15068,35421,21779,15671,6108,21779,89000,2010
37049,36.8,100001,67491,22250,5739,27918,44599,40202,25524,14678,40202,151500,2010
37051,30.9,312994,150984,109309,27908,80379,43834,117311,68516,48795,117311,116900,2010
37053,40.6,23299,20690,1412,677,6747,55376,9396,7729,1667,9396,240000,2010
37055,43,33650,30119,1221,1887,9843,53889,15465,11032,4433,15465,342100,2010
37057,39.5,160638,132320,14391,9636,45158,44249,64484,47230,17254,64484,128200,2010
37059,41.7,40581,34896,2579,2353,11890,49727,15832,13223,2609,15832,160900,2010
37061,37,56657,30053,14574,11162,13809,32816,20969,14802,6167,20969,83800,2010
37063,33.2,258578,111509,95922,32306,62250,49894,105201,58488,46713,105201,176100,2010
37065,39.3,56247,21388,32164,2014,14499,32665,21601,13580,8021,21601,82600,2010
37067,37.2,342989,205644,88328,37449,87701,46749,136612,90028,46584,136612,149000,2010
37069,39,58473,37260,15567,4330,16242,43710,22765,17707,5058,22765,121700,2010
37071,38.3,202642,155619,29790,11339,54016,43253,77363,53736,23627,77363,120800,2010
37073,42.2,12039,7549,4135,161,3350,45682,4406,3595,811,4406,120200,2010
37075,42.1,8702,7828,14,165,2494,28447,3784,2948,836,3784,119000,2010
37077,38.9,58071,33535,19152,4085,14093,48210,19820,15033,4787,19820,125200,2010
37079,37.8,21157,10132,7905,2707,5252,41488,7021,4934,2087,7021,85100,2010
37081,36.2,475786,265017,151245,31414,119383,45676,189561,119154,70407,189561,153800,2010
37083,41.1,55293,22013,28208,1121,14307,30439,21590,13827,7763,21590,85800,2010
37085,33.7,109031,71042,22618,10841,27922,42853,39111,26344,12767,39111,123500,2010
37087,45.1,58597,55227,526,1832,18125,41377,26445,19879,6566,26445,158200,2010
37089,44.9,103881,88438,3351,9590,30337,46446,45109,34640,10469,45109,184200,2010
37091,40.3,24384,8385,14365,635,5913,30878,9007,5940,3067,9007,83000,2010
37093,30.9,44128,18030,14764,5203,10557,42927,14232,10300,3932,14232,116900,2010
37095,40.6,5721,3256,2086,358,1315,38265,1921,1587,334,1921,95600,2010
37097,38.4,154632,121502,18392,9718,41363,48962,58006,43345,14661,58006,164300,2010
37099,36.6,39144,32198,652,1774,9780,37190,15866,10518,5348,15866,163200,2010
37101,36,160675,113472,24381,19316,43426,49745,59093,43253,15840,59093,136200,2010
37103,42.8,10060,6160,3255,359,2771,38354,4086,2946,1140,4086,91500,2010
37105,37.6,55576,33509,11072,9613,14771,44120,20986,14764,6222,20986,127800,2010
37107,40.6,59307,30814,23887,3595,15955,33625,24142,15039,9103,24142,91900,2010
37109,40.4,75697,64886,4120,5264,21824,47450,29407,22418,6989,29407,146700,2010
37111,41,44593,39745,1563,2210,11512,34953,17560,12741,4819,17560,99200,2010
37113,47.5,33453,30598,362,1888,10535,38615,15780,12125,3655,15780,167800,2010
37115,43.2,20549,19577,298,404,5646,38580,8002,6146,1856,8002,154600,2010
37117,43.1,24471,12676,10545,729,6883,34766,9954,6968,2986,9954,79400,2010
37119,33.8,882761,461127,262191,99716,218847,55294,350392,219296,131096,350392,185100,2010
37121,44.9,15680,14833,81,532,4601,32743,6812,5106,1706,6812,105000,2010
37123,39.5,27611,17792,5283,3799,6495,33861,9853,7364,2489,9853,83100,2010
37125,44.7,85914,66933,12018,4924,23167,48319,34030,25958,8072,34030,186900,2010
37127,39.2,94402,52073,34574,5521,25403,44499,37762,24067,13695,37762,116300,2010
37129,37.2,197272,152100,29536,9348,48870,48553,83679,51420,32259,83679,227800,2010
37131,44.5,22161,8624,12887,281,5179,30578,8377,6270,2107,8377,74600,2010
37133,25.5,169207,116779,26972,16235,41731,43561,56633,32073,24560,56633,137400,2010
37135,33.3,129562,93059,15619,9640,30200,52981,50085,30344,19741,50085,258800,2010
37137,47.6,13072,9773,2628,345,3936,40561,5463,4460,1003,5463,133800,2010
37139,36,40167,22386,15128,1537,10281,44085,14563,9671,4892,14563,170700,2010
37141,41.2,50256,36973,9513,2884,14391,44338,20209,16297,3912,20209,147200,2010
37143,46.3,13091,9354,3508,222,4083,43041,5353,4134,1219,5353,159100,2010
37145,40.9,38942,26054,10688,1504,10757,44668,15388,11370,4018,15388,115900,2010
37147,30.9,161385,93549,54453,8217,37234,38592,64005,35404,28601,64005,125900,2010
37149,48.9,20289,18043,996,985,5929,43692,9038,7037,2001,9038,167500,2010
37151,39.1,140034,114868,7712,13791,38888,40346,54925,40399,14526,54925,119100,2010
37153,38.3,46477,27692,14118,2539,11472,30439,17228,12180,5048,17228,71300,2010
37155,34.1,131708,36130,31776,10142,31073,29667,44504,29919,14585,44504,69200,2010
37157,41.7,93322,68994,17635,4771,26424,39231,37831,27294,10537,37831,101000,2010
37159,38.7,136880,101320,21684,9736,37116,43596,52877,37749,15128,52877,125100,2010
37161,41.8,66928,56505,6535,2195,18443,35364,27458,19723,7735,27458,101100,2010
37163,37.7,62832,33704,17141,9731,16559,35740,23781,16288,7493,23781,87500,2010
37165,37,36325,17005,14135,801,9112,29368,13236,8566,4670,13236,77700,2010
37167,39.9,60109,49454,6553,2065,15505,44802,22134,17031,5103,22134,125600,2010
37169,41.4,47194,43352,1986,1261,14018,42689,18759,15345,3414,18759,117800,2010
37171,41.2,73287,62753,2560,6670,20106,37294,29668,22037,7631,29668,103700,2010
37173,40.6,13861,9147,125,497,3877,35071,5772,4474,1298,5772,114600,2010
37175,48.4,32404,29480,1149,889,9017,39408,13847,10608,3239,13847,169600,2010
37177,43.6,4374,2510,1553,194,1276,32215,1663,1272,391,1663,112000,2010
37179,35.6,190346,143609,21993,18819,52641,63386,65635,53840,11795,65635,194900,2010
37181,37.5,44975,19105,22278,2850,11227,34025,16473,10742,5731,16473,98100,2010
37183,34.1,850546,538820,172818,77347,213822,63770,325486,215485,110001,325486,222300,2010
37185,45.3,20810,7848,11027,670,5316,30641,7835,5898,1937,7835,94700,2010
37187,43.1,13248,6023,6931,93,3275,32716,4911,3457,1454,4911,91900,2010
37189,28,49705,46308,511,1509,11224,31967,21153,11440,9713,21153,215800,2010
37191,36.5,120102,67556,37859,10900,32101,41224,46280,29737,16543,46280,104800,2010
37193,41.3,69063,61663,2912,3589,19534,33438,27814,20658,7156,27814,109100,2010
37195,38.5,79533,39843,30881,7060,21395,38596,31677,19572,12105,31677,111100,2010
37197,41.1,38158,32959,1357,3479,10358,39807,14908,11660,3248,14908,109000,2010
37199,44.2,17911,16810,108,731,5458,35703,7491,5862,1629,7491,129700,2010
38001,49.5,2348,2235,0,19,646,35966,1015,688,327,1015,81300,2010
38003,44.5,11056,10639,9,131,2861,41773,4830,3290,1540,4830,80600,2010
38005,32.2,6662,2975,16,96,1644,30479,2307,1432,875,2307,47800,2010
38007,45.8,897,868,0,0,236,51923,354,294,60,354,79500,2010
38009,47.7,6430,6055,13,49,1876,40227,3010,2346,664,3010,68300,2010
38011,47.1,3102,2997,0,76,891,48063,1318,1057,261,1318,85100,2010
38013,50.4,1948,1892,18,19,600,50800,982,814,168,982,45600,2010
38015,37.5,78776,72966,374,1030,21184,53465,33001,23194,9807,33001,152900,2010
38017,31.4,144410,131854,2966,2853,34580,47600,62916,33712,29204,62916,147900,2010
38019,50.4,4046,3982,9,0,1289,48786,1760,1476,284,1760,58800,2010
38021,42.3,5340,5085,58,119,1276,37179,2167,1579,588,2167,61600,2010
38023,51,2050,1993,0,32,630,48152,1012,820,192,1012,56000,2010
38025,44.2,3477,2957,4,76,892,48707,1318,1119,199,1318,73000,2010
38027,46.8,2455,2355,3,28,646,38404,1036,845,191,1036,48900,2010
38029,49.8,3617,3594,9,2,1031,35615,1608,1352,256,1608,59600,2010
38031,45.8,3434,3325,0,97,992,41066,1506,1142,364,1506,76500,2010
38033,45.2,1539,1488,0,15,406,33333,730,582,148,730,56400,2010
38035,29.2,66771,59650,1239,1963,14689,44242,26514,14426,12088,26514,139100,2010
38037,50.8,2486,2391,2,0,731,39500,1152,942,210,1152,59200,2010
38039,52,2426,2390,0,0,672,40085,1099,868,231,1099,61200,2010
38041,49,2506,2477,15,14,788,38393,1177,969,208,1177,58400,2010
38043,47.5,2521,2374,0,127,800,34250,1188,843,345,1188,59400,2010
38045,48.7,4233,4159,11,17,1247,46098,1962,1640,322,1962,63400,2010
38047,50.8,2001,1986,0,15,554,41741,815,675,140,815,55500,2010
38049,45.5,5400,5245,0,89,1508,36944,2540,1954,586,2540,66300,2010
38051,52.3,2917,2821,17,45,847,34904,1337,1113,224,1337,49800,2010
38053,38.9,6004,4503,14,129,1689,48480,2468,1687,781,2468,86600,2010
38055,49.4,8861,8060,15,113,2639,52922,3937,3123,814,3937,94100,2010
38057,45.7,8353,7959,43,28,2549,60191,3644,2870,774,3644,96100,2010
38059,40.5,26712,25000,41,375,7266,50591,10724,8494,2230,10724,110800,2010
38061,38.1,7228,4662,35,219,2043,53912,2851,2065,786,2851,66900,2010
38063,50.2,3185,3093,0,58,824,39071,1448,1196,252,1448,51100,2010
38065,45.8,1808,1764,0,10,551,62308,762,654,108,762,92100,2010
38067,46.2,7530,7080,8,204,2240,48502,3289,2618,671,3289,71800,2010
38069,47,4364,3986,3,101,1137,37091,1847,1304,543,1847,77100,2010
38071,42.4,11371,9976,109,116,3018,41792,4762,3117,1645,4762,85300,2010
38073,43,5624,5469,12,83,1589,46044,2345,1752,593,2345,87200,2010
38075,45.8,2442,2376,0,2,773,49583,1097,832,265,1097,64900,2010
38077,39.3,16507,15596,69,259,4153,47131,6517,4800,1717,6517,93400,2010
38079,30.6,13766,2947,16,140,3232,28265,4653,3444,1209,4653,56700,2010
38081,45.1,3971,3857,14,15,1125,49318,1770,1375,395,1770,74600,2010
38083,52.9,1293,1251,8,0,487,37727,638,549,89,638,48700,2010
38085,27,4121,541,0,35,793,30990,1060,530,530,1060,71800,2010
38087,45.4,727,718,0,9,236,43625,327,260,67,327,52900,2010
38089,39.7,23486,22243,160,397,6028,49536,9643,7014,2629,9643,115300,2010
38091,45.4,1977,1937,0,37,578,44191,825,666,159,825,63100,2010
38093,42.1,20984,19948,76,321,5302,44620,8633,5933,2700,8633,91500,2010
38095,48.2,2289,2196,4,9,637,43684,1056,834,222,1056,48800,2010
38097,42.3,8190,7810,31,206,2207,44290,3425,2570,855,3425,89000,2010
38099,45,11286,10085,18,890,2902,44139,4756,3531,1225,4756,64300,2010
38101,33.3,59461,52967,1323,1811,15818,48793,24260,15617,8643,24260,118200,2010
38103,50.8,4276,4131,0,10,1276,40136,2059,1566,493,2059,55700,2010
38105,40.4,21194,19169,16,389,5869,55396,9192,6544,2648,9192,93800,2010
39001,39,28578,27780,46,238,7598,32791,10754,7826,2928,10754,97600,2010
39003,38.1,106586,88200,12573,2411,27769,43632,40719,28986,11733,40719,104800,2010
39005,39.1,53341,51595,310,553,14293,44542,20040,15790,4250,20040,128500,2010
39007,40.6,101867,92715,3415,3340,26473,42139,38911,28311,10600,38911,118500,2010
39009,25.9,64455,58779,1743,1053,12241,31559,22283,13065,9218,22283,114100,2010
39011,39.1,46023,44733,104,531,13166,52018,18209,14184,4025,18209,125000,2010
39013,43.1,70403,65975,2523,499,19685,38320,29004,21585,7419,29004,85200,2010
39015,39.1,44618,43351,380,307,11758,45887,15997,12747,3250,15997,124100,2010
39017,35.7,363465,309922,25392,12852,93516,54788,134287,95230,39057,134287,160600,2010
39019,42.2,28988,28273,142,204,8071,43148,11488,9383,2105,11488,110300,2010
39021,38.8,40140,37903,751,522,10887,49246,15161,11413,3748,15161,124900,2010
39023,40.2,139374,119548,12255,3495,36684,44141,55145,38735,16410,55145,109900,2010
39025,37.8,195312,185634,2419,2822,53547,58472,72927,56238,16689,72927,162000,2010
39027,37.7,42416,39789,824,650,11763,46261,16323,11459,4864,16323,125600,2010
39029,41.6,108609,103139,2178,1429,29413,39502,42162,31485,10677,42162,97400,2010
39031,40.6,37046,35785,364,301,9848,39469,14582,10872,3710,14582,94800,2010
39033,41.3,44294,42789,319,535,12264,41228,18105,13202,4903,18105,93800,2010
39035,39.7,1293825,804397,377549,58173,319049,43603,538944,336055,202889,538944,137200,2010
39037,40,52945,51422,185,674,14530,44280,20769,16162,4607,20769,114600,2010
39039,38.6,39119,34498,583,3304,10999,44480,15232,11977,3255,15232,108400,2010
39041,36.5,166108,147554,5684,3476,47302,87908,61203,50935,10268,61203,252700,2010
39043,42.5,77454,66113,6412,2465,21379,46593,31855,23206,8649,31855,138100,2010
39045,37.4,143949,129130,8194,2434,39807,56796,53911,40877,13034,53911,167200,2010
39047,38.8,28913,27203,587,536,7688,39599,11597,7493,4104,11597,112200,2010
39049,33.4,1141117,780037,237202,49675,270541,49087,457799,262478,195321,457799,155300,2010
39051,38.9,42756,38855,130,3139,12114,50717,16345,13230,3115,16345,134000,2010
39053,39.4,30943,29193,822,324,8411,37409,12246,8934,3312,12246,98100,2010
39055,42.1,93604,90128,1012,1022,25905,65663,34285,29823,4462,34285,230900,2010
39057,36.6,159940,137129,10713,3427,42058,56679,61962,42433,19529,61962,160000,2010
39059,40,40351,38484,421,411,10978,37573,16217,11657,4560,16217,90800,2010
39061,36.9,802194,548406,202354,18473,196262,48234,327864,200681,127183,327864,148200,2010
39063,37.7,74670,67952,1218,3200,20410,49070,30632,21767,8865,30632,130400,2010
39065,34.4,32104,30892,184,407,7804,41343,11768,8191,3577,11768,102700,2010
39067,43.5,15867,15218,375,100,4219,35363,6377,4956,1421,6377,81800,2010
39069,38.8,28546,26225,134,1787,7734,48367,11111,8818,2293,11111,119800,2010
39071,38.3,43648,41926,531,79,11795,39844,16638,12272,4366,16638,106200,2010
39073,40,29338,28505,178,183,8094,39586,11486,8668,2818,11486,114000,2010
39075,29.3,42068,41357,85,302,9630,43533,12120,9551,2569,12120,154600,2010
39077,37.3,59932,55140,325,3211,16596,47058,22972,17143,5829,22972,121500,2010
39079,39,33165,32106,185,301,9000,34044,13105,8992,4113,13105,88600,2010
39081,43.8,70041,63980,3563,810,19014,37527,29130,21225,7905,29130,84800,2010
39083,38,60201,57967,373,743,15586,45655,22582,16949,5633,22582,134700,2010
39085,41.9,229418,209899,6749,7200,62168,54896,94211,72582,21629,94211,158100,2010
39087,39.9,62647,59805,1507,519,16879,36461,24631,18085,6546,24631,92300,2010
39089,38.6,163708,152133,5009,2203,44683,53291,62569,46529,16040,62569,152600,2010
39091,38.9,46006,43617,542,575,12774,46493,18398,13422,4976,18398,124500,2010
39093,39.5,299605,241735,24279,24094,80230,52066,114479,84955,29524,114479,147400,2010
39095,36.6,444046,319078,82545,25733,110758,42072,179000,116420,62580,179000,122400,2010
39097,38.7,42844,38637,2747,622,10319,50533,14745,10508,4237,14745,146800,2010
39099,42.4,241899,188736,37613,10389,63773,40123,99024,71548,27476,99024,98400,2010
39101,39.3,66530,59917,2796,1415,17026,40511,24863,17755,7108,24863,98500,2010
39103,39.8,170137,161632,2290,2597,48222,66193,64202,52505,11697,64202,184900,2010
39105,41.2,23649,23005,258,134,6354,33407,9675,7763,1912,9675,80700,2010
39107,38.5,40958,39732,134,567,11385,49719,15606,12679,2927,15606,125600,2010
39109,40.1,102315,96024,2452,1325,28364,51507,41087,29306,11781,41087,137700,2010
39111,44.4,14751,14460,50,29,4209,37030,6174,4930,1244,6174,86900,2010
39113,38.7,538461,393762,112165,11397,138332,43965,223660,144289,79371,223660,119100,2010
39115,42,15113,14102,492,93,4407,34962,6187,4889,1298,6187,86000,2010
39117,39.1,34815,32726,132,354,9771,49891,13037,10700,2337,13037,131300,2010
39119,39.2,85951,79820,2798,717,23069,39538,34121,23915,10206,34121,111100,2010
39121,46.2,14634,13265,1089,133,3480,39500,4904,3835,1069,4904,88600,2010
39123,45.3,41553,38969,454,1725,12423,53463,17933,14726,3207,17933,142200,2010
39125,40.1,19679,18434,130,738,5596,46459,7661,6246,1415,7661,89600,2010
39127,37.7,35843,35053,66,191,9711,42388,13554,10013,3541,13554,100400,2010
39129,37.8,55128,51551,1904,616,14034,49262,19045,14201,4844,19045,144800,2010
39131,38.3,28674,27620,276,219,7758,35912,10643,7530,3113,10643,96400,2010
39133,36.9,159943,146693,6187,2025,41040,50447,61819,42719,19100,61819,157100,2010
39135,40.3,42502,41433,117,280,11902,49780,16392,12893,3499,16392,123500,2010
39137,38,34647,32479,45,1757,9723,56573,12891,10804,2087,12891,130200,2010
39139,40.1,125980,109312,11437,1737,32844,42664,48557,34588,13969,48557,112200,2010
39141,39,77537,69943,3812,783,19366,42626,28107,20609,7498,28107,111800,2010
39143,40.3,61284,53215,1691,5158,16746,48056,24109,18243,5866,24109,116300,2010
39145,38.6,78988,74216,2056,880,20287,32812,30162,20973,9189,30162,85000,2010
39147,38.9,57091,52327,1318,2428,15187,42573,22138,16624,5514,22138,101100,2010
39149,37.4,49350,46402,994,684,13440,48475,18488,13918,4570,18488,124500,2010
39151,40.6,376346,331655,27422,5630,100974,44941,150921,107165,43756,150921,128000,2010
39153,39.5,543150,435494,77451,8188,142556,47926,223122,155046,68076,223122,141200,2010
39155,42,212780,188157,17484,2710,56165,42296,86463,64534,21929,86463,102500,2010
39157,40.5,92508,88931,916,1601,24774,42081,36128,26998,9130,36128,110900,2010
39159,36.1,50708,47002,983,677,13215,68452,17826,13824,4002,17826,174800,2010
39161,39.3,29029,27698,213,637,7984,44415,11472,9494,1978,11472,88100,2010
39163,38.9,13485,13168,0,30,3855,34242,5349,4082,1267,5349,87300,2010
39165,37,207790,186623,6363,4404,56780,71274,74144,59240,14904,74144,194700,2010
39167,42,62066,59710,474,564,17023,41654,25373,18945,6428,25373,110800,2010
39169,37.8,114438,108711,1609,1706,30246,48375,42395,32072,10323,42395,136800,2010
39171,39.7,38172,35927,303,1325,10477,44538,14953,11462,3491,14953,101900,2010
39173,34.6,125295,113636,2660,5396,31024,53298,48636,33645,14991,48636,154600,2010
39175,40.6,22665,21840,30,436,6286,47216,9169,6859,2310,9169,107500,2010
40001,35.6,22424,9676,18,1143,5900,29811,7919,5687,2232,7919,74100,2010
40003,45.7,5621,4948,189,200,1412,42500,2032,1637,395,2032,50100,2010
40005,39.2,14140,10388,1161,415,3388,31179,5272,4031,1241,5272,68300,2010
40007,42.2,5564,4393,6,955,1658,49743,2213,1611,602,2213,66800,2010
40009,34.9,21817,17399,539,2377,4992,43642,7778,5065,2713,7778,86100,2010
40011,38.9,11972,7681,682,1719,2767,41421,4079,3010,1069,4079,67900,2010
40013,36.7,41195,30754,655,1985,10492,37230,16060,10678,5382,16060,85700,2010
40015,38,28951,17537,732,2719,7434,36413,10410,7458,2952,10410,64100,2010
40017,35.7,109814,88649,2614,6957,30429,60489,40119,31232,8887,40119,131600,2010
40019,38.7,46993,34506,3242,2360,11996,38385,17648,12498,5150,17648,88500,2010
40021,34.1,46182,23532,692,2866,11003,32322,16655,11069,5586,16655,97100,2010
40023,40.5,15190,9810,1497,443,4035,27549,6145,4186,1959,6145,68300,2010
40025,45.1,2503,1997,6,470,766,34096,1117,857,260,1117,56400,2010
40027,32.5,246831,189255,9601,16082,61824,52688,93179,63718,29461,93179,131800,2010
40029,40.7,5801,4247,12,145,1483,31764,2327,1649,678,2327,63100,2010
40031,31.6,119902,71156,20477,12755,30269,44012,43757,25720,18037,43757,99900,2010
40033,38.9,6230,5001,115,317,1690,44144,2442,1782,660,2442,72100,2010
40035,40.9,14951,9872,476,415,4032,39836,5682,4479,1203,5682,87000,2010
40037,39.6,68914,54378,1422,2104,18797,42314,26633,19937,6696,26633,100600,2010
40039,31,26824,19824,827,3519,6744,42108,10391,6750,3641,10391,90000,2010
40041,44.1,41017,27152,142,1244,11574,34383,16070,12309,3761,16070,92400,2010
40043,43.6,4720,4103,31,194,1263,39940,1802,1478,324,1802,73200,2010
40045,45.1,4041,3685,0,223,1180,43032,1688,1372,316,1688,66800,2010
40047,37.6,59093,48395,1454,4714,15461,40636,23694,15987,7707,23694,82100,2010
40049,39.6,27462,21915,763,1611,7407,37785,10092,7585,2507,10092,74400,2010
40051,37.5,51545,43240,1101,2371,14570,45260,19391,15014,4377,19391,104100,2010
40053,44.9,4579,4222,0,146,1333,42043,1885,1460,425,1885,60900,2010
40055,39.3,6182,4479,506,557,1354,35096,2094,1456,638,2094,57800,2010
40057,42.6,2875,1832,238,689,805,31679,1128,830,298,1128,44400,2010
40059,43.4,3607,2985,0,530,1101,39946,1537,1220,317,1537,65700,2010
40061,39.9,12577,9349,117,373,3100,37474,4640,3559,1081,4640,72200,2010
40063,40.1,13606,9226,661,499,3706,32677,5159,4017,1142,5159,65700,2010
40065,34.3,26386,17627,1786,5301,7216,41437,10384,6444,3940,10384,85100,2010
40067,41.8,6435,5253,48,479,1725,32750,2488,1939,549,2488,56100,2010
40069,38.8,10816,7846,334,419,2929,34556,4261,3154,1107,4261,64900,2010
40071,39.5,46473,36421,902,2905,12296,39505,18397,13115,5282,18397,74700,2010
40073,38.2,14776,12028,185,1780,3926,49104,5439,4220,1219,5439,101800,2010
40075,42.8,9540,7425,369,831,2458,32565,3846,2554,1292,3846,50100,2010
40077,39.1,11015,7680,15,265,2925,42639,4130,3040,1090,4130,65700,2010
40079,38.1,49822,36841,1053,3247,13374,36335,18651,13682,4969,18651,72700,2010
40081,39.4,33823,28591,703,878,9391,42282,12799,10149,2650,12799,87700,2010
40083,37.5,39777,31540,3579,1934,10570,48683,14468,11236,3232,14468,116400,2010
40085,42,9306,7208,173,999,2696,41629,3595,2731,864,3595,77200,2010
40087,38.5,33107,27148,25,2212,9151,53708,11819,9653,2166,11819,118200,2010
40089,38.2,33130,22016,2946,1536,8975,31082,13255,8931,4324,13255,71500,2010
40091,46.1,20012,13913,675,436,5039,30620,7670,6006,1664,7670,74400,2010
40093,43.9,7487,6642,0,477,2236,46748,3138,2543,595,3138,77600,2010
40095,42,15465,10962,58,2051,4003,40419,5718,4377,1341,5718,80800,2010
40097,39.5,40807,27570,164,1123,11362,41228,16073,12044,4029,16073,89200,2010
40099,40,13193,10135,198,607,3626,40870,5232,4174,1058,5232,77700,2010
40101,37.5,70383,41593,7942,3421,17751,37002,26927,18538,8389,26927,84100,2010
40103,39.8,11509,9613,243,305,2965,39515,4493,3349,1144,4493,74800,2010
40105,40.5,10674,7302,248,253,3191,37500,4224,3345,879,4224,76800,2010
40107,40.3,12036,7745,1003,352,3042,33286,4321,3089,1232,4321,70400,2010
40109,34.4,704023,427087,104158,97871,173643,42916,279434,172276,107158,279434,117500,2010
40111,38.3,39664,25951,3475,1316,10712,37820,15342,11026,4316,15342,78000,2010
40113,40.4,47192,30649,5231,1403,13093,41125,18055,14393,3662,18055,96100,2010
40115,38.5,32193,22048,342,1511,8496,35483,12164,9121,3043,12164,78700,2010
40117,42,16564,13276,74,347,4285,40059,6119,4661,1458,6119,78100,2010
40119,27,75687,60790,2554,2812,16055,34752,28735,15489,13246,28735,116000,2010
40121,41.6,45417,33068,1527,1739,12239,39245,18623,13305,5318,18623,83000,2010
40123,35.7,36644,25686,904,1475,9629,37484,14782,9653,5129,14782,92500,2010
40125,37.2,68751,51612,2062,2801,18004,40085,25069,18376,6693,25069,89300,2010
40127,43.7,11500,8562,46,257,3106,26742,4755,3529,1226,4755,69400,2010
40129,43.5,3530,3098,28,148,1060,48917,1376,1068,308,1376,78900,2010
40131,37.9,85044,63527,657,3035,23967,57443,31318,24706,6612,31318,139200,2010
40133,39.1,25224,17034,1115,907,6082,32985,9220,6672,2548,9220,66000,2010
40135,38.4,41855,27442,829,1451,11088,36357,15328,11090,4238,15328,80100,2010
40137,41,44454,36996,840,2616,12289,43524,17781,13342,4439,17781,80900,2010
40139,31.5,19826,11018,286,7789,5035,44623,7083,4854,2229,7083,83600,2010
40141,40.8,8154,5355,585,1691,2099,29832,3039,2193,846,3039,51100,2010
40143,35.3,589757,392397,61575,59649,150577,45613,238715,148259,90456,238715,126200,2010
40145,37.6,70232,52375,2366,3176,20215,55487,25576,21254,4322,25576,133800,2010
40147,41.2,50339,38516,1178,2378,13935,44823,21196,15742,5454,21196,99700,2010
40149,39.5,11571,10087,114,761,3090,43039,4476,3349,1127,4476,72800,2010
40151,38.1,8656,7572,286,344,2317,48076,3549,2426,1123,3549,80700,2010
40153,37.1,19967,16833,221,1782,5414,49672,7604,5521,2083,7604,95600,2010
41001,47.3,16150,15054,41,510,4577,39704,6902,4913,1989,6902,142400,2010
41003,32,84158,70850,853,5181,19022,48012,33471,19159,14312,33471,263200,2010
41005,39.8,370479,315863,2819,27104,99085,62007,143357,101324,42033,143357,331100,2010
41007,42.7,36858,32357,233,2682,10086,42223,16267,10079,6188,16267,253100,2010
41009,40.8,49006,44415,142,1974,13371,55199,19075,14650,4425,19075,219800,2010
41011,46.5,63319,55479,158,3328,16777,37491,27247,18256,8991,27247,194800,2010
41013,43.6,21515,19242,35,1484,6408,46059,8754,6308,2446,8754,228700,2010
41015,52.3,22411,19964,34,1208,6591,37469,10473,7420,3053,10473,266800,2010
41017,39.7,154568,137508,472,10864,43434,53071,63190,42982,20208,63190,314400,2010
41019,45.3,107209,96431,369,4855,29724,39711,43916,30988,12928,43916,185100,2010
41021,49.9,1731,1479,4,179,482,42148,851,567,284,851,99900,2010
41023,48.7,7349,6883,17,182,2255,35974,3349,2433,916,3349,128500,2010
41025,45.1,7364,6630,39,264,2176,39036,3350,2141,1209,3350,124300,2010
41027,37.3,21706,14547,41,6164,5664,51307,7985,5453,2532,7985,308000,2010
41029,41.7,200587,169582,1086,20143,53903,44142,83333,52782,30551,83333,274500,2010
41031,39.1,21652,13408,118,4222,5665,41425,7795,5473,2322,7795,184900,2010
41033,46.4,82172,73139,268,5023,22391,38035,34325,23564,10761,34325,253600,2010
41035,41.4,66520,54376,180,6676,18523,41818,27663,19013,8650,27663,170100,2010
41037,46.6,7882,6931,47,481,2329,41105,3462,2367,1095,3462,122200,2010
41039,38.5,347156,296315,3164,24229,86947,42923,143894,87469,56425,143894,230000,2010
41041,49,45857,39013,149,3457,12514,39738,20652,13873,6779,20652,246300,2010
41043,39,114315,100237,436,8321,30410,45832,44375,30259,14116,44375,180300,2010
41045,36,31326,20173,326,9494,7011,39144,10181,6578,3603,10181,136400,2010
41047,35,309894,216386,2691,71641,77101,46069,112773,69943,42830,112773,205100,2010
41049,36.1,11112,7330,7,3312,2764,43902,3876,2760,1116,3876,115300,2010
41051,35.8,712036,518801,39492,73952,162105,49618,298398,167797,130601,298398,281600,2010
41053,37.2,73745,60044,310,8517,19139,50975,27690,19096,8594,27690,227900,2010
41055,45.3,1819,1695,0,91,518,41354,813,545,268,813,119500,2010
41057,47.4,25200,22075,142,2119,6984,39412,11126,7702,3424,11126,237900,2010
41059,35.6,74804,53121,399,16645,18716,45861,26545,16991,9554,26545,137900,2010
41061,40.1,25373,23173,89,994,6992,42162,10269,6778,3491,10269,151200,2010
41063,50,6919,6556,0,155,1925,41116,3015,2252,763,3015,183800,2010
41065,42.1,24695,19404,25,3462,6434,42133,9801,6616,3185,9801,188400,2010
41067,34.9,516665,367004,7880,77659,130272,62574,196438,123208,73230,196438,303700,2010
41069,54.6,1443,1385,0,11,406,33403,631,491,140,631,99100,2010
41071,36.5,96930,77578,611,13612,24414,52485,34025,23914,10111,34025,237800,2010
42001,40.2,100839,91685,1474,5651,27605,56529,38331,29813,8518,38331,200700,2010
42003,41.1,1223066,992497,157061,17627,306769,47961,522703,350029,172674,522703,115200,2010
42005,43.8,69489,67931,586,397,19818,42752,28814,22021,6793,28814,89100,2010
42007,43.8,171569,155713,10121,1978,47819,46190,70350,52870,17480,70350,112400,2010
42009,42.9,49882,48726,190,429,14119,40249,19913,15874,4039,19913,112800,2010
42011,38.9,407310,318999,16114,61268,106995,53470,153307,112068,41239,153307,170400,2010
42013,41.7,127071,121828,2138,1231,34060,42363,51651,37686,13965,51651,97400,2010
42015,42.6,62415,60460,268,692,16832,40543,24861,18606,6255,24861,101700,2010
42017,41,622859,545579,21888,24480,165261,74828,229552,180092,49460,229552,321500,2010
42019,40.7,182554,175456,1789,1872,49979,56878,71911,55391,16520,71911,159000,2010
42021,43.3,144741,135567,4928,1985,38530,39574,58802,43396,15406,58802,86000,2010
42023,46.9,5197,5086,3,28,1358,40733,2181,1594,587,2181,74200,2010
42025,43.1,64563,60852,907,1972,18063,47744,26111,20940,5171,26111,139800,2010
42027,28.4,151411,133547,4237,3546,31564,47016,54971,33011,21960,54971,175800,2010
42029,38.8,490571,407255,29355,29003,128975,84741,181136,139743,41393,181136,334300,2010
42031,39.2,40290,39110,440,245,10361,40028,15742,11230,4512,15742,97800,2010
42033,42,82131,77803,1758,1735,22065,37130,32823,25177,7646,32823,82900,2010
42035,38.8,38970,37511,516,402,9757,39354,15238,11043,4195,15238,98400,2010
42037,39.2,66642,63167,913,1255,16648,42788,25884,18515,7369,25884,118800,2010
42039,41,89153,85390,1491,853,23607,38924,35456,26230,9226,35456,97900,2010
42041,39.9,231336,208490,6675,5895,60630,60219,93739,67896,25843,93739,174600,2010
42043,39.1,264823,187794,45446,16973,66883,52371,107808,70581,37227,107808,153100,2010
42045,38.5,556468,402764,105020,15032,137911,61876,206542,148298,58244,206542,232300,2010
42047,43.8,32480,31927,92,174,9059,43745,13743,10979,2764,13743,91300,2010
42049,38.4,279234,243363,18597,8751,69875,43595,108252,74895,33357,108252,111300,2010
42051,42.9,138807,129263,5512,1053,37057,34796,55363,40415,14948,55363,82500,2010
42053,42.4,7585,6115,1181,254,1286,35150,1996,1713,283,1996,79700,2010
42055,39.9,146558,133329,4464,5674,39902,51035,58290,43298,14992,58290,175000,2010
42057,40.8,14839,14420,136,121,4123,45240,5848,4527,1321,5848,157500,2010
42059,40.4,39003,36768,1326,445,9729,40498,14010,10549,3461,14010,81800,2010
42061,40.8,45830,42214,2363,660,11373,41700,16876,12960,3916,16876,105800,2010
42063,38.1,88745,84138,2162,920,22533,40225,34375,24697,9678,34375,98200,2010
42065,42.4,45244,44350,121,275,12408,38406,18236,14007,4229,18236,80100,2010
42067,40.2,24385,23424,62,511,6732,44276,9037,6957,2080,9037,127200,2010
42069,41.9,213731,194499,4343,8963,55937,43673,86318,57054,29264,86318,137100,2010
42071,37.7,511250,437422,15935,41186,135716,54765,191474,134348,57126,191474,184400,2010
42073,43.1,91682,85684,3195,934,25107,42570,36587,28592,7995,36587,92600,2010
42075,40.6,131341,115446,2076,10883,35797,52356,51543,38439,13104,51543,155900,2010
42077,39.1,343946,252984,15904,59141,90171,53541,132879,91431,41448,132879,203200,2010
42079,42.4,319120,286730,9101,17297,83462,42224,130855,91484,39371,130855,113300,2010
42081,40.7,116376,107363,4858,1464,31313,42689,46612,32540,14072,46612,119200,2010
42083,40.9,43853,41537,945,740,11520,40097,17324,12881,4443,17324,72300,2010
42085,42.2,117296,107270,6332,1255,31300,42573,46681,35132,11549,46681,101700,2010
42087,41.7,46583,45221,251,521,12678,37539,19051,13988,5063,19051,92500,2010
42089,39.3,168080,121062,19150,20528,44495,56733,59997,48855,11142,59997,206400,2010
42091,40.2,790497,633796,64796,30440,208556,76380,306661,227627,79034,306661,297200,2010
42093,43.7,18152,17129,257,279,5027,45255,7310,5436,1874,7310,143900,2010
42095,40.2,294536,242185,12214,28720,77774,58762,111929,84441,27488,111929,220800,2010
42097,42.8,94099,89228,1779,2020,25915,38387,39234,28404,10830,39234,93500,2010
42099,40.4,45599,44198,303,552,13039,52659,17943,14520,3423,17943,144800,2010
42101,33.7,1504950,560846,647062,175118,311376,36251,574488,317755,256733,574488,135200,2010
42103,41.9,56993,47852,2828,4766,16430,56843,22190,18717,3473,22190,217900,2010
42105,43.9,17583,17129,62,155,5108,39196,7291,5547,1744,7291,89600,2010
42107,42.6,148288,138973,3608,3584,39864,42315,60347,46595,13752,60347,88400,2010
42109,39,39400,37938,362,593,10168,44713,14258,10704,3554,14258,122900,2010
42111,43.7,78219,74985,1668,782,20470,39194,30319,23782,6537,30319,92200,2010
42113,48.7,6467,6134,186,10,1621,36250,2436,2011,425,2436,120600,2010
42115,44.1,43343,42216,132,534,11998,43457,17225,13649,3576,17225,124400,2010
42117,41.8,41631,40360,241,404,11960,40338,17182,12868,4314,17182,105700,2010
42119,38.4,44866,38273,3138,2268,10591,45474,14963,11023,3940,14963,143200,2010
42121,43.8,55320,53508,541,514,15120,39812,22457,16839,5618,22457,76500,2010
42123,44.2,41877,40974,108,293,11679,41286,17630,13803,3827,17630,83900,2010
42125,43,206987,194165,6673,2227,55627,49687,83604,64597,19007,83604,130300,2010
42127,44.8,52302,48363,1363,1712,13551,45930,19678,15802,3876,19678,173600,2010
42129,44.4,365841,347844,7753,3031,102132,47689,152640,116809,35831,152640,126800,2010
42131,41,28262,27352,181,377,7731,47403,11023,8496,2527,11023,140800,2010
42133,39.6,428175,373114,20544,21830,118102,57494,166600,127342,39258,166600,175500,2010
44001,41.9,50501,47765,195,1021,12905,68333,19236,13863,5373,19236,363100,2010
44003,41.9,167235,153963,2430,4996,43845,61088,69109,50970,18139,69109,246600,2010
44005,42.9,83253,73738,3049,3373,21802,67239,34771,22127,12644,34771,388800,2010
44007,36.7,628413,425087,47555,112109,147352,48500,238059,132204,105855,238059,258000,2010
44009,41.1,126987,117534,1419,2933,32668,70285,49130,37381,11749,49130,351100,2010
45001,41.1,25643,17741,7281,268,6679,33143,9875,7642,2233,9875,85900,2010
45003,39.6,156670,107020,38812,7003,43274,44468,62072,45491,16581,62072,119000,2010
45005,37.6,10688,2596,7827,194,2337,20081,3458,2042,1416,3458,67500,2010
45007,39.2,183691,145546,28744,4904,51466,42871,71973,53272,18701,71973,117700,2010
45009,38,16139,5775,10141,115,3747,32538,5658,4124,1534,5658,84300,2010
45011,38.2,22748,11904,10238,433,5545,33816,8429,6141,2288,8429,67400,2010
45013,40.2,155550,103300,30677,17383,44566,55286,63459,44868,18591,63459,290900,2010
45015,34.3,169878,109213,42188,9222,43721,50777,60472,42582,17890,60472,149700,2010
45017,43.9,15212,8042,6578,364,4014,36790,6121,5012,1109,6121,94500,2010
45019,35.7,342434,211734,104039,16678,81898,48433,137844,85019,52825,137844,242100,2010
45021,37.4,54832,40898,10829,1868,13569,34132,20975,14360,6615,20975,82700,2010
45023,39.3,33246,19718,12333,488,8649,32743,12497,9535,2962,12497,87100,2010
45025,38.7,46087,28536,15174,1552,11667,32979,17235,12691,4544,17235,77600,2010
45027,40.9,34621,15930,17423,861,8868,33066,12636,9406,3230,12636,89100,2010
45029,39.5,38833,21638,15535,1043,10293,33263,15228,11036,4192,15228,90000,2010
45031,38.7,68602,37894,28400,1141,17368,38379,25805,19108,6697,25805,81800,2010
45033,37.1,31666,15038,14663,841,7744,26818,11714,7243,4471,11714,61400,2010
45035,35.7,129618,86386,32717,5289,35228,55034,47622,35264,12358,47622,171400,2010
45037,40.1,26680,14858,10289,1228,6595,42834,9121,7052,2069,9121,101600,2010
45039,41.8,24040,9255,14284,36,5764,32022,9121,6866,2255,9121,91500,2010
45041,37.2,134897,74103,54711,2794,36052,40487,51636,34112,17524,51636,108400,2010
45043,44.5,60236,37438,20454,1799,15577,42666,22406,16654,5752,22406,174700,2010
45045,36.9,436437,310850,77281,32305,113005,46830,171233,116410,54823,171233,148100,2010
45047,38.1,68890,42698,21237,3463,17592,38797,26189,18292,7897,26189,105000,2010
45049,37.6,21173,8716,11408,679,4877,34846,7196,5437,1759,7196,79600,2010
45051,40.8,258267,200920,35510,14430,73100,43142,112057,79600,32457,112057,170100,2010
45053,34.9,23634,8658,11188,3247,5019,37393,7695,5587,2108,7695,118700,2010
45055,40.1,60166,41984,15079,2020,17226,44064,23358,18911,4447,23358,110800,2010
45057,38.8,72302,50264,17680,2901,19928,38959,28180,20925,7255,28180,122300,2010
45059,40.2,67026,46551,16830,2500,17660,37529,25583,18165,7418,25583,85800,2010
45061,37.6,19615,6506,12631,317,4287,23378,6631,4748,1883,6631,61400,2010
45063,37.5,252563,196756,35646,12386,69014,52205,100793,75402,25391,100793,136800,2010
45065,48.2,10203,4881,5110,63,2969,35858,4116,3186,930,4116,110800,2010
45067,39.1,33568,13604,18940,783,8670,30629,12234,8130,4104,12234,82500,2010
45069,38.1,29112,11849,15020,474,6644,27688,9768,6469,3299,9768,60300,2010
45071,39,37197,22608,11180,2513,10168,41815,14266,10427,3839,14266,102300,2010
45073,42.6,73035,63061,5795,3040,20692,42266,29910,23000,6910,29910,126700,2010
45075,37.3,92475,31767,57427,1639,22889,32849,34725,23671,11054,34725,81000,2010
45077,34.5,117823,103301,7589,3496,29035,41898,44048,31096,12952,44048,123500,2010
45079,32.7,372597,171305,169145,16733,86609,47922,141564,86553,55011,141564,146300,2010
45081,39.4,19567,11550,5285,2500,4949,40508,6827,5215,1612,6827,96400,2010
45083,37.7,278167,196759,56828,14920,74223,42680,106397,75765,30632,106397,116300,2010
45085,35.3,106601,50662,49802,3330,26744,39137,38856,25967,12889,38856,98800,2010
45087,41.7,29089,19332,8928,283,8461,33470,12106,8858,3248,12106,74300,2010
45089,39.9,34994,10973,23275,390,7519,24191,11079,7229,3850,11079,67200,2010
45091,36.7,214916,157557,40221,8838,58011,51925,81826,58939,22887,81826,158900,2010
46003,40.9,2739,2555,0,155,710,45230,1027,780,247,1027,63100,2010
46005,41.5,16829,14815,332,1018,4316,40716,7205,4696,2509,7205,83400,2010
46007,32,3441,1067,0,66,789,32841,1054,631,423,1054,60200,2010
46009,43.5,7080,6366,92,100,1794,41107,2582,2146,436,2582,67700,2010
46011,26,31250,29036,226,626,6094,45134,11405,6734,4671,11405,138300,2010
46013,38.9,36011,33545,124,499,8999,45615,14942,10337,4605,14942,115700,2010
46015,39.9,5128,4553,3,8,1372,48277,2077,1503,574,2077,87300,2010
46017,23.4,1932,178,8,4,430,27926,503,144,359,503,67500,2010
46019,41.1,9888,9198,82,254,2720,39041,3977,3020,957,3977,114300,2010
46021,47.8,1431,1394,0,0,426,42833,612,519,93,612,40600,2010
46023,39,9075,5938,2,165,2241,35808,3236,2225,1011,3236,67700,2010
46025,45,3702,3601,1,65,933,43894,1387,1131,256,1387,64500,2010
46027,25,13816,12537,106,269,2461,37198,4936,2890,2046,4936,116900,2010
46029,38,27040,25681,98,411,7182,43275,11336,7891,3445,11336,131000,2010
46031,29.6,4053,1300,17,117,806,30877,1114,618,496,1114,45900,2010
46033,49.6,8085,7536,0,132,2323,46743,3654,2863,791,3654,160700,2010
46035,38.4,19397,18287,92,274,4983,41867,8086,5097,2989,8086,108800,2010
46037,47.1,5714,5059,2,60,1541,36818,2504,1732,772,2504,64800,2010
46039,43.1,4373,4250,0,98,1221,47000,1802,1475,327,1802,87200,2010
46041,28.8,5354,1214,36,16,1232,33255,1699,967,732,1699,56900,2010
46043,47.7,3046,2947,0,9,888,42794,1224,944,280,1224,58300,2010
46045,46.9,4047,3892,0,102,1135,47026,1587,1281,306,1587,70300,2010
46047,50.1,7078,6237,51,275,1588,35833,3014,1954,1060,3014,86800,2010
46049,44.5,2386,2364,0,0,589,38203,913,731,182,913,51300,2010
46051,44.5,7382,7145,8,178,2085,42625,3183,2379,804,3183,99800,2010
46053,47.4,4272,3860,0,73,1244,33940,1973,1528,445,1973,56100,2010
46055,50,1886,1759,8,24,552,46281,769,626,143,769,74800,2010
46057,38,5761,5576,32,132,1444,44439,2025,1682,343,2025,83700,2010
46059,48.1,3402,3394,0,6,1054,45895,1483,1078,405,1483,74900,2010
46061,36.5,3382,3369,0,1,835,46556,1156,977,179,1156,87300,2010
46063,46,1250,1203,0,22,386,34792,526,391,135,526,67000,2010
46065,39.4,16827,14431,59,283,4527,53501,7111,4916,2195,7111,133200,2010
46067,46.5,7388,7148,24,110,2036,39310,2961,2338,623,2961,68700,2010
46069,44.9,1520,1379,0,19,375,41196,588,449,139,588,66600,2010
46071,29,2991,1511,0,98,756,36354,964,624,340,964,54600,2010
46073,51.9,2038,1980,0,18,610,40607,903,630,273,903,62200,2010
46075,43.5,1076,1049,0,0,335,49464,471,344,127,471,75000,2010
46077,46.4,5169,5027,0,87,1581,44948,2332,1816,516,2332,70300,2010
46079,38.1,11008,10557,50,159,2894,45606,4533,3217,1316,4533,108800,2010
46081,39.4,23670,22029,0,560,6154,42356,10651,6889,3762,10651,155100,2010
46083,32.8,41289,39397,119,573,11805,67365,15782,12017,3765,15782,169700,2010
46085,34.9,3736,2205,0,0,959,36323,1449,877,572,1449,64900,2010
46087,42.8,5639,5481,3,70,1544,42022,2171,1736,435,2171,91900,2010
46089,49.1,2506,2464,0,21,658,31923,1048,838,210,1048,45100,2010
46091,43.1,4618,3958,4,253,1091,41023,1737,1219,518,1737,81700,2010
46093,35.9,25156,22779,156,774,6700,46180,9714,7052,2662,9714,145800,2010
46095,31.8,2032,965,0,10,513,34055,677,451,226,677,49800,2010
46097,47.8,2411,2376,0,6,709,43958,1089,884,205,1089,58400,2010
46099,34.8,165799,144741,5257,6407,42428,51799,65462,43143,22319,65462,144900,2010
46101,40.3,6511,5294,0,114,1870,52354,2595,2027,568,2595,102800,2010
46103,36.7,97922,80768,1023,3863,26250,46849,39939,26605,13334,39939,149700,2010
46105,47.3,2976,2888,0,9,825,33361,1371,952,419,1371,50800,2010
46107,49.5,2380,2332,0,20,680,42422,1019,836,183,1019,55600,2010
46109,39.5,10033,6251,8,124,2691,37708,3766,2663,1103,3766,73200,2010
46111,44.2,2380,2300,0,64,646,44732,966,740,226,966,62700,2010
46113,22.7,13437,824,0,286,2368,24392,2828,1452,1376,2828,18600,2010
46115,44.3,6518,6179,59,31,1705,45000,2640,2051,589,2640,62700,2010
46117,41,2896,2568,2,17,754,51875,1160,883,277,1160,113700,2010
46119,46.8,1328,1268,0,14,385,48958,587,461,126,587,72200,2010
46121,23.4,9575,943,21,254,1862,25196,2553,1037,1516,2553,53800,2010
46123,44.1,5743,4833,42,16,1817,40221,2542,1870,672,2542,69400,2010
46125,43.3,8368,8123,4,116,2365,48068,3403,2714,689,3403,85600,2010
46127,40.1,13903,13158,114,285,3938,59889,5799,4354,1445,5799,132200,2010
46129,47.5,5408,4491,0,8,1541,39517,2208,1695,513,2208,62500,2010
46135,41,22216,20427,295,579,5538,47124,8688,6095,2593,8688,115500,2010
46137,25.7,2765,653,16,37,596,27578,770,405,365,770,62200,2010
47001,41.8,74257,67521,2995,1656,20408,44650,30939,22202,8737,30939,116400,2010
47003,35.9,44172,34865,3457,4761,11318,38550,16005,10977,5028,16005,114400,2010
47005,45.1,16456,15591,378,254,4627,33953,6980,5806,1174,6980,77900,2010
47007,41.2,12946,12058,459,261,3195,29729,4430,3400,1030,4430,99700,2010
47009,40.8,121140,111784,3485,3092,33774,47322,48151,36642,11509,48151,157200,2010
47011,37.7,97192,86659,4151,4161,26368,40032,37476,25353,12123,37476,133800,2010
47013,40.7,40623,39453,154,453,11130,30686,15791,11366,4425,15791,86400,2010
47015,40.8,13631,13037,104,112,3840,38733,5321,4056,1265,5321,112100,2010
47017,41.1,28644,24645,2890,548,7405,36160,11090,8568,2522,11090,77400,2010
47019,41.4,57710,55239,704,915,16292,31173,23933,17543,6390,23933,92700,2010
47021,38.9,38809,36701,599,897,10659,52585,14198,11483,2715,14198,155900,2010
47023,36.1,16793,14585,1526,296,4520,39915,5987,4445,1542,5987,102500,2010
47025,40.4,31901,30837,274,290,8719,31353,12512,9666,2846,12512,89300,2010
47027,47.1,7888,7691,140,44,2449,32106,3621,2822,799,3621,88600,2010
47029,41.4,35473,33458,638,621,9989,28809,14757,10771,3986,14757,95900,2010
47031,38.9,52344,47378,1392,1929,14561,40078,20869,15080,5789,20869,119200,2010
47033,40.2,14524,11223,2067,1154,3947,36556,5549,3801,1748,5549,84100,2010
47035,47.4,54977,52851,203,1195,15934,36813,23035,18220,4815,23035,133900,2010
47037,34,612884,358845,169391,54859,141879,45668,252477,145521,106956,252477,164700,2010
47039,44,11716,10927,277,280,3183,30445,4985,3892,1093,4985,66500,2010
47041,39.7,18569,16955,294,1068,4983,34863,7165,5180,1985,7165,98000,2010
47043,37.8,48712,44164,1982,1413,13333,44554,18889,13992,4897,18889,128700,2010
47045,39.1,38174,31129,5526,952,10701,36856,15079,9797,5282,15079,91900,2010
47047,40.3,37458,25456,10689,838,10674,56729,13498,11244,2254,13498,170400,2010
47049,41.6,17777,17380,10,164,5155,29642,7331,5649,1682,7331,101000,2010
47051,40.7,41054,36976,1337,1026,10917,40983,15750,12177,3573,15750,110700,2010
47053,40,49015,38003,9368,987,12761,35947,19548,14072,5476,19548,86900,2010
47055,41.9,29558,25356,3197,492,8185,37860,11697,8738,2959,11697,98700,2010
47057,41.3,22419,21598,69,461,6008,30623,8623,7113,1510,8623,89900,2010
47059,41.8,68172,64217,1389,1611,20279,36867,28134,20887,7247,28134,104200,2010
47061,41,13910,11922,73,125,3670,26529,5258,4242,1016,5258,80100,2010
47063,38.7,61857,51922,2371,6104,16936,39807,24451,17438,7013,24451,118900,2010
47065,39.1,328960,238770,66323,12978,86800,45408,133953,87802,46151,133953,147200,2010
47067,42.8,6782,6648,14,20,2010,23125,3008,2152,856,3008,76200,2010
47069,39.3,27655,15461,11328,373,6478,32539,8993,6582,2411,8993,88700,2010
47071,42.5,25995,24137,789,467,7017,30732,10505,8112,2393,10505,86600,2010
47073,41.7,56562,54281,657,693,17064,35392,23669,18013,5656,23669,104900,2010
47075,38,19010,8527,9605,631,5180,32414,7445,4862,2583,7445,87100,2010
47077,39.4,27518,24347,2164,453,7886,38887,10850,8420,2430,10850,90700,2010
47079,43.4,32042,28273,2603,534,9204,36836,13534,10462,3072,13534,85000,2010
47081,39.5,24506,22568,1095,423,6584,42075,9020,7035,1985,9020,102800,2010
47083,41.7,8286,7817,133,140,2336,33738,3392,2495,897,3392,87900,2010
47085,40.7,18416,17440,487,236,5192,41486,7555,5708,1847,7555,104900,2010
47087,43.9,11491,11151,35,110,3125,32722,4648,3547,1101,4648,89200,2010
47089,39.7,50600,47212,1172,1485,13362,38239,19597,14663,4934,19597,122600,2010
47091,42.7,18190,17331,383,243,5091,29949,7376,5635,1741,7376,92800,2010
47093,37.1,423748,358211,37869,13031,108731,46759,177855,119607,58248,177855,152300,2010
47095,38.4,7827,5361,2189,102,1387,24700,2300,1418,882,2300,65400,2010
47097,35.9,27745,17071,9651,493,6391,32894,9365,6228,3137,9365,77100,2010
47099,38.9,41319,39315,684,691,11357,34985,15786,12293,3493,15786,91600,2010
47101,40.4,12003,11422,140,310,3165,35000,4546,3571,975,4546,90400,2010
47103,40.7,32885,29092,2030,820,9399,42962,13452,10252,3200,13452,113600,2010
47105,45.1,47102,42858,354,2918,14094,49343,19441,15149,4292,19441,166400,2010
47107,40.6,52075,47289,2061,1446,14734,37146,20810,15659,5151,20810,105600,2010
47109,41.1,25760,23430,1506,366,7070,34777,10113,7772,2341,10113,84200,2010
47111,37.3,21934,20768,113,766,5889,33087,8204,6187,2017,8204,93500,2010
47113,36.6,97378,57416,34619,3121,24727,40178,37020,24832,12188,37020,112100,2010
47115,41.5,28123,26263,478,347,7952,38785,11305,8706,2599,11305,107400,2010
47117,38.7,29902,25975,2057,1319,8426,40435,11707,8741,2966,11707,107900,2010
47119,37.9,79029,63416,10207,3687,22157,46278,31745,23066,8679,31745,137100,2010
47121,40.9,11581,11143,125,146,3515,33506,4558,3445,1113,4558,107000,2010
47123,40.2,44015,40754,872,1400,12249,36209,17546,13078,4468,17546,107900,2010
47125,30.4,163603,110884,30876,12260,43742,48930,60412,39308,21104,60412,129400,2010
47127,42.8,6266,5888,85,33,1782,44433,2396,1927,469,2396,135500,2010
47129,39.6,21664,20446,576,173,5924,36772,7954,6509,1445,7954,79600,2010
47131,40.5,31905,27217,3278,965,8625,39543,12662,8822,3840,12662,87700,2010
47133,41.3,21777,21215,124,41,6151,34347,8830,7102,1728,8830,87700,2010
47135,42.9,7778,7393,190,71,2273,31776,3293,2515,778,3293,71600,2010
47137,42.3,5072,4839,0,130,1513,30193,2174,1655,519,2174,94900,2010
47139,41.6,16690,16180,16,190,4337,34027,6311,5094,1217,6311,96300,2010
47141,35.7,70570,63785,1381,3580,17837,35185,27560,17662,9898,27560,124000,2010
47143,40,31215,28919,659,1047,8449,36761,11861,8837,3024,11861,102600,2010
47145,44.2,54156,50896,1327,752,15741,42698,22572,17367,5205,22572,118900,2010
47147,37,64347,54788,4737,3601,17881,50820,23793,18439,5354,23793,149100,2010
47149,32,250517,192498,30490,15447,64395,53770,92343,63739,28604,92343,157100,2010
47151,36.7,22171,21752,0,207,5866,28728,8617,6379,2238,8617,76600,2010
47153,39,13814,12409,0,365,3618,33850,5083,3955,1128,5083,105800,2010
47155,40.7,87507,80902,655,3916,27123,41476,37583,25813,11770,37583,155500,2010
47157,34.2,922696,366601,473341,47047,223039,44705,340443,210032,130411,340443,135300,2010
47159,38.8,19035,17916,358,371,4905,43200,6837,5237,1600,6837,117400,2010
47161,42.7,13133,12325,208,227,3845,40214,5383,4359,1024,5383,105900,2010
47163,42.9,155815,147606,2942,2174,44918,39957,66584,50445,16139,66584,110500,2010
47165,38.2,155592,136181,10223,5583,43754,54916,59503,44459,15044,59503,169100,2010
47167,36.7,59689,45800,11249,1218,16263,49378,21235,15755,5480,21235,135100,2010
47169,38.1,7751,6699,557,181,2044,44205,2814,2240,574,2814,109300,2010
47171,44.1,18257,17345,142,633,5049,34387,7600,5460,2140,7600,111900,2010
47173,39.6,19088,18585,0,198,5286,30143,7390,5944,1446,7390,91300,2010
47175,43.2,5503,5237,99,35,1451,29087,2096,1764,332,2096,73800,2010
47177,38.2,39539,34615,1135,3070,10337,34946,14994,10949,4045,14994,90400,2010
47179,38.9,119768,108594,4649,3247,31164,41256,49111,33341,15770,49111,136700,2010
47181,40.5,17016,15551,986,245,4211,34993,5877,5003,874,5877,74500,2010
47183,37.4,34557,30419,2445,666,8917,32358,13781,9114,4667,13781,82100,2010
47185,41.3,25460,24197,394,405,7037,33865,9827,7526,2301,9827,94600,2010
47187,37.9,174260,152133,7416,7338,50013,87832,62508,51795,10713,62508,335800,2010
47189,38.8,109563,96507,7131,3264,31044,60678,41221,33805,7416,41221,187500,2010
48001,38.5,58016,35769,12356,8783,10842,40378,15904,11715,4189,15904,81000,2010
48003,34.6,14048,6901,105,6633,3892,48699,5205,4159,1046,5205,86600,2010
48005,35.7,85254,54720,12698,16012,22467,39148,31100,21521,9579,31100,81300,2010
48007,46.8,23247,16465,247,5618,7026,42179,10056,7473,2583,10056,129900,2010
48009,41.4,9055,8213,63,621,2521,50891,3363,2727,636,3363,93500,2010
48011,43,1958,1739,17,180,572,60530,706,579,127,706,90700,2010
48013,35.6,44049,16275,331,26893,11324,42927,14521,11013,3508,14521,80400,2010
48015,40,27783,18608,2719,6076,7592,53263,10447,8093,2354,10447,146500,2010
48017,30,7027,3505,418,3098,1835,42375,2380,1776,604,2380,65000,2010
48019,47.6,20265,16518,125,3238,6096,44352,8419,6606,1813,8419,147100,2010
48021,37.6,72289,42252,5946,22471,18815,51829,25214,19931,5283,25214,119800,2010
48023,45.9,3795,3204,40,517,1039,33459,1657,1184,473,1657,64700,2010
48025,35.7,31896,10864,2957,17772,6109,40278,8485,5689,2796,8485,73200,2010
48027,29.5,294689,152693,59838,61332,72676,48618,101433,59072,42361,101433,113800,2010
48029,32.7,1650052,513405,113979,958534,394340,47048,580224,362686,217538,580224,117100,2010
48031,45.2,10085,7988,229,1776,2624,46128,3935,3250,685,3935,165600,2010
48033,43.2,564,453,0,111,163,58409,244,153,91,244,75200,2010
48035,44.4,18067,14711,286,2755,4920,45288,6732,5079,1653,6732,88800,2010
48037,37.4,91399,60605,21307,5715,22758,42550,33573,22367,11206,33573,88600,2010
48039,34.9,300522,165462,34129,80577,77353,65607,101656,77062,24594,101656,140300,2010
48041,24.1,185426,111928,19566,41208,37297,37898,66105,31168,34937,66105,141700,2010
48043,40.3,8971,4788,99,3750,2265,35799,4151,2517,1634,4151,101200,2010
48045,44.8,1723,1245,10,389,469,34196,679,549,130,679,43000,2010
48047,36.3,7349,504,0,6818,1668,19959,2588,1737,851,2588,46800,2010
48049,39,38199,28769,1484,7260,9375,38832,13559,9826,3733,13559,76900,2010
48051,41.3,17058,11689,2079,2977,4827,43185,6750,5411,1339,6750,80200,2010
48053,43,42215,32559,778,8102,11947,48187,16315,12235,4080,16315,137800,2010
48055,34.5,37416,16892,2502,17172,8307,41594,11408,7890,3518,11408,99600,2010
48057,38.6,21120,9910,477,9576,5770,43258,7971,5547,2424,7971,89800,2010
48059,41.3,13458,12019,32,1008,3720,44596,5133,4251,882,5133,73700,2010
48061,30.2,393566,44389,1151,344031,91493,31264,113547,78606,34941,113547,74000,2010
48063,38.1,12288,7434,2213,2395,3396,36029,4588,3067,1521,4588,93700,2010
48065,40.7,6284,5547,57,496,1817,56106,2415,2059,356,2415,82800,2010
48067,43.2,30254,23362,5281,1034,8527,36360,12099,8726,3373,12099,68700,2010
48069,33.6,7848,3111,163,4428,2067,35087,2677,2060,617,2677,68300,2010
48071,35.8,32371,22927,2767,5909,8992,66764,11080,9554,1526,11080,136600,2010
48073,37.9,50035,31923,7690,9622,11973,36966,16799,12445,4354,16799,68100,2010
48075,33,7115,4420,863,1778,1570,42004,2177,1591,586,2177,54800,2010
48077,44,10922,10107,62,445,3264,50881,4451,3830,621,4451,77300,2010
48079,34.6,3155,1354,167,1589,849,37446,1099,849,250,1099,40100,2010
48081,46.1,3301,2587,20,614,852,38702,1287,949,338,1287,58000,2010
48083,44.5,8857,7087,166,1340,2343,26951,3514,2494,1020,3514,59000,2010
48085,34.6,738745,478474,58413,104901,195993,80504,268042,189724,78318,268042,199000,2010
48087,36.3,3009,1705,177,1040,779,39712,1188,896,292,1188,58900,2010
48089,42.5,20751,12670,2842,5051,5474,41145,8205,6324,1881,8205,97000,2010
48091,42,102836,73819,1508,25165,29432,64752,38984,29602,9382,38984,187400,2010
48093,42.2,13863,10355,51,3348,3636,35218,5243,4111,1132,5243,83900,2010
48095,40.5,4047,1924,67,2021,785,49063,996,781,215,996,70300,2010
48097,38.9,38316,30506,1050,5583,10526,48899,14547,10228,4319,14547,111400,2010
48099,29.1,74082,45816,12402,11333,16368,47374,20762,12360,8402,20762,92000,2010
48101,46,1618,1099,190,239,442,33859,617,493,124,617,42400,2010
48103,38.2,4141,1858,161,2052,1158,50425,1426,1081,345,1426,54200,2010
48105,34,3746,1583,0,2163,1011,50653,1259,771,488,1259,60800,2010
48107,36.8,6207,2736,234,3136,1519,36301,2144,1542,602,2144,51200,2010
48109,30.1,2480,693,0,1778,491,35500,724,553,171,724,39900,2010
48111,33.4,6471,3705,149,2418,1579,47073,2154,1426,728,2154,70200,2010
48113,32.3,2321014,802890,503205,860131,544733,47974,832360,454958,377402,832360,129700,2010
48115,34.9,13853,5455,1096,7139,3146,33623,4424,3351,1073,4424,48000,2010
48117,30.8,19054,6183,186,12368,4534,41127,6053,3932,2121,6053,73600,2010
48119,41.2,5248,4389,395,262,1319,37908,2045,1644,401,2045,62700,2010
48121,32.6,628084,414552,48087,109914,158005,70622,224840,148766,76074,224840,178300,2010
48123,43,20025,11660,2052,6162,4988,40668,7361,5634,1727,7361,68700,2010
48125,41.1,2441,1594,72,726,588,33813,841,676,165,841,44000,2010
48127,35.4,9908,1327,43,8379,2908,25882,3600,2501,1099,3600,49000,2010
48129,40.9,3655,3132,152,282,950,46130,1279,937,342,1279,58300,2010
48131,36.4,11999,1358,130,10436,2890,30493,4138,3033,1105,4138,53300,2010
48133,41,18560,15279,503,2569,4745,32452,7273,5484,1789,7273,58400,2010
48135,31.3,133015,57001,5234,67644,33389,45815,47653,32154,15499,47653,75500,2010
48137,42.6,2029,944,0,1085,490,40163,858,697,161,858,61500,2010
48139,34.6,143502,95401,12323,32453,38397,60877,48503,36986,11517,48503,136100,2010
48141,31.2,772280,104318,20018,632410,186687,36333,242943,155280,87663,242943,101800,2010
48143,31.7,37142,29048,389,6764,8836,39200,13877,8597,5280,13877,110900,2010
48145,38.9,17799,9516,4275,3442,3858,31083,5700,4157,1543,5700,59500,2010
48147,40.2,33765,27461,2437,3055,8360,44551,11676,8725,2951,11676,81500,2010
48149,45.6,24175,18046,1599,4197,7216,45450,10658,7896,2762,10658,133500,2010
48151,45,4057,2911,138,917,1183,41458,1673,1238,435,1673,52000,2010
48153,35.7,6599,2903,133,3360,2046,35240,2612,1873,739,2612,56000,2010
48155,41.9,1379,1025,48,297,376,30417,563,346,217,563,29700,2010
48157,34.6,541983,201279,115318,127356,139504,79845,167620,135409,32211,167620,171500,2010
48159,40.9,10675,8733,512,1271,2647,45625,3734,3017,717,3734,94600,2010
48161,41.1,19461,13531,3303,2362,4539,44560,7107,5600,1507,7107,89900,2010
48163,31.7,16956,3432,501,12907,3610,35940,4748,3159,1589,4748,49500,2010
48165,29.2,16658,10141,209,5966,3997,46393,5348,3902,1446,5348,77600,2010
48167,37.1,286326,171018,39801,61877,74089,58317,106617,74086,32531,106617,141400,2010
48169,35.6,6204,2501,134,3463,1179,35750,1649,1199,450,1649,57000,2010
48171,49.3,24197,19165,14,4583,7323,52682,10413,7860,2553,10413,191100,2010
48173,39.6,1317,882,59,376,338,61184,430,316,114,430,90800,2010
48175,44.5,7161,4315,293,2373,2114,51786,2920,2419,501,2920,99100,2010
48177,36.4,19635,9037,1624,8875,5088,37094,7036,4815,2221,7036,69500,2010
48179,38.7,22497,15899,1034,4849,5836,40442,8221,6319,1902,8221,65500,2010
48181,38.9,119111,94852,6540,12485,31768,46875,45545,32076,13469,45545,99600,2010
48183,35.4,119525,74542,23794,17928,30586,43367,44873,28305,16568,44873,109800,2010
48185,38.7,26208,16027,4300,5279,6059,39429,8366,6270,2096,8366,89400,2010
48187,36.3,122728,68398,7186,43287,33373,61274,42738,33594,9144,42738,142400,2010
48189,32.5,36041,14021,1874,19546,8471,36509,11444,7470,3974,11444,73500,2010
48191,42.8,3424,2036,252,1033,966,29219,1440,965,475,1440,44300,2010
48193,45.5,8473,7638,0,789,2119,40808,3064,2478,586,3064,82900,2010
48195,36.4,5470,3098,35,2228,1443,52239,1948,1477,471,1948,64900,2010
48197,44.2,4226,3053,388,710,1220,36295,1672,1318,354,1672,46900,2010
48199,38,53220,46962,3140,2235,14679,52755,19711,15407,4304,19711,95500,2010
48201,32,3950999,1356404,739423,1563194,943393,51444,1372163,793400,578763,1372163,131700,2010
48203,37.6,64484,42514,14315,6412,16583,44425,22997,17186,5811,22997,94400,2010
48205,39.9,5963,4233,398,1269,1299,66583,1715,1257,458,1715,128500,2010
48207,44.2,5842,4141,304,1327,1784,35295,2549,1938,611,2549,39200,2010
48209,30,146439,87335,5261,50032,32834,56353,50479,34241,16238,50479,173300,2010
48211,41.8,3668,2728,0,808,1104,62159,1533,1185,348,1533,90700,2010
48213,42.3,78299,63846,4998,7949,21329,39779,30540,23678,6862,30540,86400,2010
48215,28.1,736973,60071,2688,664767,170503,31879,205971,145896,60075,205971,73000,2010
48217,39.9,34854,25860,2297,6126,9088,39293,12988,9939,3049,12988,85000,2010
48219,33.4,22933,12124,692,9651,6103,46430,8100,6026,2074,8100,71200,2010
48221,45.5,49816,43440,234,4864,14669,54882,20240,15880,4360,20240,152200,2010
48223,39.2,34540,26415,2683,4883,9433,41642,13045,9280,3765,13045,95300,2010
48225,42.8,23642,14783,6045,2214,5437,31929,7872,5851,2021,7872,67600,2010
48227,38.3,34285,18414,1728,12914,7476,39574,11080,7630,3450,11080,57200,2010
48229,36.9,3441,664,13,2720,730,22647,1066,846,220,1066,43900,2010
48231,37.2,84836,63946,7336,10936,21277,43101,30391,21412,8979,30391,90700,2010
48233,37.2,22094,16673,455,4131,5901,42213,8390,6761,1629,8390,56400,2010
48235,44.5,1673,1236,70,362,433,48833,620,516,104,620,74700,2010
48237,39.2,9072,7411,367,1134,2033,46801,2984,2316,668,2984,67500,2010
48239,39,13987,8909,1011,3888,3575,47483,5030,3728,1302,5030,77500,2010
48241,39.6,35248,26697,5811,1885,10011,38062,13466,10685,2781,13466,76600,2010
48243,47.7,2340,1447,0,831,737,43750,999,787,212,999,101300,2010
48245,36.2,249349,114687,83910,38911,60524,42293,90671,59157,31514,90671,88400,2010
48247,33.1,5211,244,1,4808,1394,40000,1738,1252,486,1738,65000,2010
48249,33.9,40631,8211,277,31710,9973,37020,13441,9854,3587,13441,67800,2010
48251,36.1,147611,114546,3965,25148,39050,54954,50425,38608,11817,50425,111800,2010
48253,38.2,20157,12518,2391,4820,4048,39568,6022,4747,1275,6022,51700,2010
48255,38.5,14880,5993,1486,7214,3452,39611,4657,3203,1454,4657,69700,2010
48257,35.2,98402,69832,10017,15855,26322,58555,33131,25697,7434,33131,130000,2010
48259,43.3,31515,24506,301,6242,9277,66655,12055,9085,2970,12055,243900,2010
48261,51.2,241,90,0,151,63,48333,92,35,57,92,71000,2010
48263,45.8,772,672,3,93,202,47750,365,295,70,365,48900,2010
48265,46.7,48826,35598,875,11340,14235,43072,20285,14934,5351,20285,129600,2010
48267,50.4,4568,3344,0,1070,1226,43429,1897,1361,536,1897,89500,2010
48269,39.5,219,179,0,22,70,61563,95,37,58,95,325000,2010
48271,44.9,3555,1604,53,1818,720,24388,1150,916,234,1150,46400,2010
48273,28.9,31611,7645,1156,21830,7386,36571,10924,6524,4400,10924,74500,2010
48275,42.5,3708,2373,315,1001,1061,32055,1625,1101,524,1625,42900,2010
48277,39.6,49536,38125,6464,2982,13724,38015,19053,13108,5945,19053,81100,2010
48279,35.9,14092,6300,666,6963,3553,35458,4804,3608,1196,4804,50100,2010
48281,40.1,19677,15026,636,3342,5160,46378,7031,5355,1676,7031,121300,2010
48283,32,6709,1125,165,5293,1323,30144,1872,1145,727,1872,39600,2010
48285,44.5,19217,14810,1409,2878,5520,41429,7974,6246,1728,7974,83100,2010
48287,40.2,16499,10906,1798,3508,4225,46986,6022,4627,1395,6022,115300,2010
48289,45.1,16640,13041,1436,2037,4529,40355,6569,5500,1069,6569,78100,2010
48291,35.9,74922,52574,8574,12364,17852,45929,24034,18971,5063,24034,79200,2010
48293,39.4,23170,14519,4307,4120,5598,42140,7856,6194,1662,7856,78600,2010
48295,39.8,3218,2182,15,882,793,52566,1127,874,253,1127,73700,2010
48297,41.8,11507,6962,353,4080,2706,43719,3856,3099,757,3856,83500,2010
48299,54.5,18992,17111,179,1446,5471,41969,8463,6596,1867,8463,150700,2010
48301,36.9,41,32,0,0,19,83889,22,10,12,22,66700,2010
48303,30.3,269932,157709,18589,83777,64941,42562,102170,61000,41170,102170,103100,2010
48305,40.6,5988,3009,79,2697,1703,43672,2165,1599,566,2165,66900,2010
48307,42.8,8220,5596,191,2319,2038,34459,3098,2218,880,3098,71200,2010
48309,32.7,229587,137667,33640,51841,55570,40672,82998,49856,33142,82998,101000,2010
48311,35.5,897,421,0,468,172,41453,307,255,52,307,83100,2010
48313,34.1,13433,7935,2922,2518,2541,37207,3592,2853,739,3592,84700,2010
48315,47.9,10771,7709,2495,319,3073,29943,4744,3785,959,4744,58700,2010
48317,35.3,4606,2366,122,2010,1147,38111,1492,1125,367,1492,75200,2010
48319,46.2,3928,3240,13,630,1102,38702,1553,1240,313,1553,131400,2010
48321,37.7,36647,17619,4105,13489,10237,43205,13786,9877,3909,13786,83400,2010
48323,29.6,52493,1540,9,50042,11995,28813,14552,10150,4402,14552,77700,2010
48325,37.6,45073,21202,1131,21984,11818,49138,15106,11604,3502,15106,102900,2010
48327,50.4,2212,1536,0,663,668,40996,927,694,233,927,66600,2010
48329,33.6,132103,72221,8523,48077,35366,54945,49122,34235,14887,49122,121200,2010
48331,39.8,24934,16538,2339,5539,6743,39035,9575,6992,2583,9575,81600,2010
48333,47.7,4887,3917,3,930,1389,31895,1974,1549,425,1974,95000,2010
48335,35.6,9342,4771,1125,3241,1989,37260,2711,2109,602,2711,55300,2010
48337,43.1,19789,17550,14,1723,5555,42482,7978,6227,1751,7978,83900,2010
48339,35.8,427717,311710,17267,82895,114133,65620,150546,113868,36678,150546,157100,2010
48341,31.1,21102,8539,234,10914,5094,44216,6724,4483,2241,6724,83100,2010
48343,43.5,13077,8848,3003,913,3427,38843,5131,4049,1082,5131,75500,2010
48345,44.3,1123,1001,11,109,261,34081,435,326,109,435,60500,2010
48347,29.9,63141,39792,11325,10353,14885,33189,23082,13832,9250,23082,88600,2010
48349,36.6,47483,28963,7198,10579,12428,41654,17313,12381,4932,17313,79300,2010
48351,40.3,14389,10709,3055,425,3679,37452,5164,4297,867,5164,67600,2010
48353,38.6,14990,9165,660,4831,3872,37102,5836,3976,1860,5836,51600,2010
48355,34.7,334370,112863,12787,199930,82670,43280,121056,74556,46500,121056,103900,2010
48357,31.2,9953,5140,38,4468,2510,49309,3533,2457,1076,3533,82100,2010
48359,34.9,2020,1652,64,210,526,51111,710,504,206,710,86900,2010
48361,38.2,82014,68579,6948,4450,22737,47914,31271,24117,7154,31271,81500,2010
48363,40.1,27927,22027,709,4737,7541,41095,10513,7180,3333,10513,80500,2010
48365,39.7,23569,17529,3975,1726,6384,45622,8632,6991,1641,8632,81900,2010
48367,38.3,112158,96101,1794,11269,30780,61340,40489,32502,7987,40489,147100,2010
48369,32.2,10098,4251,35,5770,2602,39753,3299,2397,902,3299,88500,2010
48371,36,15400,4301,709,10016,3584,38125,4912,3440,1472,4912,50900,2010
48373,43.4,45590,33442,5089,5533,11326,33325,16789,13240,3549,16789,67700,2010
48375,32.7,120124,60688,11852,41025,27218,36766,41422,24609,16813,41422,80600,2010
48377,38.1,7703,1221,29,6381,1695,29513,2617,1766,851,2617,56200,2010
48379,44.5,10942,9615,285,807,2970,42491,4069,3391,678,4069,82000,2010
48381,35.4,116811,92744,2462,17766,31501,56041,46018,32256,13762,46018,130400,2010
48383,30.3,3298,1167,162,1969,870,54224,1142,810,332,1142,63100,2010
48385,49.1,3279,2523,0,738,944,29186,1335,1008,327,1335,75300,2010
48387,44.3,12987,9685,2152,777,3696,37047,5108,3635,1473,5108,59700,2010
48389,32.4,13269,1401,337,11295,2601,32593,3628,2696,932,3628,31400,2010
48391,43.2,7434,3440,484,3371,2088,42949,2786,2170,616,2786,67800,2010
48393,45.1,877,847,0,21,275,52500,328,249,79,328,111400,2010
48395,40.2,16574,9859,3600,2790,4619,38393,6232,4167,2065,6232,77300,2010
48397,35.3,73311,55078,3895,11268,20199,78032,24790,20906,3884,24790,189000,2010
48399,43.1,10492,6882,227,3231,2903,37823,3953,2847,1106,3953,60100,2010
48401,39.2,52016,34889,9451,6837,13407,46574,18102,14226,3876,18102,86700,2010
48403,49.7,10653,9338,946,304,3090,33589,4430,3675,755,4430,68000,2010
48405,46.3,8996,6257,2121,475,2291,25974,3691,2919,772,3691,65000,2010
48407,42.2,25859,19981,2894,2526,6976,46285,9184,7577,1607,9184,75600,2010
48409,35.1,66100,28507,1279,35021,17018,45189,22592,14961,7631,22592,88300,2010
48411,40.2,6023,4257,55,1565,1465,36308,2122,1649,473,2122,71200,2010
48413,35.9,3343,1817,22,1465,804,55186,989,798,191,989,67900,2010
48415,37.6,16579,9740,797,5683,4598,42401,6181,4391,1790,6181,71100,2010
48417,41,3182,2775,63,303,753,46629,1195,930,265,1195,69000,2010
48419,38.4,25423,16832,4517,3737,7115,32425,9705,7395,2310,9705,64400,2010
48421,36.7,3000,1882,7,1075,715,50069,971,764,207,971,80800,2010
48423,35.9,203393,128452,36855,32913,53113,46139,76427,53032,23395,76427,118000,2010
48425,39.2,8200,6593,84,1405,1964,52135,2923,2251,672,2923,144300,2010
48427,28.6,59989,726,29,58986,13137,24441,15569,12357,3212,15569,57000,2010
48429,39.8,9562,7344,261,1829,2513,35691,3624,2689,935,3624,57600,2010
48431,42,1160,834,0,322,314,41548,446,348,98,446,68700,2010
48433,46.1,1434,1213,96,110,424,52222,592,477,115,592,55300,2010
48435,36.7,4257,1688,120,2405,1023,56146,1375,982,393,1375,77700,2010
48437,35.8,7828,4135,458,2956,1814,37907,2689,1864,825,2689,59500,2010
48439,33.2,1743300,928812,248965,447348,439906,55306,632518,400711,231807,632518,134900,2010
48441,32.7,129477,87766,8709,27718,32979,42403,49757,30811,18946,49757,89900,2010
48443,45.4,850,386,0,389,207,35403,372,260,112,372,42600,2010
48445,35.5,12498,5837,686,5829,2731,39498,4043,2935,1108,4043,63000,2010
48447,47.9,1814,1644,0,134,536,36339,795,644,151,795,46700,2010
48449,32.5,30995,15700,2904,11708,8038,39423,10693,7508,3185,10693,86800,2010
48451,34.3,108000,63245,3998,37786,27769,41398,41464,28134,13330,41464,88600,2010
48453,31.6,979712,501239,81867,321162,223380,54074,390862,205503,185359,390862,200300,2010
48455,46.1,14451,11767,1546,1001,3473,36814,5124,4156,968,5124,73800,2010
48457,41.2,21472,17356,2962,751,5701,35346,8113,6630,1483,8113,71100,2010
48459,40.4,38685,31972,3376,2364,10670,44403,14668,11416,3252,14668,86100,2010
48461,38.8,3243,1639,146,1405,874,49234,1179,929,250,1179,42800,2010
48463,34.9,26285,7860,128,17902,6628,35087,8824,6490,2334,8824,64400,2010
48465,32.1,48088,8623,732,38215,11640,36993,15042,9890,5152,15042,81000,2010
48467,41.8,52362,45096,1518,4648,13984,43074,19559,15268,4291,19559,95900,2010
48469,36.4,85813,41921,4985,36847,23077,48767,31917,21115,10802,31917,98200,2010
48471,34.3,66353,39076,14868,10706,11356,34259,19902,11534,8368,19902,106100,2010
48473,32.3,40831,18670,10052,11090,9737,47324,13499,9256,4243,13499,117900,2010
48475,36.5,10505,4974,516,4801,2759,41117,3790,2804,986,3790,45200,2010
48477,40.8,32949,22106,5879,4219,8665,43159,12855,8916,3939,12855,135500,2010
48479,27.4,240346,8521,564,229399,53860,36684,64714,41777,22937,64714,104000,2010
48481,37.4,41036,19957,5707,14845,10333,41148,14808,10261,4547,14808,85800,2010
48483,40.3,5235,3898,150,1046,1503,42909,2113,1670,443,2113,65300,2010
48485,34.1,130976,90647,13825,20697,32066,42971,48601,31147,17454,48601,87400,2010
48487,36.6,13637,8765,1237,3365,3535,40105,5201,3165,2036,5201,57500,2010
48489,31.6,21769,2472,378,18788,4419,22881,5485,3898,1587,5485,46200,2010
48491,34,391715,254331,22680,87805,104878,68780,142110,99937,42173,142110,172200,2010
48493,39.2,41264,24256,709,15713,11717,60493,14455,12212,2243,14455,124100,2010
48495,34.7,6933,3101,60,3525,1645,41828,2521,2059,462,2521,38900,2010
48497,37.5,58054,47008,499,9165,15475,55207,19712,15967,3745,19712,119900,2010
48499,46.5,41625,35474,1954,3272,11700,41277,16026,13048,2978,16026,94800,2010
48501,32.8,7706,3162,180,4289,2113,49146,2596,2212,384,2596,61000,2010
48503,41.8,18298,14974,229,2697,5110,36900,7484,5171,2313,7484,69400,2010
48505,29,13609,1103,0,12506,3645,24496,4341,3293,1048,4341,47100,2010
48507,31,11658,943,0,10715,2725,21707,3558,2411,1147,3558,36900,2010
49001,31.7,6431,5734,8,606,1563,41514,2091,1604,487,2091,150200,2010
49003,30.2,48221,42683,133,3867,12837,55135,15612,12721,2891,15612,162000,2010
49005,25.2,107078,92242,559,10085,25552,47013,33820,21597,12223,33820,180300,2010
49007,34.9,20765,17597,127,2455,5432,41967,7966,5638,2328,7966,109200,2010
49009,43,839,765,0,51,221,36389,352,226,126,352,181800,2010
49011,28.7,294532,254650,3394,23399,73301,66866,90607,70979,19628,90607,224400,2010
49013,30,17408,15223,17,935,5377,52895,6521,4853,1668,6521,162600,2010
49015,31.5,10728,9884,17,603,2950,49237,3779,3057,722,3779,105500,2010
49017,39.8,4958,4579,0,109,1545,44745,2136,1698,438,2136,129900,2010
49019,40.5,8987,7636,15,717,2183,41396,3719,2566,1153,3719,194100,2010
49021,26.1,44439,39043,84,3199,11352,42247,15155,9581,5574,15155,204600,2010
49023,29,9855,9293,7,313,2615,53225,3045,2517,528,3045,163300,2010
49025,45.3,6893,6459,1,218,2153,43540,3065,2335,730,3065,174500,2010
49027,33.7,12189,10423,23,1390,3160,44594,4046,3101,945,4046,121100,2010
49029,31.6,9013,8681,0,193,2302,70152,2714,2394,320,2714,260600,2010
49031,37.4,1661,1497,34,103,395,37708,539,480,59,539,163500,2010
49033,40,2181,2143,1,12,637,54737,762,673,89,762,120300,2010
49035,30.4,1000155,752287,13582,162475,236504,58004,335075,229637,105438,335075,237500,2010
49037,30,14299,6314,0,626,3229,38076,4331,3388,943,4331,108000,2010
49039,28.3,26651,23268,269,2378,6064,42395,7870,6072,1798,7870,148700,2010
49041,31.9,20438,19011,31,826,5398,45622,6937,5638,1299,6937,148300,2010
49043,36,35295,30471,129,3819,10072,79461,13600,10123,3477,13600,492100,2010
49045,29.1,55398,47008,430,6166,14014,60590,17718,13387,4331,17718,183000,2010
49047,29,30991,25855,20,1974,8231,59730,10474,7871,2603,10474,183100,2010
49049,24.3,486067,412745,2306,49522,109670,56927,135620,94142,41478,135620,233800,2010
49051,31.3,22176,19067,108,2560,6027,65204,7154,5576,1578,7154,317900,2010
49053,31.8,134033,115919,588,12240,35313,50050,45895,32541,13354,45895,240900,2010
49055,38.1,2706,2506,10,182,722,49414,899,705,194,899,167500,2010
49057,30.6,222849,176010,2962,35783,57231,54086,77656,56398,21258,77656,168300,2010
50001,40.4,36841,34840,325,661,9462,55800,14080,10649,3431,14080,219000,2010
50003,44.3,37122,35570,174,537,10060,47396,15559,11291,4268,15559,198800,2010
50005,41.9,31214,29996,178,323,8067,42706,12581,8982,3599,12581,154200,2010
50007,36.2,154729,141992,2506,2731,36798,59878,61581,40586,20995,61581,254700,2010
50009,45.8,6359,6145,43,45,1820,37734,2842,2385,457,2842,124300,2010
50011,38.9,47547,45050,222,581,12887,53623,18482,13823,4659,18482,202800,2010
50013,44.5,7105,6766,20,89,2222,57436,3077,2511,566,3077,235600,2010
50015,39.2,24040,23065,144,316,6554,52232,10345,7135,3210,10345,211100,2010
50017,42.9,29059,28036,82,317,7973,52079,11967,9716,2251,11967,182700,2010
50019,43.1,27256,26216,185,290,7098,40202,10785,8264,2521,10785,149200,2010
50021,43.3,62278,60162,297,705,16982,47027,26405,18495,7910,26405,172100,2010
50023,41.4,59379,56497,348,1019,15216,55313,24621,17877,6744,24621,197600,2010
50025,44.1,44438,42012,385,786,11831,46714,19483,13554,5929,19483,204600,2010
50027,44.8,56891,54425,289,754,15782,50893,24804,17894,6910,24804,209900,2010
51001,43.9,34066,20936,9729,2732,9054,41372,14085,10436,3649,14085,149800,2010
51003,37.6,96633,76042,9387,4790,24304,64847,37459,24510,12949,37459,349800,2010
51005,44.7,16406,15178,979,72,4765,43160,6964,5758,1206,6964,104000,2010
51007,41.5,12517,9096,2954,292,3429,50135,4901,4080,821,4901,189800,2010
51009,41.1,32315,24394,6093,675,8821,44757,12706,9576,3130,12706,142200,2010
51011,43.3,14653,11182,3246,36,4352,49224,5976,4539,1437,5976,132200,2010
51013,33.9,197467,126061,16668,29359,40779,94880,91892,43168,48724,91892,571700,2010
51015,42.3,73201,67615,3077,1525,20340,50612,27909,22683,5226,27909,187800,2010
51017,47,4779,4513,172,60,1494,50589,2025,1761,264,2025,129700,2010
51019,43.2,67697,61224,3784,1063,20104,54110,27150,22933,4217,27150,187200,2010
51021,44.6,6873,6544,198,21,1992,41552,2580,2189,391,2580,88600,2010
51023,43.6,32867,30926,1165,380,9807,64724,12918,11264,1654,12918,202500,2010
51025,40,17707,7109,10390,92,4013,35184,6086,4263,1823,6086,97500,2010
51027,42.6,24459,23552,492,40,6379,29183,9123,7254,1869,9123,62000,2010
51029,43.4,16874,10283,6278,122,3338,34720,4859,3632,1227,4859,99300,2010
51031,40.4,54174,44138,7593,942,14985,43478,22005,16657,5348,22005,134000,2010
51033,38.7,27844,17728,8129,974,7315,57690,10270,8517,1753,10270,218800,2010
51035,44.7,29985,28823,361,419,8893,36142,12818,9770,3048,12818,97400,2010
51036,45.6,7205,2952,3544,111,1815,46337,2713,2306,407,2713,146000,2010
51037,42.8,12644,8401,4039,69,3150,34881,4415,3440,975,4415,103200,2010
51041,36.9,308633,206443,65155,20112,84586,71321,112404,88092,24312,112404,235600,2010
51043,43.8,14013,12366,735,496,3838,73244,5535,4195,1340,5535,366900,2010
51045,43.2,5173,5079,35,0,1458,51291,1989,1704,285,1989,142100,2010
51047,37.1,45749,33077,7148,3855,11934,65132,15834,11498,4336,15834,309000,2010
51049,40.7,9855,6190,3254,189,2655,40143,3969,3089,880,3969,149700,2010
51051,43.2,15966,15718,71,24,4125,29080,6170,4972,1198,6170,71300,2010
51053,40.1,27449,17361,8926,651,7125,51459,9800,7427,2373,9800,163800,2010
51057,44,10901,6158,4202,278,3068,46235,4466,3341,1125,4466,185400,2010
51059,37.3,1048554,591054,92436,152973,266580,105416,381768,274448,107320,381768,507800,2010
51061,40.4,64546,53119,5374,3942,16576,83877,22369,17633,4736,22369,390900,2010
51063,43.6,15030,14205,234,347,4332,42044,6334,4970,1364,6334,138800,2010
51065,41.1,25308,20061,3903,721,6842,68223,9128,7957,1171,9128,246100,2010
51067,43.3,54938,48102,4666,1341,16665,45555,23355,18324,5031,23355,156100,2010
51069,38.7,75835,65473,2997,4871,21161,61973,28558,22495,6063,28558,248600,2010
51071,42.4,17205,16552,197,179,4936,41186,7100,5527,1573,7100,97800,2010
51073,41.9,36610,31316,3361,963,10656,59331,14014,11544,2470,14014,228100,2010
51075,44.1,21136,14544,5892,426,5468,79574,6831,6233,598,6831,338000,2010
51077,46,15855,14960,384,383,4496,32178,6858,5573,1285,6858,92200,2010
51079,38.7,18082,15623,1255,701,4750,54307,6709,5357,1352,6709,223100,2010
51081,40,12181,4584,7318,154,2369,38574,3385,2525,860,3385,94600,2010
51083,43.9,36311,21798,13406,598,9767,34705,14650,11124,3526,14650,96000,2010
51085,40.4,99172,85061,8974,2047,28144,76425,36114,30301,5813,36114,281600,2010
51087,37.1,300053,175944,84919,13353,78361,60114,121767,81504,40263,121767,230000,2010
51089,43.6,54860,39325,12202,2471,15700,34086,22909,17396,5513,22909,91200,2010
51091,52.4,2395,2355,0,6,813,43481,1130,866,264,1130,177400,2010
51093,42.6,34762,24645,8674,677,10266,62242,13553,10995,2558,13553,256600,2010
51095,44.3,64386,50469,8536,2653,19040,73903,25851,19772,6079,25851,348600,2010
51097,42.5,6926,4515,2199,162,1961,44442,2815,2263,552,2815,171500,2010
51099,36,22794,17080,3867,824,6027,76241,8194,6261,1933,8194,305200,2010
51101,39.1,15509,11751,2907,344,4540,64946,5909,5049,860,5909,198100,2010
51103,53.4,11478,8020,3297,70,3656,45209,5421,4180,1241,5421,254500,2010
51105,40.7,25434,23810,943,373,6828,31352,9836,7263,2573,9836,77600,2010
51107,34.3,291653,187588,20321,34145,71188,115574,95330,77022,18308,95330,495000,2010
51109,42.3,32248,24867,5882,716,9715,54257,13253,10367,2886,13253,218600,2010
51111,43,12968,7711,4754,405,3002,37424,4515,3361,1154,4515,101500,2010
51113,43.3,13342,11376,1408,289,4001,56608,5213,4221,992,5213,250900,2010
51115,48.9,9004,7819,889,108,2726,47435,3773,3131,642,3773,207900,2010
51117,45.1,32774,19286,12252,773,8107,36431,12594,9463,3131,12594,115000,2010
51119,50.4,10831,8495,2086,127,3162,50207,4303,3489,814,4303,248100,2010
51121,26,92527,79864,3573,2373,19276,43229,34369,19387,14982,34369,187600,2010
51125,46.4,14989,12301,2062,399,4522,48118,6534,5086,1448,6534,174100,2010
51127,41.9,17655,14186,2838,147,5171,70590,6513,5865,648,6513,251000,2010
51131,46.3,12572,6849,4826,741,3207,35760,5088,3617,1471,5088,199600,2010
51133,52.6,12419,8763,3416,110,3700,51944,5478,4619,859,5478,251600,2010
51135,41.9,15819,8703,6238,515,3958,37344,5607,3608,1999,5607,126100,2010
51137,42.1,32730,26658,4169,1096,9308,54916,12669,9937,2732,12669,249100,2010
51139,42.4,24116,22958,443,379,6533,41617,9629,7282,2347,9629,168700,2010
51141,45.4,18643,16833,1149,412,5091,35813,7344,5973,1371,7344,102200,2010
51143,43.4,63147,46886,14169,1272,18671,39224,26563,21094,5469,26563,102000,2010
51145,40.3,27758,21569,5338,475,6836,73593,8637,7743,894,8637,279300,2010
51147,31.4,22723,14106,7988,213,4551,36191,7314,4638,2676,7314,155400,2010
51149,36.6,35129,20435,11338,2041,8322,64171,10474,7893,2581,10474,202700,2010
51153,33.3,379415,189455,72489,75806,96441,91098,124879,93372,31507,124879,377700,2010
51155,43.1,34963,31928,1919,485,9996,41163,14898,10892,4006,14898,121100,2010
51157,46.8,7376,6650,449,103,2151,62117,3163,2294,869,3163,428700,2010
51159,42.7,9328,5828,2898,426,1912,42182,3007,2402,605,3007,148700,2010
51161,42.5,91583,81621,4552,1924,25652,59446,37833,29401,8432,37833,189500,2010
51163,45.3,22217,21475,470,34,6588,44417,9372,7160,2212,9372,180900,2010
51165,39.8,74922,68705,1362,3761,21677,49930,29701,22200,7501,29701,192900,2010
51167,42.4,28842,28110,365,28,8106,32780,11529,8881,2648,11529,85200,2010
51169,44.3,23234,22646,136,193,6650,34250,9610,7403,2207,9610,85000,2010
51171,42.8,41468,37735,789,2330,11636,50171,17316,12039,5277,17316,216200,2010
51173,42.3,32383,30892,568,467,8778,34864,12992,9474,3518,12992,86900,2010
51175,42.6,18493,11005,7060,98,4658,45426,6571,5004,1567,6571,149200,2010
51177,35.7,120212,87595,18136,8748,32156,76574,41009,32759,8250,41009,305000,2010
51179,34.2,124587,85747,20750,10910,32620,93065,40183,31502,8681,40183,355300,2010
51181,43.5,7039,3524,3380,92,1677,55030,2481,1840,641,2481,171800,2010
51183,41,12167,4623,7354,169,2344,37978,3796,2544,1252,3796,119300,2010
51185,43.4,44706,42509,1234,60,12934,35215,18015,13215,4800,18015,80200,2010
51187,39.1,37044,33032,1491,1279,9765,60522,14160,10591,3569,14160,254400,2010
51191,43,54322,52364,601,695,16077,40422,22711,16853,5858,22711,126100,2010
51193,45.7,17237,10977,4902,913,4694,52990,7135,5433,1702,7135,202300,2010
51195,39.4,41496,38378,2140,461,10907,33608,15750,10973,4777,15750,77100,2010
51197,42.6,29005,27423,1140,283,7953,38948,11665,8981,2684,11665,104500,2010
51199,39.3,64846,48681,8766,2826,18857,81055,24002,18871,5131,24002,324800,2010
51510,35.7,133647,73316,28478,20057,29010,80847,63738,29103,34635,63738,486800,2010
51515,43.1,6177,4500,1357,91,1728,32262,2782,1852,930,2782,139100,2010
51520,41,17704,16080,1178,75,4899,32079,7948,4909,3039,7948,94100,2010
51530,38.5,6653,6044,400,59,1807,39955,2693,1745,948,2693,126000,2010
51540,27.7,42267,28103,8326,2001,7048,42240,17290,7143,10147,17290,279700,2010
51550,36.5,219268,134185,64481,8622,59611,67855,78778,58988,19790,78778,272800,2010
51570,42.1,17472,14251,1829,643,4555,50571,7075,4652,2423,7075,187700,2010
51580,43.5,5989,4989,700,56,1528,35277,2641,1814,827,2641,65900,2010
51590,42.8,43787,20862,21033,1152,11759,29936,19448,10623,8825,19448,89100,2010
51595,39.5,5822,1876,3641,219,1356,32788,2406,1164,1242,2406,97700,2010
51600,39.6,22058,13862,1019,3195,5629,97900,8524,6148,2376,8524,488900,2010
51610,40.4,11465,8557,516,978,2930,114409,4706,3006,1700,4706,641900,2010
51620,39.7,8549,3480,4827,22,2390,33174,3524,1631,1893,3524,184900,2010
51630,28.7,23375,14672,5368,2162,4490,43558,9206,3592,5614,9206,335800,2010
51640,45.9,6936,5555,306,963,1738,22333,3326,2105,1221,3326,90600,2010
51650,35.4,139046,58704,67540,5991,33306,49815,53283,31573,21710,53283,191500,2010
51660,22.5,47406,34986,2955,6839,7426,37235,14965,5770,9195,14965,213400,2010
51670,36.1,22506,12325,8537,1285,5343,37789,8914,4607,4307,8914,130700,2010
51678,22.4,6990,5549,463,465,973,31571,2108,1079,1029,2108,244300,2010
51680,31.6,73726,46912,21376,2087,16268,37058,27875,15707,12168,27875,139100,2010
51683,32.1,36067,18361,4481,10687,8777,75173,11732,8003,3729,11732,325800,2010
51685,30.6,13195,5820,1602,4340,3256,70299,4206,2993,1213,4206,303400,2010
51690,43.4,14029,6964,6262,517,3566,32408,5922,3519,2403,5922,89200,2010
51700,32,181822,85471,72115,12424,45282,49562,70653,36831,33822,70653,198500,2010
51710,29.5,242143,107951,104215,15056,50208,42677,85061,39675,45386,85061,208400,2010
51720,40.4,3886,3611,208,0,955,33944,1764,952,812,1764,75200,2010
51730,39.6,32303,4942,25564,1134,7067,36449,12305,6252,6053,12305,115900,2010
51735,42.3,12099,11418,56,185,3701,84315,4524,3835,689,4524,326200,2010
51740,35.3,96785,39804,50214,2869,23779,45488,37325,22970,14355,37325,180400,2010
51750,21.7,16318,14112,1301,365,2485,29155,5667,2927,2740,5667,154700,2010
51760,32.6,201828,77619,102681,11219,40047,38266,83498,37507,45991,83498,201800,2010
51770,38.7,95793,60310,26860,4443,23381,36422,42833,24005,18828,42833,128700,2010
51775,40,24641,21768,1632,529,6236,48828,9890,6800,3090,9890,165700,2010
51790,42.8,23806,19728,2780,504,5807,42724,10408,6290,4118,10408,164400,2010
51800,37.5,82544,42835,34225,2250,22888,65104,30126,22638,7488,30126,252200,2010
51810,34.6,435996,284947,81633,27176,112593,64618,163944,109099,54845,163944,277400,2010
51820,38.6,20885,16836,1868,1229,5446,40977,8546,5020,3526,8546,169700,2010
51830,23.1,13421,9665,1801,814,2086,50794,4069,2015,2054,4069,344800,2010
51840,37,25953,18489,2880,3478,5579,44873,10221,5173,5048,10221,267000,2010
53001,29.6,17884,7416,35,10013,4598,40829,5599,3580,2019,5599,131100,2010
53003,43,21363,19838,19,631,5694,41665,8977,6403,2574,8977,157600,2010
53005,35.8,167077,126702,2163,29122,43732,57354,62038,43230,18808,62038,169500,2010
53007,39.7,70995,51170,222,17314,18366,48674,26676,18147,8529,26676,245500,2010
53009,48.5,70638,60234,592,3477,19793,44398,30987,22044,8943,30987,241500,2010
53011,36.2,414816,343071,7532,29439,108421,58262,155042,105042,50000,155042,260800,2010
53013,47.2,3957,3550,0,168,1100,43611,1732,1252,480,1732,146800,2010
53015,39.5,101244,87623,478,7315,26969,45877,39441,26529,12912,39441,191500,2010
53017,36.6,37160,25892,124,9873,9920,48708,13802,9922,3880,13802,204800,2010
53019,46.4,7504,5662,58,221,1859,35485,2706,1938,768,2706,146100,2010
53021,28.4,71329,31382,1315,35930,16344,47749,21422,14301,7121,21422,147000,2010
53023,49.7,2240,2005,0,120,602,42269,903,657,246,903,115700,2010
53025,32.2,85142,49995,791,31356,21185,42572,29427,18410,11017,29427,141100,2010
53027,41.6,72092,59208,655,5867,18170,41899,28191,19363,8828,28191,158200,2010
53029,42.4,78633,65502,1520,4242,22934,57190,32976,24364,8612,32976,307100,2010
53031,52.7,29574,26443,252,937,8554,46048,14194,10471,3723,14194,308500,2010
53033,36.9,1879189,1244837,109947,156207,456029,68065,781977,468539,313438,781977,407700,2010
53035,38.9,247336,197374,6791,14636,65215,59549,95758,65529,30229,95758,284700,2010
53037,32.2,39869,34575,262,2865,9640,41232,16619,9390,7229,16619,265600,2010
53039,44.9,20055,16900,14,2005,5767,37398,8405,5874,2531,8405,200200,2010
53041,41.1,74650,64848,313,6038,19750,43874,29290,21146,8144,29290,188600,2010
53043,46.7,10533,9849,56,214,3292,45582,4649,3651,998,4649,145000,2010
53045,43.6,59287,49540,770,4436,14740,48104,21808,17632,4176,21808,216000,2010
53047,42.2,40238,27815,136,6709,10804,38551,15747,10801,4946,15747,161600,2010
53049,49.8,21192,18055,98,1621,6056,39642,9667,7175,2492,9667,165400,2010
53051,46.4,12904,11676,12,367,3644,38896,5511,4370,1141,5511,200400,2010
53053,35.6,782681,558424,52110,66909,198545,57869,295554,187140,108414,295554,269300,2010
53055,51.9,15551,14169,101,768,4933,50726,7986,5622,2364,7986,495600,2010
53057,39.9,115231,90038,756,17995,30896,54811,45253,31709,13544,45253,278300,2010
53059,43.1,10869,9699,8,566,3081,48704,4514,3440,1074,4514,244600,2010
53061,36.7,694219,526850,15138,57513,180063,66300,263931,179763,84168,263931,338600,2010
53063,36.6,461262,402612,7475,19665,117689,47250,184590,120014,64576,184590,187900,2010
53065,44,43171,38082,215,1218,12430,42845,17404,14026,3378,17404,174800,2010
53067,38.3,243563,194052,6407,16159,65272,60930,98491,66350,32141,98491,257800,2010
53069,51.1,3982,3759,0,134,1129,40372,1763,1274,489,1763,206800,2010
53071,36.9,57585,43370,882,10858,14007,45575,21367,13197,8170,21367,195200,2010
53073,36.2,195993,162089,2020,14429,47698,49031,78186,48688,29498,78186,293500,2010
53075,24.3,43747,36254,797,1946,8173,36368,15717,7703,8014,15717,182500,2010
53077,32.3,236542,116715,1764,102265,58284,42877,79075,50710,28365,79075,149700,2010
54001,41.3,16256,15701,114,88,4245,31212,6219,4742,1477,6219,80300,2010
54003,37.1,100910,87351,6345,3633,26475,52857,38730,29297,9433,38730,193700,2010
54005,40.9,24872,24450,269,108,7180,39783,10023,7637,2386,10023,76400,2010
54007,42.6,14558,14237,100,87,3904,32158,6028,4739,1289,6028,76200,2010
54009,44.5,24194,23426,382,86,6578,39475,9824,7780,2044,9824,85300,2010
54011,38.9,95526,87200,4577,1074,24695,34492,40564,26030,14534,40564,97500,2010
54013,44.5,7588,7411,6,0,2063,26922,3030,2351,679,3030,71200,2010
54015,41.3,9572,9414,27,10,2428,30789,3530,2813,717,3530,76400,2010
54017,41.8,8035,7891,3,72,1999,30019,2860,2343,517,2860,75900,2010
54019,41.9,46138,42779,2214,429,12344,31912,18140,13946,4194,18140,67800,2010
54021,38.6,8394,6292,1171,412,1549,29706,2460,1758,702,2460,69000,2010
54023,42.8,11942,11650,75,102,3451,35593,4899,3905,994,4899,105300,2010
54025,44.5,35373,33284,1203,416,9977,33732,15302,11478,3824,15302,93900,2010
54027,41.4,23594,23327,40,137,5804,31792,9755,6594,3161,9755,134100,2010
54029,44.6,30866,29382,653,323,8882,38565,13296,9995,3301,13296,85300,2010
54031,40.8,13832,13241,155,385,3016,31347,4877,3824,1053,4877,130600,2010
54033,41.5,68490,65216,984,896,18968,39191,27740,20333,7407,27740,95500,2010
54035,41.6,29084,28493,4,163,8414,41406,11634,9256,2378,11634,102100,2010
54037,38.4,52033,44684,3374,2289,13590,65603,19164,14903,4261,19164,255800,2010
54039,42.3,192770,171404,10287,1867,51064,42669,82501,58837,23664,82501,98500,2010
54041,43.1,16406,16020,138,28,4243,33293,6527,4732,1795,6527,87400,2010
54043,40.7,21879,21593,53,67,6552,30868,8711,6784,1927,8711,65100,2010
54045,41.7,36564,35042,808,255,10514,35465,14740,10725,4015,14740,79700,2010
54047,43.7,22555,19929,2381,63,5490,22154,8338,6546,1792,8338,32800,2010
54049,41.3,56356,52937,1811,563,15027,38115,22744,17071,5673,22744,87500,2010
54051,43.6,33369,32537,118,271,9385,34419,13997,10921,3076,13997,77900,2010
54053,42.1,27016,26369,164,57,7594,36027,10932,8539,2393,10932,79400,2010
54055,41.9,61844,56581,3666,510,16011,32131,25344,18740,6604,25344,73500,2010
54057,41.3,27796,26440,873,208,7710,36571,11308,8695,2613,11308,114700,2010
54059,40.6,26956,26038,718,6,7487,32902,10936,8436,2500,10936,63900,2010
54061,29.3,92715,83514,3025,1593,18785,39167,35073,20758,14315,35073,145400,2010
54063,44.4,13495,13109,46,94,3922,39574,5594,4747,847,5594,95200,2010
54065,43.5,17409,16868,111,166,4082,37281,7068,5032,2036,7068,167100,2010
54067,43.3,26189,26047,7,67,7671,38457,10304,8451,1853,10304,73400,2010
54069,43,44582,41435,1498,438,11486,39669,18850,13201,5649,18850,94800,2010
54071,47.1,7773,7431,206,41,2211,33323,3516,2744,772,3516,95300,2010
54073,42.2,7664,7441,143,13,1674,38882,2591,2066,525,2591,89400,2010
54075,45.8,8808,8724,32,12,2703,32161,3812,3065,747,3812,100000,2010
54077,41.3,32976,31100,1140,380,9003,40753,12850,10623,2227,12850,87700,2010
54079,40.8,54940,52998,623,511,15929,52618,20975,18022,2953,20975,135200,2010
54081,40.8,78513,69125,6415,1060,21014,38036,31196,23899,7297,31196,88000,2010
54083,42.9,29233,28354,362,118,7691,36176,11319,8821,2498,11319,94100,2010
54085,43.3,10514,10346,4,79,2924,32619,4213,3273,940,4213,70000,2010
54087,42.8,15116,14175,0,116,4008,27428,6015,4580,1435,6015,75000,2010
54089,45.3,13847,13023,561,112,3196,27720,5075,4135,940,5075,74100,2010
54091,42.1,16732,16245,198,72,4588,36956,6579,5167,1412,6579,77000,2010
54093,45.4,7137,7090,8,19,2072,32712,3132,2491,641,3132,87900,2010
54095,44.1,9339,9207,12,23,2585,33496,3792,3133,659,3792,77700,2010
54097,41.3,23984,23301,135,216,6196,36114,9291,7355,1936,9291,99700,2010
54099,41.2,42647,41893,28,223,11756,35079,16751,12836,3915,16751,85500,2010
54101,43.8,9247,9067,0,109,2927,28025,4116,3256,860,4116,58500,2010
54103,44.1,16697,16444,42,82,4725,36636,6897,5519,1378,6897,82200,2010
54105,42.4,5753,5691,0,0,1697,36705,2364,1925,439,2364,61800,2010
54107,41.7,86731,83324,715,772,23934,42146,36222,26575,9647,36222,102500,2010
54109,42.3,23993,23495,174,34,6565,36343,9126,7431,1695,9126,59300,2010
55001,47.7,21044,19244,630,713,6317,39885,9341,7676,1665,9341,130700,2010
55003,40,16212,13622,59,298,4340,38111,6967,4924,2043,6967,103000,2010
55005,42.2,45915,43664,413,856,12937,42601,19421,14388,5033,19421,134500,2010
55007,48.2,15114,13119,71,150,4829,43176,6990,5716,1274,6990,157300,2010
55009,36,244376,206945,4475,16321,63331,52553,96937,64549,32388,96937,159100,2010
55011,42.8,13744,13292,7,190,3852,45302,5775,4497,1278,5775,130600,2010
55013,48.4,15749,14423,120,193,4935,39626,7414,5963,1451,7414,156100,2010
55015,37.5,47902,44612,140,1517,13905,61685,18265,15261,3004,18265,158700,2010
55017,39.8,61466,58370,732,771,16783,48672,24223,17984,6239,24223,146300,2010
55019,37.1,34552,32927,103,1072,9037,42777,13031,10296,2735,13031,110900,2010
55021,40.7,56350,53291,603,1378,15728,55910,22945,17315,5630,22945,177500,2010
55023,43.4,16801,16149,306,143,4568,39486,6891,5309,1582,6891,113900,2010
55025,34.3,477748,395558,22704,26419,113689,60519,196383,121917,74466,196383,230800,2010
55027,39.9,88935,81687,2347,3389,23499,52571,33929,25067,8862,33929,155900,2010
55029,48.7,27959,26783,174,588,9124,47775,13684,10615,3069,13684,189500,2010
55031,39.8,43907,40793,463,572,12159,43127,19138,13361,5777,19138,130200,2010
55033,33.3,43365,40846,218,623,10258,48376,15862,11320,4542,15862,152700,2010
55035,33.1,97381,90042,827,1762,23442,45846,39240,25441,13799,39240,147200,2010
55037,47.3,4587,4423,0,8,1467,40180,2048,1744,304,2048,123700,2010
55039,39.8,100919,93324,1055,4038,27406,51549,40484,29363,11121,40484,143000,2010
55041,43.4,9534,7883,126,135,2749,37627,4182,3152,1030,4182,117900,2010
55043,36.5,50716,48963,569,612,12333,43889,19157,14306,4851,19157,118300,2010
55045,40.9,36448,34909,198,871,10036,53088,14541,11272,3269,14541,150300,2010
55047,43.6,19107,18127,100,655,5311,47624,7940,6057,1883,7940,137500,2010
55049,40.5,23646,22925,140,296,6798,54737,9705,7550,2155,9705,155500,2010
55051,49.9,6075,5916,1,16,1783,35618,3016,2294,722,3016,106700,2010
55053,40.3,20284,17887,449,499,5637,43191,8269,6163,2106,8269,121400,2010
55055,37.9,82778,75575,461,5148,21864,54769,31442,22582,8860,31442,182500,2010
55057,43,26733,24832,315,640,7623,45664,11012,8705,2307,11012,115500,2010
55059,36.1,164328,130001,10424,18038,42208,54430,62226,42294,19932,62226,182400,2010
55061,41.2,20642,19879,24,410,5836,54152,8274,6757,1517,8274,144400,2010
55063,35.2,112819,103213,1550,1685,27454,49328,45501,30061,15440,45501,148700,2010
55065,41.1,16775,16103,40,418,4522,48114,6533,5174,1359,6533,117700,2010
55067,44.9,20218,19420,130,283,6175,41034,8805,7092,1713,8805,107500,2010
55069,44,29075,28131,46,332,8989,46625,13113,9801,3312,13113,131300,2010
55071,42.4,81678,75785,599,2336,22168,49354,34171,26251,7920,34171,124000,2010
55073,38.8,132644,120289,633,2645,36328,53471,52708,39797,12911,52708,139500,2010
55075,44.8,42019,40601,120,533,12173,39698,19171,14599,4572,19171,109700,2010
55077,46.6,15421,14744,41,329,4607,45012,6754,5404,1350,6754,141000,2010
55078,34.1,4251,519,25,250,1157,31076,1521,1069,452,1521,92600,2010
55079,33.7,937616,519621,245664,117045,219201,43215,379372,202656,176716,379372,165700,2010
55081,38.3,44053,40915,518,1518,11488,47333,17322,12522,4800,17322,126800,2010
55083,43,37737,36364,130,471,11578,46633,16442,13473,2969,16442,146300,2010
55085,47.2,36379,34978,161,412,11520,45857,17475,13594,3881,17475,172800,2010
55087,36.7,174457,157311,1461,5865,46389,55914,69062,50235,18827,69062,153500,2010
55089,42.4,85945,80495,1038,1904,24152,74996,33856,26523,7333,33856,255600,2010
55091,42.6,7517,7360,29,77,2070,48446,3092,2356,736,3092,138500,2010
55093,34.2,40530,38920,330,598,10207,60181,14817,11361,3456,14817,200200,2010
55095,42.1,44310,42698,122,609,12665,49806,18170,14893,3277,18170,170300,2010
55097,35.6,69437,64576,246,1748,17658,51456,27573,19318,8255,27573,143100,2010
55099,47.4,14452,13977,26,227,4349,41026,6825,5498,1327,6825,111500,2010
55101,38.4,194736,146535,20612,21155,50561,53855,75546,52833,22713,75546,175700,2010
55103,42.6,18205,17558,20,306,5043,43900,7530,5625,1905,7530,123000,2010
55105,37.5,159964,136476,7853,11195,42852,49716,62598,46005,16593,62598,138000,2010
55107,45.1,14855,14408,92,155,4383,38352,6660,5071,1589,6660,110200,2010
55109,36.2,82636,78415,679,1525,23362,67446,31824,24771,7053,31824,225700,2010
55111,39.9,60957,56845,454,2301,17113,50390,25438,18523,6915,25438,166400,2010
55113,46.2,16615,13181,8,250,5419,37091,7982,5725,2257,7982,168200,2010
55115,42.2,41842,37122,184,869,12059,45841,17174,13164,4010,17174,125100,2010
55117,39.4,115328,100928,1796,5956,30785,51127,46572,33654,12918,46572,151100,2010
55119,41.7,20557,20013,12,270,5985,44489,8821,6969,1852,8821,120100,2010
55121,40.7,28523,26717,106,1274,7817,46582,11502,8693,2809,11502,132800,2010
55123,41.2,29460,28653,67,339,8145,43632,11905,9400,2505,11905,131700,2010
55125,49.8,21750,18997,116,225,6963,41631,10560,8385,2175,10560,194900,2010
55127,37.5,101735,88979,967,9832,26137,54487,39082,27843,11239,39082,198000,2010
55129,46.7,16001,15351,114,67,4748,41641,7254,5953,1301,7254,148400,2010
55131,40,130206,123225,1058,3078,37322,64434,51458,40236,11222,51458,228000,2010
55133,41.3,386130,352099,4504,14895,109150,75064,151161,117491,33670,151161,262200,2010
55135,42.6,52533,50388,149,1210,14209,46876,21526,16231,5295,21526,137100,2010
55137,45.4,24631,22571,470,1220,7040,42540,10330,8460,1870,10330,136600,2010
55139,37.4,165032,150596,2631,5344,40637,50974,66694,45642,21052,66694,140500,2010
55141,42,74601,70337,365,1477,21217,47204,31979,24419,7560,31979,116500,2010
56001,26.4,34926,29805,409,2959,7149,42890,14591,7805,6786,14591,189500,2010
56003,42.1,11448,10289,8,862,3249,48270,4547,3518,1029,4547,116100,2010
56005,31.8,43179,38811,224,2922,11806,76576,16039,12141,3898,16039,197700,2010
56007,39.7,15624,12614,179,2424,4347,56565,6205,4424,1781,6205,129100,2010
56009,39.7,13404,12262,37,757,3675,54599,5564,3983,1581,5564,167500,2010
56011,44,6761,6603,0,132,1986,49890,2769,2090,679,2769,151100,2010
56013,38.7,38875,27902,143,2127,10542,46397,15541,11228,4313,15541,154400,2010
56015,43.6,12844,11335,26,1137,3341,42590,5241,3701,1540,5241,123100,2010
56017,48.9,4720,4585,0,43,1389,42469,2201,1410,791,2201,117800,2010
56019,46,8307,7846,0,235,2367,45638,3731,2725,1006,3731,208400,2010
56021,36.8,89221,72579,2105,11280,23771,52824,35790,24689,11101,35790,169900,2010
56023,37.5,17447,16395,5,645,4795,57794,6474,4971,1503,6474,196400,2010
56025,37,73520,65704,539,4822,19752,50936,29597,20844,8753,29597,173300,2010
56027,45.2,2430,2187,21,134,589,45813,939,599,340,939,107500,2010
56029,43.9,27574,25616,38,1288,7676,46637,11742,8071,3671,11742,191500,2010
56031,46.4,8655,8077,0,505,2438,42947,3737,2897,840,3737,127600,2010
56033,43.1,28380,26390,13,956,7541,48141,12172,8570,3602,12172,211900,2010
56035,39.5,9322,7546,2,1164,2370,70147,3148,2316,832,3148,278300,2010
56037,33.1,42266,34740,111,5849,11630,69828,16415,12096,4319,16415,169500,2010
56039,35.7,20802,17499,41,2697,4307,70271,7470,4542,2928,7470,723700,2010
56041,34.2,20537,18328,5,1636,5356,58346,7279,5365,1914,7279,171600,2010
56043,42.2,8271,6966,47,1013,2243,48379,3399,2409,990,3399,130000,2010
56045,42.3,7066,6653,4,195,2025,53853,3097,2412,685,3097,115200,2010
72001,34.8,19541,170,0,19316,4123,11983,5241,3832,1409,5241,87600,2010
72003,36.3,42232,2143,148,39796,10507,14103,13350,10615,2735,13350,88600,2010
72005,36.9,61965,1051,21,60592,14678,13956,19827,13668,6159,19827,106800,2010
72007,35.2,28827,289,0,28538,7170,14751,9084,6327,2757,9084,86100,2010
72009,36.1,26161,113,0,26048,6511,15487,8417,6405,2012,8417,90800,2010
72011,37.5,29254,347,20,28848,7126,15244,9215,7423,1792,9215,95700,2010
72013,37.7,97633,581,21,96952,24242,16564,31787,23921,7866,31787,95700,2010
72015,34.2,19607,171,19,19329,4420,14815,6102,4586,1516,6102,85700,2010
72017,34.7,24506,99,11,24396,6398,16124,8020,6252,1768,8020,104900,2010
72019,31.2,30272,82,0,30157,7299,14751,9033,6823,2210,9033,83500,2010
72021,37,212183,1792,266,209170,54711,25294,72259,53307,18952,72259,141300,2010
72023,38.6,50468,498,18,49863,11445,15809,15997,12625,3372,15997,110300,2010
72025,36.6,143301,1394,179,141614,36726,22951,48008,35423,12585,48008,131300,2010
72027,35.9,35381,156,54,35000,8365,14985,10702,8022,2680,10702,85200,2010
72029,34.4,47151,53,36,47042,10837,21934,13837,11357,2480,13837,116700,2010
72031,37.1,179356,1726,300,176676,45039,28262,61436,45092,16344,61436,151000,2010
72033,34.4,28663,115,89,28382,7251,18144,9486,6017,3469,9486,119800,2010
72035,36.4,48255,141,51,48045,11555,19040,15760,11224,4536,15760,98900,2010
72037,35.6,14493,102,44,14347,3290,18461,4649,3691,958,4649,97600,2010
72039,34.5,19067,49,0,18997,4663,13564,5736,4212,1524,5736,95400,2010
72041,34.6,43604,129,0,43451,10724,21293,13507,9961,3546,13507,106200,2010
72043,33.9,40229,143,11,40055,10038,15028,12692,10146,2546,12692,80100,2010
72045,33.9,20773,129,0,20644,5225,12927,6459,4535,1924,6459,81300,2010
72047,34,37312,317,0,36972,8650,14077,10872,8164,2708,10872,87300,2010
72049,39.9,1939,135,16,1786,398,19868,590,467,123,590,117900,2010
72051,35.6,37631,442,20,37063,9225,25473,12082,10267,1815,12082,141100,2010
72053,36.2,37875,366,60,37366,9384,19803,13003,9550,3453,13003,101500,2010
72054,34.5,12697,21,0,12676,3007,16246,3967,3083,884,3967,107200,2010
72055,35.8,19990,351,0,19639,4852,11870,6432,4409,2023,6432,74900,2010
72057,33.9,45416,127,0,45279,11097,17214,14736,10641,4095,14736,87400,2010
72059,35,21986,192,0,21794,5465,14243,6630,5192,1438,6630,74600,2010
72061,38.4,98875,1149,274,97358,25074,33279,34735,26539,8196,34735,201300,2010
72063,35,44073,316,49,43708,10355,27416,12818,10870,1948,12818,140700,2010
72065,36,41645,154,0,41411,10139,16246,12821,9702,3119,12821,93900,2010
72067,41.1,17213,242,24,16870,4533,19834,6197,4490,1707,6197,88900,2010
72069,37,58924,514,23,58210,13558,18354,18764,14576,4188,18764,108400,2010
72071,37,45681,277,10,45287,11065,13028,14721,9544,5177,14721,98700,2010
72073,32.1,16865,143,0,16722,3867,15556,4721,3182,1539,4721,94400,2010
72075,33.4,51020,129,0,50848,11919,16496,15466,11793,3673,15466,96000,2010
72077,33.6,39829,330,0,39445,9187,17694,12141,9193,2948,12141,109800,2010
72079,38.3,26000,195,19,25786,6361,14500,8520,5828,2692,8520,88500,2010
72081,36.2,31600,326,0,31102,8155,12199,10211,7053,3158,10211,92800,2010
72083,35.2,10156,39,0,10117,2863,13847,3509,2440,1069,3509,83000,2010
72085,34.5,38146,58,12,37978,8461,17680,11295,8569,2726,11295,114400,2010
72087,32.1,30703,16,13,30674,6931,19460,9069,7175,1894,9069,101700,2010
72089,35.9,20131,154,15,19944,4936,19672,6615,5145,1470,6615,109900,2010
72091,35.8,44631,292,0,44339,11239,16564,15363,11274,4089,15363,106700,2010
72093,35,6244,0,19,6225,1199,10932,1650,1156,494,1650,83900,2010
72095,37.1,12393,81,16,12296,2918,15225,3994,3237,757,3994,87100,2010
72097,36.4,91205,1019,146,89652,22259,14059,32521,19866,12655,32521,90000,2010
72099,34.1,40280,351,7,39858,9270,12841,11678,9343,2335,11678,92300,2010
72101,32,32339,95,48,32175,7768,13646,9068,7290,1778,9068,95000,2010
72103,33.6,26331,424,31,25863,6139,15250,8284,6666,1618,8284,91000,2010
72105,34,30460,164,0,30280,6882,14275,8244,6377,1867,8244,80500,2010
72107,32.3,23646,139,0,23447,5294,13713,6732,4855,1877,6732,84900,2010
72109,36.9,19552,176,83,19228,4738,14860,6499,5270,1229,6499,81800,2010
72111,32,24879,139,47,24661,5975,14872,7234,5699,1535,7234,76300,2010
72113,35.3,170920,918,72,169854,41452,16902,56157,38339,17818,56157,99700,2010
72115,35.5,25985,168,8,25773,5984,11943,8028,4896,3132,8028,103900,2010
72117,40.1,15203,1228,221,13725,3926,16067,5504,4346,1158,5504,112800,2010
72119,35.5,54270,249,31,53961,12881,20850,16775,13543,3232,16775,115200,2010
72121,37,25532,325,0,25207,6450,15497,8372,6368,2004,8372,90500,2010
72123,34.1,31265,71,32,31074,7659,13118,10161,7271,2890,10161,84500,2010
72125,38.1,35997,460,56,35481,8609,15016,12074,8963,3111,12074,88700,2010
72127,38.2,404748,4915,1419,397214,95344,23478,150331,85440,64891,150331,165700,2010
72129,35.6,41300,116,0,41080,9860,17477,12982,9473,3509,12982,110900,2010
72131,37.4,42982,426,9,42547,9890,12115,12668,9376,3292,12668,93600,2010
72133,32.5,23113,32,16,23065,5841,17605,7680,5691,1989,7680,94500,2010
72135,33.1,72756,358,19,72358,18154,25133,21850,18326,3524,21850,135100,2010
72137,35,90867,545,101,89934,22313,23297,30426,24033,6393,30426,120700,2010
72139,35.4,75464,626,14,74755,18651,30825,25108,18586,6522,25108,159100,2010
72141,36.5,33741,705,0,32628,7784,13509,10126,6589,3537,10126,90100,2010
72143,34.4,39807,491,24,39195,9210,16608,11893,9822,2071,11893,109900,2010
72145,35.5,60436,792,0,59616,14729,16530,18387,15626,2761,18387,109900,2010
72147,38.8,9313,347,46,8913,2018,16220,3231,2517,714,3231,115700,2010
72149,31.9,26565,48,10,26492,6284,15455,7512,5885,1627,7512,94300,2010
72151,35.3,38387,87,84,38113,9323,16894,11908,9127,2781,11908,90800,2010
72153,36.7,43082,478,29,42568,11020,14314,14080,10169,3911,14080,87800,2010
01001,36.4,53944,41653,9692,1298,14631,53899,19998,15548,4450,19998,137500,2011
01003,41.4,179523,150413,16913,7435,50922,51321,70757,53939,16818,70757,175700,2011
01005,38.3,27546,12941,12571,1344,6634,34041,9589,6371,3218,9589,91600,2011
01007,39.1,22746,17084,5142,375,5334,40506,7225,5998,1227,7225,87500,2011
01009,38.8,57140,50891,762,4475,15473,45404,20954,16747,4207,20954,111500,2011
01011,41.2,10877,2431,7619,684,2422,31955,3760,2994,766,3760,68000,2011
01013,40,20860,11338,9091,91,5329,31273,8090,5749,2341,8090,74300,2011
01015,38.4,117614,86884,23919,3720,30469,39467,45923,32171,13752,45923,99600,2011
01017,40.6,34375,19987,13490,540,9275,32186,13562,9677,3885,13562,82400,2011
01019,44.2,25819,23758,1269,331,8355,37833,11508,8721,2787,11508,96200,2011
01021,37.3,43444,35501,4051,3052,12236,40418,16277,12259,4018,16277,104300,2011
01023,43.6,13953,7727,6006,37,3468,32188,5165,4382,783,5165,61400,2011
01025,39.7,26046,14088,10872,287,6079,29668,9114,7027,2087,9114,79900,2011
01027,41.7,14010,11228,2213,378,4204,35410,5837,4462,1375,5837,83400,2011
01029,40.6,14881,13822,552,294,4203,38785,5521,4333,1188,5521,88200,2011
01031,37.7,49221,35761,8512,2921,13009,42065,18799,13268,5531,18799,121800,2011
01033,41.7,54478,43457,8761,1115,15597,40247,22322,16231,6091,22322,97300,2011
01035,43.1,13286,6843,5903,31,3139,27977,4712,3739,973,4712,76700,2011
01037,43.7,11303,7418,3598,196,3099,37191,4667,3950,717,4667,79200,2011
01039,42.1,37736,31719,4728,500,10273,33544,14742,10906,3836,14742,86100,2011
01041,39.7,13938,9984,3131,193,3789,38041,5650,3903,1747,5650,75400,2011
01043,39.9,80246,74470,689,3322,22464,38703,31364,23618,7746,31364,102300,2011
01045,36,49920,35347,9611,2712,13381,45491,19454,11916,7538,19454,96800,2011
01047,36.9,43868,12911,30169,316,10742,26909,16913,10406,6507,16913,70200,2011
01049,37.3,70608,58091,1114,9100,19470,36853,26196,20422,5774,26196,87400,2011
01051,37.6,78641,58959,15672,2071,20910,54831,28085,21601,6484,28085,143200,2011
01053,38.6,38081,23439,12073,733,9445,31638,13860,9982,3878,13860,84500,2011
01055,39.9,104216,82881,15634,3371,28770,37772,41160,30163,10997,41160,102000,2011
01057,42.7,17361,14911,1923,198,5111,33378,7240,5337,1903,7240,72200,2011
01059,38.5,31532,25353,1271,4417,8782,35831,12376,8527,3849,12376,81400,2011
01061,41.8,26646,22569,2557,877,7539,35237,10892,7758,3134,10892,82000,2011
01063,41.5,9170,1644,7489,0,2067,23004,3357,2396,961,3357,77100,2011
01065,39.5,15972,6337,9424,54,3823,29236,5858,4443,1415,5858,73500,2011
01067,42.5,17240,11603,4808,361,4866,39948,6783,5471,1312,6783,95100,2011
01069,38.2,100310,69201,25477,2799,26423,41766,38500,25699,12801,38500,120500,2011
01071,41.5,53357,48091,1829,1285,15278,36383,21629,16477,5152,21629,88900,2011
01073,37,657486,342391,275075,23994,167654,45750,259394,171152,88242,259394,141700,2011
01075,42.6,14644,12574,1762,179,4318,34711,6016,4414,1602,6016,70000,2011
01077,40.3,92269,79065,9299,1995,24955,39702,38315,27330,10985,38315,108100,2011
01079,40.4,34250,26325,3812,604,10201,40009,13531,10653,2878,13531,95000,2011
01081,28.9,137855,96557,31225,4374,32752,42320,55176,34845,20331,55176,144100,2011
01083,38.7,80966,63976,10506,4233,22361,47199,30821,23781,7040,30821,128700,2011
01085,40.2,11538,2924,8477,82,2926,27905,4215,3129,1086,4215,64900,2011
01087,35.8,21489,3268,17603,239,4894,29355,8031,5454,2577,8031,77900,2011
01089,37.1,329299,219333,77394,14124,85110,57453,128869,90358,38511,128869,160400,2011
01091,40.2,21130,9658,11235,77,5677,35165,8359,6138,2221,8359,88500,2011
01093,42,30771,28497,1155,611,8947,31799,12806,9641,3165,12806,75900,2011
01095,38.2,92052,77815,1535,10557,24635,38563,34587,24987,9600,34587,107000,2011
01097,36.4,410520,243565,141738,9430,106054,42187,155638,105725,49913,155638,124100,2011
01099,40,23159,12751,9465,241,6096,29849,8943,6666,2277,8943,77900,2011
01101,34.6,228939,89974,123474,7677,56657,44587,88091,55559,32532,88091,124000,2011
01103,38.6,118521,92586,13787,8529,32512,45564,46129,33279,12850,46129,117300,2011
01105,37.1,10620,3162,7286,25,2708,27222,3690,2348,1342,3690,62200,2011
01107,40.8,19765,11033,8306,266,5302,29096,7852,5675,2177,7852,81200,2011
01109,31.6,32471,18675,11764,731,8019,31179,12967,7317,5650,12967,102800,2011
01111,40.3,22838,17196,4786,601,6104,35823,8949,6630,2319,8949,91200,2011
01113,36.4,52490,27480,21523,1894,13022,33754,20453,12919,7534,20453,96200,2011
01115,38.2,82363,71934,7196,1690,22700,49200,30588,24869,5719,30588,129700,2011
01117,36.8,191705,154877,20109,10562,52627,68883,72694,57983,14711,72694,198900,2011
01119,36.3,13758,3346,10145,106,3181,21964,5036,3403,1633,5036,75300,2011
01121,39.2,82265,53158,26201,1632,22457,36609,31597,22352,9245,31597,89100,2011
01123,41.3,41614,28932,11104,968,11481,39423,16404,12050,4354,16404,96600,2011
01125,31.3,191489,124560,56908,5580,43600,43538,68711,43808,24903,68711,150600,2011
01127,41.2,67308,60898,3628,1294,18193,37161,25779,19877,5902,25779,83600,2011
01129,39,17487,11407,4371,110,4679,40286,6489,5513,976,6489,85600,2011
01131,37.8,11862,3169,8633,24,2670,23750,3732,2937,795,3732,54500,2011
01133,42.6,24593,23327,159,648,6734,32557,9568,7174,2394,9568,83500,2011
02013,39.3,3084,298,471,494,204,57083,336,173,163,336,121700,2011
02016,41.5,5488,1834,349,641,733,75179,1255,481,774,1255,193800,2011
02020,33,287390,181797,15062,21645,70070,75485,105123,64529,40594,105123,276200,2011
02050,25.9,16973,1901,77,226,3272,52063,4295,2768,1527,4295,171100,2011
02060,41.9,1035,536,1,45,304,80000,424,233,191,424,172300,2011
02068,42.8,1770,1481,18,75,389,82898,699,469,230,699,179500,2011
02070,29.1,4845,899,16,107,911,57681,1369,778,591,1369,182500,2011
02090,30.8,96161,71228,4121,5646,24344,68922,35583,21079,14504,35583,212800,2011
02100,44,2519,2032,5,31,742,51667,1176,804,372,1176,173800,2011
02105,47,2029,978,9,117,605,49545,966,604,362,966,208200,2011
02110,38.6,31244,21153,237,1666,8024,77465,12379,7982,4397,12379,299100,2011
02122,40.8,54718,45470,284,1702,14673,59256,22390,16459,5931,22390,200000,2011
02130,37.9,13417,8936,55,579,3392,57243,5479,3142,2337,5479,254900,2011
02150,31.9,13488,7101,150,1053,3158,66326,4445,2387,2058,4445,214000,2011
02164,31.2,1540,468,7,77,412,51429,562,349,213,562,157600,2011
02170,34.9,86817,72082,731,3278,22192,70343,30609,24077,6532,30609,216500,2011
02180,28.1,9443,1526,148,129,1896,52435,2756,1459,1297,2756,144200,2011
02185,29.2,9088,2824,47,319,1394,76667,1966,874,1092,1966,137500,2011
02188,25.8,7532,876,26,88,1384,59893,1797,978,819,1797,131100,2011
02195,42.4,3831,2747,74,142,900,64216,1564,1194,370,1564,182200,2011
02198,39.5,5541,2736,7,134,1501,45513,2351,1599,752,2351,145000,2011
02220,38.8,8879,5693,34,444,2527,69798,3632,1947,1685,3632,315200,2011
02230,40.4,1105,905,10,16,275,73000,430,264,166,430,310300,2011
02240,36.5,7000,5510,159,226,1747,59917,2523,1645,878,2523,158900,2011
02261,40.1,9596,6867,52,106,2524,62238,3793,2897,896,3793,167700,2011
02270,21.7,7473,249,9,33,1387,39583,1714,1149,565,1714,85100,2011
02275,44.1,2353,1627,21,53,610,50000,1004,763,241,1004,168500,2011
02282,39.4,731,276,40,60,181,74844,259,133,126,259,155500,2011
02290,35.3,5613,1226,4,80,1197,35335,2041,1430,611,2041,102500,2011
04001,31.9,70906,14232,288,4342,13322,31011,18953,14442,4511,18953,83200,2011
04003,39.8,130464,76561,4595,41860,33276,45906,48917,33855,15062,48917,155700,2011
04005,30.8,132978,73449,1551,17799,29142,49615,45266,27757,17509,45266,246600,2011
04007,47.3,53380,35184,226,9479,13071,37905,19924,15301,4623,19924,154200,2011
04009,31.7,36720,19273,767,11063,8232,43083,11100,8239,2861,11100,121100,2011
04011,35,8472,4093,55,3932,2386,49390,3292,1576,1716,3292,73200,2011
04012,52.8,20521,12878,214,4732,6309,32220,10374,7736,2638,10374,95700,2011
04013,34.4,3798374,2245777,176642,1115360,920943,55099,1394016,908339,485677,1394016,219300,2011
04015,46.8,200690,159936,1771,29469,53147,40573,80389,57273,23116,80389,158200,2011
04017,34.3,107418,46935,943,11486,25403,38975,34921,25421,9500,34921,130400,2011
04019,37.5,974181,542627,32097,332417,238175,46341,382366,244641,137725,382366,190500,2011
04021,35.6,351709,205003,14784,101324,88028,51212,121281,92825,28456,121281,144500,2011
04023,35,46727,7472,137,38446,10154,38092,13114,9037,4077,13114,152700,2011
04025,48.6,210838,173140,1043,28266,57057,44084,90309,64863,25446,90309,216900,2011
04027,33.8,193995,69873,3386,114400,54175,41441,69993,49276,20717,69993,138600,2011
05001,41.7,19146,13648,4664,472,5169,38986,8089,5388,2701,8089,79000,2011
05003,39.1,21966,14942,5654,1011,6204,35657,8828,6529,2299,8828,61800,2011
05005,50.4,41527,39780,108,716,12460,35589,18581,14374,4207,18581,121900,2011
05007,34.5,216314,166535,2389,32883,58751,52159,80140,55708,24432,80140,155700,2011
05009,41.2,36908,35137,96,690,10096,37703,14596,10623,3973,14596,108400,2011
05011,39.7,11580,6748,3287,1417,3492,32337,4906,3456,1450,4906,63900,2011
05013,40.4,5417,3978,1287,66,1386,30625,2037,1672,365,2037,51300,2011
05015,43.6,27145,22841,86,3390,7782,36031,11418,8197,3221,11418,118200,2011
05017,42.5,11947,4804,6510,514,3047,23954,4674,3215,1459,4674,54700,2011
05019,33.1,23066,16222,5533,912,5101,32998,8072,5397,2675,8072,78700,2011
05021,42.8,16136,15627,54,201,4479,31135,6850,5087,1763,6850,59100,2011
05023,46.2,25788,24679,109,504,7496,38510,10678,8342,2336,10678,116800,2011
05025,39.5,8738,7398,1120,142,2442,34292,3292,2556,736,3292,74900,2011
05027,36.6,24607,14617,9066,518,6518,36163,9799,6965,2834,9799,79500,2011
05029,40,21164,17430,2508,757,5449,31890,8137,5992,2145,8137,82900,2011
05031,33.2,95034,76339,12102,4114,24943,40221,36815,22171,14644,36815,111900,2011
05033,37.7,61336,53295,832,3666,17578,40409,23174,16619,6555,23174,99400,2011
05035,33.7,50701,23183,25586,1050,13416,35264,18757,10665,8092,18757,99200,2011
05037,39,17992,13359,4017,256,4956,38432,6823,4638,2185,6823,73600,2011
05039,43.4,8200,4446,3559,178,2048,30011,3065,2129,936,3065,58400,2011
05041,38.8,13131,6209,6236,549,3547,30786,5313,3126,2187,5313,58100,2011
05043,37.3,18499,12553,5163,442,4850,32038,7378,4903,2475,7378,73500,2011
05045,31.5,111058,91882,11329,4196,28340,47649,41540,27392,14148,41540,130900,2011
05047,41,18157,17016,142,383,4855,34819,6763,5101,1662,6763,85800,2011
05049,47,12301,11860,38,103,3145,33281,4819,3779,1040,4819,87300,2011
05051,44.3,95914,80601,7915,4514,25540,38210,40002,28036,11966,40002,128400,2011
05053,39.7,17767,16677,410,371,5024,50927,6629,5362,1267,6629,102500,2011
05055,37.6,41764,39816,244,903,11683,39090,16378,10864,5514,16378,92800,2011
05057,38.3,22658,12842,6802,2627,6098,34885,8719,6086,2633,8719,69000,2011
05059,39.5,32797,27647,3363,894,8230,38188,11998,8945,3053,11998,81600,2011
05061,38.8,13786,9303,2922,1295,3620,37146,5015,3382,1633,5015,71900,2011
05063,38.3,36279,32691,780,1975,10415,34878,14776,10645,4131,14776,86700,2011
05065,46.6,13600,12905,256,113,4162,31865,5891,4486,1405,5891,79200,2011
05067,40.8,17969,14156,3006,418,4221,31352,6383,4513,1870,6383,58100,2011
05069,36.7,77693,32600,42329,1236,18722,37682,28062,18105,9957,28062,78400,2011
05071,37.3,25408,21310,382,3012,6612,31400,9626,6761,2865,9626,86200,2011
05073,43,7691,4624,2843,116,1853,30152,2746,2043,703,2746,50600,2011
05075,39,17336,16760,116,163,4575,32337,6693,4673,2020,6693,58700,2011
05077,41,10563,4393,5910,171,2185,25270,3484,2229,1255,3484,51600,2011
05079,36.2,14141,9255,4280,400,2925,31480,4073,2783,1290,4073,61900,2011
05081,42.1,13113,9757,2597,350,3737,38564,5369,4181,1188,5369,78200,2011
05083,41.3,22502,20763,250,541,6042,38447,8285,6478,1807,8285,80200,2011
05085,35.4,67189,59032,4258,2170,18672,51096,24667,18310,6357,24667,117200,2011
05087,39.6,15626,14396,32,713,4303,35579,5887,4569,1318,5887,99400,2011
05089,49.7,16744,16018,1,250,4948,34063,7055,5754,1301,7055,92100,2011
05091,37.7,43266,30636,10405,1103,11390,40200,16552,10864,5688,16552,89400,2011
05093,34.6,46608,28300,15791,1658,12126,34267,17136,10142,6994,17136,72400,2011
05095,43.3,8322,4666,3402,131,2308,28306,3462,2177,1285,3462,58900,2011
05097,46.2,9492,8815,21,334,2658,34934,3725,3151,574,3725,75500,2011
05099,39.6,9078,5873,2859,218,2574,38006,3707,2722,985,3707,57800,2011
05101,46,8353,7915,35,39,2575,29702,3506,2881,625,3506,76400,2011
05103,42.4,26137,14697,10414,423,7358,33008,10782,7553,3229,10782,63400,2011
05105,42.1,10450,9797,255,215,2895,42514,4013,3321,692,4013,82400,2011
05107,36.4,22055,7666,13906,286,5511,28225,8102,4506,3596,8102,60400,2011
05109,38.8,11288,9950,398,693,3048,32457,4123,3093,1030,4123,74900,2011
05111,39.2,24622,21923,1690,543,6329,31939,9427,6228,3199,9427,66000,2011
05113,43.2,20524,18489,36,1130,5668,32395,7979,6184,1795,7979,82500,2011
05115,35.4,61166,53388,1936,3891,15955,40325,22599,15717,6882,22599,103300,2011
05117,44.2,8768,7486,1127,88,2613,36194,3685,2714,971,3685,73800,2011
05119,35.9,379981,212602,131509,20636,96484,45897,154346,93485,60861,154346,139800,2011
05121,41.5,18015,17258,66,273,5122,33072,7271,5500,1771,7271,69800,2011
05123,36.9,28195,11954,14591,1177,5948,26360,9060,5007,4053,9060,66400,2011
05125,38.4,105033,93817,4740,3726,29025,52982,40132,30873,9259,40132,135300,2011
05127,40.3,11232,9623,30,765,3070,38910,4156,3098,1058,4156,76700,2011
05129,46.5,8192,7808,0,115,2239,29384,3421,2571,850,3421,79000,2011
05131,36.6,124961,91649,7312,14809,32225,40680,48441,30679,17762,48441,113100,2011
05133,34.3,16841,10452,674,5011,4282,35289,5825,4239,1586,5825,73900,2011
05135,46.4,17386,16543,59,267,4614,29590,7106,5791,1315,7106,77300,2011
05137,46.7,12395,12129,7,162,3422,31364,5141,4117,1024,5141,93200,2011
05139,39.8,41879,25964,13751,1393,11481,37794,16757,11702,5055,16757,72300,2011
05141,46.3,17255,16261,186,432,4710,32906,7097,5474,1623,7097,81600,2011
05143,30.8,200621,149973,6248,30130,49183,41474,76841,43239,33602,76841,153700,2011
05145,36.1,76041,68295,3040,2757,20829,41618,29529,20128,9401,29529,94400,2011
05147,43.4,7379,5113,2117,34,2105,27047,3256,1917,1339,3256,57300,2011
05149,38.1,21995,16988,265,4068,5683,37477,7927,5613,2314,7927,79900,2011
06001,36.4,1494876,517548,182827,332103,344539,70821,536160,292447,243713,536160,558300,2011
06003,40.4,1167,765,0,82,225,59018,357,287,70,357,395600,2011
06005,48,38244,30589,834,4677,9647,56180,14283,11213,3070,14283,318400,2011
06007,37.2,219309,165531,3105,30476,52550,42971,85219,51406,33813,85219,254900,2011
06009,49,45794,38272,489,4688,13084,55256,18865,14839,4026,18865,312000,2011
06011,33.5,21297,8735,185,11460,5031,49558,6989,4436,2553,6989,244200,2011
06013,38.3,1037817,503705,92044,248089,262415,79135,370925,253163,117762,370925,490200,2011
06015,38.9,28561,18704,911,5003,6196,37588,9818,6034,3784,9818,239800,2011
06017,43.1,179878,144557,1331,21222,49539,68815,68812,51804,17008,68812,409400,2011
06019,30.6,920623,306388,44217,458069,207355,46903,285338,156979,128359,285338,236400,2011
06021,35.3,28027,15841,231,10270,6885,43239,9483,6281,3202,9483,233800,2011
06023,37.3,133585,103777,1545,12771,31619,40376,53724,30802,22922,53724,314400,2011
06025,31.8,171343,24364,5464,136376,38398,39402,48117,26815,21302,48117,169600,2011
06027,45.1,18457,12307,190,3445,4634,49571,7910,4960,2950,7910,271100,2011
06029,30.6,829254,325055,45154,402444,188387,48021,250999,150867,100132,250999,196000,2011
06031,31,152335,54952,10526,76401,31701,48838,40716,22251,18465,40716,208100,2011
06033,44.3,64392,47937,1414,10784,16157,39525,25654,16737,8917,25654,235900,2011
06035,37,35001,23314,2997,6075,6717,52484,10097,6580,3517,10097,199200,2011
06037,34.6,9787747,2749159,816625,4644328,2168086,56266,3218518,1539554,1678964,3218518,478300,2011
06039,33.2,149611,58157,4735,79037,32655,47724,42032,26132,15900,42032,245500,2011
06041,44.3,250666,184503,6957,37344,63729,89605,102832,64786,38046,102832,840900,2011
06043,48.4,18290,15209,180,1727,5221,49174,7607,5394,2213,7607,248900,2011
06045,41.4,87525,60561,737,18964,21596,44527,34102,21020,13082,34102,380800,2011
06047,29.5,253606,82235,8925,137974,57841,43945,74079,40924,33155,74079,197700,2011
06049,46.5,9587,7570,108,1290,2496,35402,3947,2703,1244,3947,162500,2011
06051,36.5,14016,9623,121,3613,3330,60469,5416,3096,2320,5416,428600,2011
06053,32.8,411385,138147,11908,224435,90051,59737,125217,64315,60902,125217,497400,2011
06055,39.5,135377,77582,2635,42603,33572,68641,49640,31441,18199,49640,521700,2011
06057,47.3,98392,85453,455,8185,27689,58077,41561,30473,11088,41561,412600,2011
06059,36,2989948,1339135,45836,994279,702684,75762,987164,595444,391720,987164,575100,2011
06061,40,343554,262970,4297,43268,92405,74645,130736,94539,36197,130736,387400,2011
06063,49,20192,17254,253,1617,5615,44151,9434,6592,2842,9434,266100,2011
06065,33.5,2154844,867229,128231,968700,497596,58365,672896,465385,207511,672896,284100,2011
06067,34.7,1408480,690766,139399,298709,333894,56553,510976,299603,211373,510976,285000,2011
06069,33.9,54873,21175,490,30497,13326,65570,16785,10701,6084,16785,432900,2011
06071,31.4,2023452,685741,168190,984022,457545,55853,598822,384624,214198,598822,278400,2011
06073,34.6,3060849,1500123,146379,967858,704879,63857,1064048,587778,476270,1064048,455000,2011
06075,38.4,797983,334808,47345,119029,151383,72947,338366,125502,212864,338366,767300,2011
06077,32.5,680277,248594,46907,260636,157875,53764,212902,129293,83609,212902,264600,2011
06079,39.1,267871,191177,5625,54537,64511,58630,101993,61628,40365,101993,480200,2011
06081,39.2,711622,306965,19352,177003,173905,87633,256423,154127,102296,256423,763100,2011
06083,33.4,419793,205066,6995,175692,91373,61896,141635,75889,65746,141635,523800,2011
06085,36,1762754,632114,41881,468262,424623,89064,599652,351897,247755,599652,681100,2011
06087,36.7,259402,156125,2472,81507,58859,66030,93834,55702,38132,93834,613500,2011
06089,41.6,177231,146558,1610,14622,45780,44058,69147,45151,23996,69147,246800,2011
06091,51.5,3277,2968,38,247,815,50308,1328,1020,308,1328,304700,2011
06093,46.9,44687,35688,516,4544,12389,37865,19782,12823,6959,19782,232200,2011
06095,36.7,411620,169645,58884,97268,99800,69914,139312,90365,48947,139312,340100,2011
06097,39.7,478551,320066,6808,116222,116736,64343,184170,113303,70867,184170,477300,2011
06099,32.6,512469,242716,13329,211811,122902,50671,164933,100226,64707,164933,232000,2011
06101,34.4,94192,48205,1670,26642,23644,50010,31668,19289,12379,31668,233000,2011
06103,39.4,62985,45591,418,13491,15931,38753,23810,15336,8474,23810,208000,2011
06105,49.3,13711,11446,53,924,3509,37672,5731,4148,1583,5731,264200,2011
06107,29.5,436234,145490,5453,260798,100840,43550,128324,75640,52684,128324,191500,2011
06109,47.2,55736,45448,1154,5861,14391,47359,22157,15679,6478,22157,304700,2011
06111,36.2,815745,402322,12905,323735,196174,76728,264982,174310,90672,264982,515900,2011
06113,30.1,198889,99980,4674,59340,43299,57920,69860,37743,32117,69860,365500,2011
06115,31.7,71817,42295,1849,17687,17327,46617,23885,14166,9719,23885,194200,2011
08001,32.2,434295,233495,12633,162203,105621,56089,149508,100900,48608,149508,192300,2011
08003,32,15395,7618,52,6962,3718,38299,5743,3753,1990,5743,130400,2011
08005,35.6,563508,360633,54215,101797,145055,59937,221136,143953,77183,221136,231200,2011
08007,47.1,12152,9755,25,2105,2971,60170,3951,3088,863,3951,303800,2011
08009,47.2,3807,3342,45,315,1089,37111,1675,1265,410,1675,71500,2011
08011,38,6164,3643,373,1805,1356,35667,1975,1298,677,1975,74300,2011
08013,35.5,293205,232983,2152,38543,69809,66479,118545,76150,42395,118545,353000,2011
08014,36.6,54592,43423,501,6013,13814,76531,20841,15021,5820,20841,270500,2011
08015,46.8,17707,15336,489,1620,4965,43684,7715,5750,1965,7715,244600,2011
08017,40.6,2247,1936,3,285,531,47188,869,692,177,869,83200,2011
08019,45.2,9083,8381,11,404,2342,62756,4031,3243,788,4031,279600,2011
08021,38.4,8228,3443,41,4512,2235,34435,3062,2363,699,3062,110200,2011
08023,46.8,3556,1096,13,2241,814,25949,1325,1017,308,1325,102600,2011
08025,39.6,5866,3539,525,1612,833,40636,1180,917,263,1180,83600,2011
08027,52.7,3853,3535,9,179,1117,43358,1827,1536,291,1827,225600,2011
08029,45.7,30666,25487,375,4213,8483,41856,12660,9439,3221,12660,198400,2011
08031,33.7,590507,307312,58315,188660,123510,47499,258132,133458,124674,258132,243400,2011
08033,43.7,2043,1899,0,64,596,44077,871,705,166,871,130800,2011
08035,36.2,280643,239532,3007,20880,78457,101193,100795,82110,18685,100795,337900,2011
08037,33.6,51457,34866,137,15158,11297,70914,18362,11539,6823,18362,530200,2011
08039,42.3,22859,20675,107,1263,6502,79367,8175,7405,770,8175,344200,2011
08041,34.2,611377,442309,34506,90330,156546,57079,230620,151292,79328,230620,217000,2011
08043,42.9,47040,36063,2642,5778,11058,38979,17294,12427,4867,17294,158200,2011
08045,34.2,55696,38888,87,15163,13637,63929,20186,13199,6987,20186,343700,2011
08047,44.7,5241,4765,98,237,1364,59394,2442,1722,720,2442,320700,2011
08049,41.1,14634,13150,31,1055,3229,64281,5186,3914,1272,5186,283200,2011
08051,33.5,15274,13590,88,1187,3402,50073,6351,3695,2656,6351,338100,2011
08053,54.9,731,701,0,28,221,77321,322,253,69,322,284800,2011
08055,50.8,6829,3709,187,2320,1833,29737,3096,2137,959,3096,149100,2011
08057,45.8,1494,1368,4,112,527,48571,736,532,204,736,122600,2011
08059,40,532243,426617,5074,74786,143504,67827,217763,155390,62373,217763,259400,2011
08061,43.2,1728,1630,1,60,474,41542,719,512,207,719,75100,2011
08063,38.7,8178,6308,262,1462,1982,43194,3003,2113,890,3003,115900,2011
08065,34.5,7010,4003,49,2729,1453,40543,2648,1784,864,2648,171600,2011
08067,38.1,50820,40851,242,5961,13005,56910,20769,14369,6400,20769,342800,2011
08069,35.1,296107,250577,2111,30818,75398,57215,118791,79621,39170,118791,244600,2011
08071,43.6,15549,8379,245,6397,4127,40617,6356,4388,1968,6356,147600,2011
08073,39.9,5462,4243,450,629,1199,43375,1930,1366,564,1930,104600,2011
08075,38.1,22417,18479,208,3422,5521,42324,8126,5709,2417,8126,121400,2011
08077,37.9,144766,120692,826,18831,38621,52986,58288,41928,16360,58288,222800,2011
08079,58.5,723,699,0,19,240,54375,368,316,52,368,284700,2011
08081,36.4,13586,11214,42,1869,3681,50758,5347,3979,1368,5347,178400,2011
08083,42.5,25372,19138,11,2766,7536,45623,10950,7785,3165,10950,191500,2011
08085,42,40812,31768,173,7812,11471,47479,16591,12083,4508,16591,202200,2011
08087,36.2,27943,17386,757,9350,7347,42792,10513,6664,3849,10513,136700,2011
08089,40.4,18795,10641,88,7468,4894,31246,7453,4793,2660,7453,93300,2011
08091,47.4,4371,4063,0,166,1222,61935,1688,1274,414,1688,442600,2011
08093,46.2,16259,15224,5,760,4619,61284,7000,6209,791,7000,246100,2011
08095,42.1,4391,3492,1,795,1190,44717,1792,1309,483,1792,121200,2011
08097,42.6,16709,14747,17,1428,3878,68242,7401,4931,2470,7401,664300,2011
08099,35.8,12615,8115,6,4373,3355,34513,4996,3318,1678,4996,83100,2011
08101,38.6,157946,85876,2607,64736,40178,41273,61858,42381,19477,61858,140700,2011
08103,38.2,6616,5750,45,596,1655,63125,2499,1822,677,2499,201600,2011
08105,41.2,11913,6766,41,4950,2619,37885,3960,2890,1070,3960,141600,2011
08107,39,23201,21147,0,1463,6595,64230,9929,7200,2729,9929,434700,2011
08109,43.1,6165,3352,19,2531,1652,33672,2695,1906,789,2695,131400,2011
08111,39.3,801,614,0,154,157,36378,404,192,212,404,259500,2011
08113,38.6,7383,6524,2,603,1890,66789,3453,2110,1343,3453,487100,2011
08115,50.4,2390,2060,7,243,663,36797,1070,796,274,1070,83500,2011
08117,36.3,27496,22928,136,3703,5896,67915,11001,7545,3456,11001,465200,2011
08119,46.6,23035,20877,160,1193,6538,57931,9051,7647,1404,9051,229600,2011
08121,44.2,4709,4232,7,426,1478,43945,2089,1477,612,2089,117000,2011
08123,32.9,248441,168360,1920,70017,62837,55825,88242,62696,25546,88242,193300,2011
08125,36.2,9960,7795,23,1985,2612,44991,3839,2630,1209,3839,117700,2011
09001,39.3,911196,609542,93170,149907,229222,82558,332139,233684,98455,332139,466700,2011
09003,39.8,890588,594243,108331,132983,227717,64007,348438,230923,117515,348438,248000,2011
09005,44,189719,173539,2071,8238,52009,71497,76477,60350,16127,76477,279600,2011
09007,42.6,165274,142611,7018,7634,44652,77095,66798,50865,15933,66798,306900,2011
09009,39,858759,584928,99843,125017,215884,62497,330396,214190,116206,330396,270900,2011
09011,40,272891,215051,13504,22261,70795,67010,107115,74325,32790,107115,265700,2011
09013,37.6,151774,133197,4050,6417,38316,80333,54386,41529,12857,54386,266300,2011
09015,39.1,117971,100948,2038,10950,30229,60063,44366,31473,12893,44366,227000,2011
10001,36.4,159936,105374,36822,8975,40837,54783,57629,41713,15916,57629,208300,2011
10003,37,536478,334185,123979,45186,134758,64158,199922,140936,58986,199922,254400,2011
10005,45.1,194442,147394,24444,16035,51162,53215,75286,60159,15127,75286,246900,2011
11001,34.1,593955,202229,304769,53372,109514,61835,260136,111381,148755,260136,442600,2011
12001,29.6,246203,157403,48280,20518,51981,41373,97542,53129,44413,97542,185100,2011
12003,35.9,26863,22093,3688,582,6520,47041,8333,6341,1992,8333,142600,2011
12005,39,167645,133206,17056,7894,44095,48225,68819,45222,23597,68819,168400,2011
12007,38.4,28701,21104,5878,1044,6396,41397,9188,7034,2154,9188,121400,2011
12009,45.1,542320,422475,52235,42694,143017,50068,219669,165493,54176,219669,171200,2011
12011,39.4,1742012,776876,443823,428881,417862,51782,665037,453419,211618,665037,225300,2011
12013,39.1,14530,11292,2099,727,3349,31142,4796,3547,1249,4796,80200,2011
12015,55.4,160095,137721,8443,9125,47415,45112,71059,57063,13996,71059,166700,2011
12017,53.8,141157,126719,3848,6444,39352,38189,59915,49936,9979,59915,134800,2011
12019,37.8,188890,146430,18104,14156,51783,59994,67592,52407,15185,67592,178900,2011
12021,46.4,320087,211481,20393,81813,81277,56876,119554,90948,28606,119554,317200,2011
12023,39.7,67287,50361,11885,3261,15973,38589,24127,16905,7222,24127,127100,2011
12027,37.7,34669,19546,4371,10258,7294,36407,10462,7912,2550,10462,114900,2011
12029,44.8,16317,14826,905,327,3580,34243,5380,4336,1044,5380,104400,2011
12031,35.5,860479,491013,248679,63213,209148,49964,330821,208992,121829,330821,170300,2011
12033,37.5,297668,198167,65973,13801,71877,43707,111928,75363,36565,111928,145000,2011
12035,47.2,94431,72289,10221,8091,26273,48708,36232,29418,6814,36232,201300,2011
12037,42.6,11531,9195,1638,469,3015,37017,4618,3047,1571,4618,170100,2011
12039,38.3,46205,15419,25585,4344,10685,33453,16488,11500,4988,16488,109000,2011
12041,39.6,16843,14852,785,777,4280,38467,6009,4880,1129,6009,119600,2011
12043,42.3,12684,7899,1432,2565,2646,39611,3903,3033,870,3903,95200,2011
12045,42.8,15878,12959,1861,656,3752,41291,5385,4026,1359,5385,150600,2011
12047,38.1,14742,8065,5145,1246,3050,36683,4441,3248,1193,4441,75600,2011
12049,33,27690,13424,1781,11635,6105,38046,7850,5794,2056,7850,104100,2011
12051,32.3,39084,13863,5171,18918,8409,37989,11013,7704,3309,11013,103400,2011
12053,47.2,172079,141700,8567,17360,48729,42700,70809,58320,12489,70809,145000,2011
12055,51,98985,70412,8691,16760,25989,34913,39970,31727,8243,39970,115600,2011
12057,36,1219331,663407,191189,297353,296335,50195,463425,288995,174430,463425,185900,2011
12059,41.5,20003,17745,947,485,4663,33510,6761,5351,1410,6761,86800,2011
12061,48.5,137004,106615,11918,14982,37116,46363,57467,43844,13623,57467,179300,2011
12063,40.2,49537,33062,12865,2114,11129,39869,16440,12999,3441,16440,97200,2011
12065,43.3,14622,8497,5404,499,3796,42096,5313,3928,1385,5313,125000,2011
12067,36,8627,6752,1005,793,1807,49713,2474,1982,492,2474,153500,2011
12069,45.4,295594,220478,27586,34910,82915,47509,118253,91843,26410,118253,167900,2011
12071,45,615955,439164,47447,111535,160528,49444,243017,179230,63787,243017,181000,2011
12073,29.2,273352,162734,81289,15082,60610,45827,109508,60264,49244,109508,195300,2011
12075,44.5,40556,32851,3768,2926,10896,35920,16034,12400,3634,16034,108400,2011
12077,38.5,8291,6363,990,675,1385,40893,2142,1612,530,2142,80600,2011
12079,40.2,19269,10587,7328,875,5121,36557,6939,5196,1743,6939,94100,2011
12081,45.3,321296,237460,27142,46330,84785,48181,131318,95809,35509,131318,195300,2011
12083,47,330100,245928,39100,35103,91356,40103,133977,104987,28990,133977,142000,2011
12085,49.3,145480,117380,7459,17029,37597,53612,59316,46746,12570,59316,238200,2011
12086,38,2474676,390139,431371,1593648,568426,43957,825337,475336,350001,825337,246800,2011
12087,46.1,73068,52404,4538,14725,16706,53889,28272,18178,10094,28272,463100,2011
12089,42.8,72379,63275,4896,2339,20430,58933,27664,22092,5572,27664,202300,2011
12091,37.9,181973,140692,15866,12176,48212,54140,71609,47937,23672,71609,196800,2011
12093,39.4,39978,26359,3206,9378,9975,36929,13857,10358,3499,13857,124300,2011
12095,33.6,1133087,525567,222319,299170,266454,49731,408605,243367,165238,408605,211100,2011
12097,35.3,265328,109553,24768,118313,70407,46479,93100,60338,32762,93100,170200,2011
12099,43.3,1309401,797160,217615,242756,323383,52951,523559,380150,143409,523559,236600,2011
12101,43.5,461898,371848,19076,52375,122488,44103,184270,144269,40001,184270,145100,2011
12103,45.9,916806,709018,91668,70814,226569,45891,401598,279544,122054,401598,172900,2011
12105,39.7,598376,389519,84871,103055,155529,44398,221975,159173,62802,221975,133200,2011
12107,43.1,74595,54305,11918,6560,19252,34174,29061,22435,6626,29061,105300,2011
12109,42,186077,159174,9888,9503,49592,64153,71807,55240,16567,71807,279700,2011
12111,42.2,274693,169977,49682,44666,71793,44947,103900,78190,25710,103900,157600,2011
12113,39,150073,127771,7342,6403,41824,55913,55956,42695,13261,55956,173400,2011
12115,52.1,378404,322143,16460,29088,103990,49212,169256,128934,40322,169256,213400,2011
12117,38.1,419641,281040,43133,70132,101734,58908,150443,107571,42872,150443,225500,2011
12119,62.2,90251,74163,9000,5609,28317,44817,40294,36110,4184,40294,186800,2011
12121,42.7,41171,32146,4309,3469,10954,37775,15810,11635,4175,15810,108900,2011
12123,41,22382,16407,4542,762,5454,38005,7632,6372,1260,7632,89700,2011
12125,40,15484,11001,3049,707,2826,45645,3665,2433,1232,3665,113500,2011
12127,44.9,496089,374441,49708,54457,124192,44169,197382,148039,49343,197382,172100,2011
12129,39.4,30013,24175,4079,967,7382,54151,10539,8871,1668,10539,136900,2011
12131,42.8,54309,46116,2976,2685,14971,46926,22454,16612,5842,22454,174000,2011
12133,40.6,24543,19213,3492,752,5502,37036,8727,6699,2028,8727,96600,2011
13001,38.6,18202,12795,3574,1569,4714,34989,7062,5012,2050,7062,82300,2011
13003,33,8375,4774,1516,1943,1968,32814,2745,1898,847,2745,61100,2011
13005,35.9,11075,8421,1900,714,2669,32065,3909,2579,1330,3909,67300,2011
13007,35.7,3494,1654,1830,10,858,27255,1262,850,412,1262,71200,2011
13009,34.2,46345,25051,19480,951,10201,36429,16317,9845,6472,16317,113700,2011
13011,37.5,18074,16191,504,1033,4808,41397,6583,5165,1418,6583,149300,2011
13013,33.1,68061,51017,8050,5765,17742,50604,23404,18031,5373,23404,137300,2011
13015,36.2,98905,79041,9659,7364,26141,49060,34477,24173,10304,34477,147000,2011
13017,38.3,17658,10202,6895,299,4380,31943,6344,4011,2333,6344,77100,2011
13019,37.3,18977,15644,2300,842,5060,32512,7213,5063,2150,7213,74500,2011
13021,35.5,155186,66297,78755,4278,36209,37975,57189,32857,24332,57189,121900,2011
13023,39.2,13095,8926,3720,78,2813,35997,4182,2980,1202,4182,81200,2011
13025,37.4,17937,16722,851,269,5191,38374,6735,5664,1071,6735,74400,2011
13027,39.4,16256,9448,5755,799,4355,40186,6330,4571,1759,6330,96300,2011
13029,35.7,29847,23138,3898,1336,7980,64651,10705,7891,2814,10705,182200,2011
13031,25.8,69008,45276,18621,2395,14677,33902,24826,13517,11309,24826,140100,2011
13033,35.7,23211,10810,11964,208,5105,32188,7745,5539,2206,7745,78900,2011
13035,38.1,23568,16081,6641,592,5735,49339,7931,6093,1838,7931,140400,2011
13037,38.6,6568,2215,3916,363,1137,32986,1782,1282,500,1782,60100,2011
13039,31.5,49957,35685,9672,2532,13419,51061,18015,12486,5529,18015,163000,2011
13043,37.1,10891,6850,2631,1197,2728,37315,3711,2486,1225,3711,79400,2011
13045,33.5,110292,80872,19956,6637,27908,45752,39473,26912,12561,39473,136100,2011
13047,38.3,63643,58828,1518,1503,17713,46549,24143,18002,6141,24143,133100,2011
13049,38.4,12714,8242,3077,1298,2567,42307,3739,2947,792,3739,84900,2011
13051,34.2,261322,132299,105408,13524,62360,45985,100658,59060,41598,100658,176400,2011
13053,24.4,11686,7175,2392,1485,2016,49969,2544,800,1744,2544,88300,2011
13055,39.3,26001,21633,2974,1013,6358,32224,9031,6433,2598,9031,78300,2011
13057,36.1,211316,172196,11511,19859,58003,66717,75784,60549,15235,75784,198000,2011
13059,25.7,116131,67064,29961,11771,20622,34151,41349,18872,22477,41349,161100,2011
13061,38,3194,1024,2135,0,739,24750,1194,859,335,1194,71700,2011
13063,31.3,260756,39615,167229,34284,56820,42936,85875,50721,35154,85875,121300,2011
13065,35.4,6830,4564,2119,67,1576,33143,2585,1797,788,2585,70800,2011
13067,35.2,684468,390026,165463,82452,175610,65423,258710,177428,81282,258710,210100,2011
13069,34.8,42143,25454,11394,4268,10645,34327,14714,10245,4469,14714,79400,2011
13071,34.6,45079,26593,10304,7440,11387,33345,15978,10235,5743,15978,85600,2011
13073,36.9,121335,89977,18069,5806,33977,66556,43070,34638,8432,43070,169600,2011
13075,36.4,17081,11045,4793,997,4630,35306,6521,4689,1832,6521,87500,2011
13077,36.4,124695,91007,21684,8065,34165,61015,45227,34004,11223,45227,178500,2011
13079,40.6,12751,9254,2921,283,3360,37746,4773,3880,893,4773,88300,2011
13081,37.7,23379,12149,10207,726,6036,32616,8826,5232,3594,8826,92100,2011
13083,38.8,16628,15783,181,283,4762,41629,6290,4951,1339,6290,125500,2011
13085,40.3,22121,20619,52,850,6182,51989,8049,6327,1722,8049,193800,2011
13087,36.4,27890,14532,11495,1358,6928,31391,10371,6526,3845,10371,105400,2011
13089,34.1,690003,205157,372181,65662,157432,51712,265137,154355,110782,265137,185100,2011
13091,38.4,21597,14160,6410,672,5384,33829,8197,5760,2437,8197,70400,2011
13093,40.2,14454,6261,7298,804,3108,30830,4803,3274,1529,4803,66800,2011
13095,32.9,94616,28194,62612,2128,22833,32364,36013,17445,18568,36013,102100,2011
13097,34.8,130473,65847,49011,10457,33874,54763,45451,32542,12909,45451,153900,2011
13099,38.5,11110,5300,5676,39,2782,27645,4122,2695,1427,4122,77900,2011
13101,27.8,4016,2118,79,1773,1061,29476,1292,816,476,1292,100200,2011
13103,35.3,51476,41694,6984,1488,13985,58935,17856,13409,4447,17856,154600,2011
13105,40.2,20274,13020,6005,952,5443,32634,7697,5562,2135,7697,82200,2011
13107,36.6,22439,13593,7463,982,5654,30427,8108,5331,2777,8108,80200,2011
13109,36.2,11002,6252,3325,1300,2709,38000,4114,2773,1341,4114,89800,2011
13111,47.8,23529,22602,59,401,7213,34554,10287,8268,2019,10287,168900,2011
13113,42,106094,72875,20489,6377,30106,81498,37930,32070,5860,37930,247500,2011
13115,37.4,95978,70973,13417,8709,24237,43129,34823,23268,11555,34823,120000,2011
13117,36.6,170815,138221,4482,15639,44505,88262,55465,48110,7355,55465,274200,2011
13119,39.6,22102,18970,1918,800,6099,33086,8774,6302,2472,8774,129100,2011
13121,34.1,907811,376336,396609,70329,203455,57582,362603,200682,161921,362603,250300,2011
13123,42.1,28208,24955,148,2691,8142,37091,11533,8263,3270,11533,152100,2011
13125,41.3,3046,2718,283,18,887,36275,1220,837,383,1220,68700,2011
13127,39.4,78736,51341,20450,4831,20756,49828,30980,19800,11180,30980,180400,2011
13129,35.6,54747,43793,2237,7582,13550,41336,19085,13023,6062,19085,124500,2011
13131,37.6,24916,14821,7406,2399,6518,32091,9308,6045,3263,9308,98000,2011
13133,45.7,15933,8761,6139,830,4483,38209,6205,4549,1656,6205,125000,2011
13135,33.6,794872,360297,176199,155702,198702,63076,262169,185877,76292,262169,190100,2011
13137,38.4,42744,34479,1716,5177,10858,41222,15055,11508,3547,15055,146900,2011
13139,34.2,178286,113939,12702,46113,45966,52050,60939,42435,18504,60939,174400,2011
13141,42.4,9615,2274,7244,45,1820,24483,2970,2310,660,2970,72000,2011
13143,38.2,28681,26223,1361,369,7654,38664,10626,7794,2832,10626,112900,2011
13145,42,31401,24204,5432,867,8907,67299,11321,10014,1307,11321,209400,2011
13147,42.9,25130,19179,4885,747,6693,35685,9617,7481,2136,9617,114600,2011
13149,39.5,11758,10102,1326,80,3046,39167,4364,3229,1135,4364,86800,2011
13151,35.1,199115,107482,69850,11291,52057,64251,68128,53324,14804,68128,167600,2011
13153,34.4,137887,84515,38585,8158,35769,55738,50871,34658,16213,50871,134200,2011
13155,37,9625,6746,2718,131,2363,40379,3162,2477,685,3162,78900,2011
13157,36.8,59798,49957,4238,3620,16402,52883,21266,16359,4907,21266,163700,2011
13159,37.8,13800,9997,2968,490,3745,44404,5052,3813,1239,5052,121600,2011
13161,36.5,14783,10915,2322,1448,4200,35336,5695,4045,1650,5695,83800,2011
13163,38.1,16877,6982,9271,465,4316,29178,6227,4386,1841,6227,69800,2011
13165,35.8,8322,4483,2842,852,2103,25467,2954,2096,858,2954,67300,2011
13167,40.2,10034,6196,3565,46,2343,31301,3366,2418,948,3366,66000,2011
13169,38.8,28488,20549,7135,347,7998,51265,10466,8470,1996,10466,137300,2011
13171,38,18035,11782,5621,348,4379,39684,6307,4211,2096,6307,120800,2011
13173,32.8,9779,6693,2303,427,2577,40878,3350,2162,1188,3350,130600,2011
13175,37.8,48163,28862,17201,1082,12396,37640,17636,12046,5590,17636,89600,2011
13177,35.8,28251,21432,5287,581,7253,58252,9522,7195,2327,9522,149700,2011
13179,27.6,64320,27854,26438,6271,17198,44146,22907,11659,11248,22907,125700,2011
13181,44.2,8045,5237,2609,27,2345,36741,3346,2763,583,3346,103600,2011
13183,30.2,13738,8175,3626,1599,3338,38785,4748,3007,1741,4748,85100,2011
13185,29.9,107172,60307,38062,5004,24841,38535,38605,22507,16098,38605,132200,2011
13187,36.2,29419,26945,415,1384,7370,43704,10841,7771,3070,10841,169800,2011
13189,38,21739,12289,8755,482,5955,36841,8292,5394,2898,8292,99600,2011
13191,44,14065,8498,5155,232,3638,37194,5583,4388,1195,5583,99000,2011
13193,39.2,14560,4768,8406,493,3138,28726,4716,3066,1650,4716,68900,2011
13195,38.6,27915,24013,2314,1075,7239,41407,9379,7098,2281,9379,128000,2011
13197,39.9,8536,4927,2832,536,1897,32610,3223,2367,856,3223,78200,2011
13199,40.3,22213,12640,9202,114,5669,37028,8183,5716,2467,8183,94200,2011
13201,40.4,6140,4251,1804,25,1722,33248,2552,1847,705,2552,81000,2011
13205,37.2,23677,10988,11434,998,5484,37597,8021,5276,2745,8021,81100,2011
13207,40.5,26203,18679,6456,545,6759,48632,9291,7405,1886,9291,143000,2011
13209,36.3,9121,6137,2487,437,2386,34933,3291,2331,960,3291,76600,2011
13211,40.6,17876,12719,4321,467,4891,46918,6478,4860,1618,6478,184700,2011
13213,35.9,39800,33714,282,5179,10425,37004,14300,10048,4252,14300,99200,2011
13215,33.6,188548,83293,84090,11713,46505,41088,72087,39611,32476,72087,134900,2011
13217,34.3,98864,52515,38038,4489,25713,51691,33634,25334,8300,33634,144500,2011
13219,38.8,32246,27865,1553,1382,8910,75136,11155,9148,2007,11155,234400,2011
13221,41.4,14686,11266,2589,528,3540,43255,4793,3947,846,4793,134500,2011
13223,33.5,139067,104578,23170,6977,38635,63023,47691,38889,8802,47691,147700,2011
13225,34.4,27349,12340,12490,1810,6543,41333,9188,6354,2834,9188,118900,2011
13227,41.5,29406,27747,378,827,8084,50582,11116,8821,2295,11116,169900,2011
13229,38.3,18457,15635,1856,826,5143,37489,6914,5164,1750,6914,79900,2011
13231,37.9,17646,15206,1921,202,4933,56433,6012,5006,1006,6012,156500,2011
13233,36.6,41233,30437,5245,4783,10552,38514,14675,10320,4355,14675,109200,2011
13235,41.8,11732,8221,3113,331,2794,32424,4245,3056,1189,4245,81200,2011
13237,44.5,21128,13956,5762,1236,6536,41756,8782,6771,2011,8782,150200,2011
13239,39.6,2489,1179,1279,0,674,32656,946,645,301,946,68600,2011
13241,45.5,16302,14522,179,1230,4285,33533,6908,5209,1699,6908,183600,2011
13243,39.7,7678,2746,4530,64,1948,29071,3018,2227,791,3018,61100,2011
13245,33.2,199100,76288,105978,8017,46268,39090,73214,41732,31482,73214,101700,2011
13247,36.9,84303,36143,37248,7889,21627,55819,29002,20431,8571,29002,164700,2011
13249,38,4885,3011,1173,450,1089,34691,1743,1258,485,1743,98200,2011
13251,39.6,14697,7921,6539,53,3081,31963,4682,3607,1075,4682,79700,2011
13253,43.8,8784,5519,2927,206,2194,29639,3059,2446,613,3059,74800,2011
13255,36.8,63713,38901,20894,2380,16100,41163,22920,14625,8295,22920,121000,2011
13257,40.2,25964,21792,2833,643,6334,37502,9175,6885,2290,9175,111700,2011
13259,41,5887,2097,3378,370,1349,30417,2183,1460,723,2183,48800,2011
13261,33.9,32825,13472,16935,1652,7412,34416,11473,7108,4365,11473,87500,2011
13263,42.7,6879,2634,4156,0,1942,33404,2701,2134,567,2701,83300,2011
13265,40.6,1791,683,1015,38,429,24125,638,452,186,638,67400,2011
13267,35.7,24720,14785,6981,2446,5525,33863,7844,5391,2453,7844,78900,2011
13269,39.6,8794,5056,3548,155,2477,27479,3460,2469,991,3460,64100,2011
13271,40.1,16177,8254,5828,1920,3768,23777,5780,3511,2269,5780,56700,2011
13273,38.3,9530,3409,5860,141,2352,30953,3427,2126,1301,3427,75400,2011
13275,39.2,44609,26012,16536,1281,11230,34419,17356,10381,6975,17356,128100,2011
13277,34.4,40204,23451,11751,4019,9920,37414,14164,8983,5181,14164,109700,2011
13279,35.1,27269,16689,6825,3040,6904,32462,10133,6236,3897,10133,92200,2011
13281,50.5,10502,10150,100,177,2864,39309,4499,3882,617,4499,187600,2011
13283,37.1,6846,4429,2213,41,1673,31848,2500,1541,959,2500,66000,2011
13285,35.9,66422,40286,22304,2127,17087,41961,24233,15472,8761,24233,129100,2011
13287,36.8,8973,4886,3778,271,2119,29851,3065,2014,1051,3065,84300,2011
13289,43.7,9200,5105,3937,72,1921,27715,3088,2417,671,3088,68900,2011
13291,50,21217,20162,244,566,6622,43146,9118,7073,2045,9118,199600,2011
13293,40.5,27235,18607,7515,599,7354,34068,10416,7137,3279,10416,92500,2011
13295,39.4,68370,62924,2946,1145,18841,39578,26256,19390,6866,26256,109300,2011
13297,37.1,83003,65161,12948,2688,22962,51347,29488,22529,6959,29488,163100,2011
13299,37.6,36181,23663,10591,1214,8691,35431,13091,8702,4389,13091,83900,2011
13301,43.7,5873,2179,3575,1,1481,33330,2269,1607,662,2269,60100,2011
13303,38.8,21175,9346,11201,373,4868,31784,7082,5101,1981,7082,81800,2011
13305,37.5,29988,21750,6180,1670,7377,39470,10214,7227,2987,10214,86400,2011
13307,47.6,2760,1584,957,85,768,29583,1270,1026,244,1270,59800,2011
13309,36.4,7354,3977,3197,109,1141,31456,1687,1215,472,1687,62300,2011
13311,42,26840,25179,882,282,8776,39666,12459,9459,3000,12459,176000,2011
13313,33.9,101234,63122,3778,31833,25457,42379,34514,23356,11158,34514,129100,2011
13315,39.1,9131,5482,3312,198,1812,31712,2661,2081,580,2661,65800,2011
13317,43.3,10485,5458,4432,328,2462,28989,4138,2907,1231,4138,96500,2011
13319,40.5,9617,5566,3763,190,2303,37500,3356,2772,584,3356,71500,2011
13321,39.4,21741,14993,6125,347,5634,38336,8039,5950,2089,8039,83500,2011
15001,40.6,182997,57320,980,21010,43012,53591,64270,42334,21936,64270,342100,2011
15003,37.7,944287,181397,18021,76360,216120,71263,307248,174863,132385,307248,560300,2011
15005,62.9,57,26,0,0,8,56875,46,0,46,46,NA,2011
15007,41.1,66306,20316,365,6289,15522,64422,21884,13925,7959,21884,561600,2011
15009,39.4,152907,49008,757,15400,35622,64583,52065,30365,21700,52065,594400,2011
16001,34.7,388174,336362,3858,27168,99754,55304,147753,101947,45806,147753,206200,2011
16003,49.1,3980,3776,0,41,1302,36845,1783,1437,346,1783,174300,2011
16005,31.1,81730,70732,510,5467,20336,45347,30045,21287,8758,30045,140100,2011
16007,40.6,6013,5695,22,193,1834,43897,2427,2007,420,2427,135600,2011
16009,44.1,9293,7916,70,219,2697,37508,3867,2862,1005,3867,119400,2011
16011,31.7,45002,33943,212,7560,11171,46169,14432,11289,3143,14432,133300,2011
16013,40.3,21354,16755,7,4117,5708,62906,9028,6204,2824,9028,415500,2011
16015,47.1,7094,6611,34,217,2033,47128,2990,2288,702,2990,195800,2011
16017,45.3,40849,38626,60,951,12400,42989,18399,13461,4938,18399,236200,2011
16019,31.6,102422,87835,424,11213,26802,51311,35849,26400,9449,35849,157400,2011
16021,42.8,10845,9977,0,399,2919,35324,4200,3397,803,4200,177500,2011
16023,42.6,2848,2559,5,161,761,37821,1080,891,189,1080,111500,2011
16025,38.8,1235,1014,12,176,334,41184,454,322,132,454,184300,2011
16027,31.2,186620,135826,614,43699,47026,42943,62824,44715,18109,62824,145400,2011
16029,38.4,6893,6423,0,289,1972,49740,2637,2169,468,2637,115700,2011
16031,32,22491,16448,35,5429,5318,39551,7569,5134,2435,7569,120000,2011
16033,37.8,847,422,0,425,255,39792,323,245,78,323,79700,2011
16035,48.3,8753,8062,40,237,2459,42043,3612,2909,703,3612,127600,2011
16037,44.7,4313,4132,0,90,1154,43445,1887,1508,379,1887,144900,2011
16039,30.1,26744,20076,599,4027,7055,43691,9532,6440,3092,9532,144400,2011
16041,31.7,12650,11595,52,792,3371,46344,4129,3283,846,4129,167000,2011
16043,33.4,13133,11197,7,1590,3417,42178,4514,3723,791,4514,139800,2011
16045,41.8,16783,14919,2,1321,4703,44442,6491,4925,1566,6491,160400,2011
16047,35.4,15285,10813,7,4075,3837,40854,5357,3929,1428,5357,124700,2011
16049,47.6,16108,14895,22,389,4662,36706,6710,5170,1540,6710,142300,2011
16051,30.1,25291,22175,42,2537,6770,52799,8155,6646,1509,8155,158200,2011
16053,31.5,21794,14800,83,6471,5528,39232,7481,4790,2691,7481,135900,2011
16055,38.7,137178,126441,346,5135,38141,48075,55301,39110,16191,55301,212300,2011
16057,28.2,36932,33523,298,1307,8516,39578,14801,8017,6784,14801,187300,2011
16059,49.2,7895,7491,32,162,2419,40270,3650,2712,938,3650,173300,2011
16061,48.1,3785,3376,0,112,999,35344,1639,1172,467,1639,117400,2011
16063,32.3,5106,3731,56,1252,1257,45077,1746,1328,418,1746,121600,2011
16065,22.5,36984,33649,229,2095,7662,33791,9943,5021,4922,9943,174900,2011
16067,35.6,19740,13003,2,6214,4989,43194,6728,5054,1674,6728,106400,2011
16069,40.8,39088,34694,141,1154,10132,44540,16166,10868,5298,16166,164700,2011
16071,38.9,4225,4013,0,128,1150,44435,1560,1287,273,1560,122500,2011
16073,35.6,11449,7865,6,2853,2830,32169,3873,2636,1237,3873,135100,2011
16075,36.4,22596,18442,7,3284,6015,44943,8361,6353,2008,8361,135500,2011
16077,33.9,7671,5121,0,2175,1996,41797,2597,1926,671,2597,135600,2011
16079,46.3,12849,12012,17,359,3628,37934,5792,4053,1739,5792,140100,2011
16081,33.7,9786,8138,0,1523,2639,52444,3812,2490,1322,3812,263100,2011
16083,34.5,76129,63412,321,10000,19550,43146,27940,18942,8998,27940,150900,2011
16085,45.7,9877,9376,0,343,2834,52675,4019,3101,918,4019,278500,2011
16087,42.9,10153,8190,0,1600,2839,37878,4041,3065,976,4041,145900,2011
17001,40.3,67045,62445,2401,849,17588,45792,26722,20015,6707,26722,99900,2011
17003,42,8314,5063,2923,101,2056,27727,3168,2135,1033,3168,56300,2011
17005,39,17849,15849,786,510,4549,50672,6434,5160,1274,6434,107300,2011
17007,36,54084,40826,1207,10760,13957,61613,17960,14949,3011,17960,171300,2011
17009,38.6,6897,5167,1127,372,1404,42014,2128,1559,569,2128,80000,2011
17011,42.1,34963,31528,222,2625,9752,48046,14404,10908,3496,14404,103800,2011
17013,44,5093,5003,8,19,1409,48958,2084,1663,421,2084,109400,2011
17015,46.3,15474,14692,135,391,4685,45433,6893,5243,1650,6893,102500,2011
17017,37.9,13639,10973,419,2118,3503,41139,5082,3600,1482,5082,76900,2011
17019,28.6,199443,142110,24718,10263,42807,44462,78900,43062,35838,78900,147800,2011
17021,41.6,34897,33367,604,478,9080,43964,14063,10479,3584,14063,82000,2011
17023,42.2,16442,16029,68,164,4785,47933,6676,5157,1519,6676,84700,2011
17025,42.2,13862,13453,63,93,3513,38905,5535,4193,1342,5535,71500,2011
17027,39,37577,34636,1291,1009,9834,57246,14022,11297,2725,14022,125200,2011
17029,31.2,53684,49157,2019,1199,11666,38294,21035,13117,7918,21035,93100,2011
17031,35.2,5182969,2284565,1275928,1225143,1196796,54598,1934771,1156652,778119,1934771,256900,2011
17033,42.5,19850,18246,705,350,5251,43923,7815,6234,1581,7815,70000,2011
17035,40.3,11073,10832,74,31,2941,43255,4163,3381,782,4163,82100,2011
17037,29.1,104684,83730,6338,10338,23879,54436,38011,23863,14148,38011,188100,2011
17039,42.2,16635,15945,191,322,4649,48750,6728,5213,1515,6728,104400,2011
17041,37.8,19958,18385,81,1178,5368,47921,7589,5935,1654,7589,95000,2011
17043,37.8,914224,647449,39870,119279,238576,77598,335651,254592,81059,335651,309800,2011
17045,42.9,18658,18187,105,180,5146,42947,7881,5990,1891,7881,72400,2011
17047,42.7,6693,6529,68,0,1773,39071,2799,2205,594,2799,61500,2011
17049,39,34229,33086,99,557,9214,50938,13496,10724,2772,13496,108100,2011
17051,39.8,22051,21293,237,268,5607,43081,8296,6573,1723,8296,78400,2011
17053,42.2,14088,13513,72,288,3697,50332,5709,4497,1212,5709,89900,2011
17055,41.7,39540,38269,110,504,10415,36383,16100,12619,3481,16100,63200,2011
17057,42.1,37122,34458,1198,853,9788,42963,14717,11280,3437,14717,80800,2011
17059,43.9,5685,5528,34,21,1553,38577,2382,1840,542,2382,58700,2011
17061,41.9,13911,13514,154,111,3897,42193,5809,4443,1366,5809,71800,2011
17063,36.4,49460,44084,580,3955,12985,64592,18297,13839,4458,18297,191500,2011
17065,42.5,8441,8271,23,95,2361,39000,3470,2868,602,3470,74100,2011
17067,44.4,19155,18668,70,166,5357,43567,7977,6394,1583,7977,81700,2011
17069,44.5,4357,4156,61,32,1205,30875,1856,1454,402,1856,65700,2011
17071,46.9,7379,6921,28,81,2100,47944,3155,2534,621,3155,82900,2011
17073,41.8,50465,46244,787,2361,14041,50698,20467,16035,4432,20467,109900,2011
17075,43,29901,27623,273,1594,8487,48248,11884,9008,2876,11884,99400,2011
17077,28.6,59901,45463,8532,2387,12032,32896,23718,12892,10826,23718,95100,2011
17079,42.8,9735,9547,5,81,2750,47731,3985,3291,694,3985,82700,2011
17081,40.7,39032,34076,3091,815,10143,42679,15314,11326,3988,15314,87000,2011
17083,39.9,22972,22274,185,222,6335,54469,8650,6966,1684,8650,120800,2011
17085,46.9,22709,21717,121,582,6675,52487,9862,7731,2131,9862,142200,2011
17087,42,12666,10757,1431,336,3062,42172,4298,3523,775,4298,93400,2011
17089,34.4,509622,304700,26953,152889,127921,69496,169528,129816,39712,169528,241600,2011
17091,36.6,112895,83288,16949,9694,28280,49266,41086,28700,12386,41086,147700,2011
17093,32.8,110767,82517,5210,17271,29102,82649,36856,31770,5086,36856,239300,2011
17095,41.9,52881,45124,4026,2505,13350,40112,21704,14806,6898,21704,80700,2011
17097,36.4,700424,460521,45906,136722,178632,79666,239947,186237,53710,239947,280900,2011
17099,40.9,113865,100739,1847,8886,30638,52469,45000,34414,10586,45000,127500,2011
17101,39.1,16853,13708,2283,617,3803,38326,5818,4099,1719,5818,68300,2011
17103,40.9,36012,31907,1614,1739,9009,49451,13721,10255,3466,13721,114700,2011
17105,40.4,38992,34985,1995,1485,9740,52835,14484,10985,3499,14484,105600,2011
17107,39.4,30353,25816,3020,865,7216,48714,10992,8144,2848,10992,95700,2011
17109,29.1,32673,29016,1518,871,7101,34186,12834,7773,5061,12834,87000,2011
17111,37.6,307721,258489,3194,34438,81785,76909,108361,90852,17509,108361,243500,2011
17113,31.9,168234,138565,11987,7178,39182,59410,63431,43024,20407,63431,154600,2011
17115,40.4,110712,87292,17346,2053,27834,45987,44568,31245,13323,44568,92300,2011
17117,41.5,47879,46431,278,466,13247,48739,19407,15100,4307,19407,94900,2011
17119,38.4,268473,232978,21205,7155,71548,53143,106792,79421,27371,106792,124300,2011
17121,41.1,39586,36571,1190,588,10807,40097,16108,11932,4176,16108,71300,2011
17123,44.2,12692,12178,45,286,3263,51642,5061,4191,870,5061,103200,2011
17125,43.4,14788,14417,41,114,4281,42929,6426,5118,1308,6426,81500,2011
17127,41.8,15439,13914,756,159,4083,40885,6251,4849,1402,6251,80500,2011
17129,42.5,12731,12521,72,109,3483,56943,4959,4042,917,4959,115200,2011
17131,43.5,16497,16000,74,272,5043,51216,6889,5501,1388,6889,98200,2011
17133,40.3,32767,31836,34,436,9399,69291,12311,9990,2321,12311,201300,2011
17135,41.3,30126,27942,1436,443,7757,41925,11667,8918,2749,11667,79500,2011
17137,40.7,35673,32094,2154,715,9205,44731,13993,9798,4195,13993,93000,2011
17139,41.3,14773,14443,37,74,4012,48982,5611,4408,1203,5611,93300,2011
17141,40.5,53525,47570,430,4620,14662,57094,20663,15422,5241,20663,153400,2011
17143,36.5,185780,136042,32641,6838,47093,50689,75416,50964,24452,75416,121900,2011
17145,39.7,22403,19497,1974,571,5255,41333,8252,6479,1773,8252,76600,2011
17147,42.5,16710,16266,65,156,4706,58837,6507,5400,1107,6507,122200,2011
17149,42.3,16536,15903,240,154,4479,40668,6650,5186,1464,6650,75300,2011
17151,48.3,4418,4065,152,110,1273,38651,1880,1428,452,1880,87400,2011
17153,43,6184,3959,2032,91,1655,31712,2457,1894,563,2457,50500,2011
17155,44.4,5989,5628,69,233,1696,52409,2482,1942,540,2482,126800,2011
17157,41.2,33503,28961,3228,831,8145,46148,12022,9157,2865,12022,88700,2011
17159,42.9,16180,15615,64,94,4451,42305,6687,5135,1552,6687,76000,2011
17161,39.8,147625,112291,12935,16671,37935,46726,60527,43124,17403,60527,113100,2011
17163,36.9,268086,169671,80576,8614,69325,50109,103498,69790,33708,103498,126300,2011
17165,41.8,25071,23141,939,381,6802,36083,10414,7673,2741,10414,69400,2011
17167,39.1,196393,162809,22610,3457,51395,53508,82422,58431,23991,82422,120900,2011
17169,43.1,7519,7155,44,94,2107,43902,3081,2450,631,3081,72500,2011
17171,43.3,5351,5242,4,29,1478,50702,2145,1596,549,2145,83100,2011
17173,43.5,22330,21852,95,170,6097,44689,8968,7213,1755,8968,86500,2011
17175,42.5,5980,5808,13,69,1667,49693,2371,1900,471,2371,86000,2011
17177,43.3,47730,40870,4076,1359,12510,43410,19515,14009,5506,19515,104500,2011
17179,39.8,134636,128031,1174,2462,37165,54617,54144,42218,11926,54144,128900,2011
17181,43.2,17883,16548,219,830,4768,40696,6787,5027,1760,6787,88200,2011
17183,39.3,81799,65868,10562,3384,20208,40463,31979,22753,9226,31979,76100,2011
17185,42,12041,11598,81,139,3418,47426,4752,3781,971,4752,79500,2011
17187,39.6,17740,15723,285,1354,4382,42773,6854,4993,1861,6854,84700,2011
17189,41.7,14746,14289,134,175,4227,53036,6013,4916,1097,6013,104400,2011
17191,42.6,16814,16395,95,156,5021,40654,7241,5573,1668,7241,69300,2011
17193,44.5,14747,14344,127,150,4363,43639,6327,5035,1292,6327,67800,2011
17195,41.6,58622,50544,756,6313,15968,46444,23603,17776,5827,23603,99700,2011
17197,35.2,674166,457024,72297,103297,172164,76453,221722,187321,34401,221722,236300,2011
17199,40.4,66025,60570,2402,1304,17635,41319,26764,19350,7414,26764,89100,2011
17201,38.2,294893,215347,35791,31471,74345,47597,113015,78005,35010,113015,129200,2011
17203,39.7,38523,37159,248,523,10738,66198,14083,11803,2280,14083,152200,2011
18001,34.3,34263,32440,133,1363,8910,46549,12220,9724,2496,12220,114100,2011
18003,35.3,353721,272150,41189,22451,90118,49767,136147,96182,39965,136147,113100,2011
18005,38,76536,66918,1316,4515,21103,53692,30037,21771,8266,30037,135400,2011
18007,39.8,8815,8274,96,378,2285,47240,3581,2744,837,3581,85000,2011
18009,41.8,12848,12485,42,115,3657,40214,5290,4039,1251,5290,76900,2011
18011,38.2,55730,52280,573,1283,15866,68284,21111,16558,4553,21111,178300,2011
18013,46.4,15227,14750,60,156,4241,50503,6079,5176,903,6079,159000,2011
18015,40.8,20106,19145,97,673,5658,49232,8134,6428,1706,8134,105600,2011
18017,38.4,38971,32809,604,4709,10206,42679,14813,11150,3663,14813,82400,2011
18019,37.8,108864,93223,7492,5008,28332,49130,42909,30541,12368,42909,127800,2011
18021,40.3,26947,26189,43,297,7550,46916,10120,8071,2049,10120,87300,2011
18023,37.6,33228,28464,103,4270,8324,48352,11965,8719,3246,11965,99100,2011
18025,41.5,10755,10400,119,57,2939,40354,4242,3572,670,4242,86200,2011
18027,35.7,31347,29454,140,1284,7734,45231,10944,8568,2376,10944,100200,2011
18029,40.2,49825,48249,316,529,13353,57146,18398,14098,4300,18398,161400,2011
18031,38.2,25682,24776,78,398,7088,47810,9992,6924,3068,9992,118000,2011
18033,37.5,42136,40312,60,1040,11405,47099,16140,12869,3271,16140,110500,2011
18035,34.6,117413,103481,6225,2157,27963,38730,46162,30434,15728,46162,92200,2011
18037,39.7,41933,38891,187,2435,11414,53997,15905,12336,3569,15905,133100,2011
18039,34.6,197614,152984,10989,27446,50542,47308,70088,51289,18799,70088,126600,2011
18041,40.4,24325,23424,347,235,6534,35802,9604,7033,2571,9604,84600,2011
18043,39,74112,66284,3281,1963,20225,52803,29092,21176,7916,29092,150700,2011
18045,42,17282,16662,69,337,4865,44802,6939,5568,1371,6939,90600,2011
18047,39.6,23183,22704,21,189,6463,52234,8601,6885,1716,8601,151600,2011
18049,40.3,20745,19346,203,867,5847,42330,8314,6257,2057,8314,93100,2011
18051,40.2,33405,31666,667,464,8744,48171,12903,10038,2865,12903,99600,2011
18053,39.6,70051,60796,4748,2484,17964,39377,27081,18991,8090,27081,82500,2011
18055,41.3,33014,32180,100,335,9013,43869,12886,10038,2848,12886,89100,2011
18057,35.5,268871,233406,8616,9049,74901,84449,98959,78993,19966,98959,212800,2011
18059,38.7,69035,64927,1391,1213,19520,62184,25803,21055,4748,25803,157200,2011
18061,40,38927,37572,208,601,10724,52263,14539,12309,2230,14539,124500,2011
18063,36.6,143153,127143,6702,4137,39552,68192,51624,42744,8880,51624,161700,2011
18065,41.1,49105,46653,675,717,12897,40519,18837,14230,4607,18837,94400,2011
18067,40.1,83094,72577,5894,2207,23246,45022,34215,24182,10033,34215,104200,2011
18069,38.9,37242,35811,174,645,9814,47137,14237,11223,3014,14237,98800,2011
18071,38.1,42150,38724,104,2329,12021,45666,16776,12300,4476,16776,117400,2011
18073,37.5,33254,30914,246,1685,9337,55509,12175,9478,2697,12175,143200,2011
18075,38.8,21392,20481,32,573,5584,40144,8287,6419,1868,8287,78600,2011
18077,39.8,32380,30405,607,731,8500,43635,12725,9001,3724,12725,109900,2011
18079,37.5,28441,27298,104,547,7651,44815,10936,8170,2766,10936,90500,2011
18081,36.8,138227,127539,1808,4119,36934,62754,51420,38656,12764,51420,145000,2011
18083,38.6,38446,36154,1050,616,9706,40391,14866,10396,4470,14866,84700,2011
18085,37.6,77174,69414,550,5572,21874,51141,30390,23561,6829,30390,133100,2011
18087,30.5,37152,34391,48,1339,9445,47057,12081,9912,2169,12081,148900,2011
18089,37.1,495272,275576,124460,80760,122773,49443,183198,129462,53736,183198,136400,2011
18091,39.3,111286,90769,11869,5872,28104,46934,42255,31712,10543,42255,120500,2011
18093,41,46203,44527,217,586,13084,43195,18659,14632,4027,18659,99500,2011
18095,39.1,131445,113677,8394,4028,33247,44035,51028,37057,13971,51028,95900,2011
18097,33.9,897515,542087,233570,79537,210186,43197,357586,207127,150459,357586,120700,2011
18099,37.9,47016,42080,237,3937,12640,48536,17810,13652,4158,17810,124300,2011
18101,42.1,10321,10114,16,46,2729,43592,4017,3436,581,4017,85400,2011
18103,39.7,37078,33529,1588,916,9335,39746,13378,10124,3254,13378,86800,2011
18105,27.6,136278,117454,4510,3980,27162,38524,53108,29010,24098,53108,151000,2011
18107,39.3,38220,35615,254,1609,10221,47929,14446,10482,3964,14446,109500,2011
18109,39.6,68894,66778,184,858,19294,56315,25357,19933,5424,25357,143600,2011
18111,42.4,14270,13351,36,654,3826,48108,5370,4284,1086,5370,108800,2011
18113,36.9,47522,42154,70,4511,13219,47768,17723,13845,3878,17723,114500,2011
18115,42.9,6074,5880,58,78,1744,50795,2403,1773,630,2403,132600,2011
18117,40,19881,19192,276,188,5146,37618,7677,5914,1763,7677,91400,2011
18119,42.3,21665,21068,118,200,5829,43553,8494,6869,1625,8494,98500,2011
18121,41.3,17368,16559,254,197,4244,42441,6190,5141,1049,6190,91000,2011
18123,40.6,19350,18461,377,180,4942,45808,7580,5891,1689,7580,95400,2011
18125,42.2,12901,12612,13,147,3796,40525,5388,4407,981,5388,81600,2011
18127,38.3,163406,141265,4467,13337,42876,62394,61399,47484,13915,61399,167000,2011
18129,41.1,25973,25023,280,253,7247,57757,10021,8476,1545,10021,119400,2011
18131,41.4,13529,12941,55,302,3676,45029,5074,4002,1072,5074,97100,2011
18133,37.9,38082,35263,1473,619,8954,50165,12433,9942,2491,12433,120500,2011
18135,41,26205,24936,60,748,7332,41544,10423,7862,2561,10423,78500,2011
18137,38.9,28657,27733,118,448,7701,49358,10813,8437,2376,10813,136300,2011
18139,39.8,17481,16932,163,182,5035,47102,6686,4942,1744,6686,107000,2011
18141,36.1,266740,202719,33031,18976,64958,45183,101071,71466,29605,101071,116600,2011
18143,38.5,24112,23406,91,331,6567,40532,9098,6797,2301,9098,98300,2011
18145,40,44337,41523,376,1563,12109,52156,17381,12553,4828,17381,127100,2011
18147,41.6,20978,20141,153,481,5887,54348,8082,6755,1327,8082,110700,2011
18149,40.4,23311,22126,119,728,6419,38961,9064,7211,1853,9064,99400,2011
18151,39.6,34084,30876,209,988,9961,48502,13943,10968,2975,13943,125600,2011
18153,39.1,21484,19949,825,505,5316,47640,7855,6110,1745,7855,78300,2011
18155,40.4,10479,10311,0,121,2731,43628,4149,3267,882,4149,118300,2011
18157,27.4,170965,137972,6435,12559,37373,43485,65100,35563,29537,65100,130400,2011
18159,42.3,16023,15609,22,316,4826,53543,6637,5237,1400,6637,113000,2011
18161,39.8,7481,7246,42,40,2126,43912,2988,2343,645,2988,112500,2011
18163,37.5,178985,153125,16041,3735,45085,43334,73927,47381,26546,73927,112800,2011
18165,41.5,16345,15972,16,132,4315,43856,6434,4947,1487,6434,75900,2011
18167,35.9,107472,93410,7133,2446,24783,39534,39823,26093,13730,39823,90400,2011
18169,41.2,33019,31508,255,686,9308,44242,12968,9774,3194,12968,96700,2011
18171,42.1,8525,8330,6,82,2490,49615,3328,2623,705,3328,100200,2011
18173,39.6,59104,55513,520,956,17110,63446,22412,18805,3607,22412,140300,2011
18175,38.6,28221,27481,123,290,7380,39879,10744,8505,2239,10744,101300,2011
18177,40.3,68990,61532,2359,1784,18845,40427,28071,19193,8878,28071,98200,2011
18179,40.2,27720,26683,161,561,7961,48154,10767,8433,2334,10767,108900,2011
18181,42,24714,22526,57,1687,7230,47752,9786,7551,2235,9786,111000,2011
18183,39.6,33152,31986,138,511,8928,51666,13159,10913,2246,13159,124200,2011
19001,45,7699,7531,14,47,2122,47623,3323,2544,779,3323,93300,2011
19003,46,4085,3925,10,96,1126,44389,1706,1390,316,1706,81100,2011
19005,43.9,14309,13278,45,739,3875,47096,5860,4704,1156,5860,108100,2011
19007,43.9,12926,12506,86,162,3511,35230,5475,3927,1548,5475,73300,2011
19009,46.3,6141,6022,6,70,1746,41840,2670,2123,547,2670,71200,2011
19011,39.9,26089,25280,49,263,7632,55810,10255,8330,1925,10255,128700,2011
19013,34.5,130060,109480,11596,4729,32104,44567,52002,35655,16347,52002,121600,2011
19015,40.8,26380,25313,261,495,6991,51582,10565,8101,2464,10565,116300,2011
19017,38.5,24231,23430,171,222,6613,58372,9429,7769,1660,9429,139400,2011
19019,38.8,21022,20405,148,225,5952,54879,8175,6434,1741,8175,114400,2011
19021,36.9,20078,13864,449,4443,5025,46145,7641,5223,2418,7641,90800,2011
19023,43.5,14893,14568,41,125,4286,50052,6053,4889,1164,6053,92800,2011
19025,47.8,9754,9455,87,93,2970,44331,4205,3351,854,4205,71800,2011
19027,42.5,20809,20125,46,311,5622,48038,8663,6583,2080,8663,106100,2011
19029,44.7,13928,13476,108,218,3943,41444,6022,4274,1748,6022,84000,2011
19031,42.6,18427,17834,12,262,5198,57004,7581,6056,1525,7581,129900,2011
19033,43.2,44206,40853,395,1686,12310,45973,20103,14468,5635,20103,110200,2011
19035,47,12060,11539,43,247,3384,45668,5429,4078,1351,5429,78000,2011
19037,43.7,12470,12075,11,234,3669,42098,5401,4467,934,5401,92500,2011
19039,41.4,9251,8298,50,834,2402,45610,3490,2721,769,3490,91100,2011
19041,42.9,16674,15868,89,443,4792,45462,7346,5321,2025,7346,99500,2011
19043,44.4,18150,17547,87,276,5177,46644,7678,6017,1661,7678,97900,2011
19045,41.1,49185,45622,1266,1231,12813,48063,19938,14826,5112,19938,109200,2011
19047,39.7,17035,13039,67,3823,4229,45423,6411,5043,1368,6411,79600,2011
19049,34.2,64383,57207,826,3956,17582,71691,24678,19436,5242,24678,182800,2011
19051,38.8,8723,8517,18,85,2216,46651,3078,2530,548,3078,99200,2011
19053,38.4,8451,7954,182,167,2127,34185,3224,2206,1018,3224,69800,2011
19055,41.4,17804,17455,27,222,4901,49375,7277,5846,1431,7277,119800,2011
19057,41.7,40255,36058,1928,1091,11057,43111,17007,12387,4620,17007,92600,2011
19059,47.2,16712,16297,151,166,5232,52704,8126,6274,1852,8126,157900,2011
19061,38.5,93227,86916,1297,1807,24228,49663,36984,27516,9468,36984,140200,2011
19063,40.6,10323,9348,110,698,2709,44357,4203,3298,905,4203,80100,2011
19065,42.6,20938,20057,176,359,5532,42108,8498,6679,1819,8498,81600,2011
19067,43.4,16292,15437,216,305,4505,42247,6899,5233,1666,6899,88000,2011
19069,43,10705,9351,22,1115,2908,46461,4216,3128,1088,4216,84700,2011
19071,44.7,7476,7152,38,170,2174,49934,3109,2412,697,3109,93200,2011
19073,44.9,9382,9058,5,163,2737,44981,4146,3123,1023,4146,81100,2011
19075,42.4,12407,12146,16,117,3595,55848,5075,4135,940,5075,113700,2011
19077,44.6,10991,10633,49,189,3286,50000,4734,3726,1008,4734,95300,2011
19079,41.4,15755,14494,48,696,4286,46603,6542,4968,1574,6542,89700,2011
19081,44,11416,10829,1,374,3406,48996,4778,3891,887,4778,84800,2011
19083,43.7,17595,16526,216,593,4531,46930,7155,5388,1767,7155,87100,2011
19085,42.7,14969,14580,18,164,4190,53750,6004,4736,1268,6004,113200,2011
19087,39.4,20257,18291,291,760,5323,43510,7625,5549,2076,7625,98900,2011
19089,42.1,9591,9393,30,110,2553,45682,4056,3223,833,4056,93600,2011
19091,44.4,9860,9363,13,307,2801,48075,4208,3200,1008,4208,84400,2011
19093,44.5,7139,6935,11,98,2038,43918,3180,2389,791,3180,74400,2011
19095,42.5,16342,15817,79,259,4624,57476,6677,5283,1394,6677,133700,2011
19097,43.1,19884,19275,71,209,5688,45042,8286,6482,1804,8286,107900,2011
19099,41.7,36902,35344,424,560,10094,48881,14787,10912,3875,14787,114000,2011
19101,43.6,16721,14533,103,412,4078,47784,6831,5216,1615,6831,91400,2011
19103,29,129159,108049,5447,5911,27715,53703,51772,31205,20567,51772,180200,2011
19105,42.5,20699,19759,367,247,5414,50745,8143,6624,1519,8143,112100,2011
19107,43.2,10548,10320,24,87,2869,42030,4436,3589,847,4436,74600,2011
19109,46.7,15622,15210,26,179,4465,49548,6764,5484,1280,6764,86200,2011
19111,42.3,35854,32861,1031,1101,9336,42437,14040,10193,3847,14040,79000,2011
19113,36.6,210011,188097,7997,5381,54166,55666,86027,62880,23147,86027,139700,2011
19115,38.9,11576,9451,91,1776,3007,50982,4258,3450,808,4258,90500,2011
19117,43.7,9021,8837,18,74,2500,43184,3658,2738,920,3658,87400,2011
19119,38.7,11579,11277,4,179,3120,49938,4430,3667,763,4430,101300,2011
19121,39.4,15591,15146,56,178,4288,56333,5924,4693,1231,5924,153000,2011
19123,38.8,22433,21306,208,363,5882,46477,8947,6677,2270,8947,97000,2011
19125,38.6,33372,31921,178,524,9202,53730,12531,9678,2853,12531,132300,2011
19127,39.3,40398,31979,731,6679,10393,47691,15519,11480,4039,15519,102700,2011
19129,40.9,15112,14444,65,338,4207,61796,5605,4648,957,5605,147900,2011
19131,44.1,10794,10582,33,97,2947,49389,4358,3610,748,4358,100300,2011
19133,46.6,9299,8956,25,103,2611,42283,4114,2978,1136,4114,75800,2011
19135,43.6,7949,7662,42,57,2476,43913,3329,2680,649,3329,85800,2011
19137,44.2,10792,10310,20,291,2915,38072,4570,3370,1200,4570,83500,2011
19139,38.1,42634,34688,433,6556,11265,51134,16402,12625,3777,16402,121500,2011
19141,43.8,14352,13584,65,484,3990,45995,6126,4661,1465,6126,83900,2011
19143,42.8,6506,6014,61,356,1741,45696,2677,2005,672,2677,68900,2011
19145,43.7,16029,14869,362,426,4276,41503,6332,4713,1619,6332,79400,2011
19147,42.1,9478,9167,10,133,2384,44063,3973,2983,990,3973,79800,2011
19149,41.9,24915,23707,61,680,7084,56387,9739,7696,2043,9739,124600,2011
19151,47.1,7407,7133,49,152,1979,42545,3318,2658,660,3318,55700,2011
19153,34.8,425582,345798,24667,31182,109987,57473,169246,118868,50378,169246,151800,2011
19155,38.5,92464,83293,1180,5716,24452,49924,36327,25753,10574,36327,127000,2011
19157,41.4,18965,17766,176,421,4878,52413,7675,5770,1905,7675,114600,2011
19159,45.2,5148,4986,0,61,1396,42213,2056,1637,419,2056,85600,2011
19161,46.2,10388,10077,58,178,2878,44392,4502,3674,828,4502,77900,2011
19163,37.5,163667,136443,11354,8865,41926,51274,66529,46759,19770,66529,138900,2011
19165,45.3,12242,11860,7,187,3424,46257,5067,3945,1122,5067,106900,2011
19167,32.9,33545,30210,187,2679,8636,53922,11549,9390,2159,11549,125200,2011
19169,26.5,88577,77136,2277,2547,18614,49733,34613,19000,15613,34613,159900,2011
19171,42,17864,15046,104,1247,5097,48836,7041,5462,1579,7041,96200,2011
19173,44.5,6354,5907,6,353,1763,41554,2683,2131,552,2683,64400,2011
19175,41.5,12471,11970,234,205,3397,41782,5354,3770,1584,5354,90300,2011
19177,43.2,7617,7424,35,35,2087,40640,3077,2486,591,3077,67100,2011
19179,40.2,35473,31193,340,3031,9736,40269,14771,11127,3644,14771,76800,2011
19181,38.2,45859,44000,275,854,12526,63292,17222,13675,3547,17222,151300,2011
19183,41.7,21707,20170,101,1052,5995,51875,8943,6785,2158,8943,116700,2011
19185,45.9,6372,6211,0,25,1799,36365,2699,2153,546,2699,57700,2011
19187,40.1,38105,34354,1486,1390,9448,41695,15855,10693,5162,15855,86000,2011
19189,43.7,10892,10303,92,327,3112,46395,4670,3524,1146,4670,90500,2011
19191,39.9,21033,20159,179,376,5474,52042,7979,6133,1846,7979,152500,2011
19193,35.3,101566,79376,2364,13360,25553,45844,38716,26262,12454,38716,95900,2011
19195,44.1,7605,7344,35,139,2261,50540,3264,2603,661,3264,94900,2011
19197,44.2,13278,11879,3,1150,3392,43105,5503,4116,1387,5503,74300,2011
20001,40.9,13411,12338,238,388,3720,40275,5598,4341,1257,5598,64200,2011
20003,42.7,8093,7759,19,10,2335,40753,3201,2608,593,3201,81100,2011
20005,35.6,16867,15045,934,412,4023,44433,6096,4210,1886,6096,87600,2011
20007,45.8,4877,4630,23,107,1497,41677,2305,1721,584,2305,54400,2011
20009,39.7,27572,23121,409,3547,7243,44989,11241,8116,3125,11241,72500,2011
20011,37.6,15095,13887,364,323,3983,39843,5727,4229,1498,5727,80900,2011
20013,41.8,10000,8429,129,306,2622,36218,4133,2783,1350,4133,77000,2011
20015,37.4,65307,59428,986,2503,17525,57573,24039,18662,5377,24039,122500,2011
20017,45.2,2808,2628,28,91,759,39095,1151,880,271,1151,82000,2011
20019,48.1,3685,3311,59,85,1071,35791,1545,1191,354,1545,46000,2011
20021,40,21646,19353,49,461,5757,41513,8189,6452,1737,8189,71400,2011
20023,49.5,2755,2583,0,121,780,36364,1276,985,291,1276,68400,2011
20025,43.8,2179,1995,3,129,601,42011,885,663,222,885,59100,2011
20027,44.3,8555,8202,68,149,2259,41829,3517,2634,883,3517,84000,2011
20029,42.7,9501,9037,26,235,2555,37073,3979,3104,875,3979,63200,2011
20031,43.6,8562,8140,77,156,2501,49552,3482,2759,723,3482,97400,2011
20033,47.6,1903,1726,0,140,527,38750,843,691,152,843,44600,2011
20035,38.5,36237,29878,1026,3171,8903,40924,13489,9642,3847,13489,79900,2011
20037,33.1,39051,34778,798,1738,9103,36043,15354,9777,5577,15354,85200,2011
20039,50.8,2975,2818,12,55,902,35887,1484,1191,293,1484,52200,2011
20041,41.6,19713,18302,46,759,5379,49003,7591,5687,1904,7591,102500,2011
20043,38,7959,7315,239,151,2078,45000,3108,2299,809,3108,83100,2011
20045,28,110075,89984,4110,5598,23320,47063,43238,22436,20802,43238,179900,2011
20047,43.8,3041,2461,17,467,918,41406,1352,1046,306,1352,55500,2011
20049,48,2899,2710,18,77,905,34246,1289,1042,247,1289,53200,2011
20051,31.4,28253,26019,233,1223,6601,43713,11678,7441,4237,11678,123600,2011
20053,43.7,6481,5725,239,282,1676,43125,2560,1934,626,2560,68900,2011
20055,30.3,36297,17126,728,16767,8912,51179,12105,8204,3901,12105,105300,2011
20057,30.6,33232,14984,573,16545,7925,49061,10982,7340,3642,10982,85000,2011
20059,38.7,25882,23838,198,904,7075,50231,10148,7288,2860,10148,120600,2011
20061,28.1,32081,19284,5610,3948,8484,45649,11868,5861,6007,11868,122000,2011
20063,48.4,2695,2618,10,50,824,41853,1151,926,225,1151,66300,2011
20065,48.8,2643,2425,80,68,669,41008,1183,945,238,1183,67500,2011
20067,32.9,7795,4249,6,3288,2195,59127,2811,2083,728,2811,86400,2011
20069,34.8,5923,5012,7,811,1540,55559,2052,1541,511,2052,93200,2011
20071,49.8,1232,1010,12,172,382,58971,502,382,120,502,75200,2011
20073,46.1,6764,6337,14,189,1791,37543,2944,2243,701,2944,51400,2011
20075,35.2,2662,1963,1,687,726,41351,1071,810,261,1071,73300,2011
20077,44.1,6022,5575,28,249,1786,42021,2660,1926,734,2660,64100,2011
20079,39.2,34392,29225,538,3634,8945,48880,13137,9746,3391,13137,106700,2011
20081,34.3,4217,2997,24,1096,1012,49760,1397,1064,333,1397,90300,2011
20083,44.5,1944,1745,1,115,549,44176,781,609,172,781,68500,2011
20085,41,13374,11480,143,425,3973,54440,5336,4136,1200,5336,119300,2011
20087,42.9,19046,18107,57,346,5675,58083,7401,6305,1096,7401,135800,2011
20089,51.5,3117,2999,16,22,965,39713,1470,1146,324,1470,48400,2011
20091,36.3,538836,444705,21824,37108,145153,74761,212587,152175,60412,212587,211800,2011
20093,35.5,3951,2706,16,1087,1010,50612,1385,1081,304,1385,90700,2011
20095,44.2,7897,7516,45,174,2309,45817,3357,2528,829,3357,81300,2011
20097,43.7,2572,2411,3,45,746,39496,1013,701,312,1013,81600,2011
20099,40.4,21710,18619,829,892,5994,40587,8781,6364,2417,8781,63500,2011
20101,45.9,1511,1312,1,95,408,41536,737,512,225,737,56500,2011
20103,37.5,75500,60740,6445,4214,18814,62853,25932,17683,8249,25932,167300,2011
20105,47.1,3279,3152,0,73,891,41050,1444,1143,301,1444,62900,2011
20107,44.1,9702,8907,47,163,3038,44408,4323,3552,771,4323,98100,2011
20109,45.5,2772,2625,7,23,805,41289,1323,986,337,1323,69700,2011
20111,31.8,34561,25224,703,6969,8006,37954,13428,8135,5293,13428,92600,2011
20113,41.4,29190,27253,263,990,8099,53332,11541,8930,2611,11541,119000,2011
20115,44.3,12639,11963,95,265,3584,45941,5058,4090,968,5058,83300,2011
20117,44.9,10111,9741,67,168,2804,42464,4309,3280,1029,4309,76400,2011
20119,38.9,4523,3736,40,639,1283,49551,1765,1298,467,1765,77400,2011
20121,39.8,32419,30382,368,830,9061,59668,12034,9739,2295,12034,166000,2011
20123,45.3,6365,5997,48,217,1847,45237,2710,1943,767,2710,72100,2011
20125,39.6,35383,28815,1989,1772,9326,40925,14179,10246,3933,14179,71200,2011
20127,46.5,5937,5586,5,187,1646,44070,2558,1922,636,2558,76800,2011
20129,38.5,3228,2470,54,583,855,44263,1221,910,311,1221,69500,2011
20131,42.4,10206,9881,96,110,2844,47476,4040,3226,814,4040,89000,2011
20133,39.9,16536,15178,216,664,4425,38883,6686,5022,1664,6686,68400,2011
20135,48.5,3118,2878,2,202,939,46417,1359,1103,256,1359,49700,2011
20137,43,5668,5159,145,222,1250,37656,2255,1603,652,2255,61100,2011
20139,42.2,16360,15618,88,315,4870,51878,6656,5228,1428,6656,99000,2011
20141,47.5,3878,3766,9,53,1069,36489,1752,1410,342,1752,42300,2011
20143,42.3,6114,5857,43,117,1753,53287,2354,1927,427,2354,83500,2011
20145,43,6942,6006,377,393,1711,43676,2523,1853,670,2523,69000,2011
20147,45.5,5597,5320,16,101,1616,43476,2406,1929,477,2406,61000,2011
20149,35.9,21223,19428,216,898,5781,54309,7878,6207,1671,7878,148200,2011
20151,41.3,9675,8844,120,468,2540,42825,3980,2788,1192,3980,74700,2011
20153,50.6,2565,2438,5,78,767,40625,1200,891,309,1200,58400,2011
20155,39.6,64207,55498,1938,5016,17034,42207,25827,18266,7561,25827,88700,2011
20157,50.6,5019,4892,9,15,1503,40538,2348,1925,423,2348,47600,2011
20159,38.7,10102,8679,36,913,2644,46155,3822,2874,948,3822,69100,2011
20161,24.3,70249,56152,4217,4480,13391,41427,25375,11116,14259,25375,164500,2011
20163,44.2,5213,5014,34,32,1484,40000,2372,1820,552,2372,63500,2011
20165,49.7,3279,3140,35,14,949,40036,1568,1231,337,1568,51200,2011
20167,46.9,6926,6581,44,111,2049,38168,3270,2523,747,3270,64200,2011
20169,38.3,55258,45486,1761,5176,14159,45635,22239,14889,7350,22239,116700,2011
20171,41.8,5071,4363,7,646,1586,58453,2051,1740,311,2051,90600,2011
20173,34.4,491988,347150,42757,61602,124016,49451,191853,127706,64147,191853,120400,2011
20175,29.2,22802,8421,809,12562,5340,44550,7426,4733,2693,7426,86500,2011
20177,38.3,176723,134347,14845,18525,46963,47701,73219,48366,24853,73219,117300,2011
20179,46.2,2572,2454,13,81,706,46821,1087,833,254,1087,83100,2011
20181,42.4,6019,5204,45,618,1634,43012,2569,1716,853,2569,71300,2011
20183,50,3893,3755,1,68,1289,42569,1769,1446,323,1769,60200,2011
20185,45,4416,3814,7,466,1138,42006,1853,1481,372,1853,53000,2011
20187,36,2204,1317,5,859,562,49152,765,596,169,765,81500,2011
20189,34.1,5558,3692,74,1711,1576,56019,2060,1447,613,2060,81500,2011
20191,39.9,24115,22075,274,1049,6271,48060,9239,7141,2098,9239,84700,2011
20193,36.4,7809,7283,57,319,1766,45125,3165,2098,1067,3165,91000,2011
20195,47.8,2965,2850,13,58,833,42009,1220,971,249,1220,69600,2011
20197,41.9,7041,6661,55,191,2030,53292,2768,2347,421,2768,103300,2011
20199,45.4,1499,1367,5,100,414,46128,627,497,130,627,65100,2011
20201,46.5,5830,5602,31,141,1554,40469,2496,1989,507,2496,52500,2011
20203,38.7,2243,1705,0,505,598,50324,862,643,219,862,75300,2011
20205,44.2,9512,8976,11,204,2615,40069,3830,2896,934,3830,60300,2011
20207,48.9,3324,3156,8,77,928,31779,1562,1166,396,1562,51500,2011
20209,33.1,156362,68698,39981,39945,36884,39812,57114,35934,21180,57114,97000,2011
21001,38.4,18613,17482,672,165,4754,31775,7193,5294,1899,7193,78900,2011
21003,38.6,19866,19109,259,262,5454,35357,7849,5943,1906,7849,92300,2011
21005,38,21308,20211,524,285,6008,52447,8386,6356,2030,8386,132900,2011
21007,41.4,8235,7753,230,93,2327,41875,3358,2724,634,3358,79300,2011
21009,40.2,41961,38478,1778,1040,11780,38616,16708,11598,5110,16708,97600,2011
21011,38.8,11605,11150,171,175,3008,28776,4306,3498,808,4306,66400,2011
21013,41.1,28744,27336,738,232,7237,25269,10632,7204,3428,10632,63900,2011
21015,35.4,117216,105503,3358,4114,30860,68087,41843,32316,9527,41843,175200,2011
21017,40.1,19987,17110,1408,1248,5449,42192,7933,4885,3048,7933,141300,2011
21019,41.7,49368,46276,1290,740,12961,38848,19521,13498,6023,19521,93500,2011
21021,40.4,28345,24601,2030,805,7520,41035,10916,7525,3391,10916,124300,2011
21023,40.2,8486,8259,11,191,2130,39643,3070,2412,658,3070,89100,2011
21025,40.3,14062,13755,128,67,3566,22304,5314,3732,1582,5314,50600,2011
21027,41.9,20029,19101,559,170,5400,38325,7519,5933,1586,7519,79400,2011
21029,37.7,73529,70647,451,1041,20565,51857,27705,22381,5324,27705,143400,2011
21031,39.8,12746,12116,36,293,3556,32508,5081,3962,1119,5081,78600,2011
21033,42.8,12962,11941,694,148,3206,37078,5047,3871,1176,5047,73100,2011
21035,33.7,36999,33526,1454,872,8998,39316,14967,10093,4874,14967,112300,2011
21037,37,89598,83559,2260,1456,22386,53018,35258,25201,10057,35258,145500,2011
21039,43.2,5094,4895,66,45,1470,35699,2018,1673,345,2018,70300,2011
21041,36.3,10801,9631,146,718,3062,42063,4195,2648,1547,4195,105000,2011
21043,38.9,27760,27017,194,103,7287,35637,10407,8186,2221,10407,73900,2011
21045,39.8,15939,15314,25,460,4178,27327,6032,5037,995,6032,74800,2011
21047,28.9,73266,50145,15419,4509,18771,37958,26117,14542,11575,26117,97700,2011
21049,40.1,35446,32302,1756,858,10295,45726,14406,9357,5049,14406,138000,2011
21051,37.5,22001,20442,1068,202,4612,20206,6731,5109,1622,6731,56700,2011
21053,41.6,10215,9827,84,188,2773,27654,3986,3039,947,3986,64300,2011
21055,42.1,9331,9085,58,67,2402,32545,3855,2966,889,3855,76700,2011
21057,43.2,6884,6535,264,42,1813,29528,2668,2005,663,2668,65500,2011
21059,38.7,96062,86759,4472,2372,25144,44763,37279,26246,11033,37279,107800,2011
21061,40.8,12110,11789,108,98,3471,35217,4770,3575,1195,4770,88200,2011
21063,39.7,7594,7203,286,101,1865,25769,2602,2090,512,2602,68200,2011
21065,40.3,14711,14451,26,6,3891,28148,5680,4085,1595,5680,71700,2011
21067,33.6,292370,215268,41604,19057,71215,48306,122075,69445,52630,122075,161100,2011
21069,39.9,14376,13892,119,142,3933,31979,5611,4479,1132,5611,83400,2011
21071,39.7,39701,38807,387,244,10614,28221,15562,11117,4445,15562,68500,2011
21073,39.2,49205,41179,4953,1314,12717,47062,20936,13447,7489,20936,140400,2011
21075,42.9,6836,5016,1596,76,2041,34545,2876,1806,1070,2876,56800,2011
21077,39.6,8503,7895,99,326,2002,45400,2988,2196,792,2988,105800,2011
21079,41.4,16902,15982,414,377,4683,40137,6388,4998,1390,6388,115800,2011
21081,35.1,24720,23635,161,535,6953,43755,8755,6168,2587,8755,124300,2011
21083,39.9,37088,32709,1478,2005,10295,35514,14789,11259,3530,14789,84100,2011
21085,39.5,25677,24839,151,128,6845,32919,9939,7473,2466,9939,84700,2011
21087,43.4,11334,10769,332,94,3299,35313,4422,3334,1088,4422,75600,2011
21089,41.6,36974,35836,222,320,10013,41902,14309,11229,3080,14309,88300,2011
21091,39.5,8559,8271,81,99,2486,47895,3309,2755,554,3309,86100,2011
21093,35.4,102873,80571,11609,4979,27431,48743,37883,24565,13318,37883,135700,2011
21095,40.7,29479,28172,853,230,7268,26914,10642,7433,3209,10642,53000,2011
21097,40.9,18823,17818,528,338,4694,38690,7172,4783,2389,7172,106300,2011
21099,40.5,18228,16800,1018,158,4862,31858,6892,5214,1678,6892,78900,2011
21101,39.2,46095,40719,3587,846,12297,41473,18652,12889,5763,18652,100500,2011
21103,40.6,15472,14301,421,450,4350,42506,6023,4316,1707,6023,122800,2011
21105,43.5,4905,4286,501,42,1185,37535,1983,1542,441,1983,62700,2011
21107,40.4,46921,42073,2750,730,12881,39187,18518,13241,5277,18518,79700,2011
21109,39.2,13537,13337,9,86,3924,21448,5569,4364,1205,5569,58700,2011
21111,37.7,735804,523160,149509,30393,186142,46298,301312,193856,107456,301312,147900,2011
21113,35.5,47880,43790,1530,1310,13391,48547,17797,11888,5909,17797,154400,2011
21115,39.4,23327,22862,84,86,6919,32421,9397,6838,2559,9397,75300,2011
21117,36,159008,143278,7604,4002,40479,53375,62054,42640,19414,62054,146700,2011
21119,41.3,16483,16136,144,63,4226,31735,5878,4361,1517,5878,59500,2011
21121,38.6,31820,30759,493,331,8142,22364,12541,7968,4573,12541,71900,2011
21123,38.9,14162,13109,454,364,3466,37920,5035,3840,1195,5035,97400,2011
21125,37.5,58590,56412,464,732,16457,37286,22002,16247,5755,22002,95800,2011
21127,39.4,15899,15555,39,87,4176,32279,5800,4290,1510,5800,67100,2011
21129,41.1,7858,7667,82,68,1971,24674,2827,2144,683,2827,58200,2011
21131,40.9,11388,11220,12,9,3045,29050,4428,3372,1056,4428,52100,2011
21133,40.4,24449,24040,122,121,6354,29564,9300,6922,2378,9300,52300,2011
21135,40.2,13946,13725,58,105,3638,27181,4983,4102,881,4983,56900,2011
21137,38.9,24758,23452,530,370,6680,33398,9793,7469,2324,9793,87100,2011
21139,44.5,9503,9227,106,113,2625,40248,3576,2967,609,3576,80400,2011
21141,40.8,26841,23983,2076,602,7846,35973,11044,8101,2943,11044,87800,2011
21143,47.3,8347,7700,533,67,2205,40546,3295,2631,664,3295,96200,2011
21145,41.6,65451,55120,6421,1373,18104,44054,27182,18891,8291,27182,114700,2011
21147,38.1,18201,16578,1059,247,4637,24292,6333,4659,1674,6333,65800,2011
21149,42.2,9604,9346,64,108,2654,40183,3765,2926,839,3765,75800,2011
21151,33.2,82363,74644,2971,1789,20270,41876,31130,18840,12290,31130,143000,2011
21153,38.9,13286,13061,35,50,3437,25410,4795,3855,940,4795,45600,2011
21155,38.1,19735,17204,1978,274,4753,38202,7206,5793,1413,7206,97200,2011
21157,43.5,31409,30630,73,332,9108,45605,12434,10081,2353,12434,101300,2011
21159,37.9,13014,11609,832,361,3250,23920,4391,3171,1220,4391,72800,2011
21161,40.3,17468,15713,1169,248,4819,40678,6568,4635,1933,6568,99500,2011
21163,35.1,28944,26184,1202,899,7634,45007,10162,7254,2908,10162,111700,2011
21165,41.8,6378,6032,114,178,1406,28279,2173,1734,439,2173,65000,2011
21167,41.7,21289,19642,979,447,5819,47690,8330,6255,2075,8330,133000,2011
21169,41.6,10124,9764,144,110,2814,35199,4019,3099,920,4019,78300,2011
21171,41.9,11009,10360,244,282,2870,28548,4358,3234,1124,4358,65600,2011
21173,37.4,26242,24513,895,612,7023,37393,10189,6895,3294,10189,103600,2011
21175,38.3,14012,13259,582,74,3402,29872,4627,3587,1040,4627,70300,2011
21177,40.5,31473,29298,1470,333,8923,37440,12117,9770,2347,12117,77200,2011
21179,37.2,43026,39225,2181,850,11831,45149,16160,12328,3832,16160,120600,2011
21181,39.1,7120,6981,33,102,2026,39586,2798,2112,686,2798,84100,2011
21183,38.8,23932,22700,377,729,6198,38252,8667,6866,1801,8667,79400,2011
21185,38.9,59639,53423,2603,1978,15732,82578,19400,16497,2903,19400,240300,2011
21187,40,10923,10464,160,226,3251,45551,4713,3408,1305,4713,100800,2011
21189,43.2,4759,4732,27,0,1105,19344,1650,1263,387,1650,68900,2011
21191,38.3,14840,14473,49,39,3726,48354,5339,4054,1285,5339,104500,2011
21193,40.6,28722,27648,312,198,7623,32538,10849,7743,3106,10849,57800,2011
21195,40.3,65174,63594,340,482,18748,33148,26904,19985,6919,26904,66500,2011
21197,38.4,12730,12388,159,91,3273,28382,4581,3127,1454,4581,76500,2011
21199,40.9,62654,59584,686,1258,17904,33282,26199,18994,7205,26199,97600,2011
21201,32.5,2261,2261,0,0,474,26544,776,535,241,776,62900,2011
21203,41.1,17098,16765,55,60,4584,26967,6474,5213,1261,6474,73200,2011
21205,31.5,23258,22116,303,283,5450,32763,8206,5535,2671,8206,100400,2011
21207,41.1,17521,16685,128,503,4749,31087,7409,5661,1748,7409,84500,2011
21209,35.1,46113,40740,2445,1785,12611,57967,17628,12542,5086,17628,155900,2011
21211,38,41671,33902,3181,3631,11128,56417,15030,10878,4152,15030,168400,2011
21213,38,17269,14877,1661,303,4772,41493,6672,4716,1956,6672,115400,2011
21215,38.8,16934,16168,520,82,4833,61921,6224,5467,757,6224,166200,2011
21217,40.4,24400,22286,1133,427,6501,35054,9633,6684,2949,9633,94800,2011
21219,36.6,12381,10752,1057,445,3326,39417,4665,3355,1310,4665,79600,2011
21221,44.1,14224,12489,1188,86,4409,43331,6149,4860,1289,6149,105800,2011
21223,39.4,8845,8462,27,204,2633,52224,3420,2659,761,3420,118600,2011
21225,36.8,15045,12692,1829,244,3865,38651,5468,4176,1292,5468,77800,2011
21227,32.7,111843,91596,10142,4999,27075,43018,42910,26246,16664,42910,137800,2011
21229,39.7,11671,10350,719,366,3428,42516,4541,3669,872,4541,110700,2011
21231,40.3,20807,19611,395,537,5998,26309,8526,6182,2344,8526,70900,2011
21233,39.6,13697,12334,675,545,3646,42115,4990,3864,1126,4990,68300,2011
21235,37.6,35951,34728,214,327,9226,29280,13197,9244,3953,13197,67600,2011
21237,41.1,7333,7301,1,7,1780,21968,2543,1936,607,2543,53200,2011
21239,41.1,24683,21427,1290,1524,6638,55124,9878,7072,2806,9878,190000,2011
22001,35.7,61430,48178,10854,1055,15889,37970,22083,15236,6847,22083,90900,2011
22003,37.5,25830,18172,5517,1133,5968,39007,8257,6087,2170,8257,78300,2011
22005,34.3,105208,74970,23165,4802,27934,66173,36546,30097,6449,36546,166800,2011
22007,39.1,23421,15446,7170,482,6354,46699,8590,7031,1559,8590,89100,2011
22009,38.5,41977,27840,12279,647,11087,32321,15801,10963,4838,15801,85000,2011
22011,36.7,35328,28497,4530,1019,9444,45113,12853,10106,2747,12853,84500,2011
22013,40.8,14464,7927,6171,55,3590,30594,5571,4261,1310,5571,55600,2011
22015,34.6,115667,80254,24776,6609,29351,51771,43962,29632,14330,43962,138600,2011
22017,36.4,253924,122274,118687,5955,61691,39086,98270,62022,36248,98270,118400,2011
22019,35.9,190891,133158,47004,4760,49920,43614,72061,51223,20838,72061,116500,2011
22021,39.5,10158,8043,1844,196,2462,38606,3834,2786,1048,3834,71900,2011
22023,40.3,7083,6735,165,77,1937,61679,2461,2201,260,2461,118600,2011
22025,37.8,10448,6999,2960,331,2762,37115,3750,2953,797,3750,68000,2011
22027,40.9,17123,8095,8792,87,3760,32972,5702,4226,1476,5702,65900,2011
22029,38.4,20617,11708,8426,214,5361,28705,7710,5194,2516,7710,78100,2011
22031,39.9,26592,15004,10355,661,7007,39213,10326,7945,2381,10326,83100,2011
22033,32.5,437401,207044,196233,15284,103524,46838,167150,103356,63794,167150,161600,2011
22035,32.2,7854,2192,5437,196,1651,25267,2525,1452,1073,2525,45800,2011
22037,40.5,20330,10682,9143,127,4993,37403,6978,5684,1294,6978,102200,2011
22039,35.9,34233,23311,9578,760,8628,34848,12165,8284,3881,12165,81800,2011
22041,38.6,20752,13829,6638,111,5553,34105,7965,5827,2138,7965,76200,2011
22043,37.3,21892,17096,3349,874,5062,39988,7231,5701,1530,7231,80700,2011
22045,35.4,73407,44842,23420,2274,18958,42989,26370,18590,7780,26370,102600,2011
22047,37.6,33455,15967,16305,647,7730,43195,11040,8390,2650,11040,89300,2011
22049,39.3,16151,10859,4839,206,4481,39809,6037,4193,1844,6037,72800,2011
22051,38.5,432310,245520,111850,50761,108258,48374,165404,105772,59632,165404,176700,2011
22053,37.5,31545,24627,5182,564,8509,43585,11878,9029,2849,11878,85400,2011
22055,33.5,218586,147970,56222,8044,52695,48591,84594,54804,29790,84594,157300,2011
22057,36.5,95895,75155,12826,3467,24894,49262,34474,26911,7563,34474,120200,2011
22059,37.9,14777,12419,1791,304,4104,42066,5547,4671,876,5547,74400,2011
22061,27.1,46198,25061,18519,1180,9872,34152,16594,9230,7364,16594,109700,2011
22063,34.5,125732,113445,6521,3607,32942,57254,44166,35541,8625,44166,152800,2011
22065,34.7,12181,4437,7420,183,2466,26178,3938,2402,1536,3938,70200,2011
22067,37.9,28097,14417,13059,272,6906,31269,10264,7092,3172,10264,75900,2011
22069,32.8,39364,21021,16246,775,9617,31830,15044,9193,5851,15044,94700,2011
22071,35.2,321409,98246,191611,16603,73163,37325,134342,64857,69485,134342,183500,2011
22073,34.1,152970,91753,55436,2762,37341,39724,56390,34748,21642,56390,116900,2011
22075,35.6,22976,15609,5002,1075,6144,55301,8198,5874,2324,8198,203000,2011
22077,42,22830,13670,8429,443,5922,43030,8903,7058,1845,8903,108500,2011
22079,37.2,131254,81704,41987,3372,31813,40470,47418,31863,15555,47418,113500,2011
22081,37.9,9098,5275,3642,39,2303,37159,3174,2481,693,3174,73500,2011
22083,38.1,20748,12661,7540,322,5277,38469,7287,5127,2160,7287,69700,2011
22085,40.8,24236,16858,4060,797,6497,36959,9414,7334,2080,9414,78700,2011
22087,33.9,32347,22379,5321,3023,8655,40450,12246,8376,3870,12246,130500,2011
22089,36.5,52662,34820,13911,2562,14318,60207,18569,15474,3095,18569,175200,2011
22091,39,11097,4966,5991,21,2883,29632,4142,3289,853,4142,77100,2011
22093,38.4,22064,10523,11149,236,5924,52887,7578,6392,1186,7578,114000,2011
22095,35,46310,18900,24386,2182,11640,49671,15775,12233,3542,15775,148800,2011
22097,36.9,84003,46602,34527,1347,21016,34350,30381,21764,8617,30381,84700,2011
22099,35.9,52105,33895,16138,1069,13501,40358,18825,15077,3748,18825,88200,2011
22101,37,54360,31391,17110,2684,14266,40171,20148,14086,6062,20148,87200,2011
22103,39,231629,187143,26281,10542,62392,61442,86374,68577,17797,86374,201700,2011
22105,33.4,119891,77545,35940,3975,30048,40214,43518,29698,13820,43518,140000,2011
22107,41.5,5299,2172,2987,116,1547,28090,2205,1385,820,2205,66600,2011
22109,35,111518,76920,20873,4153,27996,48166,39040,28778,10262,39040,124300,2011
22111,40.6,22715,15427,6142,863,6206,37426,8344,6640,1704,8344,79000,2011
22113,36.8,57660,46180,7982,1412,15589,43349,21737,16699,5038,21737,94900,2011
22115,29.9,50706,36638,7170,3602,13346,45292,18025,10153,7872,18025,87600,2011
22117,38.9,46969,30871,14636,856,11680,30554,17444,13090,4354,17444,82900,2011
22119,39.8,41235,26144,13805,681,11447,36225,16412,11212,5200,16412,79900,2011
22121,35.6,23570,13723,8414,538,6200,49929,8510,6114,2396,8510,132000,2011
22123,40.2,11635,9330,1853,265,2775,30446,4070,2945,1125,4070,76200,2011
22125,41.7,15631,7973,7023,219,3109,50685,4112,3107,1005,4112,163300,2011
22127,39.1,15348,10128,4816,228,3608,30938,5375,4103,1272,5375,60600,2011
23001,39.7,107785,99676,1722,1702,28206,45699,43968,29553,14415,43968,157100,2011
23003,44.8,72143,68635,411,745,19291,37138,30459,21852,8607,30459,88400,2011
23005,40.8,281044,258617,6852,5082,71781,57267,117138,79466,37672,117138,245900,2011
23007,42.5,30697,29693,79,167,8028,40502,12235,9248,2987,12235,134300,2011
23009,45.7,54422,52259,110,634,15104,47421,23649,17736,5913,23649,203000,2011
23011,42.2,122008,116586,860,1562,32621,46904,51043,36844,14199,51043,151000,2011
23013,46.3,39972,38624,152,371,10615,46845,16876,13334,3542,16876,202800,2011
23015,47.7,34579,33544,81,293,9910,48862,15009,12746,2263,15009,206900,2011
23017,44,57892,55766,251,628,15222,40889,23512,18330,5182,23512,144200,2011
23019,39.8,153400,145413,1000,1701,39314,43601,62570,43594,18976,62570,137900,2011
23021,47.7,17518,16910,9,150,5119,35123,7860,6228,1632,7860,106900,2011
23023,43.5,35546,33857,344,498,9785,56865,14853,11284,3569,14853,192800,2011
23025,43.6,52228,50466,171,450,14625,37875,21795,16981,4814,21795,111700,2011
23027,43.6,38737,37478,79,365,10372,41728,16204,12840,3364,16204,152700,2011
23029,45.5,33015,30212,151,478,8928,35272,14111,10804,3307,14111,104700,2011
23031,42.5,197557,189000,1001,2481,53132,56552,80319,60041,20278,80319,233500,2011
24001,40.8,74788,66277,5477,1109,17781,39408,28596,20017,8579,28596,123300,2011
24003,38.3,532369,388373,79132,30990,138085,85690,197348,147837,49511,197348,361700,2011
24005,39,802487,508521,204250,32203,203641,65411,315127,210981,104146,315127,269400,2011
24009,39.3,88329,70554,11923,2478,23272,92981,30381,25513,4868,30381,384500,2011
24011,38.6,32955,25804,4372,1740,8579,61021,11842,8791,3051,11842,232600,2011
24013,40.6,167277,152612,5494,4281,44655,83325,59314,49777,9537,59314,342900,2011
24015,38.4,100716,88294,6027,3275,26182,66903,35943,26783,9160,35943,262600,2011
24017,36.8,145508,72172,57683,6225,38005,92135,50305,40270,10035,50305,341200,2011
24019,43.1,32480,21595,8956,1101,9103,46683,13528,9443,4085,13528,202000,2011
24021,38.3,231725,181260,19146,16540,61292,82668,85048,64588,20460,85048,335600,2011
24023,42.5,30128,29335,287,208,8463,45280,12410,9500,2910,12410,168500,2011
24025,39.2,243955,194161,29832,8356,65726,79953,89260,72744,16516,89260,295900,2011
24027,38,283655,170882,48026,16144,76263,105692,103547,76862,26685,103547,447000,2011
24029,45.1,20098,15626,3229,869,5056,53480,7605,5683,1922,7605,272900,2011
24031,38.3,959738,480156,160575,158814,242848,95660,355434,244497,110937,355434,469900,2011
24033,34.8,858539,132621,545650,124454,199493,73447,302091,193551,108540,302091,312800,2011
24035,41.9,47468,41545,3506,1365,13035,84483,17189,14787,2402,17189,365500,2011
24037,35.9,103805,79693,14400,3836,27130,82529,36662,26777,9885,36662,324500,2011
24039,37.5,26453,13937,10598,830,5262,41420,8573,5713,2860,8573,162300,2011
24041,46.8,37575,29813,4880,1946,10701,63399,15539,11593,3946,15539,352200,2011
24043,39.5,147118,123124,13983,4950,37712,53180,55485,37086,18399,55485,230500,2011
24045,35.7,97862,65820,23044,4280,24137,51739,36406,23553,12853,36406,195400,2011
24047,47.8,51307,41352,7149,1566,14651,57474,21785,17039,4746,21785,279600,2011
24510,34.4,620210,174005,393680,24301,127029,40100,238959,118323,120636,238959,163700,2011
25001,49.4,216639,199814,4132,4676,60416,60525,96775,77244,19531,96775,384200,2011
25003,44.2,131221,119201,3487,4336,32981,48705,55793,38471,17322,55793,208100,2011
25005,39.6,547305,471461,17176,31969,141246,55813,210536,134698,75838,210536,296400,2011
25007,44,16353,14611,685,71,3719,69760,5568,4550,1018,5568,679000,2011
25009,40.2,739505,566620,20106,118430,189180,65785,284940,184985,99955,284940,362300,2011
25011,44,71495,66197,661,2224,18773,52246,30362,21059,9303,30362,223200,2011
25013,38.6,462752,315948,36344,93692,115701,48866,177954,112160,65794,177954,202500,2011
25015,36.2,157630,136112,3585,7348,34613,60331,58921,39585,19336,58921,263600,2011
25017,38.4,1491762,1157303,62698,94944,367464,79691,577349,366002,211347,577349,410100,2011
25019,38.9,10135,8305,809,608,2447,84979,3745,2624,1121,3745,993900,2011
25021,40.4,666426,540173,35954,21268,168783,83733,255944,180071,75873,255944,398100,2011
25023,40.8,492934,417333,38892,15564,126163,74698,178996,138788,40208,178996,350700,2011
25025,31.6,713089,345160,144851,139129,140275,51638,286437,103366,183071,286437,371300,2011
25027,38.8,794981,647080,28440,72663,202179,65772,299089,200870,98219,299089,274900,2011
26001,54.7,11102,10786,44,115,3151,35490,4643,4188,455,4643,114700,2011
26003,46.9,9571,8247,778,114,2328,38231,3606,2970,636,3606,114700,2011
26005,38.4,111405,99836,1347,7425,30957,51232,41914,34698,7216,41914,147600,2011
26007,45.1,29797,28818,151,324,8678,38081,13234,10521,2713,13234,102800,2011
26009,47.4,23787,22748,69,386,6717,42440,9720,8244,1476,9720,156600,2011
26011,46.3,16226,15173,329,224,4430,36281,6526,5398,1128,6526,94900,2011
26013,44.4,8854,6663,797,95,2209,40115,3308,2516,792,3308,84700,2011
26015,40.8,59422,56702,292,1370,16689,52061,22831,19336,3495,22831,142800,2011
26017,41.4,107838,98478,1305,4988,29149,45962,44005,34964,9041,44005,104600,2011
26019,45.5,17625,16755,56,301,4986,47017,7366,6276,1090,7366,156700,2011
26021,40.7,157109,119832,23992,6899,40657,42488,61678,45202,16476,61678,135400,2011
26023,39.7,45765,41464,1403,1903,11163,42505,16078,12726,3352,16078,109800,2011
26025,38.9,136554,109423,14680,6087,35095,42287,53481,38009,15472,53481,107000,2011
26027,41.7,52373,45866,2590,1606,14505,45432,19913,16587,3326,19913,131800,2011
26029,44.8,26149,24800,140,384,7784,48745,11025,9163,1862,11025,158700,2011
26031,46.4,26432,24631,95,245,7654,37844,11536,9464,2072,11536,119100,2011
26033,39,39029,27891,1821,626,9357,41108,14699,10658,4041,14699,103700,2011
26035,45.2,31058,29687,158,487,8501,34431,13170,10524,2646,13170,87000,2011
26037,37.8,74752,68025,1376,2836,20202,58244,28565,23241,5324,28565,162400,2011
26039,46.8,14210,13452,196,174,3842,39597,5663,4700,963,5663,102700,2011
26041,44.9,37248,35083,126,353,10604,42932,16038,12824,3214,16038,102900,2011
26043,44.9,26436,25532,77,280,7598,43651,11444,9145,2299,11444,88600,2011
26045,39.8,107948,91982,6197,5009,28972,54170,43416,32202,11214,43416,147900,2011
26047,42.5,32794,30243,186,466,9052,50269,13599,10287,3312,13599,181700,2011
26049,37.9,429272,313176,86265,12864,109074,43418,166479,118158,48321,166479,109000,2011
26051,46.9,25906,25080,152,306,7842,38160,11326,9652,1674,11326,112100,2011
26053,46.6,16422,15002,766,196,4340,34917,7268,5573,1695,7268,67900,2011
26055,40.7,86787,81091,1042,1924,22940,50629,34450,26326,8124,34450,172800,2011
26057,38.6,42495,37250,1736,2261,10306,39867,14717,11484,3233,14717,90300,2011
26059,40.3,46832,44922,229,845,12662,43139,17617,14285,3332,17617,113000,2011
26061,33.1,36366,33987,294,467,8140,34625,14016,9754,4262,14016,86200,2011
26063,46.3,33305,32051,80,642,9151,40200,14237,11755,2482,14237,102200,2011
26065,31,281257,204747,30497,20151,62102,45758,108155,65668,42487,108155,133000,2011
26067,36.4,64418,57244,2395,2753,16123,46958,22420,17705,4715,22420,118600,2011
26069,50.3,26161,24965,188,432,7073,36445,10934,9266,1668,10934,98300,2011
26071,51,11965,11495,166,142,3080,35390,5248,4443,805,5248,75400,2011
26073,25,69861,61109,1780,2274,13823,36815,24746,14651,10095,24746,124100,2011
26075,39.3,160834,138214,12536,4814,41129,47169,60257,45178,15079,60257,123200,2011
26077,33.9,248810,199467,26977,9693,60680,46019,99603,65008,34595,99603,144200,2011
26079,42.6,17321,16632,98,203,4707,39130,7186,5916,1270,7186,105300,2011
26081,34.2,602046,458610,56405,57355,153602,50801,227698,161662,66036,227698,145300,2011
26083,47,2139,2043,44,27,575,39821,887,756,131,887,87000,2011
26085,49.7,11594,9911,1120,182,2677,30639,4192,3466,726,4192,89600,2011
26087,41,89218,83030,925,3648,24765,54240,32815,27812,5003,32815,155000,2011
26089,49.7,21685,19707,113,814,6712,55247,9388,8001,1387,9388,241700,2011
26091,39.7,100456,88108,2395,7575,26359,48595,37673,30114,7559,37673,133800,2011
26093,40.5,181362,172829,824,3474,51016,71694,67397,58137,9260,67397,203200,2011
26095,43.4,6657,5347,719,183,1606,42083,2447,1946,501,2447,84200,2011
26097,48.2,11198,8551,70,194,3176,39055,4917,3925,992,4917,126600,2011
26099,39.6,839217,709514,67041,18947,221640,54087,330452,256695,73757,330452,148600,2011
26101,46.5,24853,22555,729,657,6914,41169,10745,8617,2128,10745,120000,2011
26103,39.5,66859,62274,1059,824,15955,45495,25752,18466,7286,25752,127700,2011
26105,44.9,28682,26608,196,1128,8317,40683,12312,9266,3046,12312,121500,2011
26107,33.3,42817,39553,1205,779,10020,37677,15842,11583,4259,15842,117500,2011
26109,45.7,24138,22786,47,300,7171,42014,10866,8718,2148,10866,96700,2011
26111,39.9,83708,77858,1014,1759,23215,52465,33658,25963,7695,33658,131900,2011
26113,42.2,14937,14319,51,268,4145,39735,5861,4817,1044,5861,111800,2011
26115,39.7,152410,141056,2928,4611,42617,55826,58200,46788,11412,58200,156600,2011
26117,38.7,63431,58709,1437,1972,16607,40068,23332,18562,4770,23332,107000,2011
26119,52.1,9827,9531,16,93,2815,34490,4204,3654,550,4204,100200,2011
26121,38.1,172745,133877,23988,8143,44854,40298,65272,48822,16450,65272,108700,2011
26123,40,48778,44390,617,2620,13281,43864,18616,15628,2988,18616,113800,2011
26125,39.9,1202625,908798,155448,41308,319724,66456,481449,354203,127246,481449,190500,2011
26127,41.4,26839,22516,102,3568,6924,40422,9759,8197,1562,9759,110900,2011
26129,47.2,21781,20963,63,296,5558,35988,8291,6930,1361,8291,100800,2011
26131,52.3,6848,6609,57,74,2058,34786,3413,2925,488,3413,75000,2011
26133,41.4,23612,22615,153,353,6321,39035,9042,7266,1776,9042,99500,2011
26135,49.2,8791,8528,6,81,2561,32838,3987,3350,637,3987,88800,2011
26137,42.4,24305,23344,16,308,6714,46303,9692,7967,1725,9692,120500,2011
26139,34.3,263037,225460,3076,22500,68725,55661,93777,74202,19575,93777,158900,2011
26141,51.1,13528,13119,27,108,4078,39240,6195,5510,685,6195,105600,2011
26143,52.8,24710,23852,85,283,7185,33286,11255,9532,1723,11255,102900,2011
26145,39.3,200998,142022,37059,15442,50478,43258,76828,56581,20247,76828,106400,2011
26147,40.6,164374,151641,4052,4716,44256,48869,63985,49897,14088,63985,141800,2011
26149,38.4,61630,54425,1724,3970,15840,44433,22319,17475,4844,22319,113800,2011
26151,42,43554,41286,178,1421,11419,40437,16657,13773,2884,16657,108900,2011
26153,47.9,8552,7476,55,79,2467,38367,3673,3218,455,3673,85100,2011
26155,39.6,71016,67632,331,1712,19816,47552,27581,21544,6037,27581,122800,2011
26157,41,56134,52931,623,1583,15468,43315,21525,17698,3827,21525,106300,2011
26159,39.8,76410,63219,3182,7565,20190,44428,28846,22849,5997,28846,122300,2011
26161,32.8,344727,249194,41662,13659,78354,59737,134165,83762,50403,134165,208800,2011
26163,36.9,1844186,913038,747503,94249,432589,41886,681674,453730,227944,681674,110000,2011
26165,40.7,32711,31240,146,551,8553,42209,12426,9935,2491,12426,108400,2011
27001,51.3,16303,15485,25,146,5087,41301,7823,6424,1399,7823,175400,2011
27003,36.7,329487,282316,13252,11619,86611,69139,120886,99544,21342,120886,215900,2011
27005,42.5,32422,28482,132,461,9285,47959,13458,10599,2859,13458,169300,2011
27007,33.8,44233,32945,359,773,11001,43989,16536,11875,4661,16536,148900,2011
27009,33.8,38357,35894,762,681,9860,51159,15139,10809,4330,15139,165800,2011
27011,48.5,5297,5181,23,56,1550,44438,2395,1897,498,2395,83300,2011
27013,29.7,63370,57768,1495,1605,14042,48911,24045,16063,7982,24045,161700,2011
27015,43,25926,24701,64,820,6890,48149,10861,8536,2325,10861,122400,2011
27017,40.6,35141,31316,560,512,9539,53553,13820,11090,2730,13820,163300,2011
27019,36,90064,81764,961,3464,24923,82710,32715,27164,5551,32715,277600,2011
27021,46.4,28584,24417,109,386,8966,43042,12943,10650,2293,12943,185400,2011
27023,42.9,12383,11351,62,586,3237,44712,5223,3848,1375,5223,94900,2011
27025,37.9,53334,50453,653,921,14495,67075,19540,16781,2759,19540,224700,2011
27027,31.8,58032,52597,851,2108,14584,52108,21928,15528,6400,21928,149900,2011
27029,42.7,8654,7522,81,115,2512,39143,3684,2863,821,3684,117300,2011
27031,49.6,5213,4579,41,31,1646,49496,2627,1905,722,2627,240600,2011
27033,43.6,11695,10479,61,676,3335,43111,4861,3871,990,4861,83100,2011
27035,42.6,62267,59760,444,711,18030,45853,26906,20581,6325,26906,188600,2011
27037,36.4,396547,328506,17713,22865,106186,73723,151719,118286,33433,151719,238300,2011
27039,37,19961,18694,70,881,5486,66216,7347,6381,966,7347,162100,2011
27041,43.2,36051,35044,181,360,10427,48436,16222,12245,3977,16222,188100,2011
27043,45.7,14690,13692,72,742,4145,43214,6274,5036,1238,6274,87300,2011
27045,42.9,20946,20463,37,182,5781,47940,8507,6816,1691,8507,137000,2011
27047,44.4,31301,27873,231,2633,8529,43447,13210,10439,2771,13210,109500,2011
27049,41.3,46051,43062,485,1285,12665,56099,18686,14666,4020,18686,188000,2011
27051,46.3,6055,5871,11,91,1750,43777,2646,2054,592,2646,102600,2011
27053,35.9,1146195,828629,131185,75076,276073,62966,475737,308358,167379,475737,244100,2011
27055,43.7,19108,18582,68,124,5433,53017,7810,6382,1428,7810,151000,2011
27057,46.7,20318,19068,52,316,5957,45733,8640,7193,1447,8640,173400,2011
27059,37.3,37910,36020,197,625,10008,58721,13778,11353,2425,13778,196400,2011
27061,44.8,44955,41901,111,458,12816,47106,18761,15317,3444,18761,151900,2011
27063,44.3,10326,9772,26,252,2987,47455,4526,3558,968,4526,97000,2011
27065,41.4,16344,15718,94,202,4457,46863,6316,5208,1108,6316,162000,2011
27067,39.6,41992,35970,738,4569,11839,49915,17270,12839,4431,17270,162000,2011
27069,47.8,4575,4445,22,31,1224,50049,1954,1649,305,1954,65600,2011
27071,45.9,13365,12576,23,185,3719,41135,6194,4708,1486,6194,102500,2011
27073,48.3,7298,7088,41,101,2129,48269,3072,2555,517,3072,80300,2011
27075,47.9,10877,10435,9,88,3244,47450,5180,4153,1027,5180,142300,2011
27077,48.2,4085,3908,53,15,1229,43523,1728,1533,195,1728,130100,2011
27079,39.5,27754,25757,49,1438,7637,58074,10938,9060,1878,10938,190900,2011
27081,46,5898,5763,13,49,1615,46270,2570,2149,421,2570,77400,2011
27083,34.4,25716,22637,483,1529,6093,47254,10174,6896,3278,10174,137600,2011
27085,38.7,36719,34055,177,1854,10260,57323,14871,11489,3382,14871,166200,2011
27087,37,5396,2773,42,110,1356,39385,2007,1491,516,2007,89600,2011
27089,44.1,9519,9018,60,327,2790,49636,4116,3394,722,4116,87500,2011
27091,45.1,20821,19750,92,711,5801,44791,8943,6895,2048,8943,98800,2011
27093,40.9,23348,22267,50,718,6766,51929,9400,7673,1727,9400,165600,2011
27095,39.1,26095,23674,108,393,7048,46100,10594,8114,2480,10594,163100,2011
27097,40.5,33178,32143,38,402,9155,46054,13573,10828,2745,13573,157600,2011
27099,38.7,38985,33163,766,3884,10322,45596,16042,11721,4321,16042,108300,2011
27101,46.9,8729,8347,12,217,2620,47833,3914,3281,633,3914,88100,2011
27103,33.1,32471,29772,668,1165,8138,59877,12247,9053,3194,12247,170000,2011
27105,37.4,21188,14578,688,4550,5620,45552,8035,5795,2240,8035,100100,2011
27107,45,6849,6293,13,268,1815,43333,2852,2284,568,2852,81400,2011
27109,36.2,142934,119926,6552,5862,37583,66202,56601,42987,13614,56601,173000,2011
27111,45.6,57442,54480,421,1492,16693,45494,24560,19411,5149,24560,161400,2011
27113,40,13915,12903,173,362,3529,45007,5825,4478,1347,5825,94100,2011
27115,42,29567,26875,573,715,8040,44463,11862,9633,2229,11862,158200,2011
27117,43.1,9572,8895,58,309,2603,42217,3929,2948,981,3929,87100,2011
27119,40.8,31392,28390,231,1712,8363,49257,12442,9137,3305,12442,118800,2011
27121,45.5,11013,10749,41,64,3219,49599,4823,3747,1076,4823,150500,2011
27123,34.6,506608,343197,52593,35673,118543,52713,204342,124904,79438,204342,217400,2011
27125,42.4,4101,3899,27,98,1187,47719,1718,1414,304,1718,78500,2011
27127,42.8,16039,14216,106,334,4428,45177,6594,5143,1451,6594,85100,2011
27129,43.6,15834,14481,89,1011,4355,48442,6491,5116,1375,6491,97700,2011
27131,34.9,63594,54121,1958,4986,15318,59533,22117,17078,5039,22117,204200,2011
27133,40.7,9625,9193,55,186,2624,44510,3942,2998,944,3942,104100,2011
27135,40.1,15769,14864,57,123,4455,48612,6357,5069,1288,6357,101300,2011
27137,40.7,199849,184709,2763,2486,51229,45399,86446,61685,24761,86446,141800,2011
27139,34.7,128447,109143,3449,5630,33909,83415,44593,38274,6319,44593,263100,2011
27141,33.7,87881,81610,1536,1925,22498,71819,29572,24441,5131,29572,218600,2011
27143,40.2,15219,13844,80,1046,4149,52482,6103,4928,1175,6103,148100,2011
27145,33,149337,135843,4234,4006,36845,53035,56469,41005,15464,56469,172600,2011
27147,38.3,36529,32612,941,2209,9791,57290,14053,10968,3085,14053,158800,2011
27149,34,9703,8899,60,311,2227,47712,3739,2620,1119,3739,119100,2011
27151,44.4,9852,9190,235,341,2629,43846,4192,3075,1117,4192,94600,2011
27153,41.5,24848,23125,82,1186,7040,44202,9994,8253,1741,9994,135400,2011
27155,47.1,3603,3373,3,66,993,44773,1604,1296,308,1604,69200,2011
27157,42.8,21701,20762,124,563,6090,52346,8751,7307,1444,8751,160300,2011
27159,43.6,13820,13251,114,181,3893,35307,5968,4489,1479,5968,117600,2011
27161,39.2,19154,17376,223,934,5117,52357,7303,5886,1417,7303,142700,2011
27163,38.1,235802,202627,7473,7888,64299,79571,87446,72590,14856,87446,257200,2011
27165,41.5,11190,8598,29,2252,2947,49307,4396,3489,907,4396,93400,2011
27167,43.1,6613,6340,13,137,1871,51957,2658,2199,459,2658,103300,2011
27169,32.6,51394,47854,481,1173,11632,44848,19292,13703,5589,19292,160200,2011
27171,34.4,123019,115299,1120,2969,33670,69674,44683,37933,6750,44683,213900,2011
27173,42.9,10446,9627,69,359,2902,50740,4157,3286,871,4157,98500,2011
28001,40.6,32431,12744,18887,509,7181,26784,12074,8329,3745,12074,81100,2011
28003,39.1,36881,31208,4238,979,9634,32221,13867,10052,3815,13867,85500,2011
28005,43.4,13213,7530,5593,36,3200,31402,5001,4188,813,5001,73800,2011
28007,39.4,19552,10887,8272,308,4989,29805,7308,5377,1931,7308,70800,2011
28009,40.4,8704,5277,3210,43,2105,28666,3197,2494,703,3197,82600,2011
28011,33.7,34592,11323,22736,84,7995,27173,12396,7049,5347,12396,81000,2011
28013,39.2,14937,9841,4243,735,4054,29893,5988,4215,1773,5988,58700,2011
28015,40.9,10578,6826,3645,7,2838,28793,3958,3317,641,3958,62200,2011
28017,37.5,17497,9259,7311,591,4574,30395,6673,4811,1862,6673,62300,2011
28019,41.7,8586,5793,2701,21,2213,29832,3383,2647,736,3383,68800,2011
28021,33.1,9775,1447,8303,9,1983,21924,3299,2554,745,3299,53800,2011
28023,40.2,16758,10692,5979,31,4753,31059,6521,5154,1367,6521,61600,2011
28025,38.6,20748,8342,11952,101,5977,32919,7917,5748,2169,7917,78200,2011
28027,32.1,26376,6059,19793,107,6395,26050,9367,5072,4295,9367,56000,2011
28029,36.3,29459,13446,14978,741,6639,38154,10045,7750,2295,10045,75500,2011
28031,36.8,19575,12207,6718,322,4784,31127,7040,5965,1075,7040,78900,2011
28033,35,158486,112988,31069,7591,43058,59734,56641,43553,13088,56641,153600,2011
28035,31,74802,44077,26756,2524,17030,35805,28032,16396,11636,28032,112200,2011
28037,41.3,8112,5195,2843,5,2239,33250,3184,2590,594,3184,69700,2011
28039,36.2,22361,19740,1950,472,5999,45365,8069,6587,1482,8069,96100,2011
28041,36.2,14249,10237,3497,273,3504,40404,4233,3627,606,4233,75300,2011
28043,39,22032,12463,9224,129,5826,33123,8766,6087,2679,8766,84900,2011
28045,41,43322,37346,3027,1464,12350,42591,17166,13263,3903,17166,149700,2011
28047,35.5,185120,125077,40290,9340,46264,44550,69384,44753,24631,69384,146600,2011
28049,32.9,245891,70699,167942,3620,58636,39290,88159,53165,34994,88159,108200,2011
28051,31.9,19372,3163,16036,14,4256,22259,6603,4785,1818,6603,49700,2011
28053,34.3,9504,2222,7108,170,2160,25730,3256,1907,1349,3256,65100,2011
28055,37.3,1825,634,1187,4,326,22396,508,319,189,508,54400,2011
28057,38.8,23350,21338,1519,275,6556,37769,8870,7030,1840,8870,80500,2011
28059,37.1,138511,97265,29987,6002,36001,49620,50185,36258,13927,50185,129100,2011
28061,40.3,17229,7929,9021,69,4353,28914,6874,5694,1180,6874,68500,2011
28063,39.3,7845,1094,6721,10,1799,20375,2735,1962,773,2735,64300,2011
28065,41.1,12504,4870,7382,53,3319,25842,4905,3878,1027,4905,69500,2011
28067,37,67497,44391,18643,3162,17841,37643,24589,17970,6619,24589,85000,2011
28069,37.4,10394,3708,6123,149,2453,25584,3794,2867,927,3794,63300,2011
28071,26.8,46702,33007,11186,1088,9461,41166,15944,9834,6110,15944,158000,2011
28073,33.5,54275,41766,10119,1147,14449,50075,21237,14734,6503,21237,158100,2011
28075,36.8,79882,43468,33689,1458,20506,35420,29762,20110,9652,29762,85200,2011
28077,38.9,12945,8542,4117,227,3567,37000,5006,3971,1035,5006,75000,2011
28079,32.7,23634,11615,9604,976,5720,32537,7756,5959,1797,7756,74400,2011
28081,35.8,82340,56739,22124,1965,22924,41150,31765,21919,9846,31765,109000,2011
28083,32.6,32706,8204,23200,751,7215,22353,11062,5641,5421,11062,66100,2011
28085,37.4,34751,23594,10538,364,9774,38438,13220,10105,3115,13220,80600,2011
28087,36.1,59533,31821,25797,967,15790,37626,23243,14878,8365,23243,110400,2011
28089,35.7,93807,52787,35876,2620,24288,59730,35297,24955,10342,35297,190600,2011
28091,37.3,26861,17479,8727,348,6930,32117,9688,7807,1881,9688,82800,2011
28093,38.5,37089,18053,17688,1077,9001,33279,12735,9984,2751,12735,83700,2011
28095,39.1,37118,25012,11448,361,10653,35102,14493,11365,3128,14493,79000,2011
28097,40.7,11022,5817,5116,0,3127,33087,4286,3288,998,4286,68800,2011
28099,35.3,29627,17868,6124,535,7515,36128,10652,8104,2548,10652,69900,2011
28101,37.6,21763,13634,6656,300,6133,37386,7978,6363,1615,7978,68400,2011
28103,36.7,11643,3215,8264,92,2783,21798,4151,3098,1053,4151,53000,2011
28105,25.1,47064,27381,17088,737,9835,29013,18537,9293,9244,18537,108100,2011
28107,35.9,34763,17054,16979,514,8324,34592,12133,9317,2816,12133,78400,2011
28109,38.4,56042,46225,7076,1601,15358,42971,20581,16119,4462,20581,119100,2011
28111,39,12256,9485,2683,5,3633,39070,4709,4053,656,4709,82200,2011
28113,37,40314,18698,20567,509,10103,32751,14849,10678,4171,14849,82200,2011
28115,35.8,29682,23496,4052,1661,7210,38574,10028,7793,2235,10028,80600,2011
28117,38.7,25388,21299,3381,276,7047,32518,9638,7628,2010,9638,73800,2011
28119,38.3,8378,2467,5822,63,2050,24545,3153,2113,1040,3153,47700,2011
28121,35.9,140443,107255,26616,3608,38029,56159,52539,40172,12367,52539,144400,2011
28123,35.3,28219,14438,10872,2787,6858,36999,9791,8017,1774,9791,62700,2011
28125,38.3,4692,1326,3331,27,1072,29451,1644,1094,550,1644,61900,2011
28127,37.9,27505,17191,9692,404,7279,36606,10324,7771,2553,10324,78600,2011
28129,38.1,16446,12317,3892,165,4647,36795,6173,5541,632,6173,74500,2011
28131,36.3,17294,13433,3381,237,4624,43731,6083,4875,1208,6083,106900,2011
28133,33.2,30074,7685,21799,407,5914,27042,8459,4946,3513,8459,65500,2011
28135,35.5,15279,5600,8284,1207,3300,27092,4626,3467,1159,4626,57700,2011
28137,36.2,28447,18830,8513,605,7221,41839,9982,7429,2553,9982,107000,2011
28139,38.2,22082,17378,3419,907,6101,35769,8322,6373,1949,8322,74300,2011
28141,42.3,19570,18276,646,533,5480,30734,7531,5963,1568,7531,75000,2011
28143,32,10802,2550,7777,237,2370,30470,3992,1984,2008,3992,57900,2011
28145,37.2,27037,21656,3775,1114,7609,36661,10128,7611,2517,10128,85000,2011
28147,36.7,15495,8136,7020,221,3671,34045,5286,4480,806,5286,81900,2011
28149,37.5,48663,24288,22608,944,12283,40469,19023,12702,6321,19023,98500,2011
28151,35,51665,14163,36173,575,12751,28591,18821,10313,8508,18821,73600,2011
28153,37.1,20875,12408,8042,233,6079,31388,8436,6956,1480,8436,64400,2011
28155,40.2,10204,7961,1913,124,2914,36392,3950,2898,1052,3950,72100,2011
28157,36.4,9946,2897,6989,53,2375,33732,3459,2603,856,3459,58900,2011
28159,39,19284,10045,8948,200,4899,33007,7348,5744,1604,7348,75100,2011
28161,40.1,12787,7698,4877,136,3453,33076,4737,3477,1260,4737,60700,2011
28163,35.3,28238,10630,15721,1310,5810,27979,8518,5342,3176,8518,67000,2011
29001,28.6,25421,23540,493,548,5624,33157,9636,5810,3826,9636,100800,2011
29003,41.5,17073,16424,60,263,4882,54148,6634,5208,1426,6634,127300,2011
29005,46.1,5742,5524,82,48,1592,44330,2447,1767,680,2447,71200,2011
29007,38,25623,22718,1682,650,6536,41567,9426,7089,2337,9426,83900,2011
29009,41,35652,31587,26,2747,9681,38321,13891,10507,3384,13891,102700,2011
29011,39.9,12506,11834,15,206,3609,39144,4995,3785,1210,4995,83400,2011
29013,41.1,17097,16361,121,262,4440,38966,6602,5041,1561,6602,103100,2011
29015,51.1,19058,18285,24,282,5797,34512,8253,6914,1339,8253,103800,2011
29017,42.1,12418,12093,55,94,3406,36119,4788,3890,898,4788,96100,2011
29019,29.4,160628,130363,14132,4848,36743,47123,63790,36738,27052,63790,156600,2011
29021,36.8,88801,76886,3822,4461,21315,43386,33662,22504,11158,33662,106800,2011
29023,40.3,42607,38322,2232,725,11425,34080,17375,11706,5669,17375,86200,2011
29025,41.8,9373,9012,76,135,2686,40522,3708,2766,942,3708,100300,2011
29027,37.3,44026,39966,1887,773,11779,50669,16899,12993,3906,16899,127700,2011
29029,48.3,43533,41526,218,994,12814,44961,18104,14603,3501,18104,187100,2011
29031,36.3,75017,66137,5125,1495,19906,45795,29452,19732,9720,29452,137100,2011
29033,41.8,9388,8984,142,119,2591,44015,3660,2912,748,3660,77700,2011
29035,41.2,6208,5939,36,74,1583,26689,2472,1830,642,2472,88800,2011
29037,37.8,98713,88574,3208,3850,27727,60807,36864,29063,7801,36864,154700,2011
29039,44.9,14040,13494,49,189,4091,31353,6101,4609,1492,6101,93100,2011
29041,45.2,7814,7527,168,61,2056,40958,3065,2445,620,3065,75600,2011
29043,36.3,75998,71588,521,1944,22439,51961,29166,21703,7463,29166,146600,2011
29045,42.2,7130,6976,28,12,1921,40333,2846,2217,629,2846,68900,2011
29047,36.1,218767,184819,10321,12579,59064,60507,86954,62181,24773,86954,156100,2011
29049,40.5,20771,19670,323,356,5837,51439,8085,6044,2041,8085,150700,2011
29051,37.7,75343,62677,8240,1787,19436,55580,29356,19421,9935,29356,139300,2011
29053,37.3,17606,15723,1001,236,4472,45869,6376,4644,1732,6376,116600,2011
29055,40.4,24725,23833,55,368,6351,35947,9528,7293,2235,9528,106900,2011
29057,45.4,7896,7504,48,112,2131,32248,3222,2498,724,3222,72200,2011
29059,41,16846,16121,18,243,4622,39132,6368,5091,1277,6368,99100,2011
29061,40.1,8357,8137,32,87,2293,41133,3179,2408,771,3179,109500,2011
29063,39.9,12847,10980,1136,211,2615,45252,3947,2634,1313,3947,118900,2011
29065,43.3,15550,14933,80,152,4337,36715,6063,4603,1460,6063,82500,2011
29067,43.9,13682,13373,15,115,3539,32300,5096,3999,1097,5096,102900,2011
29069,39.3,32055,26647,3194,1705,8350,30806,12862,7941,4921,12862,68500,2011
29071,38.8,101263,97215,1121,1409,27556,50098,38817,29837,8980,38817,150300,2011
29073,44.8,15274,14852,40,145,4173,40788,6368,5053,1315,6368,112000,2011
29075,42.2,6765,6629,36,57,1830,36307,2731,2055,676,2731,78800,2011
29077,35.6,273020,245010,7537,8080,69686,41622,113800,69228,44572,113800,128100,2011
29079,42.3,10222,9822,101,98,2739,36590,4335,3045,1290,4335,75400,2011
29081,43,8942,8660,61,127,2313,35915,3482,2607,875,3482,73100,2011
29083,43.5,22305,21262,286,377,6310,36944,9458,6954,2504,9458,105100,2011
29085,51.8,9603,8620,64,31,2858,28850,4301,3586,715,4301,92200,2011
29087,45.7,4910,4780,29,12,1468,41737,2199,1700,499,2199,77700,2011
29089,39.6,10144,9233,545,132,2575,46991,3794,2973,821,3794,97300,2011
29091,39.3,40088,38155,89,711,11109,35625,15538,11181,4357,15538,98600,2011
29093,42.6,10661,10190,119,128,2840,32029,4298,3160,1138,4298,77200,2011
29095,36.2,670100,426316,159005,54269,165772,46874,270493,168904,101589,270493,130300,2011
29097,35,116307,100546,2281,7713,29694,39522,44674,29182,15492,44674,96900,2011
29099,37.4,217531,207665,1721,3417,59051,56400,80703,66940,13763,80703,154100,2011
29101,29.8,52428,46228,2277,1695,12771,47268,19435,12500,6935,19435,135700,2011
29103,43.9,4127,4025,31,32,1083,34596,1760,1292,468,1760,53900,2011
29105,38.9,35495,33596,254,746,10288,39697,14357,10267,4090,14357,94400,2011
29107,40.2,33296,30999,806,748,9300,50000,13290,9949,3341,13290,120800,2011
29109,39.1,38548,35153,171,2330,10535,39829,15012,10925,4087,15012,96300,2011
29111,39.2,10207,9546,335,66,2623,40579,3795,2852,943,3795,80100,2011
29113,35.4,52122,48991,809,1068,14061,53726,18638,15185,3453,18638,156100,2011
29115,42.8,12749,12297,74,171,3262,38211,4968,3704,1264,4968,68600,2011
29117,41.2,15032,14232,414,178,3682,42260,5547,3853,1694,5547,93600,2011
29119,36.7,23015,18691,158,2595,5877,37701,8240,5682,2558,8240,88100,2011
29121,42,15549,14734,367,152,4204,37889,6311,4820,1491,6311,84100,2011
29123,40.6,12281,11858,42,211,3295,35141,4774,3657,1117,4774,85600,2011
29125,42.2,9192,8887,45,93,2638,42018,3635,2927,708,3635,116200,2011
29127,38.7,28623,26069,1457,423,7495,40915,11194,7717,3477,11194,99000,2011
29129,43.9,3758,3659,21,36,1039,34440,1560,1186,374,1560,69600,2011
29131,40.1,24807,23839,160,353,6747,36411,10320,7861,2459,10320,109300,2011
29133,39.9,14196,10426,3238,346,3348,28474,5289,3423,1866,5289,65200,2011
29135,37,15541,13659,785,586,4030,50887,5507,4179,1328,5507,114500,2011
29137,43.8,8985,8485,284,92,2458,39495,3630,2804,826,3630,83700,2011
29139,42.4,12254,11658,179,170,3565,40175,4979,3825,1154,4979,107600,2011
29141,46.5,20617,19672,158,340,5832,36928,8215,6853,1362,8215,116700,2011
29143,39.6,18839,15293,2982,227,4993,34772,7620,4783,2837,7620,70700,2011
29145,38.5,57907,50935,411,2488,15829,41873,21719,16306,5413,21719,106500,2011
29147,28.2,23185,21742,391,479,4712,38680,8574,5026,3548,8574,98300,2011
29149,45.1,10810,10316,21,127,2898,27885,4518,3435,1083,4518,70700,2011
29151,39.4,13816,13582,105,91,3905,47836,5331,4473,858,5331,117300,2011
29153,48.8,9675,9341,20,99,2968,31992,4000,3278,722,4000,101700,2011
29155,36.6,18429,12841,5080,334,4449,28798,6842,3836,3006,6842,65100,2011
29157,39.7,18997,18311,95,291,5198,44383,7600,5955,1645,7600,120200,2011
29159,37.1,41831,36496,1055,2989,10620,38669,16275,11589,4686,16275,97700,2011
29161,33.7,44665,40386,1050,968,10608,40675,16688,10820,5868,16688,112700,2011
29163,39.6,18561,16494,1236,353,4650,42276,6581,4751,1830,6581,93300,2011
29165,38.3,88301,74860,4879,4295,24427,66487,35686,23531,12155,35686,188400,2011
29167,38,30952,29429,94,607,8288,38423,11700,8363,3337,11700,113500,2011
29169,26.9,50455,36613,5621,4471,10188,46919,15708,8697,7011,15708,122600,2011
29171,44.1,5003,4783,21,111,1577,34556,2238,1670,568,2238,94900,2011
29173,44,10169,9842,42,102,3148,47286,4222,3438,784,4222,106300,2011
29175,37.8,25465,22788,1616,427,5997,36484,9064,6471,2593,9064,81300,2011
29177,39.7,23542,22395,299,427,6562,54670,9041,7122,1919,9041,124000,2011
29179,44.5,6676,6394,64,78,1794,33382,2856,2109,747,2856,81300,2011
29181,42,14080,13819,10,152,4023,30198,5556,4108,1448,5556,68100,2011
29183,36.8,356070,318161,15016,9659,96568,71458,132908,109096,23812,132908,196100,2011
29185,48,9748,9325,68,8,2905,32553,4351,3422,929,4351,83500,2011
29186,42.9,18179,17625,244,152,5098,48110,7214,5908,1306,7214,125800,2011
29187,38.2,64771,60155,2821,830,16002,37630,24519,17227,7292,24519,101100,2011
29189,39.7,998760,692904,228897,24309,266067,58630,404158,291326,112832,404158,178800,2011
29195,38,23178,19375,1307,1865,5912,39727,8928,6276,2652,8928,82800,2011
29197,38.5,4386,4215,50,17,1243,32862,1944,1343,601,1944,61100,2011
29199,41.9,4831,4729,13,61,1335,36863,2020,1533,487,2020,73500,2011
29201,39.2,39268,33337,4404,710,10755,39113,15203,10469,4734,15203,95600,2011
29203,43,8428,7998,42,136,2481,31748,3362,2642,720,3362,76700,2011
29205,43.5,6389,6212,97,31,1651,35124,2653,1865,788,2653,71700,2011
29207,41.2,29992,28913,380,361,8232,34839,12235,8532,3703,12235,83400,2011
29209,49.1,32154,27785,34,542,9742,41069,13297,10390,2907,13297,141300,2011
29211,40.1,6702,5412,25,1153,1779,33193,2605,1761,844,2605,71800,2011
29213,40.9,50631,43941,144,2379,13858,40120,20525,13808,6717,20525,136100,2011
29215,42,25773,23796,861,423,6645,33128,9560,7053,2507,9560,93800,2011
29217,40.2,20959,19970,163,328,5466,37312,8137,5855,2282,8137,83200,2011
29219,39.3,32104,29821,580,924,8871,50182,12501,9933,2568,12501,159700,2011
29221,39.5,25069,23847,495,254,6614,35148,9161,7180,1981,9161,81500,2011
29223,45.6,13448,12992,23,45,3618,29331,5638,4146,1492,5638,74000,2011
29225,37.4,36027,34296,420,614,9854,41764,12848,9893,2955,12848,118600,2011
29227,46.3,2178,2153,2,11,687,39671,977,730,247,977,57500,2011
29229,40.8,18764,18072,116,233,5199,29212,7529,5264,2265,7529,90800,2011
29510,33.9,318367,134206,156346,10748,66803,34402,139693,64837,74856,139693,123300,2011
30001,42.5,9170,8488,22,315,2484,41226,4004,2511,1493,4004,182200,2011
30003,30.1,12776,3966,1,523,2547,37277,3489,2323,1166,3489,88800,2011
30005,35.1,6476,3125,0,125,1625,38721,2318,1491,827,2318,69900,2011
30007,41.8,5447,5081,87,17,1357,44570,1959,1537,422,1959,160600,2011
30009,47.5,10016,9604,22,181,2779,46194,4265,3075,1190,4265,202100,2011
30011,50.3,1266,1247,0,4,362,35121,551,407,144,551,69400,2011
30013,39,80931,70847,946,2776,21534,44074,33134,22200,10934,33134,151200,2011
30015,41.1,5784,4413,10,93,1523,40825,2167,1377,790,2167,109200,2011
30017,42.3,11621,10963,57,232,3121,41373,5122,3512,1610,5122,97700,2011
30019,50.6,1721,1606,0,4,493,37578,801,629,172,801,78600,2011
30021,42.4,8961,8485,16,171,2605,51761,3749,2748,1001,3749,110900,2011
30023,46.4,9294,8543,103,238,2421,34095,4041,2854,1187,4041,105700,2011
30025,43,2861,2768,0,14,782,49573,1216,911,305,1216,89200,2011
30027,47.7,11516,11012,10,165,3136,37601,4881,3525,1356,4881,115000,2011
30029,41,90317,84921,191,2111,24188,45588,36697,26263,10434,36697,235200,2011
30031,32.1,89146,83219,369,2482,21942,51391,36528,22683,13845,36528,276000,2011
30033,48.4,1162,1131,0,5,312,37500,472,373,99,472,69100,2011
30035,32,13329,4169,1,248,3128,40109,4259,2546,1713,4259,74900,2011
30037,46.8,873,826,0,3,218,36250,343,258,85,343,97600,2011
30039,51.4,3055,2951,0,42,936,38179,1537,1125,412,1537,170800,2011
30041,35.4,16092,11740,64,386,4173,46724,6069,4141,1928,6069,109700,2011
30043,45.8,11281,10628,45,212,3248,59284,4517,3842,675,4517,234700,2011
30045,51.2,2061,2032,0,17,583,40046,911,720,191,911,102900,2011
30047,41.7,28628,19638,48,1022,7949,38268,12017,8220,3797,12017,200600,2011
30049,40.7,62597,57956,246,1581,16087,53053,26549,19144,7405,26549,196700,2011
30051,47.4,2300,2256,12,0,563,42674,822,531,291,822,85700,2011
30053,49,19574,18481,28,439,5987,32012,8998,6897,2101,8998,162900,2011
30055,47,1815,1778,0,0,513,50774,745,572,173,745,84300,2011
30057,49.2,7654,7321,9,159,2250,45242,3672,2616,1056,3672,250300,2011
30059,42.1,1900,1791,0,97,433,33846,694,467,227,694,111500,2011
30061,49,4193,3924,46,87,1107,36261,1713,1192,521,1713,169100,2011
30063,34,108431,98784,465,2894,25999,43895,44946,27214,17732,44946,239000,2011
30065,49.3,4426,4247,10,103,1399,38669,1983,1540,443,1983,122200,2011
30067,45,15704,14978,0,311,4381,41232,6735,4872,1863,6735,208000,2011
30069,45.7,568,482,34,20,185,38162,253,173,80,253,103000,2011
30071,47.5,4227,3651,0,80,1060,38958,1740,1396,344,1740,77900,2011
30073,42.4,6165,5042,40,100,1514,38852,2265,1605,660,2265,85500,2011
30075,47.6,1656,1563,0,60,480,39091,702,483,219,702,106800,2011
30077,45.7,7068,6462,33,128,1611,41347,2365,1752,613,2365,119500,2011
30079,56.1,1093,1038,0,3,311,34440,491,413,78,491,64000,2011
30081,45.6,40199,37792,121,1194,11434,43512,16631,12703,3928,16631,241000,2011
30083,41.6,9669,9029,23,285,2732,57413,4083,2821,1262,4083,112100,2011
30085,31,10323,3757,7,143,2067,37807,3333,2084,1249,3333,60600,2011
30087,36.5,9200,5523,69,299,2351,44449,3276,2241,1035,3276,104900,2011
30089,49.3,11421,10362,24,216,3381,30368,5078,3910,1168,5078,174600,2011
30091,49.7,3426,3268,8,23,973,42148,1684,1245,439,1684,81500,2011
30093,41.7,33985,31368,85,1238,8631,40030,14981,9816,5165,14981,120700,2011
30095,45.4,9026,8617,23,200,2668,56652,3754,2852,902,3754,175800,2011
30097,48.2,3702,3580,0,91,1009,41913,1517,1165,352,1517,182400,2011
30099,45.3,6103,5814,2,96,1715,40811,2406,1872,534,2406,138500,2011
30101,43.2,5176,4676,13,119,1313,44688,2034,1349,685,2034,99200,2011
30103,46.8,824,679,0,80,213,38571,314,218,96,314,76400,2011
30105,45.8,7392,6390,8,106,2006,44641,3221,2299,922,3221,87900,2011
30107,49.4,2138,2094,1,0,519,32331,847,649,198,847,75000,2011
30109,49.7,964,928,8,16,247,43417,353,270,83,353,71900,2011
30111,38.4,146151,128833,810,6814,38221,50185,60263,42281,17982,60263,173500,2011
31001,37.7,31181,27750,228,2359,8156,47469,12441,8795,3646,12441,96900,2011
31003,46.1,6697,6459,21,164,2028,40474,2804,2064,740,2804,69000,2011
31005,37.7,448,441,0,5,120,43194,177,115,62,177,78300,2011
31007,48.3,703,685,0,11,207,27167,316,192,124,316,79200,2011
31009,45.2,585,553,0,0,198,39688,247,157,90,247,48300,2011
31011,45.3,5512,5396,1,79,1529,41691,2374,1802,572,2374,73500,2011
31013,40.9,11383,9634,15,1124,3318,44118,4803,3257,1546,4803,92100,2011
31015,49,2095,2017,0,71,569,37375,909,720,189,909,53700,2011
31017,46.9,3153,3098,5,2,807,29856,1395,991,404,1395,57100,2011
31019,32.3,45842,41081,363,3276,11007,49851,17340,11312,6028,17340,132600,2011
31021,46.7,6901,6571,55,121,2013,45813,2909,2245,664,2909,84000,2011
31023,44.1,8360,8071,67,192,2253,48804,3473,2643,830,3473,91600,2011
31025,41.2,25230,24118,79,594,7068,63608,9787,7993,1794,9787,146900,2011
31027,43.9,8839,8658,9,109,2294,42857,3474,2799,675,3474,86100,2011
31029,44.2,3937,3534,1,397,1170,40465,1698,1324,374,1698,83000,2011
31031,46.2,5750,5203,11,162,1597,41929,2462,1669,793,2462,92900,2011
31033,40.3,10056,9177,27,548,2839,50143,4423,3024,1399,4423,96900,2011
31035,43.4,6530,5971,40,427,1773,45590,2598,2069,529,2598,77200,2011
31037,35.2,10322,6122,110,3960,2632,46685,3726,2923,803,3726,81800,2011
31039,43.1,9194,8321,3,715,2631,46847,3795,2876,919,3795,88300,2011
31041,44.8,10962,10590,30,206,3241,43657,4545,3491,1054,4545,74600,2011
31043,33,20802,11879,581,7089,5458,43294,7301,4699,2602,7301,99700,2011
31045,33,9180,8092,183,301,1926,36396,3601,2230,1371,3601,90900,2011
31047,36.1,24261,15668,653,7529,6188,45038,8899,6297,2602,8899,85400,2011
31049,49.9,1967,1851,4,80,590,37500,906,684,222,906,65500,2011
31051,40.4,5996,5314,10,583,1690,44840,2378,1847,531,2378,76500,2011
31053,40,36651,32378,141,3396,9916,44744,15097,10200,4897,15097,110100,2011
31055,33.6,511739,371000,56909,55398,123483,52929,199576,127954,71622,199576,142400,2011
31057,47.3,1988,1849,1,131,654,40278,906,646,260,906,71700,2011
31059,45.7,5915,5687,19,160,1613,44031,2532,1981,551,2532,74700,2011
31061,48.3,3201,3130,6,46,896,40556,1370,1121,249,1370,54800,2011
31063,43.7,2779,2618,7,50,781,47552,1145,883,262,1145,75100,2011
31065,47.3,4927,4729,6,118,1396,38650,2153,1642,511,2153,54800,2011
31067,43.3,22423,21539,37,382,5941,45573,9121,6625,2496,9121,99700,2011
31069,51.6,2013,1892,0,93,633,35861,956,680,276,956,63800,2011
31071,47,2105,2057,7,41,602,38973,892,666,226,892,79600,2011
31073,45.8,2046,1951,12,72,578,42875,818,658,160,818,103600,2011
31075,47.3,671,656,0,13,205,39531,292,187,105,292,44700,2011
31077,41.2,2530,2489,10,26,659,42396,1024,831,193,1024,55500,2011
31079,35.5,57748,42623,1128,12779,14687,47469,21975,14532,7443,21975,110900,2011
31081,41.9,9135,8862,15,172,2528,54980,3396,2694,702,3396,109100,2011
31083,48.3,3439,3367,7,34,997,45396,1525,1248,277,1525,67500,2011
31085,46.5,979,947,5,19,315,45536,443,311,132,443,70300,2011
31087,48.5,2910,2817,4,62,905,36920,1350,999,351,1350,50200,2011
31089,45.7,10437,10055,18,260,2901,46292,4269,3244,1025,4269,86800,2011
31091,49.8,718,711,0,0,221,39125,329,273,56,329,64500,2011
31093,43.1,6298,6097,33,109,1785,46358,2641,2046,595,2641,93500,2011
31095,46,7619,7309,5,176,2129,42979,3233,2614,619,3233,71000,2011
31097,43.1,5200,4461,272,419,1201,43643,1984,1528,456,1984,78300,2011
31099,42.3,6548,6223,14,222,1874,54611,2616,2062,554,2616,99100,2011
31101,47.2,8342,7709,19,432,2424,42705,3811,2810,1001,3811,91200,2011
31103,54.1,763,760,0,0,253,38125,361,296,65,361,68000,2011
31105,45.6,3794,3450,9,213,1119,43191,1727,1204,523,1727,76800,2011
31107,46.1,8707,7735,58,144,2516,38965,3834,2840,994,3834,68400,2011
31109,32.5,282931,239902,9488,16035,70126,51059,112904,69787,43117,112904,146200,2011
31111,38.7,36199,32757,253,2524,9798,49521,15127,10473,4654,15127,111900,2011
31113,45.8,717,699,0,2,232,45625,317,236,81,317,76000,2011
31115,44.9,669,645,0,17,187,36250,262,205,57,262,70400,2011
31117,43.5,411,411,0,0,144,57917,175,122,53,175,77500,2011
31119,37.1,34618,29031,395,4294,8745,45077,13748,9124,4624,13748,103300,2011
31121,42.4,7768,7353,35,246,2283,49262,3234,2326,908,3234,79800,2011
31123,42.6,5052,4234,0,698,1459,42075,2062,1425,637,2062,77300,2011
31125,44.6,3742,3637,8,74,1032,43399,1516,1189,327,1516,65100,2011
31127,41.8,7243,6966,19,122,1898,41424,3049,2166,883,3049,80800,2011
31129,49.2,4538,4377,44,38,1339,32444,2024,1590,434,2024,50500,2011
31131,43.4,15751,14594,26,819,4335,50000,6406,4639,1767,6406,116700,2011
31133,48.9,2752,2666,0,37,848,44477,1290,1031,259,1290,57200,2011
31135,42.9,2966,2854,0,100,851,52266,1216,889,327,1216,84800,2011
31137,43.8,9190,8724,9,346,2489,44570,3851,2793,1058,3851,93300,2011
31139,42,7267,7096,9,97,2099,51205,2931,2395,536,2931,92200,2011
31141,39.1,31963,27217,19,4096,8230,51273,12333,9105,3228,12333,109900,2011
31143,45.1,5393,5180,4,142,1550,50298,2220,1637,583,2220,89500,2011
31145,42.5,11039,10371,59,422,3034,42627,4698,3338,1360,4698,78800,2011
31147,47.2,8396,7871,10,118,2249,39512,3769,2958,811,3769,62800,2011
31149,49.2,1601,1569,12,20,450,39977,673,591,82,673,61000,2011
31151,35.8,14170,10955,23,2666,3437,45347,4979,3419,1560,4979,96200,2011
31153,32.9,155874,131016,6159,10988,42768,69018,57759,41233,16526,57759,160800,2011
31155,41.7,20635,19869,63,411,5968,58348,8102,6567,1535,8102,139700,2011
31157,38.9,36729,27839,159,7538,9715,40939,14992,9841,5151,14992,95700,2011
31159,38,16639,16038,135,274,4470,59088,6364,4563,1801,6364,139000,2011
31161,46.1,5488,4587,10,158,1494,34588,2386,1701,685,2386,60900,2011
31163,49.5,3134,3011,0,83,914,41250,1379,1178,201,1379,61900,2011
31165,48,1336,1303,0,20,395,42386,587,451,136,587,107400,2011
31167,39.3,6167,5784,10,264,1806,49236,2433,1892,541,2433,88100,2011
31169,48.7,5231,5082,5,92,1485,43198,2212,1830,382,2212,58800,2011
31171,46.4,737,715,1,0,216,51375,318,236,82,318,66000,2011
31173,28.9,6920,2704,33,221,1491,39568,2053,1400,653,2053,64500,2011
31175,48.8,4253,4157,2,72,1228,42897,1868,1445,423,1868,71700,2011
31177,40.8,20199,19408,101,407,5254,64737,7454,6107,1347,7454,172900,2011
31179,27.7,9530,8860,97,373,2057,46418,3315,2266,1049,3315,95700,2011
31181,47.3,3802,3595,19,128,1051,38538,1572,1249,323,1572,63500,2011
31183,45.1,696,680,0,10,185,39653,315,213,102,315,75900,2011
31185,41.4,13804,12904,117,527,3795,48655,5653,4205,1448,5653,92200,2011
32001,38.4,24904,19075,416,2954,5909,52589,8849,5756,3093,8849,175300,2011
32003,35.3,1928695,940212,192400,554099,460177,55961,701836,400037,301799,701836,226200,2011
32005,46.9,47058,39323,136,4994,13077,60383,19175,14051,5124,19175,346600,2011
32007,33.6,48390,33520,374,10972,12282,69459,17244,12632,4612,17244,180700,2011
32009,59,897,720,7,128,193,29438,509,326,183,509,86400,2011
32011,39.4,1778,1527,11,124,462,61908,719,530,189,719,103400,2011
32013,36.6,16249,11324,27,3838,4243,54943,6098,4438,1660,6098,144000,2011
32015,36.9,5651,4048,1,1294,1659,69814,2006,1420,586,2006,108900,2011
32017,35.7,5177,4404,141,359,1242,42662,1815,1309,506,1815,156300,2011
32019,40.3,51937,40745,384,7681,12416,46598,18373,12848,5525,18373,166700,2011
32021,48.7,4760,3460,130,383,1235,31108,2209,1527,682,2209,101000,2011
32023,48.1,44052,34902,935,5915,12287,39740,18348,13146,5202,18348,142800,2011
32027,40.4,6720,4599,317,1451,1536,56473,2062,1508,554,2062,153100,2011
32029,50.4,4011,3574,14,143,1304,59386,1755,1644,111,1755,215200,2011
32031,36.8,417855,277641,10003,91641,102069,55813,160889,95897,64992,160889,257400,2011
32033,42.6,9884,7601,182,1250,2392,49812,3565,2619,946,3565,116800,2011
32510,41.8,55378,39502,1109,11487,13647,54235,21289,12983,8306,21289,244600,2011
33001,43.9,60166,57616,258,777,16755,56921,24645,18981,5664,24645,228100,2011
33003,47.3,47817,46334,53,510,13677,50555,20564,16554,4010,20564,239200,2011
33005,40.6,77301,73833,390,1137,19157,55241,30141,21341,8800,30141,202600,2011
33007,45.9,33224,32005,184,406,9407,41087,14860,10666,4194,14860,133200,2011
33009,40.9,88696,82167,770,1643,21870,53000,34498,24220,10278,34498,209900,2011
33011,38.9,400243,351793,7601,20645,105000,70591,153471,104861,48610,153471,265100,2011
33013,40.8,146785,138571,1424,2381,38633,65722,57045,41725,15320,57045,241900,2011
33015,41.9,295162,277982,1893,6207,80993,77470,115105,90208,24897,115105,296500,2011
33017,36.6,122859,114032,948,2234,30058,59082,46384,31494,14890,46384,227100,2011
33019,43.7,43658,42032,147,512,12490,51678,18156,13292,4864,18156,182700,2011
34001,39.7,273674,161285,41254,44881,67468,55222,101418,71670,29748,101418,256600,2011
34003,41,900730,569881,46254,140364,237263,83443,333073,222670,110403,333073,474200,2011
34005,40,448095,318379,70973,27975,116248,77798,165727,129949,35778,165727,266200,2011
34007,37.5,513582,312295,93388,71059,127897,61824,190337,131095,59242,190337,224800,2011
34009,46.8,97265,84853,4616,5716,29768,55315,44788,33263,11525,44788,332400,2011
34011,36.7,156142,79727,29403,40892,35333,52004,50868,34808,16060,50868,177800,2011
34013,36.2,781668,264177,309372,155306,182483,55876,276441,129501,146940,276441,389800,2011
34015,38.5,287036,233633,27222,13165,75291,74830,103548,83270,20278,103548,236100,2011
34017,34.2,627589,195468,72414,263719,147116,57660,240526,81737,158789,240526,374000,2011
34019,42.9,128355,112890,3351,6539,34380,103879,47455,40505,6950,47455,437100,2011
34021,37.7,365318,201812,71404,53299,87734,73883,129933,87752,42181,129933,302100,2011
34023,37.1,804299,404049,70987,144893,201144,78622,278513,185605,92908,278513,349000,2011
34025,41,628920,485705,44354,58707,162415,83842,233120,176545,56575,233120,413500,2011
34027,40.9,491307,370613,14698,54799,130451,98148,179581,136585,42996,179581,463200,2011
34029,42.5,572991,493842,16423,45689,151664,60712,222863,182548,40315,222863,284100,2011
34031,36.2,498009,228441,56667,181239,113864,56299,161488,89540,71948,161488,372700,2011
34033,40.8,65984,50788,9107,4295,17267,57174,25004,18260,6744,25004,198800,2011
34035,39.9,321304,203792,26844,40640,83131,98842,114348,90645,23703,114348,420500,2011
34037,41.2,149589,133119,2644,9449,41347,84860,55554,47252,8302,55554,312500,2011
34039,37.9,532378,244929,109513,142189,129480,68688,184584,113087,71497,184584,386000,2011
34041,41,108829,93467,3847,7436,29597,72615,41685,31636,10049,41685,294000,2011
35001,35.8,655306,275696,16146,309974,160961,48231,261525,168317,93208,261525,191400,2011
35003,57.4,3687,2828,0,637,1052,37857,1786,1551,235,1786,154600,2011
35005,34.9,64949,28990,477,33256,16262,37293,23740,16235,7505,23740,90000,2011
35006,36.6,27316,5949,74,9923,5702,36020,8037,5732,2305,8037,81300,2011
35007,46,13762,6908,27,6397,3473,38012,5781,3816,1965,5781,108200,2011
35009,31.6,47453,24278,2799,18448,11966,40397,17498,10962,6536,17498,104400,2011
35011,48.2,2020,1178,10,829,552,33714,832,661,171,832,74700,2011
35013,32.3,205637,62379,2982,134659,50621,37223,72748,48057,24691,72748,141900,2011
35015,37.3,53228,28027,577,23129,13778,47725,19557,14636,4921,19557,96200,2011
35017,45.6,29684,14485,56,14234,7997,36925,12367,9355,3012,12367,133000,2011
35019,40,4684,831,81,3561,938,26152,1472,1216,256,1472,78300,2011
35021,52.2,673,337,0,315,167,30208,300,265,35,300,59800,2011
35023,36.4,4953,1982,141,2800,1143,35532,1621,1081,540,1621,90500,2011
35025,31.6,63690,27963,2707,31875,15663,46781,21238,14976,6262,21238,93900,2011
35027,48.9,20476,13523,24,6030,5902,44557,9108,7115,1993,9108,168900,2011
35028,43.7,18040,13825,99,2621,5169,104914,7484,5913,1571,7484,300700,2011
35029,38.7,25250,9206,211,15351,6191,30921,9222,6396,2826,9222,91300,2011
35031,30.3,71290,7490,464,9688,12050,31947,17263,12500,4763,17263,72200,2011
35033,46.1,4878,936,4,3888,1040,39792,1791,1499,292,1791,105700,2011
35035,36.2,63494,33730,2165,21803,17012,38588,24375,16385,7990,24375,105900,2011
35037,45.4,9000,4851,44,3722,2285,29772,3686,2831,855,3686,68800,2011
35039,38.9,40216,5469,184,28598,10292,40232,14987,12019,2968,14987,134300,2011
35041,29.6,19622,10946,300,7693,4725,35841,6888,4091,2797,6888,104300,2011
35043,37.7,128280,61205,2561,44587,33536,57651,46061,37127,8934,46061,187800,2011
35045,32.5,128160,54365,838,24146,31599,49024,42215,31443,10772,42215,154200,2011
35047,41,29300,5737,223,22441,7193,32332,12010,8046,3964,12010,118000,2011
35049,42.6,143053,63094,870,72060,36012,53698,60594,42790,17804,60594,293900,2011
35051,53.8,11925,8234,25,3231,2232,28373,4338,3406,932,4338,105100,2011
35053,36.2,17926,6845,187,8590,3610,34148,5694,4302,1392,5694,115900,2011
35055,45,32720,11882,193,18234,7674,36205,13014,9697,3317,13014,214000,2011
35057,41.3,16391,9237,99,6324,3707,32435,5691,4480,1211,5691,96300,2011
35059,44.3,4433,2595,111,1591,1145,42230,1690,1238,452,1690,96900,2011
35061,36.7,75640,27434,923,43666,20149,41388,27389,22024,5365,27389,132700,2011
36001,38.1,303957,232317,35467,14526,70927,57715,123544,73513,50031,123544,207300,2011
36003,37.6,48991,46800,487,678,12692,41900,18936,14097,4839,18936,66800,2011
36005,32.6,1374593,154240,417472,729048,310909,34744,471923,94903,377020,471923,391300,2011
36007,39.9,200448,173612,8624,6605,49229,45619,80257,53498,26759,80257,103100,2011
36009,40.5,80478,74079,1045,1372,20846,42754,32440,23505,8935,32440,78400,2011
36011,41.2,80204,73379,3100,1923,20574,50140,31807,22957,8850,31807,100200,2011
36013,40.5,135018,120840,2560,7950,35189,41432,55499,38383,17116,55499,80900,2011
36015,40.9,88731,77828,5318,2247,22809,46589,35528,23854,11674,35528,89400,2011
36017,42.4,50788,48610,275,965,13582,44662,20003,15371,4632,20003,89700,2011
36019,38.6,82265,74958,2987,2148,19987,49260,31527,21839,9688,31527,119600,2011
36021,44.9,63055,55733,2826,2415,16449,56185,25681,18952,6729,25681,224100,2011
36023,35.9,49441,46318,676,1126,10935,45956,17915,11862,6053,17915,98400,2011
36025,45,48079,44817,688,1578,12861,43554,20177,15301,4876,20177,133000,2011
36027,39.8,296842,222589,26728,30016,73232,71125,107151,75313,31838,107151,314500,2011
36029,40.2,919714,717160,118870,40686,231918,48805,379478,250215,129263,379478,120600,2011
36031,44.2,39357,35372,1265,1014,10197,46629,16067,11701,4366,16067,153200,2011
36033,39.3,51711,42655,3115,1649,12409,43673,18940,13659,5281,18940,91400,2011
36035,41.9,55456,52113,972,1306,15211,45289,22939,16067,6872,22939,98700,2011
36037,41.1,59966,55068,1363,1595,16093,50861,23965,17592,6373,23965,103400,2011
36039,43.6,49298,42959,2746,2487,12107,47033,18922,13764,5158,18922,181300,2011
36041,50.9,4870,4712,36,36,1470,51142,2303,1901,402,2303,166300,2011
36043,42,64354,61611,581,1044,17673,42680,26470,19083,7387,26470,89400,2011
36045,32.5,115941,99020,5395,6308,31094,45559,44722,25869,18853,44722,124000,2011
36047,34.1,2486119,886855,807108,492496,581085,44593,907785,271007,636778,907785,570800,2011
36049,40.2,27037,26142,219,337,7320,44281,10602,8207,2395,10602,103900,2011
36051,39.4,65387,60289,1422,1823,15938,53231,24201,18176,6025,24201,114300,2011
36053,38.9,73156,68701,1122,1368,18402,53473,26930,20375,6555,26930,114900,2011
36055,38.3,742783,543555,106658,52160,183607,52260,293104,193594,99510,293104,132800,2011
36057,40.9,49985,42711,768,5449,12796,43254,20059,13728,6331,20059,99500,2011
36059,40.9,1332947,882383,140111,188736,341008,95823,443315,362670,80645,443315,478600,2011
36061,36.4,1588257,758922,208269,407066,301691,67204,733393,166164,567229,733393,842300,2011
36063,41.6,216036,189003,14959,4637,56047,46599,88589,62247,26342,88589,100200,2011
36065,40.6,234549,199972,12598,10565,58426,48382,91568,62288,29280,91568,106200,2011
36067,38.5,464921,370468,47749,18148,113954,52636,183381,120744,62637,183381,128600,2011
36069,42.1,107070,98355,2152,3585,28405,57069,43474,32732,10742,43474,133600,2011
36071,36.4,371833,256245,34300,64957,89815,70294,124939,88027,36912,124939,299500,2011
36073,40.5,43011,37708,2426,1774,10888,47788,15896,12222,3674,15896,87700,2011
36075,38.2,122206,116300,985,2534,30221,47036,45600,33525,12075,45600,90600,2011
36077,40.4,62380,57914,1136,1926,15416,45334,24713,17858,6855,24713,131100,2011
36079,41.2,99662,83062,1920,11165,26597,92711,34998,29202,5796,34998,406000,2011
36081,37.2,2213977,622684,396702,603315,526275,56406,773130,347077,426053,773130,474000,2011
36083,39.4,159053,136865,8879,5908,39714,56271,63626,41719,21907,63626,177300,2011
36085,38.3,466034,301599,44302,78238,122569,72752,163747,114360,49387,163747,456100,2011
36087,36.8,308682,202957,35175,46740,74982,84661,98106,69289,28817,98106,465100,2011
36089,37.2,111809,103867,2712,2228,27558,43390,41825,29917,11908,41825,80900,2011
36091,40.5,218520,202960,2974,5180,58113,67186,87762,64659,23103,87762,224800,2011
36093,39.9,153935,119517,13807,8457,35788,55587,58203,39587,18616,58203,165000,2011
36095,41.6,32766,30831,452,915,8332,50795,12801,9817,2984,12801,147600,2011
36097,43.5,18490,17772,210,230,5054,47804,7610,6072,1538,7610,89400,2011
36099,41,35306,31997,1502,995,8919,47266,13257,9988,3269,13257,90600,2011
36101,41.1,98837,93470,1640,1389,26644,44967,41101,29482,11619,41101,84200,2011
36103,39.6,1487177,1074429,103638,237061,376811,87187,496677,401345,95332,496677,411000,2011
36105,41.5,77553,58197,5978,10220,19553,48303,29432,19667,9765,29432,186000,2011
36107,42.3,51287,49213,281,732,14578,53789,20458,16202,4256,20458,105600,2011
36109,29.5,101033,80868,3677,4297,19940,49789,38531,21305,17226,38531,165900,2011
36111,41.6,182710,149971,9822,15544,44923,58808,70034,48518,21516,70034,242500,2011
36113,43.6,65767,62714,612,1205,18311,53877,28392,19693,8699,28392,190800,2011
36115,41.8,63174,58932,1776,1469,16839,50117,24682,18312,6370,24682,143000,2011
36117,41.3,93628,85274,3222,3388,26052,54380,36563,28317,8246,36563,108400,2011
36119,39.9,944249,548778,125743,200128,238645,80725,345908,214765,131143,345908,547000,2011
36121,40.8,42223,38024,2252,1247,10695,51312,15549,11785,3764,15549,98700,2011
36123,40.2,25342,24393,189,413,6551,48125,9552,7391,2161,9552,117000,2011
37001,38.4,149439,101077,26813,16106,40534,44430,59948,41130,18818,59948,136000,2011
37003,40.5,36964,32446,1944,1556,9109,40658,13372,10622,2750,13372,121400,2011
37005,46,11106,9825,141,923,3087,32478,4815,3618,1197,4815,143100,2011
37007,39.7,26788,12333,12873,788,6687,34659,9688,6639,3049,9688,81600,2011
37009,45.2,26991,25199,137,1237,7989,36498,11814,9473,2341,11814,154100,2011
37011,41.7,17844,14945,733,758,4673,37985,7089,5092,1997,7089,160700,2011
37013,43.6,47392,31451,12304,3049,13803,40986,19831,14501,5330,19831,113600,2011
37015,43.1,21082,7381,13266,222,5314,29326,8018,6147,1871,8018,79200,2011
37017,40.6,34789,19081,12060,2337,8758,30273,13960,9699,4261,13960,78100,2011
37019,47,105242,85306,11841,5272,32196,45132,46733,36336,10397,46733,189500,2011
37021,40.6,236230,200153,15055,13566,61079,44321,100909,66797,34112,100909,192200,2011
37023,41,90753,75329,5928,4602,24178,37440,34996,25784,9212,34996,110500,2011
37025,36.6,174730,126032,25967,16024,45866,54280,64430,47411,17019,64430,168200,2011
37027,40.8,82464,73078,3852,3701,21513,37845,31497,23757,7740,31497,106800,2011
37029,40.3,9858,7898,1485,215,2653,63998,3503,2992,511,3503,225700,2011
37031,45.4,65743,57541,4118,2211,18742,47403,28692,20846,7846,28692,208200,2011
37033,43.2,23734,14533,8043,755,6151,37926,8690,6550,2140,8690,100900,2011
37035,39.2,153886,120511,12671,12749,39794,43733,58850,42018,16832,58850,129000,2011
37037,43.3,62506,44560,8367,7932,17650,56935,25251,20113,5138,25251,204100,2011
37039,47.9,27380,25275,217,684,8303,38621,11400,9472,1928,11400,155500,2011
37041,43.7,14863,9073,5311,165,3705,34565,5870,3899,1971,5870,132400,2011
37043,49.2,10506,10113,72,229,3020,36711,4464,3727,737,4464,162100,2011
37045,40.3,97880,72806,20425,2736,26372,38352,37690,25370,12320,37690,104300,2011
37047,40,57264,34759,17408,2519,14904,34938,21656,15819,5837,21656,86100,2011
37049,36.8,101576,68378,22406,6032,27818,46251,39986,25446,14540,39986,154700,2011
37051,30.9,316478,151340,110724,29131,81028,44861,118117,68313,49804,118117,123400,2011
37053,40.7,23507,20841,1460,703,6617,57588,9322,7493,1829,9322,236500,2011
37055,43.5,33819,30124,1363,2022,9751,54750,15234,10903,4331,15234,321200,2011
37057,40,161724,132841,14726,10040,46007,44728,65052,47709,17343,65052,130200,2011
37059,42.3,40985,35114,2728,2450,11827,50562,16000,13382,2618,16000,162000,2011
37061,37.1,57627,30435,14580,11637,14175,34264,21545,14877,6668,21545,86300,2011
37063,33.3,263862,112696,97391,34123,63781,50078,107150,59354,47796,107150,178400,2011
37065,39.5,56232,21245,32222,2061,14787,34198,21533,13612,7921,21533,81800,2011
37067,37.2,347567,206311,89649,39628,87495,46417,137682,90729,46953,137682,150800,2011
37069,39.4,59607,37917,15434,4551,16979,44598,23068,18040,5028,23068,124700,2011
37071,38.5,204788,156244,30459,11875,54603,43052,78571,53797,24774,78571,124300,2011
37073,42.1,12103,7608,4147,166,3287,45183,4404,3585,819,4404,139500,2011
37075,42.7,8752,7850,28,175,2445,32255,3664,2920,744,3664,124400,2011
37077,39.3,59032,34058,19102,4306,14183,49090,19729,15333,4396,19729,131100,2011
37079,38.3,21323,10136,7891,2872,5013,41073,7069,4942,2127,7069,88600,2011
37081,36.3,483081,265318,154016,33266,119849,46288,192064,120778,71286,192064,156200,2011
37083,41.5,54988,21795,28171,1151,14080,31370,21517,13465,8052,21517,86300,2011
37085,33.7,112287,72627,23100,11655,28545,42965,40262,27219,13043,40262,128500,2011
37087,45.4,58836,55327,556,1909,18028,41768,26659,19959,6700,26659,156800,2011
37089,45.1,105453,89330,3547,10042,30162,47371,45180,34729,10451,45180,190700,2011
37091,41,24469,8355,13970,1220,5864,31969,8994,5778,3216,8994,83400,2011
37093,30.6,45718,18707,15332,5539,11014,46540,14808,10762,4046,14808,126700,2011
37095,38.6,5763,3330,1965,406,1441,40753,2025,1519,506,2025,93600,2011
37097,38.7,157501,123227,18933,10323,42475,51139,58879,43776,15103,58879,168300,2011
37099,36.4,39574,32388,735,1876,9378,36826,15759,10500,5259,15759,165800,2011
37101,36.2,165238,115982,24919,20564,44787,49888,60115,43753,16362,60115,138800,2011
37103,43.9,10066,6173,3188,380,2765,40687,4074,2957,1117,4074,93800,2011
37105,37.4,56787,33885,11230,10132,14781,44836,21069,14486,6583,21069,135500,2011
37107,40.8,59326,30625,23831,3766,15948,33749,24280,14849,9431,24280,93000,2011
37109,40.4,77035,65970,4100,5334,21771,50279,29507,22681,6826,29507,151900,2011
37111,41.5,44825,39857,1563,2299,11549,35230,17483,12465,5018,17483,100700,2011
37113,48.1,33719,30642,326,2043,10464,38653,16024,11895,4129,16024,167000,2011
37115,43.3,20661,19657,226,420,5660,38063,8082,6188,1894,8082,163100,2011
37117,43.5,24375,12646,10468,756,6708,36345,9884,6861,3023,9884,82400,2011
37119,33.9,905277,465558,270094,106490,224165,55994,356833,220693,136140,356833,187300,2011
37121,45.1,15631,14737,144,584,4632,36165,6553,4891,1662,6553,111100,2011
37123,39.9,27673,17785,4890,3887,6713,32946,10166,7434,2732,10166,87800,2011
37125,44.9,87216,67819,11787,5107,23619,48348,34625,26213,8412,34625,192500,2011
37127,40,95182,51965,35014,5780,25355,45052,37954,24132,13822,37954,119100,2011
37129,37.2,200336,154022,29832,10023,49976,48893,84825,50906,33919,84825,227500,2011
37131,44.8,22120,8618,12542,299,5515,32090,8505,6277,2228,8505,79000,2011
37133,25.7,172917,119078,27413,17035,42203,45457,57571,32923,24648,57571,144300,2011
37135,33.2,131856,93974,16029,10229,31089,56055,50837,30603,20234,50837,270300,2011
37137,47.5,13114,9795,2613,368,3785,43658,5279,4357,922,5279,146600,2011
37139,36,40511,22456,15292,1597,10247,45298,14550,9544,5006,14550,174000,2011
37141,40.9,51441,37917,9527,3060,14202,44568,20128,15809,4319,20128,152000,2011
37143,46.2,13289,9495,3536,248,3932,37862,5272,4084,1188,5272,161100,2011
37145,41.2,39218,26215,10663,1566,10918,43271,15523,11301,4222,15523,118900,2011
37147,30.8,165012,95086,55508,8714,37878,39824,64507,35845,28662,64507,131400,2011
37149,48.9,20354,18041,1004,1057,5847,43332,8937,7015,1922,8937,168800,2011
37151,39.5,140916,114921,7825,14330,38759,40602,54897,40517,14380,54897,122400,2011
37153,38.7,46546,27509,14180,2655,11386,31847,17292,11929,5363,17292,74000,2011
37155,34.1,133033,36242,31990,10602,31778,30874,44528,29934,14594,44528,68900,2011
37157,42,93393,68813,17402,4973,26382,38311,37836,27351,10485,37836,102800,2011
37159,38.9,137654,101523,21965,10190,36583,43121,53009,37445,15564,53009,127200,2011
37161,41.9,67262,56756,6586,2299,18609,37128,27229,19783,7446,27229,104400,2011
37163,38.3,63161,33690,17060,10115,16296,36832,23463,16011,7452,23463,88700,2011
37165,37.3,36227,16811,14142,807,8974,30465,13075,8655,4420,13075,75600,2011
37167,40.3,60394,49687,6479,2136,15858,43424,22629,16925,5704,22629,127800,2011
37169,42,47294,43372,2044,1275,14111,43099,18968,15063,3905,18968,120900,2011
37171,41.4,73473,62652,2523,6918,20609,36788,30072,22086,7986,30072,105000,2011
37173,40.9,13932,9167,226,530,3757,40719,5455,4442,1013,5455,119700,2011
37175,48.9,32670,29645,1008,920,9171,41103,13914,10897,3017,13914,166300,2011
37177,46.3,4379,2449,1528,188,1162,34071,1612,1319,293,1612,109600,2011
37179,35.9,196931,147619,22735,20095,53762,64813,66720,55288,11432,66720,196400,2011
37181,37.9,45112,19092,22255,2966,11122,34084,16477,10639,5838,16477,100500,2011
37183,34.3,879658,551677,180100,83115,220691,65289,334302,222745,111557,334302,227600,2011
37185,44.2,20882,7915,10795,676,5394,34495,7999,5949,2050,7999,102600,2011
37187,43.6,13179,5998,6860,117,3395,34219,5028,3687,1341,5028,94800,2011
37189,28.2,50421,46806,591,1612,11080,34497,20655,11306,9349,20655,234300,2011
37191,36.7,121324,67875,37919,11476,32147,41751,47027,29636,17391,47027,107200,2011
37193,42,69162,61592,2903,3704,19633,33464,27928,20546,7382,27928,112200,2011
37195,38.7,80351,40049,30984,7378,21367,38760,31830,19461,12369,31830,114600,2011
37197,41.6,38232,32924,1323,3627,10429,40375,14958,11714,3244,14958,113000,2011
37199,45.3,17885,16748,93,770,5231,38950,7194,5521,1673,7194,135300,2011
38001,49.5,2337,2250,0,25,725,40236,1097,770,327,1097,86300,2011
38003,44.4,11048,10603,15,126,2898,43730,4758,3334,1424,4758,84000,2011
38005,32.1,6665,2941,16,92,1576,32149,2300,1462,838,2300,52800,2011
38007,48.1,890,869,0,0,233,53846,364,312,52,364,77100,2011
38009,47.6,6412,6030,3,53,1880,44399,2999,2409,590,2999,70000,2011
38011,47.4,3125,3025,0,52,848,50487,1317,1039,278,1317,89600,2011
38013,48.2,1959,1903,11,25,585,54402,989,796,193,989,54000,2011
38015,37.5,80225,74158,366,1080,21430,56231,33437,23707,9730,33437,159000,2011
38017,31.5,147222,133834,3045,3005,34834,49429,63901,34364,29537,63901,150700,2011
38019,51.1,3994,3939,0,0,1228,49293,1713,1440,273,1713,70800,2011
38021,42.7,5319,5117,29,107,1296,41776,2156,1578,578,2156,65200,2011
38023,51.9,2058,1982,0,44,642,47545,1023,841,182,1023,59500,2011
38025,44,3535,3005,7,70,919,52861,1359,1155,204,1359,81000,2011
38027,47.4,2426,2277,5,66,604,40096,997,784,213,997,50700,2011
38029,50.3,3578,3550,0,7,1028,36903,1618,1345,273,1618,64400,2011
38031,46.3,3389,3332,1,50,1002,47500,1506,1149,357,1506,77100,2011
38033,45.5,1576,1519,1,9,429,35402,733,566,167,733,59600,2011
38035,29.3,66662,59325,1343,1993,14730,46050,26760,14603,12157,26760,143700,2011
38037,50.3,2458,2357,2,0,736,41821,1175,932,243,1175,61700,2011
38039,51.7,2408,2391,0,0,685,43000,1086,847,239,1086,65700,2011
38041,49.8,2495,2431,19,14,730,41179,1073,886,187,1073,61600,2011
38043,49.4,2499,2363,0,128,777,37105,1152,890,262,1152,61000,2011
38045,48.6,4184,4147,12,3,1224,49922,1923,1589,334,1923,70500,2011
38047,50.5,1996,1970,1,25,564,42069,848,716,132,848,55300,2011
38049,45.6,5400,5231,2,93,1557,41989,2515,1945,570,2515,68800,2011
38051,53.3,2857,2773,3,54,816,35757,1301,1124,177,1301,49700,2011
38053,38,6262,4700,0,142,1764,53902,2566,1775,791,2566,88400,2011
38055,49.3,8923,8097,13,119,2579,52996,3904,3030,874,3904,98900,2011
38057,46.2,8382,7966,54,44,2546,62578,3662,2908,754,3662,109300,2011
38059,40.5,27076,25274,62,393,7445,55196,10918,8536,2382,10918,120400,2011
38061,37.3,7482,4826,47,59,2020,56593,2885,2128,757,2885,75400,2011
38063,50.8,3141,3040,17,54,828,41961,1443,1172,271,1443,51100,2011
38065,48.8,1793,1675,0,80,551,61131,773,637,136,773,91100,2011
38067,47,7440,6978,1,201,2217,52270,3304,2612,692,3304,73000,2011
38069,46.4,4361,4126,3,71,1215,40139,1951,1364,587,1951,81700,2011
38071,42.5,11400,9958,88,90,3029,44452,4807,3157,1650,4807,85400,2011
38073,43,5559,5394,7,82,1522,47922,2307,1702,605,2307,88800,2011
38075,45,2440,2371,0,0,742,50093,1098,840,258,1098,66200,2011
38077,39.1,16382,15421,60,279,4100,48908,6483,4746,1737,6483,99000,2011
38079,30.7,13885,2930,24,82,3266,27662,4619,3325,1294,4619,61200,2011
38081,45.7,3909,3790,13,17,1125,52154,1715,1371,344,1715,72400,2011
38083,53.3,1271,1254,4,0,451,38235,608,524,84,608,53800,2011
38085,26.7,4149,543,7,45,777,32802,1067,485,582,1067,72900,2011
38087,47.6,721,704,0,17,229,55625,306,259,47,306,54800,2011
38089,38.9,23973,22613,194,447,6382,54269,9793,7036,2757,9793,130000,2011
38091,46.3,1962,1953,0,6,584,49485,836,681,155,836,65500,2011
38093,42.4,20973,19873,64,340,5221,46317,8574,5831,2743,8574,92800,2011
38095,48.2,2259,2148,3,7,618,47703,992,790,202,992,53000,2011
38097,42.3,8172,7772,35,212,2163,48341,3375,2535,840,3375,90100,2011
38099,45.4,11196,9914,20,934,2988,46453,4825,3618,1207,4825,66000,2011
38101,33.2,60667,53845,1342,1900,15902,51081,24453,15720,8733,24453,124300,2011
38103,50.2,4242,4195,0,9,1228,42035,2032,1494,538,2032,55600,2011
38105,39.3,22046,19912,8,459,6154,62082,9273,6563,2710,9273,110000,2011
39001,39.5,28551,27735,52,242,7788,34232,10905,7873,3032,10905,95800,2011
39003,38.1,106468,87833,12426,2482,27782,43323,40703,28507,12196,40703,105400,2011
39005,39.4,53331,51552,424,556,14392,45641,20125,15725,4400,20125,126500,2011
39007,40.9,101676,92351,3532,3424,26096,41501,38771,28214,10557,38771,116600,2011
39009,26.3,64562,58653,1823,1086,12430,33546,22496,12776,9720,22496,117400,2011
39011,39.7,45986,44659,137,548,13118,52838,18297,13889,4408,18297,124700,2011
39013,43.3,70346,65853,2527,498,19212,39712,28747,21545,7202,28747,86500,2011
39015,39.4,44688,43363,369,306,11844,46046,16112,12867,3245,16112,124200,2011
39017,35.9,366167,310132,25889,13758,94396,55497,135104,95795,39309,135104,160400,2011
39019,42.8,28913,28168,181,219,7991,43323,11485,9282,2203,11485,112000,2011
39021,39.5,40092,37807,779,511,11073,48335,15278,11386,3892,15278,123000,2011
39023,40.3,138782,118728,12036,3657,36046,44037,54771,38254,16517,54771,110400,2011
39025,38.3,196731,186700,2592,2925,53113,60219,73333,56331,17002,73333,160500,2011
39027,37.8,42296,39659,839,637,11598,47264,16190,11465,4725,16190,123800,2011
39029,42,108198,102653,2297,1421,29301,41003,42235,31446,10789,42235,97700,2011
39031,40.8,36974,35644,431,299,9993,40727,14375,10797,3578,14375,96400,2011
39033,41.6,43998,42446,325,539,12435,41336,17905,12694,5211,17905,92600,2011
39035,39.9,1285279,794411,375199,59830,316333,44088,537203,330799,206404,537203,134900,2011
39037,40.3,52907,51337,223,679,14476,45055,20700,15923,4777,20700,113100,2011
39039,39,39066,34368,478,3367,10889,46864,15183,11816,3367,15183,110500,2011
39041,36.8,170541,150817,5922,3654,48660,90022,62618,51744,10874,62618,253400,2011
39043,43,77223,65749,6406,2539,21192,47466,31642,22605,9037,31642,138000,2011
39045,37.8,145167,129643,8115,2517,39977,58249,54388,40420,13968,54388,168000,2011
39047,39.3,28955,27157,563,550,7744,39263,11543,7277,4266,11543,110000,2011
39049,33.4,1153671,782604,240154,52730,270205,50045,460497,260980,199517,460497,155200,2011
39051,39.2,42702,38713,145,3205,12342,51851,16332,13284,3048,16332,131500,2011
39053,39.7,30954,29158,789,319,8295,36918,12009,8779,3230,12009,96900,2011
39055,42.8,93476,89928,1044,1031,25717,66229,34447,29901,4546,34447,228400,2011
39057,36.9,160940,137205,11073,3555,42676,57553,62558,42768,19790,62558,159700,2011
39059,40.4,40219,38350,585,403,10556,38179,15913,11607,4306,15913,92300,2011
39061,37,801223,544845,203643,19564,194818,49218,325766,198429,127337,325766,147800,2011
39063,37.9,74847,67913,1186,3300,20404,49888,30425,21633,8792,30425,130300,2011
39065,34.4,32127,30852,214,417,7604,39945,11692,7884,3808,11692,101000,2011
39067,43.6,15864,15193,393,96,4164,36920,6298,4881,1417,6298,84200,2011
39069,39.1,28353,26020,160,1804,7786,48932,11110,8725,2385,11110,119200,2011
39071,38.6,43631,41913,492,77,11995,40423,16841,12254,4587,16841,104300,2011
39073,41.1,29400,28552,208,193,8175,42227,11491,8862,2629,11491,115600,2011
39075,29.4,42264,41529,173,317,9708,44746,12261,9512,2749,12261,153400,2011
39077,37.3,59813,54893,346,3286,16212,48358,22684,16779,5905,22684,121400,2011
39079,38.9,33176,32054,182,297,9136,37243,13252,8839,4413,13252,91100,2011
39081,43.7,69672,63544,3772,809,18825,39453,28741,21114,7627,28741,85700,2011
39083,38.1,60623,58282,378,760,15615,48734,22495,16614,5881,22495,134600,2011
39085,42.2,229745,209336,7162,7534,62015,55968,94347,72332,22015,94347,156000,2011
39087,40,62592,59673,1493,509,17157,38639,24479,17914,6565,24479,93800,2011
39089,38.9,165110,152968,5227,2292,44819,54699,63314,46944,16370,63314,152600,2011
39091,39.3,45964,43506,586,574,12510,47378,18095,13488,4607,18095,123200,2011
39093,39.9,300491,241633,23969,24660,80715,52194,115534,84592,30942,115534,146400,2011
39095,36.8,442708,316260,82052,26331,110536,41949,178777,114608,64169,178777,119200,2011
39097,38.6,43151,38830,2720,641,10486,54366,14791,10552,4239,14791,149100,2011
39099,42.5,240131,186759,37393,10750,62832,40570,98749,70736,28013,98749,97800,2011
39101,39.4,66503,59823,3056,1460,17039,41337,24851,17152,7699,24851,99200,2011
39103,40.1,171327,162517,2141,2715,48171,65578,64813,52620,12193,64813,184200,2011
39105,41.1,23668,23004,298,170,6343,33708,9644,7726,1918,9644,82400,2011
39107,39.1,40918,39637,136,590,11457,51236,15689,12769,2920,15689,124600,2011
39109,40.4,102487,96025,2382,1361,28646,51438,41364,29302,12062,41364,137900,2011
39111,44.7,14709,14406,46,15,4096,38811,6167,4993,1174,6167,88900,2011
39113,39,537409,391818,111135,11838,137690,44585,223546,142996,80550,223546,118600,2011
39115,42.5,15087,14047,516,98,4493,35855,6252,4895,1357,6252,87600,2011
39117,39.4,34880,33821,106,376,9661,50252,13084,10667,2417,13084,131200,2011
39119,39.5,85997,79745,2578,717,22981,40590,34262,23913,10349,34262,111800,2011
39121,42.5,14658,13363,1070,152,3480,40239,4771,3865,906,4771,80300,2011
39123,45.9,41508,38871,450,1750,12439,53614,18009,14634,3375,18009,141900,2011
39125,40.7,19615,18376,109,781,5389,43683,7571,5993,1578,7571,91800,2011
39127,38,36024,35188,85,121,9758,42860,13762,10016,3746,13762,97500,2011
39129,38.4,55509,51944,1877,629,14268,51418,19284,14460,4824,19284,148500,2011
39131,38.7,28685,27605,197,220,7686,39669,10816,7809,3007,10816,95900,2011
39133,37.2,160713,147048,6176,2102,40974,51441,61746,42653,19093,61746,156500,2011
39135,40.6,42394,41260,153,283,11732,48874,16321,12738,3583,16321,117500,2011
39137,38.6,34546,32333,71,1811,9688,59378,12936,10912,2024,12936,132900,2011
39139,40.6,125241,108591,11421,1762,32597,43098,48593,34092,14501,48593,110900,2011
39141,39.5,77868,70233,3651,803,19338,44577,28158,20658,7500,28158,114800,2011
39143,40.5,61088,52875,1645,5275,16778,47277,24031,18141,5890,24031,113100,2011
39145,38.6,79189,74316,2078,897,19679,33596,29788,20502,9286,29788,87500,2011
39147,38.8,56901,52042,1397,2473,15018,41761,22026,16043,5983,22026,102000,2011
39149,37.7,49389,46477,977,687,13396,50527,18507,14002,4505,18507,124300,2011
39151,40.9,376142,330657,27375,5850,99732,45347,150072,106112,43960,150072,126700,2011
39153,40,542169,433086,77451,8513,141044,48790,221498,152811,68687,221498,140700,2011
39155,42.4,211403,186710,17186,2788,56042,42441,86746,63903,22843,86746,100500,2011
39157,40.7,92561,88798,949,1689,24944,42846,36262,26772,9490,36262,110000,2011
39159,36.5,51539,47619,1000,689,13414,68279,17795,13864,3931,17795,175900,2011
39161,39.7,28880,27498,278,685,7936,45111,11381,9285,2096,11381,88800,2011
39163,39.5,13457,13131,2,17,3811,34399,5305,4043,1262,5305,84800,2011
39165,37.2,210662,188269,6614,4661,57728,71961,75283,59619,15664,75283,193200,2011
39167,42.3,61946,59489,527,546,16856,43185,25184,19064,6120,25184,109300,2011
39169,38.1,114508,108654,1637,1764,30380,49261,42485,31905,10580,42485,138200,2011
39171,39.8,37985,35668,442,1365,10590,44604,15139,11601,3538,15139,101800,2011
39173,34.9,125566,113534,2806,5554,30934,53610,48680,33690,14990,48680,154200,2011
39175,41.2,22661,21800,70,465,6321,47958,9179,6745,2434,9179,107500,2011
40001,36,22506,9615,90,1183,5963,31038,7909,5642,2267,7909,77100,2011
40003,45.8,5625,4821,168,218,1386,42730,2033,1636,397,2033,54200,2011
40005,39.4,14183,10373,574,432,3683,33919,5367,4144,1223,5367,69100,2011
40007,41,5586,4353,36,1030,1590,47386,2150,1546,604,2150,75700,2011
40009,35,22272,17489,789,2596,5012,45726,7715,5101,2614,7715,89200,2011
40011,39,11122,7584,824,1228,2731,41306,4095,2848,1247,4095,67600,2011
40013,36.6,41865,31065,658,2079,10659,36661,16354,10780,5574,16354,87100,2011
40015,38.1,29042,17408,784,2836,7287,37835,10296,7283,3013,10296,69500,2011
40017,35.7,113154,90626,2647,7539,31287,62355,41293,31867,9426,41293,135100,2011
40019,38.6,47326,34512,3258,2481,12081,39722,17603,12407,5196,17603,87700,2011
40021,34.5,46653,23591,728,2949,10811,33990,16501,11087,5414,16501,97100,2011
40023,40.4,15186,9713,1549,454,4056,28039,6103,4252,1851,6103,69500,2011
40025,44.6,2486,1946,14,489,786,35440,1095,781,314,1095,59100,2011
40027,32.5,251643,191282,9749,17097,62248,53759,94096,64553,29543,94096,136400,2011
40029,40.9,5853,4264,6,152,1559,34217,2390,1643,747,2390,65600,2011
40031,31.6,121744,71987,20431,13309,30329,45947,44179,25450,18729,44179,106300,2011
40033,39.8,6199,4925,140,339,1700,46075,2359,1722,637,2359,74000,2011
40035,40.9,14989,9872,502,410,3956,41010,5744,4511,1233,5744,86200,2011
40037,39.9,69450,54540,1444,2197,18536,42940,26373,19622,6751,26373,106200,2011
40039,31,27144,19840,851,3713,6583,43125,10407,6599,3808,10407,94900,2011
40041,44.4,41295,27254,167,1287,11289,35552,16070,12408,3662,16070,96800,2011
40043,43,4773,4126,14,213,1272,41500,1802,1430,372,1802,75100,2011
40045,44.7,4071,3704,20,235,1223,45017,1735,1372,363,1735,71600,2011
40047,37.6,59680,48427,1507,5048,15671,41688,24022,16223,7799,24022,85500,2011
40049,39.8,27498,21825,733,1684,7242,39171,10106,7686,2420,10106,79700,2011
40051,37.8,52062,43537,1177,2445,14635,47456,19646,15290,4356,19646,107400,2011
40053,45.2,4569,4201,23,149,1314,42227,1899,1463,436,1899,59100,2011
40055,41.6,6194,4853,526,579,1488,38882,2221,1550,671,2221,59700,2011
40057,41.6,2873,1819,226,709,827,31211,1159,809,350,1159,44800,2011
40059,41.9,3641,2981,1,581,1149,44850,1542,1230,312,1542,66500,2011
40061,39,12677,9349,117,399,3134,37326,4734,3631,1103,4734,75500,2011
40063,39.9,13686,9221,714,518,3587,33895,5155,3942,1213,5155,64200,2011
40065,34.4,26311,17440,1615,5408,7168,41391,10470,6629,3841,10470,87600,2011
40067,41.5,6454,5243,86,500,1705,34256,2454,1872,582,2454,58700,2011
40069,39,10907,7854,103,431,3001,35789,4354,3156,1198,4354,69300,2011
40071,39.6,46458,36174,881,2992,12300,40164,18510,12960,5550,18510,76900,2011
40073,38.3,14928,12051,187,1892,4113,52130,5662,4357,1305,5662,111400,2011
40075,41.9,9470,7325,377,842,2448,33068,3876,2631,1245,3876,51200,2011
40077,39.4,11081,7700,115,287,2961,42610,4216,3122,1094,4216,67600,2011
40079,38.4,50106,36830,1070,3376,13156,36815,18672,13699,4973,18672,74900,2011
40081,39.6,33964,28660,690,882,9491,41763,12912,10096,2816,12912,91400,2011
40083,37.5,40863,32194,3660,2074,10604,50249,14553,11210,3343,14553,121700,2011
40085,40.9,9343,7181,207,1056,2546,41163,3534,2688,846,3534,79600,2011
40087,38.4,33873,27607,45,2331,9328,56128,12205,9910,2295,12205,125800,2011
40089,38.5,33121,21846,2981,1577,9045,31328,13103,8901,4202,13103,72000,2011
40091,46.3,20142,13953,664,440,5414,32305,7870,6187,1683,7870,75500,2011
40093,44.3,7530,6632,21,516,2200,48012,3185,2563,622,3185,78900,2011
40095,42.2,15675,11001,140,2160,4008,39473,5995,4732,1263,5995,79400,2011
40097,39.2,41063,27596,115,1149,11472,42425,16088,11830,4258,16088,90400,2011
40099,40.2,13313,10161,178,641,3372,41403,5092,4126,966,5092,78500,2011
40101,37.7,70593,41435,8016,3603,17690,37990,27056,18351,8705,27056,88000,2011
40103,40,11533,9606,198,310,3111,43324,4531,3394,1137,4531,77500,2011
40105,40.5,10660,7250,208,254,3041,38459,4083,3234,849,4083,72500,2011
40107,40,12132,7756,965,364,2999,34418,4329,3045,1284,4329,70600,2011
40109,34.4,712491,427162,105943,103397,176186,44413,281570,171877,109693,281570,121900,2011
40111,38.5,39766,25825,3461,1353,10502,39324,15193,10707,4486,15193,78800,2011
40113,40.8,47361,30684,5308,1436,13116,42847,18406,14567,3839,18406,92400,2011
40115,38.6,31975,21739,254,1526,8450,36931,12048,9011,3037,12048,80200,2011
40117,42.4,16585,13231,124,361,4413,41832,6392,4893,1499,6392,81900,2011
40119,27,76291,60875,2640,2956,16521,35716,29731,15526,14205,29731,123100,2011
40121,41.4,45562,32951,1494,1801,12528,41317,18765,13485,5280,18765,84800,2011
40123,35.6,37102,25882,925,1530,9518,40641,14775,9655,5120,14775,97800,2011
40125,37.2,69276,51745,1954,2896,18104,41332,25295,18358,6937,25295,92500,2011
40127,43.9,11518,8543,22,280,3127,29053,4796,3410,1386,4796,73200,2011
40129,42.7,3591,3138,33,164,1030,54352,1350,1041,309,1350,79700,2011
40131,38.2,86149,63957,731,3203,24535,58434,32056,25383,6673,32056,141300,2011
40133,39,25280,16993,1105,936,6265,33799,9250,6743,2507,9250,69500,2011
40135,38.8,42074,27482,793,1499,11355,38292,15520,11154,4366,15520,82300,2011
40137,40.4,44759,37048,859,2735,12243,45030,17809,12903,4906,17809,84300,2011
40139,31.4,20218,10896,222,8257,5164,46631,7122,4764,2358,7122,87400,2011
40141,40.9,8092,5267,533,1730,1937,31437,2809,2069,740,2809,52300,2011
40143,35.3,596873,393099,62413,63252,151676,47005,239674,148580,91094,239674,129900,2011
40145,37.9,71792,53161,2422,3377,20474,56819,26168,21829,4339,26168,137100,2011
40147,41.1,50791,38677,1231,2503,14094,47144,21371,15701,5670,21371,105600,2011
40149,39.7,11601,10034,106,839,3115,44331,4604,3307,1297,4604,73900,2011
40151,37.4,8701,7540,262,376,2138,47255,3570,2373,1197,3570,77600,2011
40153,37.2,20105,16772,212,1937,5160,51087,7558,5421,2137,7558,97600,2011
41001,47.8,16126,14984,71,536,4779,40989,6997,4845,2152,6997,157600,2011
41003,31.9,84943,71134,952,5372,19002,47716,33427,19184,14243,33427,268200,2011
41005,40.3,373832,317192,2852,28203,100692,63790,144588,101656,42932,144588,326300,2011
41007,43,36966,32317,223,2760,9975,43670,15999,9986,6013,15999,261600,2011
41009,41.2,49247,44554,135,2006,13589,56270,19173,14721,4452,19173,221200,2011
41011,46.8,63108,55050,120,3402,16760,37789,27077,18045,9032,27077,194500,2011
41013,44.8,21356,19039,47,1512,6122,45004,8741,6374,2367,8741,220400,2011
41015,52.6,22373,19825,24,1232,6468,39787,10350,7389,2961,10350,254800,2011
41017,39.9,157014,139144,504,11466,43836,52962,63935,42803,21132,63935,290400,2011
41019,45.8,107382,96309,369,4968,29595,40501,43895,30743,13152,43895,186400,2011
41021,49.4,1873,1668,5,156,544,42260,901,568,333,901,104700,2011
41023,49.3,7359,6882,27,193,2158,34367,3380,2393,987,3380,128000,2011
41025,45.9,7383,6629,33,277,2250,38702,3290,2144,1146,3290,137700,2011
41027,37.7,21962,14609,142,6350,5601,54109,8204,5545,2659,8204,326900,2011
41029,41.8,202178,169949,1034,21109,53930,43386,83897,51812,32085,83897,262500,2011
41031,39.6,21786,13452,153,4279,5608,42867,7844,5327,2517,7844,182100,2011
41033,46.8,82456,73146,331,5171,22311,37824,34482,23342,11140,34482,242600,2011
41035,41.6,66517,54124,362,6873,18426,41787,27378,18748,8630,27378,172800,2011
41037,46.8,7906,6925,24,505,2279,36583,3516,2323,1193,3516,151500,2011
41039,38.6,349832,296838,3194,25268,86546,42621,144806,87138,57668,144806,230900,2011
41041,49.4,45933,38924,72,3568,12515,41764,20769,13788,6981,20769,253100,2011
41043,38.9,115776,101078,451,8757,30526,46872,44787,29991,14796,44787,181600,2011
41045,36,31280,20033,290,9660,7099,39013,10243,6732,3511,10243,143600,2011
41047,35.1,313020,215519,2634,74315,76907,46191,112841,68789,44052,112841,206700,2011
41049,36.6,11107,7243,23,3402,2770,46110,3855,2766,1089,3855,120100,2011
41051,35.8,724803,525214,39846,77288,163808,50726,302224,166916,135308,302224,281900,2011
41053,37.7,74734,60475,385,8842,19511,52865,28111,18894,9217,28111,231900,2011
41055,46.1,1908,1755,3,110,529,46453,835,555,280,835,128800,2011
41057,47.7,25249,22020,114,2190,6802,41400,10892,7608,3284,10892,242400,2011
41059,35.7,75344,52918,474,17334,18643,45911,26805,17253,9552,26805,143700,2011
41061,40.2,25573,23261,98,1023,6971,40974,10411,6793,3618,10411,154100,2011
41063,50.4,6949,6575,12,156,1867,39556,3046,2280,766,3046,186200,2011
41065,41.4,24910,19403,183,3630,6484,43742,9857,6544,3313,9857,189300,2011
41067,35.1,524275,369103,8612,80703,132139,63814,198593,123774,74819,198593,300200,2011
41069,56.8,1238,1193,0,15,368,34338,601,444,157,601,116500,2011
41071,36.7,98293,78193,713,14175,24576,53819,33804,23635,10169,33804,237700,2011
42001,40.8,101137,91699,1566,5894,27661,57097,38431,29576,8855,38431,202800,2011
42003,41.2,1223525,988829,157480,18670,306918,49805,523175,347353,175822,523175,118700,2011
42005,44.2,69208,67607,622,404,20009,44663,28807,22226,6581,28807,91600,2011
42007,43.9,171027,154881,10155,2029,47605,47928,70198,52258,17940,70198,113600,2011
42009,43.5,49864,48678,265,445,14094,40710,20001,15906,4095,20001,114700,2011
42011,39.1,409624,317605,16138,64298,107040,54823,153780,112117,41663,153780,174000,2011
42013,42,127090,121594,2219,1262,34282,43243,51771,37436,14335,51771,101500,2011
42015,42.8,62522,60520,307,721,16847,42433,24630,18526,6104,24630,108600,2011
42017,41.5,624351,544367,21873,25693,165703,76019,229955,180127,49828,229955,319600,2011
42019,40.9,183317,175877,1977,1952,50110,57474,72458,55938,16520,72458,162900,2011
42021,43.4,144489,134961,5001,2065,38220,41202,58428,43082,15346,58428,87600,2011
42023,47.4,5130,4952,32,52,1296,40449,2133,1541,592,2133,73700,2011
42025,43.4,64974,61050,753,2087,18213,49056,26136,20960,5176,26136,146000,2011
42027,28.4,152689,134053,4502,3769,31839,48262,56134,33360,22774,56134,181400,2011
42029,39,495651,409072,29368,30716,129189,86264,182732,139759,42973,182732,333400,2011
42031,39.3,40178,38928,494,257,10294,41557,15827,11262,4565,15827,99600,2011
42033,42.5,81954,77385,1738,1862,22106,39391,32715,25290,7425,32715,84400,2011
42035,38.9,39015,37478,431,423,9758,39696,15282,11026,4256,15282,101000,2011
42037,39.3,67020,63321,1164,1348,16751,44136,25906,18355,7551,25906,129000,2011
42039,41.3,89058,85162,1440,871,23598,40379,35368,26078,9290,35368,100400,2011
42041,40.1,233726,209684,6993,6199,61457,60832,94412,67872,26540,94412,179400,2011
42043,39.1,266576,187429,45665,17907,67287,53771,108047,70505,37542,108047,157400,2011
42045,38.7,557648,400042,106535,15831,138133,63677,206596,147396,59200,206596,234700,2011
42047,44.4,32233,31653,181,183,8931,42854,13557,10801,2756,13557,94000,2011
42049,38.5,279824,243064,18733,9136,69518,44503,108303,74433,33870,108303,113300,2011
42051,43.1,137803,128098,5638,1081,36780,36605,54717,39930,14787,54717,83600,2011
42053,42.4,7600,6104,1086,317,1247,36006,1990,1712,278,1990,81300,2011
42055,40.1,148239,134220,4718,6068,39863,51171,58032,42518,15514,58032,177800,2011
42057,41.6,14858,14426,146,124,4110,45960,5929,4610,1319,5929,161300,2011
42059,41.1,38895,36641,1293,527,9774,42565,14102,10495,3607,14102,84500,2011
42061,40.8,45898,42174,2315,694,11445,43026,16791,12966,3825,16791,111700,2011
42063,38.1,88997,84115,2210,969,22223,41424,34558,24264,10294,34558,103700,2011
42065,42.9,45173,44235,164,289,12218,40058,18389,13978,4411,18389,83200,2011
42067,40.6,24439,23439,94,554,6858,45496,9103,7022,2081,9103,132800,2011
42069,42,214057,193339,4706,9794,55757,45185,86491,57693,28798,86491,142200,2011
42071,37.9,515817,439267,16095,43117,136095,55816,192681,135066,57615,192681,187300,2011
42073,43.3,91341,85211,3361,955,25141,43821,36613,28498,8115,36613,94400,2011
42075,40.8,132550,115772,2073,11626,36344,53474,51899,38217,13682,51899,160800,2011
42077,39.2,347197,251397,16459,62641,90426,54312,133159,90725,42434,133159,206100,2011
42079,42.5,319897,284623,9544,19447,83630,43296,131052,90284,40768,131052,116700,2011
42081,40.9,116335,107106,5039,1543,30709,43788,46604,32396,14208,46604,125400,2011
42083,41.3,43642,41262,1029,763,11252,40721,17180,12611,4569,17180,73500,2011
42085,42.6,116939,106650,6360,1274,30905,43504,46418,34925,11493,46418,101200,2011
42087,42.4,46671,45248,275,542,12803,38892,18987,14117,4870,18987,93400,2011
42089,39.7,169050,120142,19530,21497,44737,57700,59941,48263,11678,59941,205400,2011
42091,40.4,794921,632740,66299,32317,209017,78446,307598,226980,80618,307598,297900,2011
42093,43.7,18193,17140,266,303,4943,46421,7200,5333,1867,7200,147600,2011
42095,40.5,296323,241760,12480,30016,77576,60540,112111,83858,28253,112111,221800,2011
42097,42.9,94321,89119,1957,2152,26059,39605,39293,28183,11110,39293,96000,2011
42099,40.9,45785,44298,314,577,13063,54626,18098,14596,3502,18098,150100,2011
42101,33.5,1514456,561441,645267,181480,312755,36957,578125,317211,260914,578125,140700,2011
42103,42.7,57242,47724,2900,4992,16207,58672,22207,18803,3404,22207,216200,2011
42105,44.4,17487,17043,83,164,4985,40000,7196,5413,1783,7196,91100,2011
42107,42.9,148195,138510,3710,3857,39754,44150,60029,45998,14031,60029,91200,2011
42109,38.7,39597,38065,365,637,10171,46184,14320,10859,3461,14320,128300,2011
42111,44.2,77946,74586,1686,815,20452,41102,30168,23874,6294,30168,94200,2011
42113,49.4,6469,6262,79,42,1592,38732,2438,2022,416,2438,123700,2011
42115,44.6,43311,42126,168,553,12147,46392,17273,13558,3715,17273,131700,2011
42117,42,41850,40493,304,433,12032,42027,17187,12949,4238,17187,111100,2011
42119,38.2,44872,38257,3136,2306,10488,46269,15310,11494,3816,15310,148500,2011
42121,44.1,55106,53215,582,515,15119,40986,22482,16889,5593,22482,78500,2011
42123,44.7,41771,40815,159,310,11665,42167,17602,13706,3896,17602,85400,2011
42125,43.3,207451,194234,6668,2339,56085,51965,83806,64695,19111,83806,136400,2011
42127,45.2,52477,48429,1358,1766,13452,49020,19305,15744,3561,19305,180000,2011
42129,44.8,365438,346824,7704,3152,102425,48979,152819,116593,36226,152819,130800,2011
42131,41.5,28333,27348,215,411,7652,48063,11013,8510,2503,11013,147100,2011
42133,39.8,431967,374158,21183,23095,118084,58586,167568,127640,39928,167568,178400,2011
44001,42.1,50264,47412,168,1044,13027,70553,19289,13949,5340,19289,357500,2011
44003,42.2,166631,152862,2459,5207,42994,61279,68774,49789,18985,68774,240400,2011
44005,43.1,82765,73029,3062,3467,21514,69369,34600,21906,12694,34600,380700,2011
44007,36.8,627362,420152,47203,115058,146814,49411,238633,131455,107178,238633,247700,2011
44009,41.4,126937,117282,1544,3040,32671,72163,49179,37744,11435,49179,340500,2011
45001,41.9,25515,17630,7493,88,6716,34670,9811,7638,2173,9811,89100,2011
45003,40,158253,107723,39180,7444,43521,43999,63414,46191,17223,63414,122300,2011
45005,37.8,10548,2540,7812,149,2168,22982,3348,2052,1296,3348,72400,2011
45007,39.7,185675,146557,29273,5252,51245,42854,72519,53282,19237,72519,120500,2011
45009,40,16061,5753,10012,187,3488,26697,5742,4242,1500,5742,77400,2011
45011,38.5,22638,11786,10146,435,5618,34546,8405,6123,2282,8405,71900,2011
45013,40.7,159048,105503,30628,18347,45040,57133,64270,46037,18233,64270,288800,2011
45015,34.4,174679,111895,43455,9966,45299,51093,62447,43845,18602,62447,150600,2011
45017,43.8,15198,8034,6517,402,4185,37318,6155,5011,1144,6155,102000,2011
45019,35.8,346981,215060,104327,17691,82728,50133,139262,86111,53151,139262,242000,2011
45021,37.8,55111,40928,10930,1956,13989,35025,21012,14271,6741,21012,82300,2011
45023,40.4,33190,19664,12307,496,8639,32112,12605,9560,3045,12605,84300,2011
45025,39.1,46378,28650,15239,1623,11770,32304,17464,12524,4940,17464,77200,2011
45027,41.4,34746,16033,17378,895,8690,33355,12165,8722,3443,12165,91200,2011
45029,40,38833,21618,15521,1077,10253,31700,15281,11136,4145,15281,92600,2011
45031,39,68581,37833,28263,1167,18560,38567,26279,19101,7178,26279,85900,2011
45033,37.2,31745,15004,14642,847,8059,26067,11785,7383,4402,11785,62000,2011
45035,35.6,133796,88532,33732,5728,35735,54875,48697,35915,12782,48697,172300,2011
45037,40.2,26782,15023,10197,1315,6671,44090,9151,7043,2108,9151,104400,2011
45039,42.1,23916,9171,14363,66,5986,34117,9405,6961,2444,9405,93800,2011
45041,37.3,135968,74127,55566,2940,35701,41325,51508,34056,17452,51508,110200,2011
45043,45.1,60280,37444,20400,1860,15547,42677,22329,17125,5204,22329,170500,2011
45045,37.1,445586,315143,79543,34699,114287,48518,173082,117579,55503,173082,150100,2011
45047,38.2,69243,42699,21032,3654,18065,39366,26508,18695,7813,26508,104400,2011
45049,38.3,21120,8765,11285,709,5192,35914,7248,5459,1789,7248,81500,2011
45051,41.3,265139,205305,36330,15544,73185,42877,112358,79702,32656,112358,170600,2011
45053,35.1,24195,8927,11081,3435,4900,36696,7811,5727,2084,7811,104700,2011
45055,40.3,61010,42579,15373,2165,17495,43509,23992,18869,5123,23992,112000,2011
45057,39.3,74500,51829,18045,3165,20448,40034,29024,21482,7542,29024,133200,2011
45059,40.2,66859,46256,16826,2633,17440,38713,24839,17802,7037,24839,85600,2011
45061,38.3,19412,6421,12536,342,4172,27011,6542,4745,1797,6542,63900,2011
45063,37.5,257756,199362,36219,13484,70310,52857,102751,76616,26135,102751,138000,2011
45065,49,10178,4905,5048,74,2961,36243,4266,3362,904,4266,108100,2011
45067,39.4,33335,13447,18702,817,8509,31762,12086,8104,3982,12086,83000,2011
45069,38.7,28977,11735,14858,534,6620,28511,9830,6343,3487,9830,58800,2011
45071,39.1,37395,22661,11223,2641,10209,42866,14236,10392,3844,14236,104200,2011
45073,42.8,73629,63406,5666,3182,20927,42641,29941,22758,7183,29941,134600,2011
45075,37.5,92503,31577,57577,1705,22554,33162,34616,23687,10929,34616,81300,2011
45077,34.7,118617,103585,7524,3678,29220,42241,44127,30969,13158,44127,126400,2011
45079,32.7,378989,173103,171838,17683,87234,48485,142773,86842,55931,142773,150600,2011
45081,40.1,19681,11535,5232,2663,4848,39095,6821,5050,1771,6821,101700,2011
45083,37.9,281777,198054,57041,15908,74602,43563,106055,74890,31165,106055,118800,2011
45085,35.5,106899,50525,50078,3477,27231,40542,39273,26104,13169,39273,100900,2011
45087,42,28982,19225,8913,292,8223,33679,12052,8887,3165,12052,73100,2011
45089,40.6,34719,10884,22923,540,7543,24530,11185,7619,3566,11185,64700,2011
45091,37,221441,161628,41300,9595,60085,53536,84262,60861,23401,84262,161200,2011
46003,42.4,2722,2627,0,40,728,46205,1060,840,220,1060,65500,2011
46005,41,17111,14863,259,1161,4280,40455,7298,4797,2501,7298,84000,2011
46007,29.5,3435,1112,0,90,857,34500,1138,673,465,1138,47600,2011
46009,43.7,7039,6294,56,212,1723,43456,2547,2057,490,2547,70300,2011
46011,26,31639,29291,241,634,6426,46101,11597,6910,4687,11597,138500,2011
46013,39.2,36265,33701,206,509,8993,47327,15201,10606,4595,15201,123100,2011
46015,40.5,5187,4581,5,89,1385,48170,2025,1442,583,2025,92100,2011
46017,25.3,1936,264,8,0,444,28493,551,169,382,551,67000,2011
46019,39.9,10037,9312,22,276,2678,41145,3989,2982,1007,3989,117600,2011
46021,49.1,1407,1372,0,0,404,40385,622,533,89,622,41300,2011
46023,39.1,9095,5907,0,170,2157,36757,3238,2288,950,3238,69700,2011
46025,45.3,3687,3503,6,73,904,45844,1375,1083,292,1375,62800,2011
46027,24.7,13902,12562,110,273,2573,39118,5012,2820,2192,5012,126000,2011
46029,38,27180,25760,52,423,7033,44672,11434,8246,3188,11434,130100,2011
46031,29.8,4049,1264,8,120,788,28506,1143,655,488,1143,45200,2011
46033,50.1,8155,7577,53,174,2418,48125,3737,2922,815,3737,164300,2011
46035,38.5,19446,18272,89,287,5065,44597,8224,5121,3103,8224,115500,2011
46037,47.5,5701,5027,3,43,1581,40335,2460,1750,710,2460,66500,2011
46039,43.7,4366,4193,41,101,1189,46186,1800,1488,312,1800,87100,2011
46041,29.2,5331,1188,22,76,1271,30645,1720,996,724,1720,58400,2011
46043,48,3013,2912,0,13,881,45957,1230,958,272,1230,64800,2011
46045,46.6,4050,3913,0,69,1061,48039,1616,1275,341,1616,78000,2011
46047,50.1,7053,6199,4,148,1717,34948,3200,2191,1009,3200,91000,2011
46049,44.5,2381,2331,0,34,563,40125,931,722,209,931,55200,2011
46051,44.8,7353,7098,9,174,2112,44444,3180,2357,823,3180,105600,2011
46053,48.1,4253,3831,0,64,1264,35975,1983,1513,470,1983,57300,2011
46055,49.8,1734,1646,13,3,510,49432,750,626,124,750,80000,2011
46057,38.2,5839,5636,15,143,1444,47771,2008,1621,387,2008,95200,2011
46059,48.1,3408,3358,0,32,1066,44375,1555,1108,447,1555,82200,2011
46061,35.3,3375,3336,0,8,823,47700,1132,939,193,1132,88400,2011
46063,41.8,1328,1268,3,15,377,46797,515,382,133,515,66200,2011
46065,40.9,16943,14443,103,314,4531,58082,7102,4941,2161,7102,145400,2011
46067,47.1,7345,7094,13,118,2011,42386,2946,2320,626,2946,73300,2011
46069,44.6,1422,1297,0,21,389,43906,605,468,137,605,62100,2011
46071,32.6,3031,1431,0,68,750,38581,960,604,356,960,55700,2011
46073,49.2,2044,1876,0,55,603,43705,868,604,264,868,65100,2011
46075,43.6,1203,1138,0,0,331,50795,460,336,124,460,77500,2011
46077,46.8,5159,5001,9,92,1536,47152,2314,1760,554,2314,73600,2011
46079,39.6,11193,10710,66,170,2939,46412,4509,3217,1292,4509,114900,2011
46081,40.6,23897,22180,33,597,6285,45137,10715,7019,3696,10715,163700,2011
46083,33,43276,41216,194,603,12280,70043,16466,12595,3871,16466,177100,2011
46085,36.4,3745,2198,0,0,971,41389,1440,910,530,1440,65900,2011
46087,42.3,5613,5439,1,109,1546,46964,2192,1734,458,2192,92500,2011
46089,49.5,2482,2445,1,32,673,35065,1029,832,197,1029,48600,2011
46091,42.8,4614,3927,2,282,1035,41731,1704,1245,459,1704,88000,2011
46093,36.4,25245,22790,248,787,6979,47504,9933,7093,2840,9933,153400,2011
46095,30.8,2039,860,0,28,497,34013,633,407,226,633,53600,2011
46097,47.8,2388,2296,0,17,677,42361,1094,851,243,1094,58300,2011
46099,34.8,168014,145770,5693,6758,43042,52758,66238,43292,22946,66238,147600,2011
46101,40.5,6497,5267,0,115,1843,49016,2614,1952,662,2614,109600,2011
46103,36.8,99611,81778,1005,4000,26510,48378,40306,26643,13663,40306,153700,2011
46105,48.7,2898,2819,0,11,810,36042,1307,949,358,1307,55000,2011
46107,50.3,2375,2324,0,18,697,45682,1028,862,166,1028,57500,2011
46109,39.6,10094,6220,17,137,2627,41483,3657,2572,1085,3657,81900,2011
46111,45.8,2377,2311,0,56,673,46736,1008,722,286,1008,69000,2011
46113,22.8,13544,472,0,147,2238,25228,2753,1429,1324,2753,16800,2011
46115,44.2,6470,6242,0,95,1645,47983,2603,1972,631,2603,62900,2011
46117,41.1,2928,2615,3,22,807,55679,1159,926,233,1159,115400,2011
46119,47.1,1389,1319,0,15,410,51429,606,450,156,606,72500,2011
46121,22.7,9640,931,20,264,1953,27431,2566,1102,1464,2566,47900,2011
46123,44,5673,4743,45,14,1763,40609,2482,1800,682,2482,66800,2011
46125,43.2,8357,8092,3,121,2314,50143,3411,2757,654,3411,86000,2011
46127,40.2,14155,13374,116,297,4089,63773,5833,4331,1502,5833,139000,2011
46129,46.8,5429,4489,0,14,1478,40879,2201,1596,605,2201,71100,2011
46135,41,22350,20493,321,603,5539,51680,8654,6091,2563,8654,123000,2011
46137,25.6,2780,635,30,105,632,27917,799,442,357,799,76400,2011
47001,42,74672,67780,2800,1713,20661,44872,31086,22152,8934,31086,121300,2011
47003,36.7,44717,35223,3134,4940,11561,39480,16053,11388,4665,16053,114200,2011
47005,45.8,16451,15550,422,276,4673,34152,7023,5651,1372,7023,73800,2011
47007,42,12949,12032,495,246,3181,35137,4505,3548,957,4505,109500,2011
47009,41,122283,112597,3551,3286,33758,47298,48464,36273,12191,48464,162300,2011
47011,38.4,98286,87288,4103,4436,25850,40541,37258,25066,12192,37258,137000,2011
47013,41.2,40626,39398,176,471,11162,31337,16027,11579,4448,16027,87900,2011
47015,40.6,13728,13127,236,218,3898,36742,5364,4090,1274,5364,114700,2011
47017,41.4,28576,24529,2926,570,7330,36455,10932,8523,2409,10932,79100,2011
47019,42,57568,55022,699,922,16609,32148,24190,17635,6555,24190,96900,2011
47021,39.3,38988,36825,678,906,10816,53337,14355,11632,2723,14355,157200,2011
47023,36.8,16925,14666,1567,323,4518,39776,5962,4442,1520,5962,109400,2011
47025,40.9,32042,30924,294,290,8846,33178,12766,9829,2937,12766,92700,2011
47027,46,7845,7531,243,62,2465,28682,3610,2742,868,3610,93500,2011
47029,42.3,35583,33506,671,640,10047,28563,14955,10672,4283,14955,98000,2011
47031,39.1,52620,47475,1362,1989,14761,39268,21042,14739,6303,21042,118600,2011
47033,39.9,14549,11224,2030,1208,3983,36743,5529,3871,1658,5529,86200,2011
47035,47.7,55648,53377,226,1283,15864,36955,23231,18409,4822,23231,142600,2011
47037,33.9,620443,359984,171332,58032,142483,46737,254111,144213,109898,254111,166300,2011
47039,44,11741,10940,258,296,3258,30311,5133,3969,1164,5133,68800,2011
47041,40.2,18684,16997,286,1143,4914,36870,7074,5234,1840,7074,101300,2011
47043,38.3,49281,44447,1991,1489,13525,44201,18809,13781,5028,18809,132000,2011
47045,39.6,38202,31039,5512,991,10883,38909,15283,9894,5389,15283,93700,2011
47047,40.9,38032,25901,10735,871,10843,57437,13825,11423,2402,13825,176600,2011
47049,42.3,17881,17463,45,178,5215,29245,7448,5826,1622,7448,95300,2011
47051,40.8,41058,36888,1577,1046,11147,41726,15885,12232,3653,15885,113700,2011
47053,40,49379,38251,9365,1029,12693,37577,19452,13831,5621,19452,86900,2011
47055,41.5,29536,25250,3242,496,8148,37981,11602,8739,2863,11602,98500,2011
47057,41.8,22538,21668,109,488,6183,31711,8940,7406,1534,8940,91200,2011
47059,42.2,68617,64532,1502,1688,20203,36310,28431,21084,7347,28431,108000,2011
47061,41.2,13808,11509,116,126,3600,25890,5259,4203,1056,5259,79800,2011
47063,38.6,62343,51993,2453,6413,17094,39604,24645,17370,7275,24645,120200,2011
47065,39.1,332863,240718,67060,13947,86682,45826,134030,88103,45927,134030,151000,2011
47067,42.6,6784,6651,71,8,1925,22052,2938,2077,861,2938,76500,2011
47069,40,27459,15311,11276,387,6198,32601,8798,6401,2397,8798,86900,2011
47071,42.8,25998,24103,848,483,7211,32131,10538,8169,2369,10538,89700,2011
47073,42,56694,54361,793,701,17125,36795,23707,18327,5380,23707,108000,2011
47075,38.1,18847,8494,9431,664,4913,33504,7199,4548,2651,7199,90300,2011
47077,39.3,27686,24447,1943,492,7642,37627,10733,8463,2270,10733,95600,2011
47079,43.7,32173,28361,2505,559,8859,36463,13231,10065,3166,13231,87700,2011
47081,39.7,24556,22570,1170,440,6512,43935,8948,7213,1735,8948,102900,2011
47083,41.5,8338,7856,139,143,2318,34942,3451,2473,978,3451,88200,2011
47085,40.9,18470,17463,513,259,5187,41810,7665,5810,1855,7665,107400,2011
47087,44.1,11501,11144,85,164,3101,32846,4710,3539,1171,4710,96900,2011
47089,39.9,51118,47586,1337,1564,13348,38015,19338,14555,4783,19338,122400,2011
47091,42.7,18227,17356,460,259,5180,32159,7285,5638,1647,7285,97700,2011
47093,37.1,428777,360709,38485,14084,108513,47277,179705,119683,60022,179705,154900,2011
47095,39.3,7814,5366,2044,245,1456,26797,2352,1401,951,2352,65200,2011
47097,36,27788,17075,9616,530,6585,34078,9577,6306,3271,9577,78100,2011
47099,39.5,41593,39501,684,710,11547,35737,15958,12167,3791,15958,95300,2011
47101,40.5,12066,11449,171,308,3223,32337,4655,3558,1097,4655,93200,2011
47103,41.5,33108,29215,2309,859,9260,41454,13298,10024,3274,13298,112300,2011
47105,45.6,47919,43400,386,3139,14265,50458,19773,15216,4557,19773,173300,2011
47107,40.6,52254,47352,2089,1475,14360,38604,20802,15721,5081,20802,110100,2011
47109,41.1,25887,23546,1605,385,6877,34953,10057,7647,2410,10057,85100,2011
47111,37.5,22120,20769,89,844,5936,34747,8186,6110,2076,8186,92300,2011
47113,36.7,97677,57224,34935,3248,23961,40667,36188,24120,12068,36188,112400,2011
47115,41.8,28174,26264,425,362,7888,39857,11344,8623,2721,11344,114300,2011
47117,39.2,30310,26256,1694,1378,8371,41620,11533,8626,2907,11533,106000,2011
47119,37.9,80177,64259,10284,3840,22104,46552,31811,23026,8785,31811,138200,2011
47121,42.7,11661,11192,163,154,3509,34942,4646,3656,990,4646,102100,2011
47123,40.9,44396,41048,877,1464,12472,35096,17565,12784,4781,17565,108700,2011
47125,30.3,168315,113513,31740,13070,44725,49695,61902,39679,22223,61902,135300,2011
47127,43.1,6323,5939,114,46,1772,45950,2423,1979,444,2423,134500,2011
47129,39.9,21796,20509,559,185,5798,37130,7930,6495,1435,7930,84600,2011
47131,41.1,31870,27119,3264,995,8831,39671,12669,8900,3769,12669,88600,2011
47133,41.7,21940,21329,212,110,6323,34108,9004,7218,1786,9004,88800,2011
47135,43.4,7834,7434,210,82,2158,31857,3240,2338,902,3240,79900,2011
47137,44.5,5094,4970,19,16,1554,31157,2288,1744,544,2288,93000,2011
47139,41.8,16740,16185,45,211,4528,36204,6486,5310,1176,6486,101600,2011
47141,35.9,71464,64417,1639,3736,17784,34305,27856,17944,9912,27856,131600,2011
47143,40.5,31544,29149,725,1118,8372,36934,11949,8598,3351,11949,103800,2011
47145,44.6,54162,50801,1339,761,15454,43129,22457,17109,5348,22457,121300,2011
47147,37.4,65462,55590,4797,3776,17725,50759,24028,18493,5535,24028,153900,2011
47149,32.2,257657,196422,32028,16625,65656,54433,94173,65001,29172,94173,159600,2011
47151,37.2,22195,21762,15,124,5819,29454,8555,6526,2029,8555,78500,2011
47153,40.6,14033,13370,18,409,3816,33536,5323,4138,1185,5323,115400,2011
47155,40.9,88996,81905,631,4299,27160,42569,37218,25482,11736,37218,158700,2011
47157,34.3,925673,363323,476415,49761,220584,46102,340394,206995,133399,340394,136200,2011
47159,39.2,19121,17971,469,154,5037,43580,7013,5386,1627,7013,117100,2011
47161,42.8,13196,12353,224,248,3738,42771,5215,4283,932,5215,108500,2011
47163,43.2,156466,147919,2804,2277,44986,40572,66554,49753,16801,66554,115700,2011
47165,38.4,158554,138289,10564,5965,44628,55211,60112,44004,16108,60112,171800,2011
47167,36.9,60462,46224,11065,1267,16400,50869,21578,15867,5711,21578,137400,2011
47169,38.3,7808,6730,612,192,2062,44163,2805,2228,577,2805,112500,2011
47171,44.6,18283,17320,185,670,4999,35265,7437,5419,2018,7437,115200,2011
47173,40.1,19152,18592,13,224,5136,31535,7334,5841,1493,7334,92200,2011
47175,43.6,5518,5387,49,7,1435,31155,2066,1763,303,2066,75800,2011
47177,38.4,39678,34624,1135,3162,10645,35575,15292,11119,4173,15292,90500,2011
47179,39.3,121458,109843,4692,3441,32139,42104,50523,33542,16981,50523,142900,2011
47181,41.3,16999,15520,837,466,4194,33630,5927,5004,923,5927,70300,2011
47183,36.9,34692,30461,2646,687,9016,33932,13958,9126,4832,13958,84400,2011
47185,41.1,25720,24386,442,426,7006,34642,9824,7507,2317,9824,100400,2011
47187,38.2,179601,156118,7728,7829,50758,89063,64011,52624,11387,64011,336900,2011
47189,39.1,112151,98434,7410,3512,31816,61400,42183,34152,8031,42183,190900,2011
48001,38.7,58192,35694,12323,9048,11094,40577,15992,11447,4545,15992,82900,2011
48003,34.5,14500,6981,187,7000,3975,51598,5193,4225,968,5193,87500,2011
48005,35.9,86033,54762,12773,16627,22152,39325,31048,21286,9762,31048,82900,2011
48007,47.5,23243,16384,190,5696,6975,44129,10134,7779,2355,10134,125100,2011
48009,42.2,9013,8146,70,645,2511,53113,3262,2662,600,3262,101200,2011
48011,43.9,1929,1725,10,180,556,56538,676,540,136,676,96700,2011
48013,35.8,44553,16274,240,27379,11500,43261,14940,11417,3523,14940,81600,2011
48015,39.7,28150,18623,2749,6401,7586,52510,10502,8043,2459,10502,152600,2011
48017,30.7,7079,3653,202,3212,1782,41106,2414,1738,676,2414,70700,2011
48019,48.1,20424,16577,197,3330,5935,45595,8377,6639,1738,8377,139200,2011
48021,38.1,73368,42405,5847,23349,18733,52882,25522,20041,5481,25522,119800,2011
48023,50.4,3770,3347,24,374,1110,37159,1723,1350,373,1723,62800,2011
48025,34.8,31916,10180,3337,17853,6053,39247,8507,5613,2894,8507,67700,2011
48027,29.6,302946,155366,60856,64422,73689,49466,102547,59057,43490,102547,117500,2011
48029,32.7,1686452,517320,116306,985329,398837,48083,590364,363477,226887,590364,121200,2011
48031,45.4,10267,8109,104,1847,2666,46457,4009,3225,784,4009,165500,2011
48033,41.7,620,489,0,129,192,59643,266,157,109,266,78300,2011
48035,45,18118,14667,279,2836,4910,44744,6833,5284,1549,6833,87200,2011
48037,37.3,91903,61089,21543,5963,22826,43210,33324,22429,10895,33324,91600,2011
48039,35,307695,166324,35848,84062,79058,67018,103919,78290,25629,103919,143900,2011
48041,24.1,189858,113278,20071,43264,37989,37161,67612,31288,36324,67612,145900,2011
48043,40.6,9088,4847,110,3811,2291,39615,4066,2433,1633,4066,106700,2011
48045,42.5,1718,1199,12,444,455,34130,656,527,129,656,43300,2011
48047,34.8,7297,505,13,6720,1719,19936,2671,1707,964,2671,45200,2011
48049,39.2,38136,28556,1589,7384,9499,39965,13412,9667,3745,13412,83300,2011
48051,40.8,17109,11661,2103,3067,4585,42679,6490,5244,1246,6490,88000,2011
48053,43.5,42606,32606,801,8406,12103,48291,16477,12091,4386,16477,141500,2011
48055,34.5,37795,16858,2628,17589,7899,43136,11464,7616,3848,11464,103400,2011
48057,38.3,21240,9813,497,9753,5701,44433,7936,5809,2127,7936,90800,2011
48059,41.7,13497,11987,74,1047,3599,45933,5133,4298,835,5133,75900,2011
48061,30.4,400332,44068,1357,351049,92318,32156,114881,78454,36427,114881,76000,2011
48063,38.2,12353,7388,2294,2500,3330,36998,4490,3044,1446,4490,101100,2011
48065,40.8,6254,5505,105,513,1818,60028,2347,2066,281,2347,87000,2011
48067,43.7,30284,23324,5219,1064,8224,35592,12086,8464,3622,12086,71600,2011
48069,33.5,7919,3056,113,4575,1942,36893,2609,1962,647,2609,68400,2011
48071,36,33486,23564,2751,6290,9332,72850,11482,9934,1548,11482,148200,2011
48073,37.8,50427,31891,7622,10085,12388,37758,16989,12401,4588,16989,71000,2011
48075,31.6,7069,4191,895,1919,1524,47605,2088,1552,536,2088,56000,2011
48077,44.5,10839,9998,37,466,3154,52868,4344,3708,636,4344,79900,2011
48079,34.8,3127,1329,148,1606,839,40513,1090,859,231,1090,37100,2011
48081,46.9,3406,2720,26,606,932,40000,1378,986,392,1378,63800,2011
48083,45.3,8840,7065,217,1376,2442,27910,3568,2398,1170,3568,63400,2011
48085,34.8,764424,487331,61233,111271,203629,82758,276234,194135,82099,276234,202000,2011
48087,36.4,3036,1739,137,1108,767,38750,1207,890,317,1207,57200,2011
48089,42.6,20792,12551,2813,5255,5395,43252,8069,6365,1704,8069,98200,2011
48091,42.4,106111,75673,1629,26326,30313,65521,40119,30343,9776,40119,196300,2011
48093,42.5,13878,10123,78,3465,3535,36326,5233,4105,1128,5233,84000,2011
48095,40,4074,1913,54,2088,747,46528,965,778,187,965,66900,2011
48097,38.8,38344,30252,1007,5803,10380,50176,14442,10000,4442,14442,111300,2011
48099,29.7,74948,46286,12314,11751,16123,48920,20134,11858,8276,20134,96600,2011
48101,46.5,1693,1157,159,301,464,39038,638,524,114,638,40900,2011
48103,36.3,4246,1878,138,2141,1140,48648,1442,1119,323,1442,56600,2011
48105,34.3,3744,1557,0,2186,869,51522,1301,726,575,1301,53900,2011
48107,37.5,6133,2682,218,3137,1476,35655,2115,1481,634,2115,51700,2011
48109,40.9,2438,610,12,1783,541,37500,852,607,245,852,43700,2011
48111,32.5,6605,3696,109,2555,1668,47500,2172,1389,783,2172,69800,2011
48113,32.4,2348702,794597,506879,886310,548715,48942,840663,455397,385266,840663,129300,2011
48115,34.2,13805,5414,1050,7232,3125,39454,4373,3246,1127,4373,48100,2011
48117,30.9,19225,6054,146,12703,4627,41134,6196,4029,2167,6196,78100,2011
48119,41.8,5220,4351,412,272,1239,34710,2023,1649,374,2023,61400,2011
48121,32.8,648470,422472,51242,116342,163545,72305,231355,153254,78101,231355,180400,2011
48123,42.6,20052,11587,1899,6303,4891,43380,7069,5388,1681,7069,73100,2011
48125,43.1,2427,1624,101,683,577,35333,838,679,159,838,46900,2011
48127,35.4,9937,1370,16,8443,2684,26730,3451,2435,1016,3451,47700,2011
48129,42.9,3624,3131,194,249,900,44300,1318,923,395,1318,58600,2011
48131,36.9,11873,1283,134,10369,2802,35144,3928,2850,1078,3928,54900,2011
48133,41.6,18577,15228,364,2638,4616,34531,7105,5279,1826,7105,66900,2011
48135,31.2,135545,56625,5410,70358,34188,50056,48318,32305,16013,48318,83100,2011
48137,44.9,2023,896,3,1124,536,43095,842,703,139,842,62800,2011
48139,34.8,146997,96796,12597,34026,39440,62639,49233,37497,11736,49233,136600,2011
48141,31.2,787410,105697,20854,644844,188778,38259,247305,157199,90106,247305,108000,2011
48143,31.1,37525,29126,392,7015,8690,40096,14075,8446,5629,14075,116300,2011
48145,39,17799,9436,4536,3557,3760,31543,5647,3963,1684,5647,61200,2011
48147,40.2,33853,27387,2421,3184,8412,44136,11817,8735,3082,11817,84800,2011
48149,46,24397,18066,1695,4392,7101,47285,10517,8109,2408,10517,133400,2011
48151,43.8,4067,2837,169,964,1194,43724,1676,1253,423,1676,54500,2011
48153,37.4,6507,2821,165,3376,1978,35967,2571,1782,789,2571,61800,2011
48155,43,1286,1001,19,251,338,31006,557,363,194,557,35300,2011
48157,34.8,565295,207229,120189,134069,148169,82571,177980,142467,35513,177980,175100,2011
48159,41.6,10633,8629,526,1313,2735,47500,3804,3076,728,3804,103100,2011
48161,41.1,19573,13525,3297,2517,4507,45816,6972,5386,1586,6972,85000,2011
48163,31.8,17090,3356,549,13111,3602,37769,4745,3127,1618,4745,50200,2011
48165,29.2,17123,10365,186,6222,4105,47157,5367,3988,1379,5367,78100,2011
48167,37.2,289658,172074,40146,63928,74301,59645,107996,74342,33654,107996,144700,2011
48169,36.4,6319,2225,270,3797,1108,42883,1631,1112,519,1631,58600,2011
48171,49.4,24524,19301,55,4766,7452,54843,10610,7974,2636,10610,195700,2011
48173,41.8,1179,931,41,207,315,72188,406,319,87,406,103700,2011
48175,44.3,7188,4310,290,2414,2047,51389,2942,2371,571,2942,102000,2011
48177,36.5,19686,8914,1595,9098,5159,38623,7075,4843,2232,7075,74300,2011
48179,38.2,22628,15741,1134,5139,5829,42845,8180,6255,1925,8180,71400,2011
48181,39.3,119949,94864,6652,13133,32030,46993,45878,31666,14212,45878,102300,2011
48183,35.4,120728,74378,24238,19019,30925,44608,45290,28611,16679,45290,114600,2011
48185,38.8,26455,16075,4390,5494,6025,40509,8433,6329,2104,8433,86000,2011
48187,36.3,127499,70341,7564,45297,34374,61608,44554,34901,9653,44554,150700,2011
48189,32.5,36108,13752,1747,19885,8756,39335,11707,7442,4265,11707,73500,2011
48191,42.3,3385,2005,244,1056,997,32059,1402,963,439,1402,37800,2011
48193,45.8,8491,7565,51,828,2032,40757,3024,2456,568,3024,82600,2011
48195,35.9,5524,3078,29,2309,1424,52610,1895,1485,410,1895,69400,2011
48197,43.9,4181,2980,345,789,1198,36568,1692,1309,383,1692,46800,2011
48199,38.2,53984,47500,3248,2372,14984,54588,20204,15902,4302,20204,99200,2011
48201,32.1,4025409,1353868,747398,1621065,956941,52675,1391103,801419,589684,1391103,132300,2011
48203,37.4,64999,42495,14911,6873,16999,45357,23423,17285,6138,23423,104600,2011
48205,39.6,5974,4205,395,1326,1309,69414,1727,1267,460,1727,138200,2011
48207,44.4,5877,4150,264,1362,1787,39578,2544,1869,675,2544,40700,2011
48209,30.1,152827,89979,5108,53188,34174,58247,52717,35474,17243,52717,174800,2011
48211,39.6,3758,2693,4,917,1106,54360,1573,1185,388,1573,104900,2011
48213,42.6,78394,63554,5066,8270,21018,41242,30552,23623,6929,30552,87000,2011
48215,28.2,757453,60292,2734,684756,172845,32479,209796,147106,62690,209796,75500,2011
48217,40.7,35033,25818,2296,6322,9174,39944,13231,9940,3291,13231,85400,2011
48219,33.2,22929,11914,639,9845,6162,48201,8147,5950,2197,8147,77000,2011
48221,45.7,50569,43912,293,5100,15272,54002,20916,16164,4752,20916,150400,2011
48223,39.1,34869,26442,2651,5137,9805,42844,13200,9578,3622,13200,93700,2011
48225,44,23628,14747,5901,2288,5224,32437,7880,5660,2220,7880,67900,2011
48227,37.5,34645,18509,1808,13122,7550,41887,11016,7461,3555,11016,61800,2011
48229,30.8,3433,551,87,2754,639,22634,951,765,186,951,42200,2011
48231,37.3,85390,63915,7515,11456,21275,45253,30624,21909,8715,30624,92900,2011
48233,37.3,22088,16515,590,4272,5705,44120,8372,6778,1594,8372,64600,2011
48235,44,1526,1065,51,388,438,45250,607,493,114,607,71800,2011
48237,38.8,9044,7321,475,1211,1968,46136,2972,2181,791,2972,69700,2011
48239,38.9,14002,8840,1029,3983,3783,50010,5173,3893,1280,5173,85900,2011
48241,39.9,35538,26783,5813,1982,9695,40099,13684,10686,2998,13684,78600,2011
48243,51.3,2328,1438,2,825,736,49149,991,826,165,991,99000,2011
48245,36,250714,113490,84027,41017,60955,42883,91432,58870,32562,91432,93100,2011
48247,32.2,5231,162,57,4933,1334,36752,1708,1196,512,1708,49800,2011
48249,34.1,40821,8136,173,31997,10105,37413,13541,9994,3547,13541,68300,2011
48251,36,149681,115180,4070,26441,39287,55970,51220,38663,12557,51220,113500,2011
48253,39.6,20140,12000,2814,4898,3845,37872,5910,4590,1320,5910,57100,2011
48255,36.7,14873,5945,1362,7300,3240,39297,4630,3251,1379,4630,70100,2011
48257,35.2,101197,71122,9905,16939,26891,60575,34014,26501,7513,34014,129300,2011
48259,43.6,32642,25203,396,6618,9787,72092,12469,9353,3116,12469,264500,2011
48261,51.4,325,150,1,174,66,45625,82,38,44,82,54400,2011
48263,45.9,859,750,0,105,235,43750,410,311,99,410,57700,2011
48265,46.9,49216,35683,913,11640,13848,44529,20278,14781,5497,20278,136700,2011
48267,48.5,4578,3206,5,1247,1160,43653,1839,1285,554,1839,85300,2011
48269,45.1,253,203,1,29,78,61250,100,45,55,100,275000,2011
48271,46.2,3656,1538,78,1989,757,25703,1156,954,202,1156,49100,2011
48273,28.8,31823,7518,1159,22093,7406,37222,11119,6345,4774,11119,72000,2011
48275,41.1,3703,2354,286,1036,1000,32646,1613,1047,566,1613,40000,2011
48277,39.5,49681,37991,6675,3135,13731,40050,19045,13035,6010,19045,84300,2011
48279,35.8,14063,6158,610,7110,3456,35589,4767,3479,1288,4767,54000,2011
48281,40.3,19762,14985,608,3426,5176,48760,7067,5359,1708,7067,124100,2011
48283,32.8,6800,1244,80,5428,1311,25313,1957,1257,700,1957,42500,2011
48285,44.8,19253,14726,1403,2999,5567,43570,7928,6254,1674,7928,85000,2011
48287,40,16565,10869,1848,3604,4247,45754,6063,4637,1426,6063,111800,2011
48289,45.2,16757,13041,1348,2148,4585,42150,6478,5494,984,6478,83000,2011
48291,36,75317,52344,8500,13052,18098,47460,24217,18981,5236,24217,83500,2011
48293,39.6,23282,14464,4246,4302,5683,42851,7913,6247,1666,7913,81600,2011
48295,36.9,3260,2191,14,939,793,55457,1169,824,345,1169,77100,2011
48297,42.5,11482,6741,514,4067,2819,45276,3848,3207,641,3848,88200,2011
48299,54.9,19133,17159,141,1510,5388,41837,8221,6539,1682,8221,159800,2011
48301,33.8,62,31,0,21,18,78125,27,12,15,27,66700,2011
48303,30.2,274359,158373,18347,86564,64757,43983,102910,61254,41656,102910,105400,2011
48305,39.5,5927,2983,110,2687,1656,46456,2136,1592,544,2136,67000,2011
48307,40.9,8242,5556,208,2391,2026,37861,3160,2373,787,3160,68900,2011
48309,32.6,232396,137916,34050,53789,56074,41656,83851,50286,33565,83851,104800,2011
48311,41.2,728,385,0,332,138,29500,270,226,44,270,82100,2011
48313,33.8,13533,7943,2880,2615,2596,37437,3604,2791,813,3604,82700,2011
48315,48.6,10678,7640,2544,327,3059,31903,4667,3610,1057,4667,63300,2011
48317,34.4,4704,2446,246,1908,1110,42050,1545,1079,466,1545,71600,2011
48319,48.1,3950,3237,0,690,1145,41462,1631,1347,284,1631,152700,2011
48321,37.7,36662,17473,3987,13798,9927,43962,13461,9903,3558,13461,87500,2011
48323,30.2,53389,1606,75,50913,11985,29504,14749,10285,4464,14749,81900,2011
48325,37.9,45559,21211,949,22442,12155,50101,15350,11742,3608,15350,107200,2011
48327,46.4,2226,1512,3,662,607,41923,838,638,200,838,63400,2011
48329,33.6,135002,72612,8658,50221,35700,57807,49534,34755,14779,49534,133100,2011
48331,39.6,24861,16371,2332,5674,6576,39751,9323,6600,2723,9323,85100,2011
48333,47.4,4884,3932,28,915,1323,38138,1841,1452,389,1841,90600,2011
48335,35.3,9372,4762,1050,3318,1978,41281,2711,2050,661,2711,58800,2011
48337,42.7,19773,17423,35,1826,5454,43509,7890,6080,1810,7890,85800,2011
48339,36,443622,319029,17554,89361,117133,66657,155712,115629,40083,155712,161700,2011
48341,30.4,21379,8409,305,11171,5049,48394,6669,4776,1893,6669,83400,2011
48343,43.3,13017,8747,3001,968,3352,39698,5095,3772,1323,5095,72100,2011
48345,44.1,1030,869,17,129,247,33281,415,327,88,415,54100,2011
48347,29.7,63872,39806,11606,10861,14737,35378,23006,13577,9429,23006,90800,2011
48349,37,47621,28770,7031,10960,12263,41074,17299,12249,5050,17299,78900,2011
48351,40.9,14411,10719,2997,437,3695,38409,5048,4260,788,5048,73200,2011
48353,38.6,15098,9135,642,4973,3715,37177,5693,3892,1801,5693,52400,2011
48355,34.9,337182,112343,12493,203085,82879,44815,121969,74033,47936,121969,107900,2011
48357,31.1,10147,5091,42,4742,2757,49794,3735,2655,1080,3735,79600,2011
48359,39,2032,1714,57,173,497,57054,697,495,202,697,89600,2011
48361,38.4,82184,68354,7211,4691,22611,48833,31161,24029,7132,31161,84000,2011
48363,40.2,27977,21922,650,4877,7626,40385,10737,7506,3231,10737,81600,2011
48365,40,23690,17504,4053,1852,6350,48088,8640,7145,1495,8640,80900,2011
48367,38.6,114764,97741,1975,11979,31836,63725,41579,33030,8549,41579,150000,2011
48369,32.2,10157,4161,46,5908,2651,40926,3359,2406,953,3359,90500,2011
48371,36,15465,4211,867,10195,3433,40925,4774,3280,1494,4774,54700,2011
48373,43.3,45653,33201,5073,5753,11426,36073,16842,13329,3513,16842,73700,2011
48375,32.7,120626,60028,11809,41961,27268,37766,41768,24742,17026,41768,82800,2011
48377,39.1,7727,1125,50,6370,1705,28724,2735,1922,813,2735,58200,2011
48379,45.4,10994,9584,281,839,3070,45168,4079,3413,666,4079,90300,2011
48381,35.3,118994,93325,2636,18992,31861,57121,46735,32528,14207,46735,135800,2011
48383,33.1,3343,1120,128,2087,894,58491,1144,821,323,1144,60500,2011
48385,52.1,3314,2518,2,769,950,25870,1334,998,336,1334,79600,2011
48387,44.4,12879,9563,2164,801,3768,36969,5180,3615,1565,5180,67000,2011
48389,35.3,13473,1504,346,11311,2479,35552,3557,2732,825,3557,35300,2011
48391,43.3,7381,3365,444,3400,1984,42470,2729,2151,578,2729,67500,2011
48393,44.7,885,834,0,24,255,61042,330,257,73,330,116800,2011
48395,40.6,16606,9772,3536,2918,4311,38397,5971,4048,1923,5971,77200,2011
48397,35.4,76349,56832,4050,12054,20729,82146,25717,21239,4478,25717,193000,2011
48399,43,10479,6835,238,3288,2822,38556,3886,2805,1081,3886,59800,2011
48401,39.1,52685,35034,9461,7269,13004,46438,17994,14059,3935,17994,89500,2011
48403,50.1,10686,9357,969,319,3003,33109,4491,3944,547,4491,72900,2011
48405,47.1,8949,6219,2095,500,2259,26841,3581,2736,845,3581,73300,2011
48407,43.1,26192,20115,2940,2716,6868,48750,8980,7427,1553,8980,81000,2011
48409,35.5,65648,27970,1270,35175,16867,48389,22453,14674,7779,22453,91800,2011
48411,40,6028,4102,102,1614,1416,38675,2133,1738,395,2133,72100,2011
48413,31.8,3303,1826,12,1420,767,46058,1000,763,237,1000,71700,2011
48415,37.6,16717,9727,738,5867,4609,46380,6039,4298,1741,6039,78200,2011
48417,40.4,3233,2829,62,298,824,44647,1265,937,328,1265,68100,2011
48419,37.2,25513,16736,4473,3948,7067,34164,9778,7375,2403,9778,66800,2011
48421,36.8,3019,1794,16,1178,775,49135,1015,782,233,1015,82800,2011
48423,35.9,206839,129548,37412,34644,53907,46615,77934,53668,24266,77934,119800,2011
48425,39.5,8320,6625,116,1491,2114,48401,3146,2279,867,3146,139000,2011
48427,28.9,60525,767,46,59585,13086,25598,15571,12560,3011,15571,59900,2011
48429,39.9,9579,7292,231,1907,2508,37400,3598,2746,852,3598,70100,2011
48431,40.4,1216,723,3,487,305,41944,424,321,103,424,63500,2011
48433,50.3,1396,1172,71,138,396,47083,600,475,125,600,51200,2011
48435,39.2,4198,1776,83,2300,1015,55122,1382,1044,338,1382,76400,2011
48437,36.2,7808,4048,419,3030,1823,38988,2612,1866,746,2612,59400,2011
48439,33.4,1780700,934506,256684,467775,447495,56178,643917,405570,238347,643917,136100,2011
48441,32.8,130463,87764,8945,28468,32443,43065,49439,30791,18648,49439,90900,2011
48443,45.7,946,366,0,501,245,41417,421,309,112,421,58200,2011
48445,35.3,12543,5759,681,5981,2581,35485,3940,2809,1131,3940,60000,2011
48447,48.9,1749,1568,0,161,517,40380,795,643,152,795,50500,2011
48449,32.6,31601,15749,3033,12251,8010,39886,10717,7713,3004,10717,88300,2011
48451,34.2,109135,63330,4097,38666,28086,43465,41468,27806,13662,41468,91100,2011
48453,31.8,1007264,511550,83272,334240,230442,55452,399679,208968,190711,399679,210500,2011
48455,45.7,14511,11741,1527,1082,3247,38138,4893,4047,846,4893,79500,2011
48457,41.8,21600,17353,2414,1405,5698,35847,8238,6829,1409,8238,74000,2011
48459,40.5,39056,32108,3398,2515,11022,46734,14793,11631,3162,14793,88300,2011
48461,38.4,3278,1653,144,1465,900,52455,1203,969,234,1203,39800,2011
48463,35,26330,7779,206,18053,6349,34456,8689,6405,2284,8689,67500,2011
48465,32.4,48434,8569,745,38639,11391,38747,14909,10151,4758,14909,85100,2011
48467,42.1,52483,44989,1359,4813,13669,42359,19292,14991,4301,19292,97600,2011
48469,36.5,86410,41791,5050,37608,22929,49676,32004,21493,10511,32004,103700,2011
48471,34.7,66833,39159,15061,11030,11465,36885,20077,11775,8302,20077,108100,2011
48473,32.3,41990,18966,10176,11848,10083,50609,13653,9320,4333,13653,128500,2011
48475,36.2,10586,4927,484,4940,2713,41939,3808,2861,947,3808,49100,2011
48477,40.7,33261,22205,5896,4409,8484,45320,12613,8588,4025,12613,137700,2011
48479,27.6,245762,8661,659,234730,54821,37868,65796,42014,23782,65796,106500,2011
48481,37.3,41083,19735,5815,15137,10207,43689,14600,10098,4502,14600,87100,2011
48483,41.2,5316,3918,166,1073,1474,48000,2124,1638,486,2124,68100,2011
48485,34.1,130835,89960,13681,21262,31815,44786,48001,31313,16688,48001,88800,2011
48487,37.7,13548,8609,1102,3431,3422,40050,5069,3346,1723,5069,60700,2011
48489,31.9,21894,2477,364,18966,4113,22894,5309,3901,1408,5309,51400,2011
48491,34.2,409913,262981,24595,93711,109271,71346,147912,102631,45281,147912,175400,2011
48493,39.6,42222,24750,788,16120,12159,62689,15076,12765,2311,15076,133500,2011
48495,34.8,7039,3089,198,3662,1673,44573,2526,2097,429,2526,41600,2011
48497,38,58703,47077,686,9664,15672,57511,19995,16276,3719,19995,120700,2011
48499,47.3,41840,35565,2047,3410,11468,41260,15983,12854,3129,15983,99100,2011
48501,32.2,7825,3126,77,4463,2046,48173,2629,2106,523,2629,58900,2011
48503,42.3,18351,14884,219,2837,5159,39898,7432,5147,2285,7432,72800,2011
48505,29.2,13853,1054,0,12799,3660,26009,4282,3239,1043,4282,52600,2011
48507,31.1,11700,803,73,10815,2731,23952,3635,2561,1074,3635,39500,2011
49001,31.6,6495,5735,11,642,1498,43225,2061,1578,483,2061,152000,2011
49003,30.6,49093,43414,96,4009,13034,55588,15891,12878,3013,15891,167400,2011
49005,25.2,109752,94001,617,10636,25941,48338,34599,22085,12514,34599,185000,2011
49007,34.5,21011,17743,92,2527,5457,43659,7897,5543,2354,7897,117200,2011
49009,47.1,891,823,4,41,232,44750,373,241,132,373,162500,2011
49011,29.1,301124,259084,3420,24716,75213,69147,92652,72823,19829,92652,228200,2011
49013,29.7,18025,15729,69,1016,5502,55790,6691,4988,1703,6691,169700,2011
49015,32.9,10827,9968,20,623,2851,50800,3716,2963,753,3716,116200,2011
49017,42.3,5052,4652,5,197,1460,46029,2144,1701,443,2144,149500,2011
49019,39.5,9096,7697,13,767,2094,42004,3653,2477,1176,3653,222100,2011
49021,26.3,45383,39655,243,3421,11081,42226,15313,9373,5940,15313,196400,2011
49023,29.6,10089,9493,19,337,2673,54000,3092,2524,568,3092,169500,2011
49025,45.6,7008,6550,6,235,2069,45439,3213,2634,579,3213,171600,2011
49027,33.6,12326,10486,67,1481,3234,47062,4094,3056,1038,4094,128600,2011
49029,31.6,9285,8927,0,211,2322,76472,2757,2409,348,2757,259100,2011
49031,44.2,1657,1543,3,99,413,36667,584,503,81,584,161600,2011
49033,35.5,2234,2147,2,36,611,53924,739,631,108,739,140300,2011
49035,30.6,1016455,757561,14156,170034,238323,59168,339035,229678,109357,339035,240900,2011
49037,30,14526,6417,16,672,3119,37611,4241,3529,712,4241,116000,2011
49039,27.9,27239,23705,323,2484,6106,44799,7716,5928,1788,7716,156200,2011
49041,32.4,20667,19179,113,869,5326,44731,6989,5652,1337,6989,150100,2011
49043,36.6,35968,30866,129,4020,10185,84752,13342,10259,3083,13342,497200,2011
49045,29.4,56957,48170,451,6460,14238,63228,18019,13510,4509,18019,188400,2011
49047,29.1,31892,26483,45,2157,8318,62450,10762,8292,2470,10762,188700,2011
49049,24.4,502465,423882,2691,52929,112947,59338,138804,95927,42877,138804,234800,2011
49051,31.7,22908,19511,95,2830,6029,64651,7265,5632,1633,7265,315100,2011
49053,32.1,137020,117859,503,13029,35645,50307,46088,32320,13768,46088,235300,2011
49055,35.6,2735,2527,7,188,668,49847,814,639,175,814,166600,2011
49057,30.7,227199,178377,2937,37348,57765,54666,78814,56686,22128,78814,171900,2011
50001,41.1,36835,34753,312,678,9516,57203,14159,10592,3567,14159,228600,2011
50003,44.7,37093,35487,142,543,9909,48083,15512,11213,4299,15512,204800,2011
50005,41.9,31198,29920,150,340,8264,44433,12615,9085,3530,12615,157400,2011
50007,36.2,155666,142281,2534,2862,37239,62260,61989,40830,21159,61989,263200,2011
50009,46.1,6350,6141,33,75,1794,37679,2808,2336,472,2808,126000,2011
50011,39.3,47687,45113,239,601,13058,55181,18561,13917,4644,18561,205700,2011
50013,45.3,7056,6705,13,89,2300,59566,3194,2544,650,3194,249600,2011
50015,39.4,24234,23199,142,327,6301,53368,10097,6985,3112,10097,214600,2011
50017,43.2,29015,27954,75,324,7915,52407,11805,9647,2158,11805,182600,2011
50019,43.5,27247,26189,215,301,6965,40929,10745,8180,2565,10745,153000,2011
50021,43.9,61956,59768,263,716,16751,48190,26108,18370,7738,26108,175200,2011
50023,41.7,59426,56460,463,1028,15381,57163,24728,18008,6720,24728,203100,2011
50025,44.5,44409,41883,359,816,11759,48953,19527,13714,5813,19527,206400,2011
50027,45.3,56786,54218,275,751,15782,53129,24863,17814,7049,24863,213500,2011
51001,44.2,33701,20632,9664,2825,8766,41595,13757,10199,3558,13757,153400,2011
51003,37.9,97978,76739,9555,5104,24008,65934,37398,24731,12667,37398,350400,2011
51005,45.1,16326,15089,892,155,4770,44329,6935,5629,1306,6935,112700,2011
51007,41.4,12631,9175,2956,193,3618,51540,5001,4049,952,5001,198600,2011
51009,42,32339,24399,6108,675,8771,44383,12693,9634,3059,12693,149200,2011
51011,42.5,14820,11332,3167,54,4321,47992,5857,4417,1440,5857,140000,2011
51013,33.8,202999,129496,16808,30256,41561,99651,92436,43096,49340,92436,575600,2011
51015,42.7,73526,67792,2991,1562,20399,51719,28021,22814,5207,28021,194100,2011
51017,46.4,4747,4433,169,121,1449,52500,1926,1633,293,1926,137100,2011
51019,43.4,68275,61639,3811,1113,20234,56021,26979,22704,4275,26979,193200,2011
51021,44.9,6871,6607,236,9,1971,42864,2663,2234,429,2663,90600,2011
51023,44.3,32956,30991,1132,388,9748,65633,12789,11230,1559,12789,208800,2011
51025,40.4,17553,7028,10294,107,4126,34170,6126,4314,1812,6126,101400,2011
51027,43.4,24173,23227,503,63,6424,30606,9135,7192,1943,9135,70300,2011
51029,41.7,17021,10404,6241,120,3882,36378,5699,4175,1524,5699,119000,2011
51031,40.9,54485,44334,7890,965,14939,45992,21610,16322,5288,21610,144200,2011
51033,38.4,28234,17952,8270,999,7679,58707,10476,8664,1812,10476,212200,2011
51035,44.9,30002,28785,323,740,8755,35841,12556,9737,2819,12556,98300,2011
51036,46.4,7223,2949,3563,105,1881,47093,2747,2339,408,2747,151200,2011
51037,42.9,12601,8388,3933,99,3346,37173,4534,3513,1021,4534,107600,2011
51041,37.2,313001,206964,67171,21503,83933,72886,112895,88141,24754,112895,237600,2011
51043,44.2,14081,12385,792,505,3988,77048,5564,4269,1295,5564,356700,2011
51045,43.6,5158,5105,9,0,1468,54120,1976,1756,220,1976,144500,2011
51047,37.4,46427,33315,6916,4047,11809,66458,15750,11476,4274,15750,285000,2011
51049,41.2,9928,6240,3355,148,2884,45184,3976,3023,953,3976,150300,2011
51051,43.6,15923,15666,89,27,4191,30556,6183,4835,1348,6183,71800,2011
51053,40.7,27714,17473,9009,683,7052,50583,9598,7442,2156,9598,167500,2011
51057,44,11029,6214,4258,307,2899,44581,4420,3379,1041,4420,176900,2011
51059,37.4,1064735,589960,95279,160366,272012,108439,385570,273783,111787,385570,493100,2011
51061,40.8,65008,53247,5073,4119,17139,87958,22888,17983,4905,22888,376100,2011
51063,43.8,15156,14304,211,371,4111,40761,6148,4757,1391,6148,147900,2011
51065,41.1,25599,20218,3951,752,6844,68615,9315,8109,1206,9315,235900,2011
51067,43.8,55621,48627,4749,1405,17304,47606,23581,18695,4886,23581,163800,2011
51069,38.8,77277,66585,3130,5148,21246,66440,28655,22508,6147,28655,244700,2011
51071,42.9,17197,16509,221,190,4890,43012,7054,5494,1560,7054,98800,2011
51073,41.9,36741,31406,3262,977,10511,62067,13892,11680,2212,13892,229300,2011
51075,44.9,21481,16302,4460,442,6274,81288,7822,7257,565,7822,354700,2011
51077,46.6,15702,14796,369,398,4424,31599,6760,5412,1348,6760,96200,2011
51079,39.1,18291,15719,1331,756,4892,58550,6802,5439,1363,6802,226300,2011
51081,41.3,12194,4603,7043,410,2441,42000,3264,2360,904,3264,104300,2011
51083,44.1,36248,21746,13364,602,9514,34889,14533,11072,3461,14533,102300,2011
51085,40.8,99638,85087,9206,2137,28190,77506,36489,30595,5894,36489,280000,2011
51087,37.3,303845,175856,86540,14178,78760,61206,122919,81438,41481,122919,229500,2011
51089,43.9,54524,39027,11885,2540,15398,33695,22871,17041,5830,22871,93600,2011
51091,54.8,2354,2314,0,6,771,43045,1110,890,220,1110,181900,2011
51093,43.5,35092,24853,8605,697,10310,64925,13528,10988,2540,13528,257000,2011
51095,44.6,65818,51323,8784,2870,19199,75938,26356,20000,6356,26356,347600,2011
51097,45.3,6946,4555,2160,172,2012,48170,2891,2325,566,2891,159900,2011
51099,36.4,23321,17412,4141,846,5986,82173,8200,6133,2067,8200,289800,2011
51101,39.3,15728,11928,2944,352,4549,64982,5985,4981,1004,5985,207300,2011
51103,53.7,11424,7969,3233,111,3706,46625,5570,4298,1272,5570,254300,2011
51105,40.9,25405,23735,952,387,6836,32588,10001,7500,2501,10001,77900,2011
51107,34.6,303329,191866,22129,36563,75923,120096,99761,78987,20774,99761,472000,2011
51109,42.8,32739,25267,5853,750,9538,56502,13213,10299,2914,13213,211200,2011
51111,43.5,12928,7709,4630,435,3000,35210,4471,3267,1204,4471,104800,2011
51113,44.5,13317,11334,1386,294,3883,59734,5185,4110,1075,5185,254100,2011
51115,49.9,9000,7812,921,111,2760,54118,3788,3146,642,3788,219300,2011
51117,45.3,32778,19272,12165,810,7971,36069,12547,9346,3201,12547,124000,2011
51119,50.3,10855,8520,2126,153,3137,53615,4339,3539,800,4339,254700,2011
51121,26.1,93379,80094,3724,2491,19209,44231,34591,19042,15549,34591,196300,2011
51125,47.2,15049,12328,2111,429,4441,47426,6539,4907,1632,6539,187900,2011
51127,42.4,18086,14517,2883,198,5094,71198,6552,5953,599,6552,255100,2011
51131,46.5,12493,6802,4760,796,3218,36965,5195,3607,1588,5195,206600,2011
51133,53.1,12431,8757,3437,127,3658,51256,5569,4626,943,5569,246000,2011
51135,42.1,15845,8706,6331,570,3828,37507,5571,3771,1800,5571,130900,2011
51137,42.5,33235,26939,4313,1145,9446,56837,12614,9622,2992,12614,238500,2011
51139,42.8,24101,22914,407,382,6744,43435,9538,7183,2355,9538,177300,2011
51141,45.8,18573,16755,1153,424,4845,36057,7191,5738,1453,7191,106500,2011
51143,43.9,63194,46932,13952,1321,18577,40333,26325,20960,5365,26325,105100,2011
51145,41.7,27907,23109,3934,496,7581,76235,9468,8406,1062,9468,283300,2011
51147,31.6,23050,14324,7823,503,4764,36789,7334,4817,2517,7334,147400,2011
51149,37.1,35520,20661,11345,2123,8523,62924,10725,8141,2584,10725,206900,2011
51153,33.4,391439,191950,75300,79119,98731,95531,127170,94336,32834,127170,353300,2011
51155,43.6,34900,31922,1885,484,9919,40987,14884,10798,4086,14884,127600,2011
51157,47.3,7422,6658,334,181,2242,64113,3310,2486,824,3310,415400,2011
51159,42.8,9310,5794,2812,463,1922,46456,2909,2297,612,2909,155200,2011
51161,42.6,92023,81595,4775,1981,26169,62895,37975,29266,8709,37975,196500,2011
51163,46,22304,20913,711,316,6461,45489,9291,6833,2458,9291,179100,2011
51165,40.2,75633,69147,1268,3927,21657,51775,29711,22697,7014,29711,196700,2011
51167,42.6,28870,28100,398,27,7920,32555,11302,8666,2636,11302,89000,2011
51169,44.6,23210,22621,166,213,6641,35846,9701,7571,2130,9701,90400,2011
51171,42.6,41807,37874,846,2453,11662,50535,17152,12062,5090,17152,215100,2011
51173,43.1,32268,30731,622,492,8557,34533,12681,9055,3626,12681,87400,2011
51175,43.4,18573,11063,7025,194,4730,46733,6618,4884,1734,6618,150900,2011
51177,36.1,121508,87965,18647,9133,32753,78299,41282,32204,9078,41282,286800,2011
51179,34.3,127041,86523,21334,11508,33150,94658,40691,32086,8605,40691,334800,2011
51181,44.7,7026,3548,3294,92,1735,53505,2547,1888,659,2547,174500,2011
51183,40.2,12147,4669,7272,190,2087,40088,3600,2315,1285,3600,122400,2011
51185,43.6,44807,42506,1282,147,12817,36436,18019,13105,4914,18019,84900,2011
51187,39.8,37323,33190,1509,1323,9759,61379,14203,10554,3649,14203,244000,2011
51191,43.1,54628,52555,651,729,16565,41526,23064,17279,5785,23064,128900,2011
51193,46.1,17386,11052,5080,971,4579,52258,7077,5309,1768,7077,190000,2011
51195,39.4,41505,38345,2054,479,10817,34717,15477,10839,4638,15477,79800,2011
51197,42.9,29116,27480,1230,294,7828,40920,11610,8563,3047,11610,112400,2011
51199,39.7,65289,48614,8807,2940,19435,83747,24259,18735,5524,24259,323900,2011
51510,35.6,136968,74355,29017,21138,29439,82899,64217,28868,35349,64217,480300,2011
51515,44.1,6184,4626,1299,97,1770,34647,2776,1735,1041,2776,148000,2011
51520,41.1,17718,16016,1040,79,4938,32122,7873,4769,3104,7873,97400,2011
51530,38.3,6647,6003,494,15,1734,35426,2681,1712,969,2681,122800,2011
51540,27.6,42758,28411,8313,2104,7082,43980,17387,7179,10208,17387,283800,2011
51550,36.7,220837,134223,64824,9181,60047,70115,78898,58660,20238,78898,271700,2011
51570,42.3,17439,14103,1938,676,4479,51396,7136,4659,2477,7136,189100,2011
51580,43.8,5982,4977,647,73,1467,36242,2546,1790,756,2546,64900,2011
51590,42.9,43433,20443,20899,1208,11232,31011,18938,10426,8512,18938,88900,2011
51595,39.5,5850,1864,3652,192,1370,30481,2525,1216,1309,2525,94500,2011
51600,38.5,22277,13726,1020,3354,5573,99300,8470,5880,2590,8470,472600,2011
51610,38.8,11840,8781,570,1024,3129,120332,4807,2966,1841,4807,658500,2011
51620,40.1,8570,3450,4813,17,2266,33956,3472,1475,1997,3472,196100,2011
51630,29.3,24015,14777,5368,2371,4888,44498,9341,3619,5722,9341,333000,2011
51640,45,6959,5649,261,927,1685,24711,3525,2227,1298,3525,91700,2011
51650,35.5,138148,57556,67817,6125,32998,51083,52667,32165,20502,52667,197500,2011
51660,22.6,48230,35200,3034,7264,7990,37850,15179,5667,9512,15179,218400,2011
51670,35.8,22562,12177,8661,1367,5034,36477,8859,4441,4418,8859,140000,2011
51678,21.6,6998,5353,519,518,833,33670,1727,880,847,1727,253700,2011
51680,31,74849,47503,21585,2210,16308,37733,28513,15796,12717,28513,146100,2011
51683,31.9,36811,18029,4767,11267,8674,73091,11872,7883,3989,11872,278900,2011
51685,30.6,13759,5915,1702,4556,3156,70137,4238,2867,1371,4238,261500,2011
51690,43.3,13882,6835,6190,527,3611,32440,5958,3444,2514,5958,90500,2011
51700,32.2,181009,84245,71875,12939,45141,50942,69977,36279,33698,69977,204100,2011
51710,29.6,241943,107596,102607,15608,49550,43914,85076,39469,45607,85076,211600,2011
51720,39.9,3934,3569,269,0,944,36944,1750,959,791,1750,82800,2011
51730,39.4,32337,4985,25436,1195,6766,36289,12179,5832,6347,12179,119600,2011
51735,42.9,12097,11382,36,195,3696,86611,4525,3785,740,4525,332800,2011
51740,35.3,96066,39148,49739,2911,23605,46340,36899,22507,14392,36899,184700,2011
51750,21.9,16374,14058,1243,400,2342,29101,5644,2744,2900,5644,152200,2011
51760,32.4,203165,78955,101708,11932,40222,39201,83615,37574,46041,83615,204500,2011
51770,38.6,96264,60197,26680,4826,23326,37753,42892,24212,18680,42892,131800,2011
51775,39.9,24733,21663,1744,570,6229,48050,9944,6859,3085,9944,166200,2011
51790,42.9,23835,19710,2938,529,5840,42757,10517,6374,4143,10517,167600,2011
51800,37.8,83465,42939,34487,2382,22530,65351,30305,22769,7536,30305,254800,2011
51810,34.7,436979,283428,82062,28319,112295,65910,164041,108165,55876,164041,276500,2011
51820,38.7,21006,16815,2137,1303,5613,43605,8750,5129,3621,8750,172100,2011
51830,23.3,13741,9820,1621,874,2076,50742,4206,1830,2376,4206,331200,2011
51840,36,26117,18407,2831,3727,5614,46065,10147,5054,5093,10147,255000,2011
53001,29.5,18289,7358,49,10513,4529,41219,5666,3566,2100,5666,133400,2011
53003,43.2,21526,19923,92,647,5692,41993,8880,6335,2545,8880,170100,2011
53005,35.7,171303,128697,2304,30807,43921,59974,63240,43985,19255,63240,173500,2011
53007,39.7,71787,51210,266,18012,18240,49509,26862,17851,9011,26862,256200,2011
53009,48.7,71077,60366,663,3603,19262,46212,31056,22087,8969,31056,239800,2011
53011,36.5,421154,346236,7824,30990,109117,59051,157179,105520,51659,157179,254200,2011
53013,51.3,3988,3613,9,201,1161,44038,1790,1320,470,1790,145900,2011
53015,39.9,101901,87695,411,7686,26949,46461,39793,26782,13011,39793,193800,2011
53017,36.8,37842,26045,121,10395,10343,49707,13937,10022,3915,13937,216700,2011
53019,46.6,7530,5664,25,234,1976,35684,2825,2120,705,2825,144700,2011
53021,28.5,75102,32808,1418,38034,16850,50731,22004,14777,7227,22004,152300,2011
53023,50.3,2244,2038,0,129,669,47379,959,714,245,959,131600,2011
53025,32.3,87179,50604,753,32678,21521,44237,29922,18114,11808,29922,152300,2011
53027,41.6,72348,59172,747,6100,17792,42729,27570,19242,8328,27570,160000,2011
53029,43.2,78599,65044,1382,4337,23178,59328,33196,23855,9341,33196,312000,2011
53031,53.2,29709,26569,299,919,8638,46887,14440,10444,3996,14440,308900,2011
53033,37,1908379,1250033,113287,164646,463619,70567,790070,470685,319385,790070,402300,2011
53035,39.2,249238,197759,6759,15278,65705,61112,96683,65430,31253,96683,284300,2011
53037,32.1,40461,34885,225,3036,9474,42769,16658,9517,7141,16658,265000,2011
53039,45.2,20259,17010,19,2096,5539,38774,8228,5707,2521,8228,200600,2011
53041,41.5,75167,64932,375,6314,19854,44373,29586,20941,8645,29586,192700,2011
53043,47.3,10546,9874,68,224,3285,46765,4661,3682,979,4661,156900,2011
53045,44.1,60116,50000,651,4663,15153,48912,22914,18189,4725,22914,223800,2011
53047,42.1,40655,27901,245,6976,10543,40537,15648,10679,4969,15648,164300,2011
53049,50.2,21116,17906,108,1668,5809,40599,9390,6989,2401,9390,166800,2011
53051,47.1,12952,11665,18,381,3630,38922,5450,4269,1181,5450,192500,2011
53053,35.7,791528,560440,51489,70279,200487,58824,297839,187999,109840,297839,265200,2011
53055,52.4,15662,14204,93,821,5009,51395,8051,5575,2476,8051,494500,2011
53057,40.1,116327,90004,697,18869,31280,55555,45475,31323,14152,45475,280800,2011
53059,43.8,10979,9747,10,581,3055,52884,4435,3323,1112,4435,257600,2011
53061,36.9,704536,528945,15274,60909,182491,67777,266331,180540,85791,266331,332000,2011
53063,36.8,466497,405552,7492,20594,119299,49257,185983,120243,65740,185983,192800,2011
53065,44.6,43401,38238,198,1237,12423,44354,17652,14277,3375,17652,179300,2011
53067,38.4,248327,196654,6430,17106,66459,63129,100147,67491,32656,100147,259500,2011
53069,47.3,3994,3725,11,102,1126,41149,1648,1276,372,1648,207200,2011
53071,36.5,58154,43406,1051,11238,14113,46793,21645,13478,8167,21645,201600,2011
53073,36.3,198937,163410,1956,15217,48118,51389,79003,49677,29326,79003,290400,2011
53075,24.1,44200,36312,888,2042,8123,35409,16187,7675,8512,16187,187600,2011
53077,32.4,239836,116263,1647,105811,58670,44419,79565,50550,29015,79565,154800,2011
54001,41.2,16373,15801,79,130,4401,33158,6210,4737,1473,6210,84900,2011
54003,37.3,102801,88495,6896,3821,27078,52504,39303,29662,9641,39303,183000,2011
54005,40.8,24746,24321,208,112,7031,41359,9755,7548,2207,9755,75500,2011
54007,42.8,14541,14219,163,84,3880,31686,6087,4715,1372,6087,78600,2011
54009,44.6,24081,23286,370,167,6482,41441,9756,7704,2052,9756,85000,2011
54011,38.6,95870,87282,4503,1106,24963,35691,40397,25225,15172,40397,99500,2011
54013,45.1,7616,7433,11,0,2161,26099,3146,2425,721,3146,72900,2011
54015,41.6,9508,9353,18,14,2509,29105,3512,2816,696,3512,76400,2011
54017,42.2,8097,7986,24,66,2049,32063,2823,2328,495,2823,78100,2011
54019,42,46031,42681,2219,436,12040,32940,17801,13839,3962,17801,70700,2011
54021,38.9,8522,6541,923,453,1548,33309,2420,1838,582,2420,72300,2011
54023,43.5,11955,11649,51,114,3452,40008,4915,3862,1053,4915,109100,2011
54025,44.6,35498,33321,1103,443,10009,35180,15412,11494,3918,15412,99600,2011
54027,42.2,23750,22898,156,238,5592,29001,10331,6279,4052,10331,138600,2011
54029,44.9,30732,29222,683,334,8839,38369,13149,9999,3150,13149,87400,2011
54031,41.8,13893,13162,250,425,3055,33060,4829,3681,1148,4829,134100,2011
54033,41.6,68745,65364,1110,907,18809,40556,27696,20324,7372,27696,94700,2011
54035,41.5,29161,28534,60,176,8066,43191,11483,9135,2348,11483,104200,2011
54037,38.7,52874,45162,3275,2414,13928,65285,19415,14982,4433,19415,237100,2011
54039,42.3,192644,170903,8896,1910,50461,44265,82337,58734,23603,82337,99900,2011
54041,43.9,16400,15995,53,55,4340,34617,6587,4768,1819,6587,91600,2011
54043,41.1,21777,21489,68,23,6523,31880,8711,6842,1869,8711,69500,2011
54045,41.5,36564,35062,800,268,10361,36562,14660,10675,3985,14660,78300,2011
54047,43.9,22262,19710,2291,78,5376,21967,8292,6310,1982,8292,33300,2011
54049,41.3,56416,52891,1836,574,14888,39870,22794,17143,5651,22794,87900,2011
54051,43.8,33163,32305,159,273,9365,37313,13915,11019,2896,13915,81200,2011
54053,42.4,27152,26474,171,136,7351,36468,10715,8497,2218,10715,83200,2011
54055,42,62077,56671,3592,513,16194,33704,25611,18761,6850,25611,74400,2011
54057,41.7,27970,26561,772,209,7065,34691,11276,8264,3012,11276,114300,2011
54059,41.2,26859,25940,621,10,7358,32794,10776,8289,2487,10776,63500,2011
54061,29.1,94489,84830,3001,1699,18606,41325,35266,20169,15097,35266,154900,2011
54063,44.5,13526,13124,84,95,3839,39047,5615,4850,765,5615,97300,2011
54065,44.1,17513,16919,128,178,3874,36703,7171,4801,2370,7171,165900,2011
54067,43.5,26208,26030,9,70,7593,39636,10149,8312,1837,10149,75800,2011
54069,43.2,44452,41254,1550,425,11080,41188,18624,13169,5455,18624,95800,2011
54071,47,7725,7375,264,47,2140,32989,3305,2550,755,3305,93900,2011
54073,41.6,7653,7420,121,14,1735,39052,2630,2112,518,2630,92400,2011
54075,47,8780,8539,111,38,2568,33816,3819,3125,694,3819,98700,2011
54077,41.6,33281,31434,1070,399,9056,43434,12908,10676,2232,12908,100200,2011
54079,40.8,55305,53270,608,521,15839,53640,20999,18084,2915,20999,140800,2011
54081,40.4,78701,69123,6527,1060,20697,38596,31211,23701,7510,31211,89100,2011
54083,43.4,29316,28395,368,129,7801,35560,11276,8726,2550,11276,94500,2011
54085,44.1,10457,10287,17,75,2772,34204,4127,3255,872,4127,76100,2011
54087,42.9,15004,13888,1,117,3894,27772,5970,4574,1396,5970,75900,2011
54089,44.9,13847,12736,610,156,3346,32194,5108,4080,1028,5108,79400,2011
54091,42.4,16817,16309,208,42,4733,39142,6592,5156,1436,6592,80600,2011
54093,45.8,7119,7001,24,29,2193,36502,3215,2579,636,3215,97600,2011
54095,44.2,9270,9128,22,52,2643,36563,3752,3187,565,3752,76300,2011
54097,41.5,24096,23357,186,235,6217,37689,9139,7164,1975,9139,95500,2011
54099,41.5,42533,41758,51,203,11419,36029,16833,12982,3851,16833,84300,2011
54101,44,9202,9043,4,53,2919,25990,4020,3192,828,4020,62300,2011
54103,44.5,16581,16324,55,78,4808,37673,6957,5526,1431,6957,81500,2011
54105,43,5749,5703,0,0,1629,37482,2325,1939,386,2325,73100,2011
54107,41.9,86852,83336,864,779,23771,42257,35990,26651,9339,35990,104600,2011
54109,42.3,23818,23306,250,24,6537,36641,8965,7329,1636,8965,57600,2011
55001,48.3,20956,19116,630,743,6121,41152,9168,7489,1679,9168,135000,2011
55003,40.6,16160,13530,103,306,4282,37900,6952,4883,2069,6952,113700,2011
55005,42.6,45895,43569,424,875,13015,44806,19265,14456,4809,19265,135000,2011
55007,48.8,15105,13066,81,154,4594,44190,6852,5636,1216,6852,157900,2011
55009,36.1,246686,207695,4878,17192,63712,53353,97485,65269,32216,97485,159900,2011
55011,43.6,13671,13217,28,214,3864,46073,5754,4447,1307,5754,134100,2011
55013,48.6,15644,14287,94,193,4944,40686,7372,5909,1463,7372,155400,2011
55015,37.9,48434,44967,116,1625,13846,63395,18248,15130,3118,18248,161300,2011
55017,40.1,61969,58690,927,787,16631,50239,24239,17766,6473,24239,147900,2011
55019,37.2,34625,32896,116,1169,9098,42756,13132,10323,2809,13132,111900,2011
55021,40.9,56569,53403,656,1423,15853,57805,22888,17363,5525,22888,177000,2011
55023,44.2,16755,16088,289,153,4490,40933,6785,5172,1613,6785,116100,2011
55025,34.3,483913,398154,23394,27825,115699,61913,199767,122179,77588,199767,231400,2011
55027,40.4,88867,81505,2399,3475,23323,53589,33964,25109,8855,33964,157400,2011
55029,49.1,27893,26654,182,623,8760,48680,13550,10264,3286,13550,189400,2011
55031,40.1,43964,40768,482,555,11916,44140,19171,13111,6060,19171,133600,2011
55033,33.5,43597,41008,284,637,10428,48342,16257,11203,5054,16257,158300,2011
55035,33,98168,90518,953,1846,23235,46826,39272,25255,14017,39272,148600,2011
55037,48,4518,4304,0,15,1460,43000,1988,1709,279,1988,129600,2011
55039,40.1,101351,93417,981,4244,27391,52717,40832,29264,11568,40832,145200,2011
55041,43.9,9439,7768,67,137,2686,38176,4021,3079,942,4021,120100,2011
55043,36.3,50944,49081,492,644,12319,45022,19230,14259,4971,19230,121500,2011
55045,41.2,36653,35014,193,948,10010,53933,14527,11118,3409,14527,154000,2011
55047,44,19089,18057,89,702,5351,48937,7980,6112,1868,7980,140000,2011
55049,40.9,23646,22893,82,313,6822,55625,9695,7511,2184,9695,159200,2011
55051,50.3,6008,5852,38,23,1821,37413,2989,2369,620,2989,109100,2011
55053,41.1,20395,17951,453,516,5510,44106,8145,6163,1982,8145,124000,2011
55055,38,83308,75778,554,5386,21803,55615,31936,23072,8864,31936,183100,2011
55057,43,26741,24824,326,659,7458,45507,10934,8385,2549,10934,116500,2011
55059,36.4,165467,129930,10907,18830,42024,54846,62215,42605,19610,62215,180000,2011
55061,41.6,20613,19799,71,438,5727,54783,8203,6672,1531,8203,147200,2011
55063,35.1,113805,103797,1682,1748,27937,50510,45704,29818,15886,45704,151900,2011
55065,41,16783,16210,29,469,4516,49850,6513,5162,1351,6513,119700,2011
55067,45.5,20090,19250,116,305,5977,42045,8850,6918,1932,8850,107100,2011
55069,44.4,28914,27948,194,338,8928,47426,12881,9851,3030,12881,131000,2011
55071,42.9,81496,75433,581,2452,22343,50181,34266,26260,8006,34266,125600,2011
55073,39,133420,120622,608,2821,36583,54316,52865,39383,13482,52865,141700,2011
55075,45.4,41878,40413,129,541,11951,41574,19092,14929,4163,19092,109100,2011
55077,47.1,15426,14720,76,355,4543,45046,6654,5311,1343,6654,143000,2011
55078,33,4262,573,39,250,1075,32017,1441,971,470,1441,96000,2011
55079,33.7,942006,517115,246012,121577,218650,43397,378527,199777,178750,378527,165300,2011
55081,38.6,44427,41106,536,1609,11645,48306,17302,12279,5023,17302,131900,2011
55083,43.2,37683,36243,135,496,11428,49396,16322,13361,2961,16322,147300,2011
55085,47.6,36194,34736,208,413,11233,45184,16985,13524,3461,16985,170700,2011
55087,37,175724,157905,1689,6140,46403,57190,69070,50133,18937,69070,155300,2011
55089,42.8,86180,80547,1192,1963,24151,75634,34067,26463,7604,34067,256800,2011
55091,43.2,7491,7335,33,80,2035,48717,3069,2336,733,3069,139200,2011
55093,34.5,40703,38960,345,620,10316,61443,14960,11396,3564,14960,197400,2011
55095,42.5,44249,42572,129,636,12644,49527,18323,14739,3584,18323,167100,2011
55097,35.5,69754,64679,249,1834,17812,51887,27840,19186,8654,27840,144400,2011
55099,48.1,14276,13774,23,234,4285,41458,6789,5387,1402,6789,114000,2011
55101,38.6,195029,145719,20649,21846,50274,54356,75599,52732,22867,75599,177300,2011
55103,42.5,18144,17445,47,343,5008,44326,7510,5657,1853,7510,123600,2011
55105,38.1,160270,136042,7518,11705,43022,50532,62745,45699,17046,62745,139000,2011
55107,45.7,14791,14327,97,164,4349,38821,6639,5107,1532,6639,108100,2011
55109,36.5,83657,79242,710,1621,23413,68513,31986,25105,6881,31986,220300,2011
55111,39.7,61504,57125,342,2470,16906,51121,25504,18425,7079,25504,167200,2011
55113,46.6,16610,13110,31,256,5322,39228,7680,5697,1983,7680,167900,2011
55115,42.7,41866,37014,242,908,11814,45587,17203,13067,4136,17203,124800,2011
55117,39.7,115401,100761,1652,6154,30729,52993,46318,33551,12767,46318,154300,2011
55119,41.6,20615,20039,32,297,5999,45054,8851,6993,1858,8851,122400,2011
55121,40.7,28668,26734,105,1436,7808,47437,11513,8647,2866,11513,132100,2011
55123,41.3,29630,28743,89,368,8014,44058,11831,9338,2493,11831,133300,2011
55125,50.3,21637,18817,106,245,6777,41195,10612,8369,2243,10612,195000,2011
55127,37.7,102147,88765,1002,10204,26024,55237,39083,27669,11414,39083,198700,2011
55129,47.3,15965,15293,83,202,4985,41135,7550,6270,1280,7550,146400,2011
55131,40.4,131190,123856,1260,3247,37918,66476,51864,40491,11373,51864,231200,2011
55133,41.7,388125,352548,4759,15547,109238,75845,152181,117390,34791,152181,261100,2011
55135,43.1,52552,50351,166,1259,14328,48604,21603,16248,5355,21603,138300,2011
55137,46,24614,22466,478,1292,6934,43544,10143,8246,1897,10143,138500,2011
55139,37.7,166033,151054,2744,5583,41057,51596,66861,45573,21288,66861,140800,2011
55141,42.3,74641,70230,360,1560,21208,47182,32126,23979,8147,32126,117900,2011
56001,26.5,35515,30155,430,3087,7204,45760,14683,7886,6797,14683,194900,2011
56003,42,11553,10341,2,917,3308,52597,4612,3506,1106,4612,120400,2011
56005,31.8,44599,39875,224,3193,11969,78356,16472,12591,3881,16472,199800,2011
56007,39.4,15750,12642,118,2516,4259,58655,6217,4622,1595,6217,139200,2011
56009,39.3,13596,12421,13,800,3640,56673,5635,3985,1650,5635,180500,2011
56011,43.4,6926,6760,5,132,2008,49757,2894,2166,728,2894,156300,2011
56013,38.4,39515,28326,160,2224,10507,48788,15598,11189,4409,15598,166500,2011
56015,43.1,13064,11492,74,1203,3408,42126,5286,3655,1631,5286,132400,2011
56017,48.6,4754,4552,1,120,1336,43063,2098,1384,714,2098,136000,2011
56019,45.3,8478,7992,0,254,2459,55094,3748,2904,844,3748,215500,2011
56021,37.1,90394,73212,2217,11664,24145,54156,36566,25130,11436,36566,174100,2011
56023,37.7,17779,16678,18,686,4768,60543,6238,4992,1246,6238,205800,2011
56025,36.8,74625,66558,561,5057,19767,53519,29850,20832,9018,29850,177700,2011
56027,45.6,2466,2286,21,59,675,44875,1041,700,341,1041,105400,2011
56029,43.7,27934,25882,50,1338,7669,50105,11874,8430,3444,11874,203000,2011
56031,47.5,8681,8053,0,538,2407,46171,3647,2849,798,3647,136100,2011
56033,42.5,28743,26691,50,983,7603,51667,12268,8544,3724,12268,224900,2011
56035,38.9,9758,8399,1,583,2656,79250,3564,2614,950,3564,287100,2011
56037,32.8,43152,35141,152,6269,11780,72096,16418,12041,4377,16418,180300,2011
56039,36.5,21111,19095,30,1763,4210,73627,7246,4517,2729,7246,715300,2011
56041,33.8,20788,18460,8,1734,5226,59851,7265,5549,1716,7265,178300,2011
56043,42.9,8372,7036,49,1066,2307,50177,3464,2498,966,3464,148400,2011
56045,41.9,7144,6711,4,205,1968,55156,2944,2304,640,2944,139800,2011
72001,35.7,19514,161,0,19330,4266,12975,5498,3813,1685,5498,102800,2011
72003,37.3,42082,2393,49,39357,10641,14935,13552,10823,2729,13552,89200,2011
72005,37.4,61384,1436,8,59362,14736,14779,20111,13616,6495,20111,115000,2011
72007,35.5,28745,349,5,28380,7067,13792,8898,6148,2750,8898,90200,2011
72009,36.6,26011,69,0,25942,6446,15736,8642,6724,1918,8642,100900,2011
72011,38.1,29266,268,20,28937,7270,16291,9357,7417,1940,9357,109900,2011
72013,38.2,96984,562,10,96325,24252,17089,31881,24024,7857,31881,99400,2011
72015,34.8,19601,177,19,19318,4574,15551,6265,4668,1597,6265,86800,2011
72017,35.1,24685,92,12,24564,6376,16278,8166,6299,1867,8166,105300,2011
72019,31.6,30317,29,3,30214,7275,15117,9095,6634,2461,9095,88800,2011
72021,37.6,209900,1625,294,207244,53752,25248,72240,51958,20282,72240,143900,2011
72023,38.7,50733,385,15,50333,10906,15681,15525,11738,3787,15525,114500,2011
72025,37,143087,1096,80,141845,36360,23177,48246,34452,13794,48246,135600,2011
72027,37,35260,148,52,34921,8538,16899,10796,8250,2546,10796,89600,2011
72029,35,47458,56,40,47362,10873,21849,14256,11278,2978,14256,119300,2011
72031,37.5,177873,1604,340,175208,44568,28311,61632,44759,16873,61632,154100,2011
72033,34.7,28371,133,33,28149,7326,18193,9609,5943,3666,9609,120400,2011
72035,37.1,48184,117,36,47998,11561,20046,15904,11319,4585,15904,105500,2011
72037,37.4,14087,97,53,13937,3250,19523,4567,3555,1012,4567,98600,2011
72039,35.2,18912,59,0,18853,4517,13936,5671,4113,1558,5671,98100,2011
72041,35.4,43564,120,0,43396,10811,23354,13629,10337,3292,13629,106800,2011
72043,34.5,40433,85,12,40317,10370,16347,13075,10446,2629,13075,86600,2011
72045,34.5,20778,77,0,20701,5231,12910,6529,4411,2118,6529,87000,2011
72047,34.4,37238,341,0,36841,8450,14641,10840,7909,2931,10840,99700,2011
72049,39.9,1831,99,9,1721,352,17531,557,429,128,557,121400,2011
72051,36.1,37942,605,35,37226,9347,27701,12284,10327,1957,12284,142700,2011
72053,37.3,37387,238,66,36966,9150,20176,13042,9531,3511,13042,105000,2011
72054,34.9,12691,38,0,12653,3060,15693,3990,3107,883,3990,102100,2011
72055,36.1,19680,266,0,19414,4560,12608,6058,4167,1891,6058,80700,2011
72057,34.4,45390,117,100,45173,11022,18593,14726,10528,4198,14726,91800,2011
72059,35.5,21767,207,0,21560,5312,15049,6504,5124,1380,6504,80000,2011
72061,39,98326,1196,161,96852,24851,34661,34818,26355,8463,34818,206000,2011
72063,35.5,44868,229,50,44589,10335,27834,13107,10914,2193,13107,150100,2011
72065,36.5,41843,198,0,41431,10683,17847,13208,9850,3358,13208,101200,2011
72067,41.8,17239,203,12,16937,4680,19548,6406,4643,1763,6406,90600,2011
72069,37.6,58665,446,41,58060,13490,19404,18514,14413,4101,18514,110800,2011
72071,37.3,45668,235,12,45331,11433,13406,15163,9517,5646,15163,101700,2011
72073,33.1,16744,113,0,16631,4033,17022,4856,3253,1603,4856,96500,2011
72075,34.1,50894,114,4,50729,12266,16332,15924,12418,3506,15924,101700,2011
72077,33.9,40104,362,0,39688,9489,18579,12391,9329,3062,12391,114900,2011
72079,38.6,25856,137,0,25719,6158,14705,8364,5442,2922,8364,95900,2011
72081,37,31120,195,0,30802,7906,12529,10073,6585,3488,10073,98300,2011
72083,35.8,10012,26,0,9986,2720,15447,3389,2325,1064,3389,90700,2011
72085,34.9,38466,53,0,38350,8563,18327,11396,8665,2731,11396,116600,2011
72087,32.6,30359,15,17,30321,6698,18897,9105,7132,1973,9105,105100,2011
72089,36.8,20106,236,87,19766,4768,19333,6646,4967,1679,6646,110900,2011
72091,36.3,44331,349,0,43982,11192,16982,15591,11237,4354,15591,110400,2011
72093,35.8,6300,0,18,6282,1220,11391,1643,1142,501,1643,101000,2011
72095,37.3,12304,100,25,12179,2959,15190,4013,3159,854,4013,92200,2011
72097,36.8,89981,941,136,88505,21626,13986,32167,18989,13178,32167,91700,2011
72099,34.6,40199,394,0,39762,9089,13479,11792,9247,2545,11792,97500,2011
72101,32.8,32508,28,48,32409,7734,13871,9306,7234,2072,9306,99100,2011
72103,33.9,26576,372,11,26182,6005,16048,8449,6641,1808,8449,98000,2011
72105,34.6,30442,76,0,30331,6837,14691,8245,6173,2072,8245,87000,2011
72107,33.4,23541,142,0,23343,5380,13921,6840,5036,1804,6840,101500,2011
72109,37.3,19397,173,96,19110,4544,14506,6470,5157,1313,6470,87200,2011
72111,32.9,24553,203,47,24272,5963,14504,7418,5843,1575,7418,82000,2011
72113,36,168382,755,62,167489,40753,17273,56172,37771,18401,56172,104100,2011
72115,36.4,25951,72,0,25846,6570,13581,8447,5124,3323,8447,107600,2011
72117,40.5,15201,1065,221,13872,3915,16773,5508,4413,1095,5508,107600,2011
72119,36.1,54286,217,59,53997,13259,21329,17110,13580,3530,17110,116500,2011
72121,37.4,25392,265,0,25127,6044,15530,7867,5925,1942,7867,93700,2011
72123,34.6,31165,49,27,31014,7741,12592,10562,7615,2947,10562,86300,2011
72125,38.9,35736,478,57,35201,8406,15417,12096,8836,3260,12096,90700,2011
72127,38.6,399474,5415,1383,391342,92631,23342,149097,83755,65342,149097,168700,2011
72129,36.1,41176,172,0,40900,10064,17683,13100,9405,3695,13100,118800,2011
72131,37.8,42667,311,2,42354,9547,13148,12412,9101,3311,12412,105200,2011
72133,33,23210,32,16,23162,5751,17601,7739,5783,1956,7739,94000,2011
72135,33.8,73553,332,21,73200,18531,26526,22233,18318,3915,22233,142400,2011
72137,35.4,90147,560,125,89282,22079,22942,30639,23911,6728,30639,125400,2011
72139,36.1,75122,571,29,74449,18687,30571,25186,18319,6867,25186,161500,2011
72141,37.2,33404,516,27,32619,7911,14153,10141,6578,3563,10141,97200,2011
72143,34.8,39906,687,50,39141,8961,17072,11782,9576,2206,11782,115600,2011
72145,36.5,59995,1131,0,58864,14243,16249,17834,14915,2919,17834,113700,2011
72147,40,9318,365,19,8925,2056,16769,3199,2589,610,3199,118900,2011
72149,32.6,26290,51,10,26140,6266,15951,7664,5846,1818,7664,100600,2011
72151,35.9,38138,79,99,37947,9036,17185,11775,8931,2844,11775,95600,2011
72153,37.6,42516,476,28,41987,10175,14493,13091,9529,3562,13091,91900,2011
01001,37,54590,41982,9796,1310,14258,53773,19934,15488,4446,19934,137900,2012
01003,41.2,183226,153183,16922,7915,52117,50706,72751,53889,18862,72751,172900,2012
01005,38.2,27469,12865,12610,1365,6394,31889,9423,6285,3138,9423,88700,2012
01007,39.4,22769,17058,4944,419,5488,36824,7386,5979,1407,7386,91600,2012
01009,39.1,57466,51033,710,4646,15590,45192,21031,17057,3974,21031,115200,2012
01011,40.7,10779,2405,7609,623,2414,34500,3740,2891,849,3740,73900,2012
01013,40.3,20730,11199,8961,203,5380,30752,8149,5736,2413,8149,73500,2012
01015,38.7,117834,86764,24164,3838,30453,40093,45764,31949,13815,45764,101900,2012
01017,41.4,34228,19869,13383,555,9002,32181,13634,9439,4195,13634,78000,2012
01019,44.3,25917,23848,1234,333,8554,36241,11758,8747,3011,11758,99900,2012
01021,37.6,43611,35481,4257,3238,11964,40834,16293,12231,4062,16293,103700,2012
01023,44,13838,7664,5919,83,3475,35123,5303,4450,853,5303,59300,2012
01025,39.9,25768,13879,11310,183,6407,30954,9321,7089,2232,9321,84800,2012
01027,41.7,13828,11070,2157,401,3902,34556,5734,4318,1416,5734,80600,2012
01029,41.2,14905,13852,573,313,3991,37244,5518,4341,1177,5518,91300,2012
01031,37.8,49966,36140,8579,3070,13089,44626,19002,13452,5550,19002,126400,2012
01033,41.7,54451,43334,8706,1132,15258,40158,22290,16200,6090,22290,101500,2012
01035,43.3,13188,6756,6130,38,3294,27064,4879,3912,967,4879,74200,2012
01037,44.4,11305,7431,3558,225,2986,37425,4573,3830,743,4573,74500,2012
01039,42.5,37803,31734,4744,516,10232,35321,14899,11120,3779,14899,86700,2012
01041,40.3,13971,9932,3099,213,3738,37309,5648,4059,1589,5648,70000,2012
01043,40.1,80403,74566,743,3402,22509,39244,31287,23292,7995,31287,104700,2012
01045,36,50129,35388,9491,2794,12994,45247,19609,11883,7726,19609,96100,2012
01047,37.3,43572,12651,30027,315,10056,26178,16181,10049,6132,16181,73700,2012
01049,37.9,70949,57992,1162,9544,18746,36853,25550,19618,5932,25550,89400,2012
01051,37.7,79330,59267,15916,2091,20866,55514,28143,21773,6370,28143,143900,2012
01053,38.7,38122,23359,12265,730,9572,31075,13879,10056,3823,13879,85300,2012
01055,40.2,104317,82700,15704,3503,28246,37660,40560,29297,11263,40560,101200,2012
01057,43.1,17219,14775,1937,213,4901,33090,7129,5370,1759,7129,72600,2012
01059,38.3,31664,25283,1288,4649,8847,37235,12445,8676,3769,12445,82000,2012
01061,42.2,26769,22640,2576,899,7557,33618,10985,7822,3163,10985,79400,2012
01063,41.4,9067,1608,7421,0,2008,23777,3257,2291,966,3257,77200,2012
01065,40.4,15750,6241,9312,66,3830,29409,5965,4538,1427,5965,80300,2012
01067,42.9,17275,11676,4790,389,4873,40680,6905,5390,1515,6905,100400,2012
01069,38.3,101459,69571,25997,2950,26289,41828,38732,25439,13293,38732,122000,2012
01071,41.4,53279,47986,1770,1334,14810,37059,21197,16075,5122,21197,92000,2012
01073,37,658464,340382,276695,24770,166280,45415,259255,169039,90216,259255,142300,2012
01075,42.6,14513,12478,1728,186,4486,35271,6107,4392,1715,6107,69900,2012
01077,40.4,92528,79132,9322,2065,25106,40701,38301,27097,11204,38301,111900,2012
01079,41,34148,26187,3797,601,9822,39526,13441,10709,2732,13441,96600,2012
01081,29.6,140938,98181,31944,4668,32934,43189,55350,34890,20460,55350,149300,2012
01083,38.7,83313,65500,10623,4529,22640,48197,31186,24060,7126,31186,132500,2012
01085,40.7,11304,2837,8350,72,2808,28023,4252,3159,1093,4252,70200,2012
01087,36.6,21214,3262,17495,274,4976,27957,8094,5463,2631,8094,77500,2012
01089,37.3,334661,221765,79621,14916,85939,58242,131263,91892,39371,131263,163300,2012
01091,41.1,20909,9538,10840,364,5799,34515,8580,6112,2468,8580,89500,2012
01093,43.2,30641,28382,1153,645,9059,31970,12727,9572,3155,12727,76400,2012
01095,38.1,93070,78169,1498,11174,24284,38649,34396,24772,9624,34396,109800,2012
01097,36.6,412297,243363,143018,9864,105597,42973,156772,105189,51583,156772,125400,2012
01099,40,22993,12618,9534,224,6030,30996,8707,6571,2136,8707,76600,2012
01101,34.7,229376,88320,124716,7887,56784,44401,88749,55141,33608,88749,123500,2012
01103,38.7,119330,92689,14000,8943,32238,45852,46058,32967,13091,46058,121100,2012
01105,37,10525,3144,7223,81,2525,31008,3509,2192,1317,3509,63500,2012
01107,41.4,19646,10954,8168,320,5400,28762,8022,5726,2296,8022,82500,2012
01109,31.3,32750,18784,11905,743,7735,31702,12987,7332,5655,12987,101600,2012
01111,40.7,22843,17196,4705,636,5841,35074,8801,6450,2351,8801,89100,2012
01113,35.6,53938,27939,22579,2092,13106,33591,20904,12946,7958,20904,102000,2012
01115,38.8,83530,72840,7358,1733,23177,49652,30970,25073,5897,30970,132600,2012
01117,36.9,195237,156497,20982,11191,53172,69379,73624,58607,15017,73624,196000,2012
01119,37.1,13669,3288,10132,101,3131,22655,4966,3227,1739,4966,76800,2012
01121,39.4,82194,52980,26510,1653,22290,35209,31555,22100,9455,31555,90400,2012
01123,41.8,41534,28823,11183,1006,11492,38611,16339,11798,4541,16339,94600,2012
01125,31.4,194254,125823,58012,5860,43456,43996,67919,43469,24450,67919,152300,2012
01127,41.5,67016,60534,3611,1340,18258,37408,26025,19755,6270,26025,83600,2012
01129,39.5,17407,11362,4238,163,4933,42256,6695,5711,984,6695,85800,2012
01131,38.8,11706,3124,8546,21,2548,24212,3624,2829,795,3624,58300,2012
01133,43.1,24432,23170,152,648,6608,32830,9544,7053,2491,9544,80500,2012
02013,40.7,3114,348,405,449,239,58125,394,225,169,394,120900,2012
02016,39.1,5507,1684,316,741,579,77292,991,331,660,991,204700,2012
02020,32.9,291470,182176,15658,22473,69461,76495,105517,64718,40799,105517,277100,2012
02050,26.1,17184,1908,49,201,3194,52349,4307,2786,1521,4307,172300,2012
02060,42.7,929,488,2,49,258,79931,375,207,168,375,182000,2012
02068,41.4,1917,1634,20,43,405,74044,717,498,219,717,201900,2012
02070,28.6,4887,878,19,102,901,56857,1334,814,520,1334,173300,2012
02090,30.7,97523,71833,4267,5898,23968,69485,35740,21488,14252,35740,213500,2012
02100,42.9,2500,2021,8,32,718,50208,1139,764,375,1139,172400,2012
02105,48.3,2153,1005,5,61,607,48942,999,647,352,999,208100,2012
02110,37.8,31636,21282,212,1663,7955,78947,12323,7732,4591,12323,304100,2012
02122,40.9,55474,45967,302,1698,14326,59421,21964,16291,5673,21964,202300,2012
02130,38.4,13525,8910,54,559,3308,59736,5367,3053,2314,5367,262200,2012
02150,31.5,13710,7184,105,1044,3266,70976,4468,2489,1979,4468,233100,2012
02164,28.7,1551,416,7,19,403,49808,570,346,224,570,156300,2012
02170,34.8,89319,73850,772,3396,22477,70728,30923,23989,6934,30923,217700,2012
02180,28,9580,1548,126,123,1966,51472,2772,1505,1267,2772,135500,2012
02185,34.2,9317,2953,46,264,1368,76679,1991,893,1098,1991,151100,2012
02188,25.7,7601,857,30,66,1441,60870,1830,1010,820,1830,130100,2012
02195,42.2,3822,2699,50,158,991,61696,1671,1194,477,1671,206000,2012
02198,39,5603,2755,12,135,1442,45774,2291,1592,699,2291,156300,2012
02220,38.8,8909,5695,70,441,2392,66895,3623,2042,1581,3623,319500,2012
02230,46.7,1050,791,3,11,237,71583,395,244,151,395,306200,2012
02240,36.3,7039,5524,103,251,1715,62712,2400,1580,820,2400,178600,2012
02261,39.6,9614,6841,28,355,2637,67421,3706,2836,870,3706,175100,2012
02270,21.8,7556,233,8,34,1405,40608,1704,1171,533,1704,104300,2012
02275,50.8,2368,1739,13,21,678,47348,1160,858,302,1160,163200,2012
02282,39.1,644,247,8,14,163,71705,259,119,140,259,148400,2012
02290,35.6,5637,1223,6,70,1217,35559,2061,1469,592,2061,106500,2012
04001,32.1,71618,14323,207,4286,13121,31615,19035,14513,4522,19035,85200,2012
04003,39.9,131118,76471,4872,42595,32925,45505,49220,33743,15477,49220,151800,2012
04005,30.9,134011,73929,1642,18106,29346,48320,45718,27791,17927,45718,237200,2012
04007,47.8,53436,35059,238,9612,12888,38504,20245,15494,4751,20245,140500,2012
04009,31.8,37115,19456,706,11365,7976,44421,10944,8199,2745,10944,125500,2012
04011,33.7,8592,4116,84,4080,2488,49692,3371,1530,1841,3371,79300,2012
04012,54.1,20460,12729,179,4870,6506,35093,10497,7771,2726,10497,96300,2012
04013,34.6,3841819,2253066,182923,1136308,922294,54385,1402149,894694,507455,1402149,193900,2012
04015,47.4,201216,159755,1797,30016,52562,39383,80355,56295,24060,80355,144700,2012
04017,34.8,107415,46958,868,11549,25384,37683,34867,25229,9638,34867,122000,2012
04019,37.7,981048,541533,32608,339278,237405,46443,382814,243444,139370,382814,177500,2012
04021,35.8,368374,214423,15811,106207,88841,50164,122746,93565,29181,122746,123300,2012
04023,35.5,47057,7469,135,38905,10504,37692,13918,9189,4729,13918,145700,2012
04025,49.3,211280,173032,1047,28767,56980,43652,91168,64486,26682,91168,199200,2012
04027,33.6,196420,69613,3357,117002,54709,41156,70111,48776,21335,70111,125300,2012
05001,41.5,19029,13523,4634,512,5201,39883,7997,5443,2554,7997,76700,2012
05003,39.5,21811,14842,5610,1067,6232,38069,8774,6606,2168,8774,63600,2012
05005,50.8,41387,39608,123,712,12049,35209,18137,14018,4119,18137,119700,2012
05007,34.5,222028,169904,2463,34339,59730,53515,81380,56017,25363,81380,150700,2012
05009,41.4,37032,35197,113,720,10366,38364,14748,10759,3989,14748,105300,2012
05011,40.2,11510,6663,3180,1528,3303,32321,4920,3414,1506,4920,63900,2012
05013,42.4,5373,3932,1304,45,1386,31425,2084,1671,413,2084,57600,2012
05015,44.2,27321,22853,41,3547,7656,35558,11316,8104,3212,11316,117200,2012
05017,42.5,11759,4713,6367,557,3109,25188,4707,3185,1522,4707,55600,2012
05019,33.6,23050,16210,5438,928,5286,32393,8144,5374,2770,8144,86700,2012
05021,42.9,15981,15460,38,223,4489,32695,6848,5055,1793,6848,61200,2012
05023,46.4,25849,24721,102,536,7294,39410,10431,8012,2419,10431,118800,2012
05025,40.2,8685,7381,1043,147,2387,38060,3310,2598,712,3310,67800,2012
05027,36.1,24644,14627,9072,551,6448,34895,9498,6767,2731,9498,78200,2012
05029,40.4,21203,17446,2490,771,5574,32625,8231,6071,2160,8231,84500,2012
05031,33.1,96709,77153,12747,4270,25322,41054,37357,22247,15110,37357,116500,2012
05033,38,61670,53468,820,3768,17545,39981,23276,16903,6373,23276,101100,2012
05035,33.8,50618,22974,25748,1049,13244,36521,18560,10735,7825,18560,100200,2012
05037,39.4,17891,13271,4114,110,4765,39665,6794,4598,2196,6794,75900,2012
05039,42.9,8122,4388,3495,192,1942,30309,3128,2158,970,3128,54500,2012
05041,39.1,12922,6066,6192,581,3457,29504,5324,3011,2313,5324,59300,2012
05043,37.5,18615,12587,5271,460,5086,32087,7494,4768,2726,7494,80700,2012
05045,31.4,113730,93716,11799,4397,28690,49008,42325,27612,14713,42325,135300,2012
05047,40.8,18110,16949,116,406,4930,35918,6684,4999,1685,6684,92500,2012
05049,46.9,12301,11853,36,110,3310,35059,4865,3799,1066,4865,89700,2012
05051,44.2,96249,80620,7988,4643,25744,38680,39791,27818,11973,39791,131500,2012
05053,39.4,17852,16759,364,408,4890,49063,6697,5360,1337,6697,100200,2012
05055,37.8,42224,40224,263,940,11515,38481,16457,10536,5921,16457,95200,2012
05057,38.6,22548,12757,6796,2678,5843,31193,8575,5807,2768,8575,71800,2012
05059,39.6,33011,27733,3602,925,8435,39652,12271,8914,3357,12271,81600,2012
05061,37.1,13790,9266,2943,1338,3672,35236,5192,3387,1805,5192,72900,2012
05063,38,36572,32854,939,2089,10224,34374,14833,10546,4287,14833,85900,2012
05065,47.3,13614,12908,163,207,4087,31011,5777,4456,1321,5777,75800,2012
05067,40.9,17885,14050,2923,442,4227,31692,6456,4498,1958,6456,57600,2012
05069,37.2,76836,31895,42236,1236,18448,37561,28207,18039,10168,28207,81100,2012
05071,37.6,25554,21317,394,3121,6728,32198,9770,6678,3092,9770,85000,2012
05073,42.9,7618,4567,2834,132,1780,28633,2773,2034,739,2773,51600,2012
05075,39.8,17314,16743,114,160,4475,32205,6609,4708,1901,6609,57400,2012
05077,39.8,10430,4322,5888,186,2197,26098,3401,2065,1336,3401,52100,2012
05079,37.7,14167,9258,4173,458,3070,34107,4129,2922,1207,4129,64100,2012
05081,41.1,13068,9702,2863,130,3747,39042,5237,4203,1034,5237,78600,2012
05083,41.7,22352,20579,289,527,6093,37237,8400,6476,1924,8400,82400,2012
05085,35.5,68274,59948,4225,2261,18698,51499,24998,18472,6526,24998,119100,2012
05087,40.4,15674,14402,27,769,4150,33481,6069,4577,1492,6069,95000,2012
05089,50.2,16712,15954,39,300,4956,33497,7200,5868,1332,7200,91600,2012
05091,37.5,43449,30734,10539,1097,11301,40314,16733,11071,5662,16733,89400,2012
05093,34.6,46388,28047,15750,1700,11967,35651,17207,10129,7078,17207,75600,2012
05095,43.5,8145,4537,3406,143,2254,28075,3396,2132,1264,3396,52500,2012
05097,46.4,9453,8770,38,359,2646,33240,3797,3047,750,3797,75500,2012
05099,39.6,9003,5799,2854,238,2450,35578,3777,2753,1024,3777,64700,2012
05101,46.6,8286,7841,38,50,2500,27790,3560,2970,590,3560,74900,2012
05103,42.6,25894,14542,10381,414,7221,32032,10926,7451,3475,10926,68600,2012
05105,42.1,10413,9750,237,244,2784,42738,3998,3304,694,3998,78400,2012
05107,37.3,21646,7527,13577,299,5484,27219,8309,4642,3667,8309,59200,2012
05109,39.8,11261,9896,397,736,3151,32087,4353,3170,1183,4353,74200,2012
05111,39.6,24506,21775,1777,571,6194,31743,9329,5907,3422,9329,67200,2012
05113,43.4,20535,18434,19,1185,5656,33479,8050,6250,1800,8050,84100,2012
05115,35.3,61853,53742,1950,4149,16030,40948,22604,15650,6954,22604,107700,2012
05117,44.6,8659,7390,1119,81,2650,35806,3770,2753,1017,3770,74900,2012
05119,36,383185,212279,133365,21706,96335,46102,155516,93735,61781,155516,140600,2012
05121,41.3,17992,17239,53,290,5049,32539,7274,5557,1717,7274,68100,2012
05123,36.9,28089,11838,14552,1187,6148,30104,9177,5100,4077,9177,67800,2012
05125,38.7,107498,95467,5009,4028,29879,53817,41274,32165,9109,41274,137700,2012
05127,41.4,11170,9534,22,779,3220,38130,4247,3139,1108,4247,79100,2012
05129,47.1,8146,7741,26,127,2179,30301,3347,2507,840,3347,85200,2012
05131,36.6,125795,91715,7240,15352,31978,40247,48777,31166,17611,48777,113100,2012
05133,33.9,16978,10384,717,5212,4244,32081,5791,4098,1693,5791,70000,2012
05135,46.4,17278,16414,50,285,4578,30240,7064,5865,1199,7064,75700,2012
05137,46.9,12480,11983,9,165,3304,32834,5276,4083,1193,5276,90400,2012
05139,39.8,41594,25725,13703,1415,11509,39349,16632,11633,4999,16632,74200,2012
05141,46.5,17223,16203,154,467,4794,33900,7080,5444,1636,7080,83500,2012
05143,31.1,204057,151052,6598,31439,49372,41429,77687,44001,33686,77687,150000,2012
05145,36.1,77007,68992,3197,2863,20773,41410,29639,20549,9090,29639,98600,2012
05147,43.3,7262,5026,2086,28,2032,28061,3169,1898,1271,3169,58600,2012
05149,38.4,22033,16935,273,4154,5606,38245,7864,5357,2507,7864,84300,2012
06001,36.6,1515136,516580,181711,339441,348592,71516,539179,289758,249421,539179,514900,2012
06003,43.2,1197,835,0,78,250,59931,385,311,74,385,371300,2012
06005,48.4,37764,30248,946,4673,9620,53462,14236,10789,3447,14236,286500,2012
06007,37.3,220101,165440,2982,31256,51990,43339,85074,51234,33840,85074,237400,2012
06009,49.5,45507,37944,468,4738,13199,54686,18618,14726,3892,18618,276200,2012
06011,33.9,21329,8535,157,11740,5120,52165,6884,4390,2494,6884,210300,2012
06013,38.5,1052047,503249,93001,255128,262863,78187,373145,249560,123585,373145,433800,2012
06015,38.8,28496,18514,1069,5119,6205,39626,9703,6028,3675,9703,227700,2012
06017,43.5,180441,144479,1298,21650,49322,70117,67846,50953,16893,67846,378400,2012
06019,30.7,930517,303916,44497,467958,208532,45741,287082,155585,131497,287082,212100,2012
06021,36.5,28078,15674,211,10525,6828,42641,9540,6242,3298,9540,222300,2012
06023,37.5,134317,103889,1584,13208,31212,40830,53307,29782,23525,53307,300400,2012
06025,31.8,173487,23876,5064,139382,38219,41255,47928,27299,20629,47928,155800,2012
06027,45.7,18474,12202,152,3575,4531,45000,7910,4980,2930,7910,246200,2012
06029,30.7,839153,323572,44582,412779,189788,47727,253178,149657,103521,253178,171200,2012
06031,31.2,151982,53890,9978,77382,31787,48761,40767,21512,19255,40767,192000,2012
06033,44.8,64360,47662,1417,11068,16271,38147,26103,16530,9573,26103,200500,2012
06035,37.4,34628,23029,2852,6108,6586,51921,10127,6361,3766,10127,189400,2012
06037,34.8,9840024,2731605,809858,4694846,2163751,56241,3218511,1523331,1695180,3218511,443300,2012
06039,33.2,150615,57468,4802,80939,32472,47937,42063,25910,16153,42063,210300,2012
06041,44.6,252759,184847,6804,38605,63720,90962,103152,64588,38564,103152,810700,2012
06043,49.4,18193,15110,141,1714,5041,52584,7256,5230,2026,7256,242900,2012
06045,41.7,87577,59992,650,19426,21062,43721,34228,20398,13830,34228,353400,2012
06047,29.7,256398,81483,8857,141027,58214,43565,74496,40412,34084,74496,161600,2012
06049,46.8,9545,7518,129,1337,2397,37482,3903,2834,1069,3903,158200,2012
06051,37.1,14181,9674,69,3747,3176,61868,5056,2854,2202,5056,355600,2012
06053,32.9,416199,137358,11516,230202,90391,60143,125123,63463,61660,125123,390400,2012
06055,39.6,136644,77227,2646,43897,33596,69571,49209,30455,18754,49209,460400,2012
06057,48,98521,85313,300,8400,27282,57382,41626,30254,11372,41626,379900,2012
06059,36.2,3021840,1332316,45438,1015013,707372,75566,990266,587210,403056,990266,537600,2012
06061,40.2,350074,266065,4095,44888,93404,73356,131775,94132,37643,131775,354900,2012
06063,49.4,19926,16965,253,1604,5721,45358,9109,6426,2683,9109,251200,2012
06065,33.7,2192982,867580,129961,998113,499708,57096,676618,456981,219637,676618,248100,2012
06067,34.9,1422348,688966,138550,305985,333986,55846,512496,295190,217306,512496,249800,2012
06069,34.1,55467,21094,445,31300,13253,63939,16840,10828,6012,16840,361700,2012
06071,31.7,2041029,677104,169394,1005858,458450,54750,599698,377759,221939,599698,241500,2012
06073,34.7,3100500,1502635,148249,992087,708151,63373,1067462,582037,485425,1067462,419400,2012
06075,38.5,807755,337443,46293,121628,153345,73802,340839,125860,214979,340839,750900,2012
06077,32.6,687036,246851,46941,266808,158772,53895,213632,126268,87364,213632,225400,2012
06079,39.3,270121,191834,5475,56068,64374,59628,101708,60728,40980,101708,449300,2012
06081,39.3,721183,306464,18910,181328,173782,87751,257369,153656,103713,257369,734100,2012
06083,33.6,423594,203859,7171,180631,91950,62723,141247,75214,66033,141247,482400,2012
06085,36.2,1788393,629179,42681,478065,430878,90747,604455,351460,252995,604455,656600,2012
06087,36.9,262340,156894,2573,83709,58638,66571,93310,54897,38413,93310,576500,2012
06089,41.9,177693,146440,1563,14994,45823,44396,68880,44792,24088,68880,233400,2012
06091,51.6,3163,2806,36,281,803,42500,1338,1018,320,1338,265600,2012
06093,47,44673,35501,541,4652,12152,37948,19585,12602,6983,19585,215200,2012
06095,37,414209,168848,57592,99502,100439,69006,140295,88674,51621,140295,290500,2012
06097,39.8,483456,320460,7063,119747,116615,63565,184502,113096,71406,184502,430900,2012
06099,32.8,515115,240545,13250,216009,123582,49866,165999,98027,67972,165999,192200,2012
06101,34.5,94615,47771,1536,27119,23173,50510,31635,19148,12487,31635,204200,2012
06103,39.6,63200,45453,360,13885,15901,40307,23552,15385,8167,23552,189500,2012
06105,49.2,13693,11418,119,956,3455,36569,5811,4251,1560,5811,258800,2012
06107,29.7,441877,144029,5559,267639,102374,43803,129996,76129,53867,129996,172100,2012
06109,48,55205,44945,1105,5935,14612,48169,22105,15389,6716,22105,282500,2012
06111,36.4,822794,400432,12937,331225,196098,76483,265951,173802,92149,265951,465600,2012
06113,30.5,200873,100254,4748,60939,43483,57260,70090,37562,32528,70090,329000,2012
06115,31.9,72244,42230,1975,18193,17723,46641,24133,14450,9683,24133,180700,2012
08001,32.4,442996,235991,12970,167556,107200,56633,151034,100108,50926,151034,188100,2012
08003,32.2,15750,7767,110,7185,3732,38045,5853,3702,2151,5853,133200,2012
08005,35.7,574357,364766,55629,105174,146752,60400,223747,143158,80589,223747,230900,2012
08007,47.5,12109,9493,9,2157,3258,54007,4536,3532,1004,4536,291300,2012
08009,47.8,3783,3311,16,347,1070,39497,1675,1236,439,1675,72300,2012
08011,40.6,6192,3445,525,1908,1229,36297,1932,1215,717,1932,70600,2012
08013,35.6,297218,235676,2230,39475,70680,67403,120061,75992,44069,120061,354300,2012
08014,36.5,55913,44218,413,6380,14155,80483,21375,15002,6373,21375,274900,2012
08015,47.3,17879,15439,500,1722,4955,45713,7680,5834,1846,7680,256300,2012
08017,41,2095,1761,5,308,542,50357,858,656,202,858,81700,2012
08019,45.8,9059,8327,27,453,2235,60517,4013,3199,814,4013,278700,2012
08021,38.2,8241,3490,6,4584,2175,32860,3137,2413,724,3137,106300,2012
08023,47.4,3556,1105,12,2333,869,25309,1418,1109,309,1418,90400,2012
08025,39.4,5747,3436,441,1673,839,38507,1207,940,267,1207,80400,2012
08027,52.7,4208,3976,34,152,1230,42534,2053,1723,330,2053,224000,2012
08029,46.1,30710,25460,306,4310,8623,42786,12661,9363,3298,12661,198600,2012
08031,33.7,604356,315700,59347,192012,125598,49091,261836,132001,129835,261836,246300,2012
08033,46.5,1806,1693,0,68,524,43098,807,644,163,807,123000,2012
08035,36.7,286883,244370,3010,21771,79077,101108,102189,82767,19422,102189,335300,2012
08037,34.2,51850,34932,156,15484,11452,71030,18407,11799,6608,18407,491500,2012
08039,43,23058,20841,73,1280,6545,80811,8195,7398,797,8195,334400,2012
08041,34.1,622816,448325,35389,93837,158747,57531,234058,151047,83011,234058,217500,2012
08043,43,47006,36270,2736,5839,11139,40893,17200,12369,4831,17200,161100,2012
08045,34.7,56330,38992,267,15743,14137,60215,20272,13494,6778,20272,323100,2012
08047,44.5,5358,4845,44,319,1412,62286,2458,1857,601,2458,295800,2012
08049,41.1,14608,13110,87,1095,3434,64416,5341,4062,1279,5341,282200,2012
08051,34.3,15385,13680,95,1280,3349,50091,6447,3932,2515,6447,327400,2012
08053,56.5,790,764,0,19,245,54844,372,295,77,372,252700,2012
08055,51.5,6730,3573,129,2391,1771,32754,3134,2330,804,3134,159100,2012
08057,46.5,1397,1257,4,126,420,45298,619,461,158,619,121800,2012
08059,40.2,536095,427845,5201,77024,143882,68748,219005,154844,64161,219005,260800,2012
08061,40.1,1393,1304,2,65,367,41739,528,381,147,528,76100,2012
08063,39,8210,6307,259,1534,1974,42832,3051,2086,965,3051,118400,2012
08065,34.2,7372,4432,75,2519,1732,45082,2879,2023,856,2879,163800,2012
08067,37.7,51443,41297,186,6119,13064,57407,21060,14490,6570,21060,336800,2012
08069,35.4,300870,253754,2285,31771,76714,57927,120592,79839,40753,120592,245200,2012
08071,44.2,15385,8228,158,6459,4064,41623,6161,4358,1803,6161,143200,2012
08073,39.4,5443,4048,499,680,1178,43807,1874,1298,576,1874,105700,2012
08075,37.5,22541,18256,315,3542,5393,41369,8020,5716,2304,8020,121200,2012
08077,37.9,146562,121714,822,19484,38909,51029,58635,41993,16642,58635,216600,2012
08079,60.3,702,671,9,15,220,52750,363,305,58,363,273600,2012
08081,36.4,13547,11169,47,1918,3551,51008,5243,3922,1321,5243,184800,2012
08083,42.8,25424,19081,13,2865,7404,44102,10883,7634,3249,10883,187900,2012
08085,42.6,40994,31799,186,8037,11646,47139,16732,12406,4326,16732,200900,2012
08087,36,28200,17399,701,9557,7314,42829,10489,6724,3765,10489,138900,2012
08089,40.6,18791,10592,72,7596,4833,31860,7639,4818,2821,7639,90900,2012
08091,52.4,4445,4284,0,91,1347,66474,1886,1453,433,1886,400300,2012
08093,47,16168,14818,5,777,4583,62594,6997,6233,764,6997,249600,2012
08095,40.8,4380,3204,1,1103,1110,45339,1643,1182,461,1643,126900,2012
08097,43,17000,14919,85,1532,3752,68621,7347,4801,2546,7347,618900,2012
08099,36.7,12539,7824,27,4432,3306,33671,4995,3307,1688,4995,83900,2012
08101,38.8,159072,85971,2736,65892,40083,41820,62090,41404,20686,62090,140500,2012
08103,36.8,6728,5780,48,691,1643,58393,2540,1772,768,2540,212000,2012
08105,41.8,11925,6523,69,5098,2914,38329,4344,2967,1377,4344,136500,2012
08107,39.4,23385,21278,89,1535,6459,65041,9833,6928,2905,9833,407700,2012
08109,43.8,6189,3413,20,2556,1595,32429,2726,1848,878,2726,131300,2012
08111,37.9,747,608,0,108,167,37330,378,205,173,378,244400,2012
08113,38.2,7432,6559,1,664,1796,63766,3360,2154,1206,3360,489800,2012
08115,47.9,2389,1891,6,446,629,38401,981,715,266,981,83200,2012
08117,36.3,27753,22955,164,3836,6168,64680,11358,7766,3592,11358,460500,2012
08119,47.4,23163,20962,191,1248,6512,57970,9034,7560,1474,9034,230400,2012
08121,44.2,4796,4262,20,431,1420,43925,2073,1484,589,2073,112900,2012
08123,33.2,253552,171475,1969,71792,64319,56589,89553,63105,26448,89553,192100,2012
08125,36.3,10032,7823,15,2080,2556,45033,3886,2592,1294,3886,123200,2012
09001,39.5,918892,608561,94363,155557,230396,82614,332968,232128,100840,332968,447500,2012
09003,39.9,893504,589792,109539,137155,227776,64752,349158,230060,119098,349158,246400,2012
09005,44.4,189277,172669,2050,8575,51659,71345,76149,59687,16462,76149,272000,2012
09007,43,165639,142473,7161,7968,44659,76659,66728,50726,16002,66728,299600,2012
09009,39.1,860995,580912,101036,129612,214719,62234,329956,211821,118135,329956,263900,2012
09011,40.3,273723,214365,13635,23331,70749,68310,106817,72837,33980,106817,260600,2012
09013,38.3,152137,133125,4103,6655,37831,80887,54499,41273,13226,54499,261300,2012
09015,39.4,118046,100538,2007,11332,29811,58489,43909,31028,12881,43909,219300,2012
10001,36.6,162785,106146,38080,9521,40439,55786,57816,42124,15692,57816,205100,2012
10003,37,539665,332713,125637,46774,134499,64670,200618,140751,59867,200618,251200,2012
10005,45.4,197681,149227,24725,16935,50860,52692,75642,59913,15729,75642,241800,2012
11001,33.9,605759,209183,305141,56259,109643,64267,261192,110853,150339,261192,443000,2012
12001,30.1,247973,157819,49063,20924,51852,42818,96544,53405,43139,96544,176300,2012
12003,35.9,27010,22231,3761,572,6326,47149,8424,6527,1897,8424,126200,2012
12005,39.3,168957,133734,17289,8171,43729,47364,68862,43926,24936,68862,163000,2012
12007,38.7,28404,20966,5801,1030,6448,39082,9065,6950,2115,9065,117500,2012
12009,45.5,544019,421138,52630,44432,142392,49099,220414,164214,56200,220414,157200,2012
12011,39.7,1761993,766779,454977,444904,417267,51603,665913,447228,218685,665913,199900,2012
12013,40.1,14639,11373,2119,755,3422,32480,4852,3805,1047,4852,74400,2012
12015,55.9,160380,137481,8589,9496,47108,44596,71287,56683,14604,71287,154300,2012
12017,54.2,140805,126083,3976,6595,38239,39034,59491,49625,9866,59491,126000,2012
12019,38.2,190891,146964,18621,14867,51191,59649,67570,52175,15395,67570,167900,2012
12021,47.1,323548,212451,20461,83512,81533,56104,120938,91077,29861,120938,280700,2012
12023,40,67546,50313,11778,3325,15444,37534,23789,16646,7143,23789,120900,2012
12027,38.5,34628,19422,4373,10360,7444,35683,10508,7740,2768,10508,98400,2012
12029,44.9,16301,14059,1504,342,3873,35476,6014,4609,1405,6014,88900,2012
12031,35.7,866431,489991,250078,65943,207319,48906,330302,205598,124704,330302,161200,2012
12033,37.5,298864,197920,65923,14243,71201,43806,112012,73261,38751,112012,137300,2012
12035,47.7,95987,73190,10359,8436,25583,48134,35823,28749,7074,35823,180300,2012
12037,42.3,11545,9170,1625,524,3027,37428,4479,2984,1495,4479,159800,2012
12039,38.9,46823,15607,25873,4552,10824,35593,16608,11661,4947,16608,112000,2012
12041,39.7,16880,14849,900,810,4228,36521,5963,4831,1132,5963,107300,2012
12043,43.4,12952,7976,1479,2702,2412,35219,3745,2924,821,3745,84400,2012
12045,43.8,15796,11759,2917,685,3708,39535,5368,3907,1461,5368,126300,2012
12047,38.4,14728,8067,5021,1293,3024,36875,4473,3242,1231,4473,72300,2012
12049,33.1,27347,13174,1931,11663,5750,36115,7494,5449,2045,7494,89500,2012
12051,32.6,38669,13517,5035,18946,7903,35736,10920,7586,3334,10920,89100,2012
12053,47.8,172784,141604,8617,17986,48098,41098,70617,57110,13507,70617,128400,2012
12055,51.4,98734,69671,8673,17175,25846,35350,39857,31270,8587,39857,104800,2012
12057,36.1,1238365,665123,194233,307899,296781,49450,466765,284581,182184,466765,170000,2012
12059,42.1,19971,17672,1058,483,4806,34928,6747,5318,1429,6747,87300,2012
12061,48.9,138203,106966,12022,15501,37209,45274,58328,44402,13926,58328,165500,2012
12063,40.4,49589,32802,12861,2177,10742,38917,16355,12731,3624,16355,90600,2012
12065,43.6,14564,8400,5316,544,3730,41163,5444,4202,1242,5444,113800,2012
12067,33.8,8668,6396,1320,906,1893,44180,2722,2179,543,2722,154000,2012
12069,45.7,297995,220445,28033,36397,81488,45663,117255,89760,27495,117255,155500,2012
12071,45.5,624155,441937,48799,114755,159623,48453,242091,174748,67343,242091,161400,2012
12073,29.6,276506,163519,82814,15695,60796,45915,109560,59917,49643,109560,189100,2012
12075,45.2,40541,32725,3781,3016,10474,35093,15804,12666,3138,15804,101200,2012
12077,38.2,8300,5861,1298,687,1503,39225,2355,1835,520,2355,80300,2012
12079,40.2,19187,10506,7303,911,4829,34361,6877,5178,1699,6877,85600,2012
12081,45.6,324834,238514,27419,47943,83947,47910,131172,94100,37072,131172,175100,2012
12083,47.4,331987,245439,39874,36335,90909,39770,134733,103705,31028,134733,130900,2012
12085,49.8,146497,117581,7549,17756,37443,50573,59562,45970,13592,59562,214300,2012
12086,38.2,2512219,395156,433889,1622824,567946,43464,826179,468997,357182,826179,221900,2012
12087,46.4,73475,52212,4491,15176,16960,53418,28758,18045,10713,28758,417400,2012
12089,43.1,73303,64073,4823,2432,20149,57163,27463,21749,5714,27463,195300,2012
12091,37.7,183400,140773,15691,12958,48780,54118,72300,47934,24366,72300,188200,2012
12093,39,39779,25979,3360,9548,9341,34289,13369,9890,3479,13369,110800,2012
12095,33.7,1153795,527132,227103,312106,266077,48429,411125,239892,171233,411125,185800,2012
12097,35.4,272355,109155,25639,124711,69101,44887,92219,58940,33279,92219,146200,2012
12099,43.5,1324085,795020,222819,252510,324073,52806,523891,376594,147297,523891,216200,2012
12101,43.8,465276,371569,19335,54841,121844,43787,182707,141642,41065,182707,131200,2012
12103,46.3,917389,705264,92286,73378,225693,46051,401441,273495,127946,401441,161600,2012
12105,39.8,604562,389777,86356,107145,154647,43606,222081,157436,64645,222081,120200,2012
12107,43.2,74224,53783,11972,6729,19294,34429,28764,22030,6734,28764,97300,2012
12109,42.2,191495,163290,10016,10136,51237,64346,74021,56768,17253,74021,256000,2012
12111,42.5,278246,170356,51043,46152,71732,43923,104470,77931,26539,104470,135500,2012
12113,39.2,153086,129478,7824,6797,41810,57491,56475,42458,14017,56475,166300,2012
12115,52.6,380479,322198,16707,30241,102829,48900,169520,127592,41928,169520,191600,2012
12117,38.3,423389,280375,44241,73066,100205,58577,148635,105473,43162,148635,204000,2012
12119,63,94240,77983,8945,5687,29132,46981,41814,37800,4014,41814,187600,2012
12121,42.2,42287,32415,4761,3678,10946,36159,15880,11629,4251,15880,105400,2012
12123,41.2,22561,16462,4710,794,5341,34634,7748,6332,1416,7748,88800,2012
12125,39.8,15400,10958,3187,758,2762,43750,3782,2455,1327,3782,107900,2012
12127,45.3,495581,372109,50229,55845,122376,43419,195579,144492,51087,195579,158900,2012
12129,39.5,30449,24378,4206,1000,7574,53385,10582,8439,2143,10582,145100,2012
12131,43,55349,46855,3018,2910,14650,44254,22519,16286,6233,22519,164200,2012
12133,40.8,24732,19324,3550,757,5542,38536,8589,6627,1962,8589,88500,2012
13001,38.8,18279,12782,3563,1669,4681,35875,7047,4863,2184,7047,83700,2012
13003,34.2,8355,4734,1411,2023,1908,28682,2719,1848,871,2719,73100,2012
13005,35.7,11124,8419,1810,792,2707,33557,4001,2734,1267,4001,71600,2012
13007,41.9,3483,1485,1981,12,889,24219,1464,953,511,1464,74200,2012
13009,34.2,46378,25135,19284,933,9973,35278,16433,9626,6807,16433,106200,2012
13011,38.2,18250,16348,507,1053,4911,40162,6783,5372,1411,6783,137800,2012
13013,33.6,69136,51593,8117,6120,17727,51202,23618,18364,5254,23618,131900,2012
13015,36.7,99872,79645,9921,7599,26160,49543,34598,23789,10809,34598,137600,2012
13017,38,17612,10102,6238,1034,4163,29162,6383,3944,2439,6383,75100,2012
13019,37.9,19131,15800,2126,894,5020,31506,7175,5121,2054,7175,77000,2012
13021,35.5,155560,65642,79626,4469,36777,37920,57108,31708,25400,57108,123300,2012
13023,38.7,13009,8924,3658,60,2814,37853,4125,3007,1118,4125,84500,2012
13025,37.9,18279,17035,743,361,4969,37374,6551,5505,1046,6551,65600,2012
13027,40.6,16066,9359,5669,836,4316,35284,6445,4365,2080,6445,100600,2012
13029,36.1,30616,23589,4193,1462,8471,63818,10952,7914,3038,10952,189100,2012
13031,25.8,70360,45910,19262,2448,14756,34403,25194,13222,11972,25194,137700,2012
13033,35.5,23242,10831,11493,621,5161,31597,7743,5552,2191,7743,78100,2012
13035,38.2,23671,16107,6749,620,5683,50722,7796,5932,1864,7796,132300,2012
13037,38.8,6581,2193,3924,348,1067,30042,1797,1320,477,1797,57900,2012
13039,31.6,50435,35958,9642,2622,13478,54155,18152,11979,6173,18152,162200,2012
13043,37.6,11007,6908,2665,1230,2677,35833,3784,2487,1297,3784,79400,2012
13045,33.6,110750,80843,20020,6832,28268,46704,39404,26750,12654,39404,126000,2012
13047,38.7,64226,59264,1534,1515,17305,46143,23808,18035,5773,23808,130300,2012
13049,38,12954,8281,3121,1484,2577,39511,3755,2930,825,3755,76500,2012
13051,34,266344,134167,106489,14426,62323,45653,101727,59052,42675,101727,175900,2012
13053,23.8,11917,7306,2324,1556,2051,48684,2559,763,1796,2559,84400,2012
13055,39.5,25905,21477,2875,1073,6597,32825,9344,6589,2755,9344,74800,2012
13057,36.4,215014,174655,11712,20670,58211,67928,75937,60644,15293,75937,194400,2012
13059,25.9,117762,67434,30677,12213,20795,33846,40919,18511,22408,40919,161100,2012
13061,42.7,3174,1101,1999,6,735,22582,1285,873,412,1285,74600,2012
13063,31.7,262066,38282,168882,34960,56269,42569,85972,49139,36833,85972,111200,2012
13065,37.1,6800,4557,1910,227,1729,33967,2592,1774,818,2592,70700,2012
13067,35.4,691820,389770,169946,84703,176572,65180,259715,175469,84246,259715,203000,2012
13069,34.8,42566,25576,11621,4379,10516,35583,14764,10085,4679,14764,79000,2012
13071,34.9,45531,26591,10379,7769,11423,33186,15766,10316,5450,15766,84500,2012
13073,36.9,124665,91724,18819,6293,34261,67295,43785,34555,9230,43785,171400,2012
13075,36.5,17073,11052,4762,1014,4637,35983,6430,4543,1887,6430,91200,2012
13077,36.7,127212,92386,22246,8443,34044,60675,46316,34117,12199,46316,175000,2012
13079,40.8,12701,9266,2985,91,3569,39403,4692,3790,902,4692,89700,2012
13081,37.7,23460,12123,10224,750,6059,32320,8874,5287,3587,8874,98500,2012
13083,39.2,16598,15731,211,302,4873,41677,6463,5067,1396,6463,118700,2012
13085,40.5,22246,20718,42,869,6352,53289,8310,6346,1964,8310,191200,2012
13087,37,27815,14437,11539,1428,6905,30061,10498,6522,3976,10498,105900,2012
13089,34.3,694671,205863,373339,66469,156413,51252,264276,152514,111762,264276,178000,2012
13091,39.5,21509,14083,6452,733,5465,36042,8198,5727,2471,8198,67900,2012
13093,40.7,14528,6289,7279,879,3256,30789,4994,3431,1563,4994,66600,2012
13095,33.4,94591,27323,63207,2187,22860,31789,35918,17399,18519,35918,101900,2012
13097,35,132124,65022,51089,10990,34323,54526,45905,32464,13441,45905,146900,2012
13099,39,10928,5182,5545,73,2780,29772,4099,2708,1391,4099,81600,2012
13101,32.4,4024,2814,85,1100,1058,27933,1333,931,402,1333,92000,2012
13103,35.4,52203,42247,7086,1515,13980,62953,17979,13556,4423,17979,156900,2012
13105,41.2,20103,12893,6040,999,5522,35053,7726,5409,2317,7726,85100,2012
13107,36.9,22600,13683,7600,981,5700,31675,8106,5304,2802,8106,72700,2012
13109,35.9,10935,6224,3158,1363,2662,36602,4122,2607,1515,4122,89600,2012
13111,48.4,23554,22596,65,435,7100,35446,10040,8026,2014,10040,163900,2012
13113,42.3,106525,72369,20754,6668,30028,81242,37780,31692,6088,37780,239500,2012
13115,37.7,96204,70593,13727,8999,23897,41442,34950,22850,12100,34950,115000,2012
13117,37,177103,141915,4593,16583,45506,87585,56694,48849,7845,56694,265900,2012
13119,40,22070,18871,1922,850,5960,32179,8731,6196,2535,8731,129700,2012
13121,34.2,929535,381418,406752,72356,204595,57664,366140,200083,166057,366140,246200,2012
13123,42.9,28232,24947,106,2763,7874,37257,11270,8177,3093,11270,148500,2012
13125,39.4,3082,2746,243,14,863,32346,1182,822,360,1182,70200,2012
13127,40,79628,51676,20277,5032,21342,49986,31137,19865,11272,31137,171300,2012
13129,36,55192,43995,2170,7789,13431,40661,19194,13005,6189,19194,118500,2012
13131,38.2,25068,14879,7253,2554,6701,32206,9568,5996,3572,9568,104900,2012
13133,46.4,15988,8810,6018,906,4714,40728,6509,4926,1583,6509,136700,2012
13135,33.8,810624,357549,184809,162252,201225,61944,264592,183930,80662,264592,180700,2012
13137,38.6,43038,34544,1726,5356,10926,41894,14890,11345,3545,14890,143200,2012
13139,34.5,180831,114963,12971,47315,45843,52174,60994,41850,19144,60994,169400,2012
13141,42.1,9422,2225,7038,112,1600,22716,2860,2146,714,2860,71400,2012
13143,39.2,28627,26156,1380,339,7736,39227,10711,7661,3050,10711,109400,2012
13145,42.3,31870,24612,5529,886,8968,68816,11308,9777,1531,11308,214200,2012
13147,42.8,25277,19233,4994,799,6695,35647,9949,7639,2310,9949,115000,2012
13149,39.4,11756,10069,1372,106,2944,39947,4342,3267,1075,4342,88900,2012
13151,35.5,203185,107064,72900,11797,52584,62377,68726,52228,16498,68726,158900,2012
13153,34.4,140699,85051,39909,8553,36111,56265,51728,34977,16751,51728,135800,2012
13155,37.2,9646,6716,2794,99,2375,38770,3185,2364,821,3185,77600,2012
13157,36.8,60268,50330,4272,3761,16541,53393,21250,16315,4935,21250,162900,2012
13159,37.7,13786,9965,2930,525,3749,43768,5101,3928,1173,5101,123000,2012
13161,35.7,14972,11009,2279,1539,4163,35203,5709,3975,1734,5709,78700,2012
13163,38.1,16817,6970,9638,101,4207,27612,6180,4173,2007,6180,69700,2012
13165,38.6,8477,4636,3028,602,2171,27039,3154,2319,835,3154,66400,2012
13167,40.2,9981,6183,3519,51,2326,34521,3340,2555,785,3340,67000,2012
13169,39.1,28638,20699,7187,333,8019,53085,10531,8396,2135,10531,137000,2012
13171,38.2,18151,11818,5655,360,4477,39224,6458,4491,1967,6458,119800,2012
13173,32.7,10066,6861,2392,468,2713,41867,3627,2329,1298,3627,127700,2012
13175,38,48264,28885,17292,1101,12250,35912,17533,11656,5877,17533,88100,2012
13177,35.9,28449,21463,5382,589,7270,58400,9625,7237,2388,9625,150700,2012
13179,27.6,64663,27845,26334,6612,17228,44295,22991,11795,11196,22991,126800,2012
13181,45.2,7962,5174,2595,18,2326,34347,3412,2761,651,3412,103700,2012
13183,30.2,14488,8587,3656,1722,3503,40044,4855,2973,1882,4855,102700,2012
13185,29.8,109730,61240,39166,5311,25153,38348,39369,22024,17345,39369,134000,2012
13187,36.1,30040,27546,426,1367,7197,44595,10782,7560,3222,10782,169100,2012
13189,38.5,21762,12216,8808,486,6054,38855,8217,5458,2759,8217,105000,2012
13191,43.5,14119,8551,4978,189,3460,39506,5086,4132,954,5086,116500,2012
13193,38.9,14552,4747,8839,535,3342,30906,4775,3162,1613,4775,72400,2012
13195,38.8,27988,24015,2232,1119,6993,41404,9391,7088,2303,9391,127600,2012
13197,41.2,8615,5004,2854,567,1874,33875,3025,2164,861,3025,75300,2012
13199,41.6,21966,12536,8815,357,5649,37660,8081,5806,2275,8081,93900,2012
13201,41.2,6094,4183,1822,33,1691,32432,2494,1776,718,2494,83600,2012
13205,37.2,23510,10895,11305,1023,5558,32838,8150,5265,2885,8150,79300,2012
13207,40.7,26376,18946,6292,560,6943,47323,9577,7474,2103,9577,150700,2012
13209,36.8,9054,6084,2416,501,2261,33569,3271,2305,966,3271,76100,2012
13211,41.3,17919,12791,4440,486,4994,44908,6538,4890,1648,6538,175700,2012
13213,36.5,39635,33494,259,5269,10740,36928,14302,10063,4239,14302,98400,2012
13215,33.4,191278,83577,85175,12423,46524,41443,72182,39225,32957,72182,132900,2012
13217,34.6,100047,52297,39473,4598,25204,51336,33646,24871,8775,33646,137100,2012
13219,39.1,32814,28271,1600,1440,9077,77571,11239,8971,2268,11239,241400,2012
13221,41.4,14745,11320,2443,547,3677,42428,4981,4027,954,4981,131300,2012
13223,34,141846,106510,24061,7246,38476,63190,47858,39227,8631,47858,142700,2012
13225,33.9,27531,12321,12611,1879,6740,41488,9394,6273,3121,9394,120000,2012
13227,41.7,29445,27794,368,832,8464,50829,11314,8820,2494,11314,168400,2012
13229,38.6,18631,15768,1687,872,5137,39326,7068,5321,1747,7068,82400,2012
13231,38.3,17765,15356,1899,199,5008,56658,6129,5147,982,6129,156400,2012
13233,36.9,41350,30307,5267,4941,10546,38861,14633,10312,4321,14633,104400,2012
13235,43.3,11801,7438,3700,587,2948,34659,4297,2907,1390,4297,81300,2012
13237,44.8,21184,13965,5697,1319,6602,40115,8715,6687,2028,8715,161000,2012
13239,40.4,2542,1176,1344,0,736,32750,979,701,278,979,66800,2012
13241,45.4,16297,14502,181,1275,4231,32995,6858,5031,1827,6858,174600,2012
13243,39.2,7596,2820,4424,36,1834,32688,2833,2075,758,2833,66200,2012
13245,33.1,200337,75900,107168,8322,45884,38952,73274,41128,32146,73274,102500,2012
13247,37.2,85008,35114,38459,8121,21410,54704,29140,20613,8527,29140,156200,2012
13249,37.7,4963,3084,1420,311,1171,40612,1752,1182,570,1752,96700,2012
13251,39.7,14574,7875,6416,100,3237,34634,4861,3617,1244,4861,77200,2012
13253,43.7,8815,5549,2944,228,2344,28909,3258,2536,722,3258,71500,2012
13255,37.1,63979,38923,21018,2480,16211,40655,23073,14420,8653,23073,119200,2012
13257,40.5,26003,21809,3013,645,6439,37535,9346,6966,2380,9346,104600,2012
13259,41.6,5991,1664,3722,576,1189,28222,1941,1250,691,1941,45900,2012
13261,34.2,32425,13209,16640,1709,7448,33528,11550,6868,4682,11550,88500,2012
13263,45.3,6772,2602,4069,24,1840,26750,2680,2075,605,2680,74500,2012
13265,43.4,1674,692,930,29,411,24390,670,481,189,670,72600,2012
13267,36.2,25023,14896,7127,2554,5512,36520,8028,5699,2329,8028,84200,2012
13269,40.3,8700,5027,3474,165,2532,28402,3527,2360,1167,3527,64200,2012
13271,39.2,16312,8318,5846,2049,3894,24469,5787,3618,2169,5787,62200,2012
13273,40.4,9365,3366,5698,165,2359,32855,3371,2092,1279,3371,76900,2012
13275,39.1,44715,26016,16582,1327,11133,31471,17462,9686,7776,17462,122900,2012
13277,34.4,40430,23296,11978,4117,9377,37033,13759,8770,4989,13759,115300,2012
13279,35.7,27270,16707,6762,3076,7113,31757,10359,6311,4048,10359,89900,2012
13281,51.3,10491,10094,128,208,2938,35843,4483,3813,670,4483,166500,2012
13283,37.8,6851,4574,1958,36,1495,35960,2349,1591,758,2349,61600,2012
13285,36.1,67146,40432,22555,2195,17457,40246,24554,15175,9379,24554,124500,2012
13287,39.5,8834,4819,3632,310,1990,27056,3081,1939,1142,3081,81500,2012
13289,43.9,8984,4969,3823,76,2099,30533,3044,2436,608,3044,67600,2012
13291,51,21344,20262,205,525,6647,42125,9336,7195,2141,9336,188500,2012
13293,41,27061,18470,7559,606,7089,34905,10213,6827,3386,10213,89900,2012
13295,39.6,68463,62963,2886,1125,18544,38504,26251,19177,7074,26251,107400,2012
13297,37.4,83771,65582,12733,2826,23121,52062,29712,22419,7293,29712,160000,2012
13299,37.5,36099,23488,10715,1218,8693,34700,13248,8930,4318,13248,84300,2012
13301,43.2,5788,2141,3509,2,1463,32155,2282,1567,715,2282,65800,2012
13303,39.2,21092,9304,11170,407,4917,31441,7107,5203,1904,7107,80700,2012
13305,37.6,30157,21747,6214,1747,7296,36496,10120,7192,2928,10120,82600,2012
13307,45.6,2773,1547,1073,39,747,29926,1223,1052,171,1223,50500,2012
13309,36.6,7572,4400,3079,68,1339,27601,2028,1395,633,2028,57600,2012
13311,43.2,27141,25425,616,660,8722,40720,12154,9040,3114,12154,173400,2012
13313,34,102152,63308,3659,32577,25479,41832,34473,22919,11554,34473,123300,2012
13315,39.7,9142,5470,3316,188,1794,31509,2657,2126,531,2657,71800,2012
13317,44.2,10398,5418,4382,360,2425,28224,4090,2860,1230,4090,102300,2012
13319,40.5,9577,5528,3746,213,2338,40331,3326,2674,652,3326,72000,2012
13321,39.4,21746,14913,6114,378,5676,39205,8039,5937,2102,8039,80600,2012
15001,40.6,185399,57553,1032,21529,42762,52098,64556,42042,22514,64556,326900,2012
15003,37.7,955215,182951,18948,79173,216181,72292,308490,173960,134530,308490,557800,2012
15005,58.4,66,38,0,1,7,66250,48,0,48,48,NA,2012
15007,41.5,67113,20507,319,6415,15438,64752,22092,13901,8191,22092,513600,2012
15009,39.5,154937,49318,527,15764,35912,64058,52267,30365,21902,52267,563500,2012
16001,34.9,394961,340935,3965,28186,101648,55499,149884,102040,47844,149884,193300,2012
16003,50.3,3976,3765,0,43,1243,35756,1732,1393,339,1732,142900,2012
16005,31.5,82584,71284,547,5658,20202,45860,30206,21203,9003,30206,143200,2012
16007,39.6,5977,5653,22,218,1839,40242,2474,2002,472,2474,131600,2012
16009,44.6,9247,7848,139,243,2603,38536,3762,2847,915,3762,124000,2012
16011,32,45312,34061,113,7772,11228,46817,14638,11201,3437,14638,135900,2012
16013,40.6,21323,16666,8,4241,5813,60160,9210,6272,2938,9210,404900,2012
16015,48.8,7014,6536,31,250,1906,45403,2978,2366,612,2978,195800,2012
16017,45.7,40806,38560,90,932,11801,41379,17886,12961,4925,17886,227900,2012
16019,31.8,104177,88847,475,11864,26691,51254,35919,26529,9390,35919,157500,2012
16021,42.6,10857,9972,0,425,2904,36300,4093,3096,997,4093,174200,2012
16023,45.9,2828,2639,3,108,775,40150,1101,894,207,1101,112300,2012
16025,38,1276,1071,6,145,349,40515,449,296,153,449,165400,2012
16027,31.6,189396,137163,544,45038,46956,42691,63012,44490,18522,63012,134400,2012
16029,38.1,6872,6387,7,332,1959,52134,2634,2145,489,2634,114100,2012
16031,32.1,22813,16588,102,5703,5505,43039,7652,5311,2341,7652,124700,2012
16033,37.3,780,387,0,393,245,35833,296,197,99,296,84200,2012
16035,49.5,8679,7988,25,269,2465,41914,3621,2906,715,3621,141000,2012
16037,47.9,4338,4150,0,112,1124,41698,1878,1528,350,1878,154500,2012
16039,30.3,26655,19921,626,4090,6936,43886,9554,6226,3328,9554,142000,2012
16041,32,12739,11692,23,839,3242,47598,4098,3348,750,4098,163000,2012
16043,33.8,13123,11200,5,1654,3477,43053,4583,3853,730,4583,142500,2012
16045,42.2,16768,14888,2,1333,4497,41976,6456,4811,1645,6456,155500,2012
16047,35,15327,10730,2,4244,3951,37910,5536,3920,1616,5536,127400,2012
16049,48.3,16215,14980,19,434,4545,37067,6647,5167,1480,6647,148400,2012
16051,30.2,25940,22732,32,2650,6725,52980,8091,6691,1400,8091,159500,2012
16053,31.4,22140,14794,31,6861,5523,40309,7552,4857,2695,7552,136500,2012
16055,39.1,139083,127952,277,5331,38483,49151,55351,38866,16485,55351,201400,2012
16057,28.1,37365,33877,247,1321,8608,39466,15013,8282,6731,15013,189800,2012
16059,50,7892,7473,35,189,2275,36372,3716,2810,906,3716,182800,2012
16061,47.7,3818,3398,0,133,1059,37340,1670,1249,421,1670,118200,2012
16063,33.1,5167,3593,30,1443,1243,43926,1659,1231,428,1659,126500,2012
16065,22.7,37311,33806,209,2216,7920,33776,10089,5072,5017,10089,171600,2012
16067,35.4,19909,13037,12,6415,5139,43301,6807,5016,1791,6807,107600,2012
16069,41,39226,34756,112,1133,10210,45587,16110,10803,5307,16110,168500,2012
16071,39.7,4236,4023,0,78,1169,44298,1574,1306,268,1574,121000,2012
16073,35.8,11479,7878,0,2931,2822,33626,3881,2496,1385,3881,129600,2012
16075,38,22614,18361,15,3372,5844,42747,8204,6230,1974,8204,134000,2012
16077,34,7717,5275,0,2288,2084,41950,2553,1882,671,2553,147800,2012
16079,46.5,12797,11944,17,395,3639,38273,5791,3973,1818,5791,138800,2012
16081,33.9,10007,8176,0,1646,2587,56532,3677,2569,1108,3677,226600,2012
16083,34.6,77122,63886,350,10509,19546,42639,27980,18714,9266,27980,150300,2012
16085,46.7,9793,9164,0,381,2529,51953,3637,2852,785,3637,244200,2012
16087,44,10144,8130,0,1694,2782,36311,3994,2962,1032,3994,134400,2012
17001,40.4,67098,62414,2411,822,17483,45691,26700,19837,6863,26700,102500,2012
17003,41,8147,4918,2833,157,2028,27248,3084,2031,1053,3084,58000,2012
17005,40.4,17762,15766,514,544,4256,47705,6312,4894,1418,6312,101900,2012
17007,36.6,54141,40754,1141,10922,14138,63670,17864,15021,2843,17864,164700,2012
17009,37.2,6913,5166,994,420,1385,43915,2105,1533,572,2105,85400,2012
17011,42.6,34798,31294,221,2703,9502,48102,14289,10773,3516,14289,103700,2012
17013,44.6,5065,4977,3,13,1418,47399,2071,1647,424,2071,115600,2012
17015,46.5,15338,14533,59,447,4553,48456,6739,5131,1608,6739,99600,2012
17017,37.9,13570,10797,423,2260,3513,43180,5070,3587,1483,5070,76400,2012
17019,28.9,200931,142369,24924,10566,43084,45088,79267,43122,36145,79267,149000,2012
17021,41.6,34805,33278,501,491,9206,44211,14196,10501,3695,14196,82000,2012
17023,42.8,16353,15926,64,181,4622,47176,6593,5001,1592,6593,86300,2012
17025,42.5,13828,13404,86,61,3697,39966,5591,4347,1244,5591,75500,2012
17027,39.4,37793,34797,1286,1049,9803,60661,14058,11575,2483,14058,128700,2012
17029,32.3,53683,49208,1963,1163,11669,38088,21156,13192,7964,21156,91100,2012
17031,35.3,5197677,2277287,1267825,1245329,1189321,54648,1933670,1140135,793535,1933670,244900,2012
17033,42,19777,18175,569,371,5173,44617,7741,6274,1467,7741,74700,2012
17035,40.6,11044,10808,56,62,2922,44430,4136,3421,715,4136,82400,2012
17037,29.4,104820,83423,6395,10655,23183,53575,37959,23395,14564,37959,179300,2012
17039,42,16562,15878,217,344,4524,49626,6770,5246,1524,6770,105100,2012
17041,38.3,19908,18328,82,1240,5380,50589,7613,5972,1641,7613,98800,2012
17043,38.2,918608,645537,40620,122069,238685,78538,335532,251585,83947,335532,298500,2012
17045,43,18513,18057,64,196,5225,42730,7879,5918,1961,7879,72500,2012
17047,43.1,6691,6523,63,0,1743,39238,2742,2186,556,2742,62100,2012
17049,39.5,34258,33115,87,587,9090,51009,13643,10762,2881,13643,112800,2012
17051,39.7,22082,20522,397,313,5643,43724,8191,6637,1554,8191,79600,2012
17053,42.5,14045,13453,75,319,3595,50203,5632,4408,1224,5632,91500,2012
17055,41.8,39518,38260,69,496,10424,37158,16082,12434,3648,16082,63900,2012
17057,42.3,36989,34272,1260,885,9710,43363,14665,10917,3748,14665,81800,2012
17059,45,5592,5422,23,21,1561,38934,2364,1870,494,2364,59700,2012
17061,41.3,13828,13139,177,119,3833,42556,5816,4438,1378,5816,73300,2012
17063,36.4,49870,44302,535,4112,12853,63840,17987,13691,4296,17987,186500,2012
17065,43.3,8430,8269,21,106,2364,37904,3501,2790,711,3501,75100,2012
17067,44.7,19063,18566,60,198,5352,42494,8053,6308,1745,8053,80100,2012
17069,45.9,4315,4117,32,22,1253,35632,1903,1512,391,1903,72400,2012
17071,47.6,7275,6993,21,80,2241,49612,3219,2594,625,3219,84400,2012
17073,41.9,50378,46030,785,2444,13859,52284,20510,16111,4399,20510,108800,2012
17075,43.2,29689,27339,320,1645,8251,47908,11935,9041,2894,11935,99400,2012
17077,29.1,59992,45440,8486,2398,12071,32819,23496,12588,10908,23496,96900,2012
17079,42.7,9707,9508,6,88,2763,48703,3955,3309,646,3955,82800,2012
17081,40.5,38908,33900,3094,827,9928,42272,15178,11103,4075,15178,86000,2012
17083,41.3,22939,22230,153,227,6403,53692,8736,6906,1830,8736,118900,2012
17085,47.2,22663,21636,114,628,6630,52164,9731,7679,2052,9731,141200,2012
17087,42,12653,11057,1187,264,2956,42027,4279,3546,733,4279,92500,2012
17089,34.7,514891,304876,27215,157032,128159,68674,170069,129009,41060,170069,233800,2012
17091,36.7,113170,83125,16730,10056,27840,49994,41068,28406,12662,41068,149200,2012
17093,33,114226,84645,5977,18090,29924,83835,37817,32214,5603,37817,229400,2012
17095,41.8,52698,44811,4119,2580,13004,40419,21736,14565,7171,21736,80400,2012
17097,36.7,701282,457261,45982,139349,179208,79085,240744,184999,55745,240744,267700,2012
17099,41.1,113688,100253,1879,9145,30296,52356,44709,34195,10514,44709,126900,2012
17101,40.8,16778,12063,3635,835,4143,39324,6047,4441,1606,6047,65200,2012
17103,41.6,35778,31605,1583,1796,9109,50342,13686,10195,3491,13686,113000,2012
17105,40.2,38903,34380,2332,1555,9532,54339,14374,10681,3693,14374,108300,2012
17107,39.4,30278,25078,3552,898,7018,46647,10940,7683,3257,10940,97000,2012
17109,29.4,32568,28905,1606,858,7040,35812,12798,7809,4989,12798,86500,2012
17111,38,308163,257757,3352,35265,82182,77325,108950,90267,18683,108950,233400,2012
17113,32.2,169689,138890,11960,7441,39137,61049,63709,42843,20866,63709,156600,2012
17115,40.4,110558,86694,17540,2070,27899,46165,45074,31336,13738,45074,92500,2012
17117,41.9,47712,46238,291,427,13323,48788,19379,14933,4446,19379,93600,2012
17119,38.4,268586,232714,20946,7361,71126,52756,106933,78791,28142,106933,124900,2012
17121,41.4,39319,36317,1275,567,10596,41723,15958,11905,4053,15958,71800,2012
17123,44.9,12567,12034,52,322,3293,52565,5092,4161,931,5092,103500,2012
17125,44.3,14636,14257,135,120,4174,42394,6400,5100,1300,6400,81600,2012
17127,42.3,15370,13803,817,169,4065,42190,6157,4825,1332,6157,82700,2012
17129,43,12728,12328,93,124,3478,59428,5062,4090,972,5062,116800,2012
17131,43.7,16421,15891,87,303,4954,52700,6768,5435,1333,6768,95100,2012
17133,40.5,33003,32041,73,456,9355,71033,12457,10215,2242,12457,198300,2012
17135,41.8,29977,26983,2208,455,7765,42261,11547,8623,2924,11547,81100,2012
17137,40.9,35544,31962,2207,722,9219,46763,13919,9874,4045,13919,91600,2012
17139,41,14844,14510,58,139,4015,50005,5615,4498,1117,5615,94100,2012
17141,40.9,53378,47339,457,4732,14120,55590,20728,15496,5232,20728,151400,2012
17143,36.7,186399,135536,32903,7150,46812,50925,75847,50745,25102,75847,124000,2012
17145,39.7,22287,19346,1926,610,5221,42013,8136,6395,1741,8136,77200,2012
17147,42.8,16679,16223,73,169,4602,62125,6428,5366,1062,6428,120800,2012
17149,42,16436,15803,225,175,4387,40445,6610,5144,1466,6610,76500,2012
17151,47.9,4399,4017,199,106,1231,39854,1793,1436,357,1793,93000,2012
17153,43.5,6107,3882,2037,99,1519,31795,2414,1905,509,2414,52700,2012
17155,44.6,5968,5603,40,262,1692,54467,2453,1933,520,2453,128600,2012
17157,41.2,33353,28833,3228,862,8100,48383,11820,9000,2820,11820,89300,2012
17159,43.6,16181,15588,59,131,4405,43240,6658,5150,1508,6658,79400,2012
17161,40.1,147504,111511,12932,17087,37488,48205,60670,43026,17644,60670,114000,2012
17163,37.1,268873,169352,80973,8842,68854,50490,102936,68824,34112,102936,125700,2012
17165,41.8,24975,23047,954,351,6705,37139,10347,7577,2770,10347,71700,2012
17167,39.3,197474,162849,23438,3551,51738,55355,82402,58753,23649,82402,124100,2012
17169,43.2,7499,7112,72,105,2149,46934,3086,2502,584,3086,75500,2012
17171,43.1,5322,5212,0,27,1464,49746,2118,1550,568,2118,80800,2012
17173,44,22316,21852,72,191,6219,46546,8995,7319,1676,8995,87000,2012
17175,44,5983,5815,20,60,1657,51392,2438,1959,479,2438,86600,2012
17177,43.7,47532,40536,4111,1368,12788,44572,19633,14143,5490,19633,103400,2012
17179,39.9,135201,128394,1152,2560,37387,55580,54308,41920,12388,54308,130600,2012
17181,43.3,17799,16436,344,862,4704,41869,6858,5056,1802,6858,89700,2012
17183,39.6,81463,65363,10549,3471,20113,40961,31863,22566,9297,31863,77200,2012
17185,42.8,11935,11490,7,154,3352,45011,4759,3752,1007,4759,80000,2012
17187,40,17723,15591,338,1454,4422,41138,6882,4925,1957,6882,83000,2012
17189,42.4,14692,14214,125,201,4246,54407,6024,4862,1162,6024,104800,2012
17191,42.6,16727,16293,69,182,4890,41446,7126,5533,1593,7126,72500,2012
17193,44.5,14686,14294,96,162,4222,43151,6257,4946,1311,6257,67700,2012
17195,42,58400,50184,717,6468,15848,46193,23390,17710,5680,23390,99400,2012
17197,35.5,677669,455445,72989,105899,171998,76352,222092,185671,36421,222092,228900,2012
17199,40.4,66335,60710,2602,1314,17644,41596,26813,19131,7682,26813,90300,2012
17201,38.4,294433,213664,35652,32254,74378,47573,113119,76421,36698,113119,127500,2012
17203,40.1,38736,37337,226,546,10845,68552,14251,11744,2507,14251,156600,2012
18001,34.3,34343,32447,123,1413,8793,45339,12317,9872,2445,12317,113500,2012
18003,35.4,355940,271962,41703,23172,90363,50030,137197,96361,40836,137197,113400,2012
18005,38.1,77297,67084,1410,4737,20925,54481,30075,21728,8347,30075,137000,2012
18007,39.8,8816,8260,40,425,2294,47828,3462,2598,864,3462,85300,2012
18009,42,12742,12356,48,131,3661,39619,5293,3974,1319,5293,73000,2012
18011,38.5,56823,53171,610,1305,16016,68774,21631,16779,4852,21631,182300,2012
18013,47.3,15181,14683,24,186,4255,48652,6094,5037,1057,6094,158300,2012
18015,41.3,20105,19100,88,740,5551,49935,8060,6304,1756,8060,106100,2012
18017,38.6,38875,32345,549,4888,10091,41135,14721,11305,3416,14721,80900,2012
18019,38.1,110100,93974,7530,5195,28338,50559,42848,30654,12194,42848,127400,2012
18021,40.7,26908,26159,56,303,7419,46817,10128,7935,2193,10128,87800,2012
18023,37.8,33179,28293,186,4426,8203,48321,11689,8411,3278,11689,97000,2012
18025,41.3,10702,10357,52,130,2954,40027,4259,3521,738,4259,86500,2012
18027,35.7,31604,29651,187,1314,7896,45927,11088,8531,2557,11088,102700,2012
18029,40.2,49904,48306,338,505,13002,58098,18455,14238,4217,18455,161700,2012
18031,38.8,25772,24830,88,421,7019,48298,9881,6975,2906,9881,117500,2012
18033,37.9,42218,40390,61,1046,11451,46065,16350,12925,3425,16350,109200,2012
18035,34.6,117459,103379,5475,2145,27856,38215,46068,29855,16213,46068,90800,2012
18037,40.6,41995,38855,181,2532,11325,54168,15945,12369,3576,15945,132200,2012
18039,34.8,198214,152855,11140,28064,50519,46712,70161,50597,19564,70161,125900,2012
18041,40.7,24220,23314,293,230,6527,36602,9623,6917,2706,9623,81500,2012
18043,39.2,74601,66624,3334,1992,20054,53208,29188,21096,8092,29188,150600,2012
18045,42,17212,16570,54,375,4662,45919,6881,5408,1473,6881,89900,2012
18047,39.9,23108,22620,17,207,6415,50271,8553,6829,1724,8553,151900,2012
18049,40.3,20762,19328,205,903,6066,40910,8437,6197,2240,8437,93200,2012
18051,40.2,33437,31673,722,451,8924,48524,13048,10125,2923,13048,103100,2012
18053,39.8,69886,60522,4647,2526,17792,39751,26968,18775,8193,26968,81300,2012
18055,41.5,33032,32193,135,332,9093,43850,12912,9995,2917,12912,88100,2012
18057,35.7,276098,238359,9152,9539,75978,84821,101203,80584,20619,101203,214400,2012
18059,39,69778,65619,1443,1210,19632,62702,25943,21156,4787,25943,157700,2012
18061,40.7,39102,37746,196,592,10205,52184,14368,11948,2420,14368,125400,2012
18063,36.8,145880,128737,7030,4399,39599,68283,52122,43109,9013,52122,161500,2012
18065,41.8,49381,46794,710,707,12834,40197,18741,14085,4656,18741,93600,2012
18067,40.7,82914,72192,5857,2237,22713,44452,34168,24152,10016,34168,100500,2012
18069,39.3,37144,35695,187,661,9667,46538,14224,10939,3285,14224,98000,2012
18071,38.5,42414,38861,125,2416,11698,45883,16736,12206,4530,16736,117400,2012
18073,38.3,33369,30946,236,1757,9378,57801,12117,9501,2616,12117,145400,2012
18075,39.1,21353,20438,57,597,5605,40926,8188,6319,1869,8188,77600,2012
18077,40.5,32501,30520,672,723,8475,43395,12637,9037,3600,12637,108700,2012
18079,37.9,28373,27219,75,569,7456,45273,10705,8107,2598,10705,92100,2012
18081,37.1,140033,128765,1825,4297,37244,62888,51952,38564,13388,51952,145900,2012
18083,38.9,38392,36074,1052,603,9569,41089,14923,10309,4614,14923,84200,2012
18085,37.8,77328,69391,460,5687,21576,50822,30113,23483,6630,30113,133300,2012
18087,30.7,37284,35404,46,1348,9418,46625,11933,9601,2332,11933,154100,2012
18089,37.3,495230,273611,124204,82652,122478,49315,182028,127855,54173,182028,137400,2012
18091,39.5,111335,90579,11786,6053,28281,47754,42569,31385,11184,42569,120600,2012
18093,41.4,46131,44425,210,576,13259,41600,18869,14752,4117,18869,95700,2012
18095,39.3,131244,113315,8802,4177,32641,44245,50780,36717,14063,50780,93600,2012
18097,33.9,904535,540057,237264,83186,211413,42603,359438,204401,155037,359438,120000,2012
18099,38.2,47045,42037,205,4031,12451,47218,17773,13708,4065,17773,123700,2012
18101,42,10300,10083,20,57,2691,44291,4108,3406,702,4108,88600,2012
18103,39.9,36850,33281,1737,904,9303,39816,13320,10028,3292,13320,84200,2012
18105,27.8,138048,118580,4182,4064,27527,38675,53894,29213,24681,53894,155300,2012
18107,39.5,38207,35504,399,1677,10193,46026,14611,10386,4225,14611,108200,2012
18109,39.9,69033,66883,194,831,19427,56303,25718,19871,5847,25718,143000,2012
18111,42.8,14199,13234,37,729,3827,49816,5338,4179,1159,5338,110900,2012
18113,37.1,47547,42118,63,4579,12934,46360,17706,13640,4066,17706,112900,2012
18115,43.9,6093,5932,57,82,1687,49591,2451,1831,620,2451,142200,2012
18117,39.8,19828,19120,263,197,5250,37410,7637,5880,1757,7637,90200,2012
18119,42.7,21583,20984,100,200,6035,42707,8641,6791,1850,8641,97300,2012
18121,41.1,17251,16462,390,212,4341,45489,6039,5114,925,6039,93300,2012
18123,41.3,19408,18469,506,198,5037,47132,7499,6010,1489,7499,96400,2012
18125,42.8,12849,12765,4,12,3679,40760,5272,4413,859,5272,82500,2012
18127,38.5,164386,141314,4605,13958,43048,62457,61312,47616,13696,61312,166600,2012
18129,41.6,25840,24922,329,247,7307,57777,10063,8542,1521,10063,122200,2012
18131,41.6,13395,12794,33,333,3605,43506,5071,3980,1091,5071,99100,2012
18133,38,37995,35161,1457,605,8955,50480,12493,9876,2617,12493,123000,2012
18135,41.2,26101,24810,83,780,7096,40910,10324,7698,2626,10324,77200,2012
18137,39.2,28702,27754,97,454,7693,49031,10694,8146,2548,10694,137500,2012
18139,40.3,17349,16806,139,193,4957,46125,6798,4913,1885,6798,107200,2012
18141,36.1,266785,201770,33676,19450,64994,44989,101201,70960,30241,101201,117100,2012
18143,39.1,24044,23332,104,353,6414,41610,9028,6651,2377,9028,96800,2012
18145,39.9,44435,41481,488,1626,11959,51829,17124,12353,4771,17124,128200,2012
18147,42.3,20948,20090,138,521,5892,54832,8084,6629,1455,8084,113800,2012
18149,40.5,23310,22131,77,772,6475,39909,9040,7221,1819,9040,98000,2012
18151,40,34116,30936,264,1015,9762,48291,13668,10801,2867,13668,120900,2012
18153,39.4,21379,19842,1049,302,5471,45330,7878,5840,2038,7878,77000,2012
18155,40.6,10509,10215,45,143,2778,44833,4016,3183,833,4016,110700,2012
18157,27.7,173317,139186,6604,13025,37676,44047,65837,36189,29648,65837,129700,2012
18159,43,15917,15323,41,356,4854,53368,6665,5281,1384,6665,110800,2012
18161,40.2,7449,7211,42,31,2101,44263,2983,2328,655,2983,113200,2012
18163,37.5,179610,153301,16053,3869,45453,43645,74301,47618,26683,74301,113700,2012
18165,41.5,16224,15846,16,141,4361,41864,6520,4989,1531,6520,76400,2012
18167,36.2,107805,93531,7107,2448,24724,40547,39728,25922,13806,39728,91200,2012
18169,41.6,32804,31277,219,694,9093,44389,12817,9651,3166,12817,96600,2012
18171,42.6,8490,8289,7,86,2437,51504,3246,2483,763,3246,98600,2012
18173,39.5,59643,55974,499,938,16983,61948,22406,18482,3924,22406,143900,2012
18175,39,28162,27442,125,316,7411,41125,10757,8686,2071,10757,101200,2012
18177,40.5,68797,61254,2193,1765,18826,39131,28202,19038,9164,28202,97300,2012
18179,40.3,27677,26623,148,585,7974,49841,10807,8473,2334,10807,109700,2012
18181,42.2,24612,22396,64,1725,7107,48940,9601,7352,2249,9601,112700,2012
18183,40,33234,32042,158,510,9163,50568,13086,10906,2180,13086,127100,2012
19001,45.4,7628,7420,11,57,2075,47872,3270,2543,727,3270,96700,2012
19003,46.5,4027,3918,12,53,1164,45099,1723,1345,378,1723,88100,2012
19005,44.2,14285,13203,35,796,3893,47539,5805,4647,1158,5805,111100,2012
19007,44.2,12858,12431,56,183,3537,37866,5481,3917,1564,5481,76300,2012
19009,46.7,6077,5960,4,39,1767,47630,2696,2143,553,2696,69900,2012
19011,40.4,26044,25238,65,289,7773,57488,10230,8293,1937,10230,130900,2012
19013,34.6,130843,109799,11643,4879,31686,45610,52150,35605,16545,52150,122300,2012
19015,40.9,26324,25225,236,509,7123,51284,10648,8037,2611,10648,118200,2012
19017,38.3,24294,23444,200,253,6590,60193,9310,7604,1706,9310,139300,2012
19019,38.9,20988,20368,124,256,5883,54596,8104,6280,1824,8104,117800,2012
19021,36.5,20215,13672,467,4662,5135,46947,7645,5164,2481,7645,94700,2012
19023,43.6,14899,14565,41,138,4310,51348,6084,4908,1176,6084,97500,2012
19025,47.5,9936,9584,87,121,3063,45097,4420,3451,969,4420,72200,2012
19027,42.5,20751,20030,85,353,5694,48824,8590,6496,2094,8590,105500,2012
19029,44.8,13865,13395,28,267,3966,43114,6074,4323,1751,6074,85500,2012
19031,42.8,18446,17833,16,288,5237,58433,7594,6082,1512,7594,134000,2012
19033,43.4,44083,40824,386,1700,11900,44762,20101,14321,5780,20101,107800,2012
19035,47.3,12011,11457,36,286,3393,47816,5399,4059,1340,5399,78800,2012
19037,43.9,12409,11990,25,270,3659,43741,5341,4369,972,5341,94300,2012
19039,41.5,9286,8200,91,925,2298,44211,3627,2659,968,3627,86500,2012
19041,42.8,16649,15828,48,472,4693,46880,7260,5298,1962,7260,102600,2012
19043,44.7,18056,17490,62,308,5196,46617,7671,6065,1606,7671,98500,2012
19045,41.6,49074,45410,1382,1254,13053,49010,19923,14764,5159,19923,110700,2012
19047,38,17100,12794,72,4137,4275,46601,6303,4931,1372,6303,79500,2012
19049,34.3,66997,59214,823,4133,18184,71878,25561,20080,5481,25561,182700,2012
19051,38.6,8718,8515,9,87,2205,46807,3089,2541,548,3089,103500,2012
19053,38.4,8382,7873,148,190,2110,34942,3196,2203,993,3196,70000,2012
19055,41.9,17721,17364,18,145,4958,51663,7104,5606,1498,7104,125400,2012
19057,41.8,40268,35962,2045,1079,11086,43427,16933,12505,4428,16933,94500,2012
19059,48.3,16778,16352,58,195,5207,53426,8074,6229,1845,8074,154700,2012
19061,38.7,93776,87277,1331,1813,24507,50885,37323,27407,9916,37323,144300,2012
19063,40.2,10263,9227,92,808,2642,46547,4208,3304,904,4208,83600,2012
19065,42.3,20894,19964,186,392,5453,42995,8546,6612,1934,8546,82800,2012
19067,43.6,16204,15339,213,323,4546,42386,6913,5152,1761,6913,89200,2012
19069,43,10650,9311,19,1176,3038,49144,4260,3151,1109,4260,85200,2012
19071,45.4,7373,7062,15,182,2079,49245,3053,2378,675,3053,90500,2012
19073,45.1,9304,8961,4,195,2628,45816,4088,3080,1008,4088,78300,2012
19075,42.5,12431,12161,18,126,3567,56264,5062,4127,935,5062,118500,2012
19077,44.9,10915,10545,32,207,3306,49114,4768,3813,955,4768,95000,2012
19079,42.1,15614,14305,52,761,4209,45691,6427,4739,1688,6427,90000,2012
19081,44.7,11320,10723,7,395,3297,48695,4731,3766,965,4731,83800,2012
19083,43.6,17479,16386,128,644,4588,47902,7101,5295,1806,7101,88800,2012
19085,42.7,14838,14427,15,185,4131,53939,5995,4624,1371,5995,109100,2012
19087,39.8,20242,18199,409,781,5215,43843,7574,5502,2072,7574,98700,2012
19089,42.4,9568,9316,73,80,2509,45300,4016,3247,769,4016,90400,2012
19091,44.4,9818,9304,13,347,2796,48710,4272,3161,1111,4272,83400,2012
19093,44.8,7113,6915,16,107,1977,43690,3172,2363,809,3172,73700,2012
19095,42.3,16320,15773,60,313,4648,57318,6717,5335,1382,6717,137300,2012
19097,43.9,19807,18427,133,227,5892,44854,8414,6456,1958,8414,112700,2012
19099,41.7,36823,35248,451,536,9998,48746,14815,10486,4329,14815,116000,2012
19101,44,16791,14386,196,420,4037,48411,6844,5011,1833,6844,90100,2012
19103,29.3,131627,109500,6061,6249,28411,53993,52826,31912,20914,52826,183100,2012
19105,42.7,20686,19734,350,274,5479,53562,8109,6640,1469,8109,119000,2012
19107,43.6,10480,10241,32,104,2788,42688,4410,3593,817,4410,76200,2012
19109,46.9,15510,15046,34,220,4348,49431,6750,5444,1306,6750,88300,2012
19111,42.4,35741,32684,1043,1107,9320,41954,14220,10391,3829,14220,82200,2012
19113,36.7,211954,189055,8371,5628,53604,56790,85654,62592,23062,85654,142300,2012
19115,39.3,11448,9288,110,1834,3079,49905,4312,3420,892,4312,94100,2012
19117,43.8,8913,8735,12,66,2456,44020,3647,2776,871,3647,84700,2012
19119,38.3,11623,11289,3,224,3128,49727,4445,3613,832,4445,105500,2012
19121,39.4,15630,15175,90,198,4154,56765,5997,4641,1356,5997,159600,2012
19123,39.3,22432,21292,169,377,5781,47758,8901,6458,2443,8901,99100,2012
19125,38.8,33388,31894,185,535,9201,53684,12722,9789,2933,12722,132700,2012
19127,39.4,40568,31683,754,6982,10330,49259,15377,11423,3954,15377,104000,2012
19129,41.4,15028,14346,82,365,4104,62908,5431,4549,882,5431,151400,2012
19131,44.6,10761,10542,21,98,3021,50574,4439,3659,780,4439,100400,2012
19133,46.8,9242,8887,21,114,2632,42832,4065,2906,1159,4065,74800,2012
19135,43.3,7979,7671,50,77,2305,45266,3374,2662,712,3374,87700,2012
19137,45.2,10710,10215,4,314,2945,40530,4609,3418,1191,4609,78200,2012
19139,38,42729,34520,486,6764,11502,51675,16540,12437,4103,16540,120600,2012
19141,44.4,14302,13519,30,534,3955,45194,6138,4673,1465,6138,86000,2012
19143,43.3,6413,5920,41,393,1730,45951,2663,2018,645,2663,73600,2012
19145,43.8,15902,14724,353,446,4153,41803,6384,4704,1680,6384,77600,2012
19147,42.8,9402,9076,37,157,2450,40500,4044,3018,1026,4044,82300,2012
19149,42.5,24911,23638,36,740,7047,58916,9882,7751,2131,9882,128300,2012
19151,47.3,7307,7017,63,179,1938,42138,3327,2638,689,3327,56700,2012
19153,34.7,431811,348895,25083,32479,111570,58096,171227,119424,51803,171227,153600,2012
19155,38.5,92793,83239,1184,5992,24715,49941,36472,25709,10763,36472,124700,2012
19157,41.3,18888,17671,179,456,4751,50703,7589,5573,2016,7589,119100,2012
19159,45.4,5123,4954,5,93,1369,43655,2043,1583,460,2043,84300,2012
19161,46.3,10307,9976,75,199,2819,46606,4421,3588,833,4421,78300,2012
19163,37.4,165432,137294,11847,9262,42366,53002,66914,46573,20341,66914,141400,2012
19165,45.8,12158,11756,10,221,3386,47731,5106,4025,1081,5106,104600,2012
19167,32.9,33776,30270,155,2898,8627,55252,11538,9300,2238,11538,129400,2012
19169,26.5,89734,77999,2368,2657,18678,49683,34883,19278,15605,34883,160700,2012
19171,42.1,17746,14899,98,1302,5006,49244,6930,5263,1667,6930,100100,2012
19173,44.3,6292,5818,6,391,1764,42638,2736,2114,622,2736,65100,2012
19175,41.5,12525,12011,269,56,3430,41795,5351,3779,1572,5351,91000,2012
19177,43.8,7565,7374,20,87,2077,41572,3041,2518,523,3041,67500,2012
19179,39.9,35449,30992,444,3151,9676,41088,14570,10814,3756,14570,77500,2012
19181,38.5,46239,44316,218,884,12647,62778,17265,13738,3527,17265,154600,2012
19183,41.9,21765,20185,157,1120,5936,52636,8926,6761,2165,8926,116900,2012
19185,45.4,6372,6202,5,75,1739,38447,2651,2136,515,2651,60000,2012
19187,40,37895,34068,1532,1428,9405,41751,15808,10797,5011,15808,84000,2012
19189,43.8,10800,10200,94,345,3089,46438,4640,3518,1122,4640,92900,2012
19191,40.2,21033,20130,173,408,5448,52827,7989,6205,1784,7989,154300,2012
19193,35.2,101948,79133,2385,13828,25765,45289,38744,26302,12442,38744,97400,2012
19195,43.9,7581,7309,25,154,2170,50603,3207,2555,652,3207,98300,2012
19197,44.4,13173,11733,32,1220,3428,45713,5487,4176,1311,5487,74200,2012
20001,40.8,13364,12272,266,385,3691,39714,5577,4279,1298,5577,63400,2012
20003,43,8066,7719,22,11,2329,43060,3280,2617,663,3280,87300,2012
20005,35.8,16854,15043,880,401,4029,45666,6063,4446,1617,6063,87800,2012
20007,46.4,4867,4653,8,91,1437,43048,2251,1691,560,2251,58000,2012
20009,40,27556,22998,355,3676,7323,46639,11310,8187,3123,11310,73600,2012
20011,38,15060,13836,431,313,4018,38250,5740,4285,1455,5740,79900,2012
20013,41.9,9962,8391,144,314,2653,37515,4164,2720,1444,4164,80400,2012
20015,37.5,65647,59624,1019,2588,17352,57424,24276,18741,5535,24276,124900,2012
20017,45.5,2788,2598,32,100,742,36434,1117,847,270,1117,80300,2012
20019,48.3,3654,3267,29,89,1106,37039,1565,1197,368,1565,46100,2012
20021,40.5,21521,19215,104,431,5827,41877,8124,6327,1797,8124,71900,2012
20023,49.7,2724,2545,0,137,842,39167,1312,973,339,1312,72600,2012
20025,43.5,2198,1981,4,156,605,39563,906,672,234,906,56400,2012
20027,44.1,8547,8174,120,177,2262,43879,3488,2655,833,3488,87200,2012
20029,43.3,9479,8985,31,277,2571,37382,3985,3038,947,3985,63800,2012
20031,44,8553,8123,56,175,2444,50106,3494,2687,807,3494,102200,2012
20033,44,1893,1746,0,109,490,39950,811,605,206,811,47900,2012
20035,38.4,36259,29744,963,3324,8946,41905,13721,9503,4218,13721,79900,2012
20037,32.7,39133,34769,755,1778,9162,36927,15294,9656,5638,15294,83400,2012
20039,51.4,2939,2833,20,28,914,38750,1481,1221,260,1481,54500,2012
20041,41.6,19766,18315,68,788,5478,49535,7813,5775,2038,7813,106400,2012
20043,37.9,7931,7255,274,170,2001,46346,3142,2297,845,3142,85000,2012
20045,28.3,111073,90582,3982,5749,23552,48395,43422,22336,21086,43422,178700,2012
20047,43.6,3021,2416,8,536,857,43953,1312,1021,291,1312,54900,2012
20049,49,2856,2663,24,81,826,33239,1232,996,236,1232,53400,2012
20051,31.8,28525,26173,295,1317,6665,44253,11738,7517,4221,11738,134700,2012
20053,44.2,6477,5696,297,328,1680,46350,2612,1978,634,2612,71100,2012
20055,30.4,36608,16998,684,17136,8827,49617,12261,8054,4207,12261,106900,2012
20057,30.5,33725,14862,597,17165,8009,50577,11019,7091,3928,11019,87300,2012
20059,38.6,25916,23834,185,930,7000,50240,10108,7143,2965,10108,120000,2012
20061,27.4,34110,20485,5851,4321,8472,47879,12180,5796,6384,12180,130600,2012
20063,48.2,2771,2697,18,23,812,44426,1177,959,218,1177,66800,2012
20065,49.5,2617,2375,92,39,693,43929,1174,951,223,1174,67400,2012
20067,32.6,7817,4219,3,3429,2262,53800,2820,2155,665,2820,88200,2012
20069,35.2,5982,5013,0,856,1536,55000,2060,1526,534,2060,102400,2012
20071,49.2,1234,1014,10,190,365,52212,493,385,108,493,76600,2012
20073,46.5,6654,6215,11,224,1805,39145,2907,2128,779,2907,55700,2012
20075,36.7,2656,1914,1,727,754,43125,1105,837,268,1105,75700,2012
20077,43.3,5998,5519,38,309,1762,38340,2679,1939,740,2679,67000,2012
20079,39.7,34572,29290,398,3695,9107,49075,13204,9702,3502,13204,107800,2012
20081,34.3,4222,2986,11,1155,1062,52688,1423,1069,354,1423,98300,2012
20083,47.9,1949,1745,1,191,564,44318,810,642,168,810,72400,2012
20085,41.3,13401,11454,120,460,3968,54710,5385,4176,1209,5385,116500,2012
20087,42.9,19036,18062,46,371,5495,58434,7455,6392,1063,7455,131700,2012
20089,51.7,3085,2967,12,62,946,38462,1448,1136,312,1448,50500,2012
20091,36.4,546046,447891,22888,38735,145710,75139,214670,152467,62203,214670,211900,2012
20093,35.7,3952,2696,18,1134,1025,47069,1384,1045,339,1384,92000,2012
20095,44.6,7876,7484,42,202,2219,47801,3253,2402,851,3253,87600,2012
20097,42.3,2503,2320,9,104,717,41574,1064,720,344,1064,100300,2012
20099,40.3,21574,18459,756,876,5988,40117,8839,6214,2625,8839,64700,2012
20101,45.3,1666,1533,1,97,444,49063,759,567,192,759,57000,2012
20103,37.4,76286,61218,6410,4409,18607,62035,26167,17688,8479,26167,166600,2012
20105,46.3,3240,3108,3,73,894,41250,1459,1167,292,1459,61000,2012
20107,44.3,9613,9151,40,184,3046,44771,4246,3495,751,4246,98800,2012
20109,44.3,2766,2607,0,10,781,46047,1286,934,352,1286,74600,2012
20111,32.2,34103,24862,632,6915,7782,38877,13196,8044,5152,13196,92700,2012
20113,41.8,29208,27191,270,1030,8078,54171,11528,8883,2645,11528,121400,2012
20115,44.3,12565,11870,110,308,3438,45323,4970,3935,1035,4970,81500,2012
20117,44.9,10083,9696,21,190,2773,41867,4324,3320,1004,4324,77700,2012
20119,40,4504,3652,41,689,1321,49846,1764,1242,522,1764,83600,2012
20121,40.1,32546,30444,399,850,9118,61272,12154,9829,2325,12154,163200,2012
20123,45.1,6359,6170,21,127,1817,48046,2724,2011,713,2724,70700,2012
20125,39.7,35167,28487,2005,1829,9303,41073,14131,10137,3994,14131,72500,2012
20127,47.3,5917,5550,6,219,1621,45000,2506,1955,551,2506,76800,2012
20129,39.4,3207,2429,40,621,833,44198,1219,883,336,1219,73400,2012
20131,42.4,10170,9820,98,129,2794,46901,4046,3211,835,4046,89800,2012
20133,40.2,16501,15113,193,689,4445,40829,6637,4846,1791,6637,68900,2012
20135,50.9,3102,2843,11,218,903,47870,1350,1114,236,1350,53800,2012
20137,43.4,5658,5046,206,238,1276,42776,2279,1692,587,2279,63600,2012
20139,42.6,16300,15530,67,349,4682,50243,6557,5186,1371,6557,96200,2012
20141,47.6,3852,3732,12,48,1082,38561,1725,1433,292,1725,50000,2012
20143,42.3,6099,5827,44,123,1806,53497,2413,1954,459,2413,84800,2012
20145,42,6945,5982,347,464,1644,44106,2512,1852,660,2512,70800,2012
20147,45.7,5579,5246,10,124,1573,42838,2411,1914,497,2411,61600,2012
20149,35.1,21620,19708,272,965,5689,56775,7908,6158,1750,7908,152000,2012
20151,40.5,9670,8787,106,540,2549,43880,4026,2719,1307,4026,73600,2012
20153,50.8,2555,2416,5,87,793,40896,1219,877,342,1219,60600,2012
20155,40,64346,55459,1894,5193,17001,43649,25952,17712,8240,25952,90000,2012
20157,50.8,4965,4838,6,56,1426,41000,2322,1884,438,2322,46900,2012
20159,38.7,10077,8572,57,994,2602,45703,3864,2922,942,3864,71200,2012
20161,24.3,71927,57168,4415,4781,13597,43364,25711,10996,14715,25711,166900,2012
20163,44.4,5205,5000,24,30,1492,41123,2378,1743,635,2378,63400,2012
20165,49,3262,3149,44,14,881,41306,1516,1161,355,1516,53600,2012
20167,47.1,6926,6586,67,120,2068,40551,3264,2506,758,3264,64800,2012
20169,37.9,55493,45472,1623,5377,14260,47339,22091,15049,7042,22091,119900,2012
20171,43.8,4872,4035,7,738,1455,58520,2065,1579,486,2065,95500,2012
20173,34.4,497062,348721,43509,63829,125109,49885,192806,126272,66534,192806,123000,2012
20175,29,23013,8274,752,12972,5303,47731,7391,4839,2552,7391,86400,2012
20177,38.4,177688,134481,14083,19166,46507,47992,73213,47646,25567,73213,119400,2012
20179,46.6,2562,2446,11,81,717,49125,1104,837,267,1104,78700,2012
20181,41.1,6036,5174,62,671,1692,42642,2729,1600,1129,2729,69000,2012
20183,50.4,3835,3694,4,58,1253,44798,1789,1426,363,1789,59500,2012
20185,45.7,4398,3757,27,529,1212,43232,1893,1512,381,1893,59300,2012
20187,35.5,2200,1195,23,901,573,51823,757,588,169,757,85200,2012
20189,34.8,5633,3694,36,1813,1554,56991,1984,1492,492,1984,78100,2012
20191,39.9,24000,21920,140,1106,6302,48105,9258,7111,2147,9258,85600,2012
20193,36.2,7854,7289,112,366,1683,48029,3137,2125,1012,3137,92200,2012
20195,46.8,2977,2852,10,67,834,44063,1224,970,254,1224,69100,2012
20197,41.6,7048,6657,43,205,1980,55817,2642,2290,352,2642,109000,2012
20199,45.1,1508,1403,1,94,397,46932,599,469,130,599,64100,2012
20201,46,5806,5557,52,147,1564,42962,2473,1976,497,2473,55800,2012
20203,38.3,2239,1662,0,550,636,51098,908,696,212,908,71500,2012
20205,44.1,9368,8816,8,223,2613,40414,3777,2853,924,3777,62300,2012
20207,48.8,3311,3137,0,73,976,30852,1524,1175,349,1524,53800,2012
20209,33,157274,68313,39662,41094,36629,39163,57356,35111,22245,57356,96000,2012
21001,39.4,18651,17517,530,318,4837,31169,7236,5321,1915,7236,78900,2012
21003,39.3,20007,19230,209,300,5550,36123,7980,5894,2086,7980,93500,2012
21005,38.3,21442,20329,581,292,5783,52294,8369,6185,2184,8369,132700,2012
21007,41.6,8268,7779,256,93,2342,41989,3379,2724,655,3379,91800,2012
21009,39.9,42229,38632,1798,1092,11850,37587,16848,11566,5282,16848,101800,2012
21011,40.4,11665,11200,223,133,2943,29632,4421,3448,973,4421,65900,2012
21013,41.1,28613,27192,678,218,7603,25952,10881,7325,3556,10881,66200,2012
21015,35.7,119406,107184,3395,4268,31432,67125,42617,32362,10255,42617,173000,2012
21017,40.4,20004,17076,1328,1336,5511,40894,7971,4842,3129,7971,139000,2012
21019,41.6,49358,46284,1343,711,13181,39076,19608,13415,6193,19608,96700,2012
21021,40.8,28445,24699,1857,816,7510,41037,11143,7438,3705,11143,132700,2012
21023,39.7,8488,8253,12,193,2128,38724,3231,2555,676,3231,89000,2012
21025,40.4,13922,13615,73,74,3503,23049,5297,3929,1368,5297,50700,2012
21027,41.8,20068,19120,484,192,5299,39695,7405,5982,1423,7405,81800,2012
21029,38.2,74431,71431,430,1036,20937,53922,27791,22522,5269,27791,146600,2012
21031,40.3,12748,12204,41,351,3507,36237,5052,3830,1222,5052,80100,2012
21033,42.2,12977,11933,672,176,3433,37778,5092,3817,1275,5092,78500,2012
21035,33.6,37198,33664,1413,885,8841,39037,14998,9994,5004,14998,113600,2012
21037,36.9,90119,83866,2371,1485,22536,53580,35235,24857,10378,35235,147600,2012
21039,43.2,5081,4871,55,72,1559,37768,2085,1799,286,2085,73800,2012
21041,36.6,10851,9656,134,754,3023,40938,4268,2620,1648,4268,99600,2012
21043,39.2,27594,26817,164,346,7158,35415,10412,8152,2260,10412,74900,2012
21045,41.1,15984,15335,120,390,4229,28416,6162,4996,1166,6162,76200,2012
21047,28.9,73722,50340,15142,4636,18708,37750,26100,13945,12155,26100,100900,2012
21049,40.3,35555,32327,1843,886,10476,45486,14547,9435,5112,14547,139100,2012
21051,37.4,21833,20288,1012,215,4725,22296,6971,5266,1705,6971,58300,2012
21053,41.5,10244,9827,125,164,2581,26885,3908,3010,898,3908,67700,2012
21055,42.4,9321,9069,61,88,2463,32839,3835,2886,949,3835,74900,2012
21057,43.3,6857,6508,249,41,1712,29885,2605,1920,685,2605,63300,2012
21059,39,96711,87125,4684,2468,25329,45507,37582,26393,11189,37582,108300,2012
21061,41.7,12141,11705,146,216,3433,35243,4819,3569,1250,4819,91400,2012
21063,40.9,7774,7436,227,88,1747,24841,2508,1998,510,2508,69800,2012
21065,41.7,14647,14378,38,10,3912,28684,5801,4140,1661,5801,73800,2012
21067,33.8,296766,217204,41868,19968,71218,48779,122793,69141,53652,122793,163000,2012
21069,39.9,14415,13925,172,156,3790,32677,5468,4286,1182,5468,82000,2012
21071,39.9,39454,38580,351,242,10833,29237,15602,10959,4643,15602,69600,2012
21073,39.7,49399,41126,5137,1330,12854,47086,20948,13252,7696,20948,142200,2012
21075,42.8,6758,4902,1593,62,1988,36813,2961,1780,1181,2961,58500,2012
21077,39.4,8513,7888,68,366,2092,43860,3019,2126,893,3019,101700,2012
21079,41.7,16892,15961,347,401,4723,44115,6239,4944,1295,6239,115600,2012
21081,35.3,24683,23560,127,569,6868,46011,8674,6362,2312,8674,123400,2012
21083,40,37200,32701,1510,2077,10275,36698,14699,11030,3669,14699,85000,2012
21085,39.2,25772,24888,174,293,6705,33290,9945,7203,2742,9945,89200,2012
21087,43.4,11309,10744,299,94,3263,33573,4480,3394,1086,4480,72000,2012
21089,42,36922,35734,258,311,10151,43808,14421,11094,3327,14421,91600,2012
21091,40,8588,8287,97,97,2489,48867,3255,2694,561,3255,90200,2012
21093,35.5,104513,81327,11857,5182,28264,49257,38908,24826,14082,38908,140600,2012
21095,40.6,29210,27928,748,219,7614,26758,11058,7675,3383,11058,52700,2012
21097,41.6,18781,17765,446,356,4691,36393,7243,4730,2513,7243,105600,2012
21099,40.6,18278,16848,923,259,4967,32445,6957,5257,1700,6957,77300,2012
21101,39.4,46254,40673,3521,859,12294,42266,18665,12822,5843,18665,100500,2012
21103,40.6,15428,14232,446,479,4258,43083,6018,4309,1709,6018,124900,2012
21105,44.7,4869,4255,498,46,1163,36125,1980,1538,442,1980,61400,2012
21107,40.3,46891,41937,2750,731,12829,40501,18556,13367,5189,18556,83300,2012
21109,39,13475,13264,1,90,4011,22213,5739,4333,1406,5739,62300,2012
21111,37.8,741285,523626,151430,31991,187491,46701,303915,192102,111813,303915,148700,2012
21113,35.6,48591,44371,1461,1315,13252,48299,17960,11778,6182,17960,157000,2012
21115,39.7,23339,22871,86,138,6767,34466,9329,6940,2389,9329,76600,2012
21117,36.2,159926,143641,7433,4203,40265,53900,62260,42361,19899,62260,146200,2012
21119,41.1,16368,16031,157,55,4074,32482,5855,4515,1340,5855,57900,2012
21121,38.8,31874,30809,529,242,8351,24193,12421,7892,4529,12421,73500,2012
21123,39.5,14175,13095,468,395,3701,39103,5269,4044,1225,5269,96400,2012
21125,37.6,58891,56686,407,738,16344,36835,22490,16475,6015,22490,96200,2012
21127,39.5,15889,15602,27,71,4009,32622,5666,4341,1325,5666,75200,2012
21129,41.2,7831,7653,73,43,1851,22789,2828,2079,749,2828,57900,2012
21131,41.8,11318,11155,32,13,2994,26386,4317,3334,983,4317,50500,2012
21133,41.3,24336,23930,101,132,6504,29532,9324,7097,2227,9324,54800,2012
21135,40.3,13889,13299,107,269,3577,27311,4925,3901,1024,4925,61100,2012
21137,39.2,24671,23355,637,376,6780,34454,9767,7466,2301,9767,84400,2012
21139,44.7,9479,9199,77,84,2611,40101,3553,2887,666,3553,81600,2012
21141,40.5,26786,23886,2087,635,7553,35962,10899,7903,2996,10899,87700,2012
21143,47.7,8336,7687,557,44,2081,38414,3278,2586,692,3278,96600,2012
21145,42.1,65558,55111,6400,1378,17835,44757,27293,18649,8644,27293,118600,2012
21147,38.6,18204,16502,1095,269,4402,21758,6287,4458,1829,6287,65300,2012
21149,42.2,9554,9291,51,108,2576,40563,3699,2888,811,3699,80300,2012
21151,33.6,83174,75280,3583,1796,20213,42020,31281,19077,12204,31281,143000,2012
21153,39.4,13229,12988,37,58,3609,25461,4985,3938,1047,4985,48300,2012
21155,38.2,19872,17308,1792,488,4898,37710,7423,5725,1698,7423,100600,2012
21157,43.9,31393,30599,105,360,9008,44802,12272,9918,2354,12272,103300,2012
21159,38.6,12934,11528,867,385,3296,25340,4408,3081,1327,4408,77100,2012
21161,40.8,17495,15699,1244,252,4719,39192,6728,4853,1875,6728,99000,2012
21163,35.6,28979,26141,1174,910,7724,45629,10253,7306,2947,10253,111100,2012
21165,41.6,6331,6120,72,59,1499,25988,2352,1774,578,2352,68800,2012
21167,42.3,21283,19607,761,471,5731,44431,8486,6289,2197,8486,125600,2012
21169,41.9,10074,9610,169,122,2714,34100,3947,3092,855,3947,80300,2012
21171,42.1,10925,10274,248,290,2826,27586,4441,3220,1221,4441,68900,2012
21173,37.3,26517,24757,823,659,7017,35832,10093,6801,3292,10093,104800,2012
21175,38.6,13898,13011,511,135,3403,29154,4666,3446,1220,4666,68800,2012
21177,41,31399,29220,1416,364,8623,38835,11974,9655,2319,11974,79400,2012
21179,37.5,43500,39621,2244,859,12177,43722,16548,12518,4030,16548,121400,2012
21181,39.4,7092,6947,33,108,1902,41832,2731,2120,611,2731,81300,2012
21183,39,23975,22664,367,817,6266,38286,8719,6805,1914,8719,78600,2012
21185,39.2,60357,53981,2631,2048,15936,83164,19446,16534,2912,19446,242700,2012
21187,40.6,10870,10408,142,244,2975,41719,4578,3321,1257,4578,97300,2012
21189,43.9,4764,4581,43,0,1135,19624,1642,1251,391,1642,60500,2012
21191,39.4,14771,14409,69,100,3839,48761,5477,4118,1359,5477,105300,2012
21193,41.2,28617,27537,311,187,7673,32676,11031,8036,2995,11031,61500,2012
21195,40.5,64887,63298,358,443,18757,33227,26822,19728,7094,26822,64900,2012
21197,37.9,12638,12284,116,134,3125,27555,4678,3089,1589,4678,79200,2012
21199,40.9,63045,59923,694,1309,17928,32788,26375,18539,7836,26375,102500,2012
21201,38.6,2251,2250,0,0,527,29136,824,593,231,824,70200,2012
21203,41.3,17090,16755,70,22,4638,28178,6497,5078,1419,6497,73800,2012
21205,32,23351,22196,240,304,5423,33615,8139,5267,2872,8139,101900,2012
21207,41.2,17562,16684,143,560,4725,29465,7364,5580,1784,7364,84500,2012
21209,35.2,47211,41550,2600,1886,12939,60553,17676,12509,5167,17676,161400,2012
21211,38.2,42286,34317,3175,3761,11635,56267,15246,10842,4404,15246,167600,2012
21213,38.4,17323,14858,1698,316,4617,40930,6677,4543,2134,6677,115800,2012
21215,39.4,17135,16328,370,256,5034,62652,6234,5400,834,6234,167000,2012
21217,40.2,24514,22349,1174,429,6352,35000,9490,6704,2786,9490,96700,2012
21219,38,12472,10788,1056,479,3429,40011,4689,3327,1362,4689,80100,2012
21221,44.3,14282,12624,1074,182,4418,44144,6034,4901,1133,6034,114100,2012
21223,39.5,8829,8422,26,231,2584,52805,3464,2660,804,3464,115000,2012
21225,36.6,14992,12610,1835,252,3822,37445,5410,4086,1324,5410,77900,2012
21227,32.7,113787,92873,10342,5225,27287,43509,43801,26218,17583,43801,139800,2012
21229,40.9,11701,10361,773,400,3335,39748,4541,3691,850,4541,109500,2012
21231,40.9,20819,19594,395,585,5854,27646,8296,5857,2439,8296,72200,2012
21233,39.7,13618,12231,666,587,3512,41138,4995,3739,1256,4995,66600,2012
21235,37.9,35756,34510,197,325,9411,29876,13330,9067,4263,13330,70700,2012
21237,41.3,7298,7251,2,9,1713,21168,2686,1946,740,2686,50300,2012
21239,41.7,24847,21493,1399,1603,6638,56672,9847,7012,2835,9847,187400,2012
22001,35.6,61611,48137,11035,1059,15900,38686,22173,15373,6800,22173,88900,2012
22003,38.5,25740,18156,5099,1299,5774,38899,8303,6053,2250,8303,79800,2012
22005,34.4,107647,76279,24023,5008,28461,67688,37331,30507,6824,37331,167600,2012
22007,38.8,23321,15406,7147,484,6314,46410,8654,7147,1507,8654,88900,2012
22009,38.5,41925,27785,12350,626,10977,34512,15583,10831,4752,15583,85700,2012
22011,37.4,35662,28706,4490,1031,9615,46762,12960,10053,2907,12960,89900,2012
22013,41.3,14312,7830,5968,209,3601,31229,5672,4138,1534,5672,57300,2012
22015,34.6,117742,81453,25062,6925,29987,53070,44836,30260,14576,44836,142300,2012
22017,36.3,254970,121748,120127,6106,61561,40497,98284,61492,36792,98284,121500,2012
22019,35.9,192307,133652,47613,4968,50488,44247,72790,51999,20791,72790,118100,2012
22021,40.4,10118,8010,1792,222,2577,40181,3961,2933,1028,3961,69200,2012
22023,40.3,6934,6667,140,105,1886,62353,2482,2262,220,2482,105900,2012
22025,37.3,10409,6934,2946,336,2686,38205,3753,2986,767,3753,70000,2012
22027,41.8,17059,8005,8576,189,3576,32316,5635,4148,1487,5635,70200,2012
22029,37.5,20624,11719,8404,222,5315,28971,7765,5038,2727,7765,75200,2012
22031,39.9,26695,15130,10154,669,6904,40200,10215,7911,2304,10215,82800,2012
22033,32.7,439662,206234,198575,15864,103056,48274,167298,103314,63984,167298,164600,2012
22035,33.1,7738,2097,5401,198,1548,25413,2371,1376,995,2371,49000,2012
22037,40.6,20252,10643,9067,217,4893,43868,6856,5327,1529,6856,111700,2012
22039,35.7,33989,23112,9575,771,8639,32125,12066,8310,3756,12066,78100,2012
22041,38.8,20714,13790,6691,129,5483,32981,7765,5575,2190,7765,76900,2012
22043,37.4,22049,17096,3406,908,4934,38739,7374,5841,1533,7374,79900,2012
22045,35.6,73527,44659,23310,2325,18961,44611,26457,18886,7571,26457,102500,2012
22047,38.1,33386,15990,16180,687,7694,44037,10982,8447,2535,10982,87800,2012
22049,39.1,16210,10896,4863,219,4435,38757,6076,4126,1950,6076,76000,2012
22051,38.5,432706,242658,111962,53172,107571,48522,166480,105412,61068,166480,175500,2012
22053,38,31529,24637,5294,548,8459,41777,11874,9079,2795,11874,85100,2012
22055,33.6,221602,149342,56430,8487,53604,49705,85578,55462,30116,85578,159500,2012
22057,36.7,96453,75292,12920,3629,25489,50574,34995,27365,7630,34995,123700,2012
22059,38.3,14840,12443,1823,330,4172,43641,5718,4854,864,5718,75200,2012
22061,27.8,46543,25110,18755,1170,10397,35433,16603,9235,7368,16603,114900,2012
22063,34.7,128192,115392,6774,3801,33875,57150,45518,36006,9512,45518,152800,2012
22065,34.9,12113,4387,7387,188,2532,24700,4050,2289,1761,4050,70800,2012
22067,38.1,27893,14189,13083,265,7020,31447,10344,7024,3320,10344,76100,2012
22069,33.3,39434,21034,16225,731,9649,32649,15116,9089,6027,15116,94500,2012
22071,34.9,341407,103837,203970,17825,77069,36681,143851,68505,75346,143851,183800,2012
22073,34.2,153752,91659,56232,2833,37449,38899,57239,34694,22545,57239,119200,2012
22075,36.6,23220,15746,4887,1120,6352,57386,8459,6461,1998,8459,175500,2012
22077,42.5,22821,13722,8343,482,5861,45196,8942,6982,1960,8942,114100,2012
22079,37.4,131655,81610,42176,3408,31803,40946,47441,31564,15877,47441,117400,2012
22081,38.3,9068,5264,3575,105,2351,36591,3225,2481,744,3225,70900,2012
22083,38.2,20785,12713,7429,344,5344,39493,7406,5104,2302,7406,74900,2012
22085,40.9,24265,16798,4033,825,6438,36914,9223,7128,2095,9223,77800,2012
22087,33.2,35947,24542,6306,3408,9351,40590,13081,9040,4041,13081,127100,2012
22089,36.7,52663,34787,13869,2645,14003,59197,18406,15137,3269,18406,180500,2012
22091,39.2,11106,4954,6005,35,2973,32460,4202,3383,819,4202,78200,2012
22093,38.6,21978,10468,11108,266,6048,53728,7701,6370,1331,7701,123400,2012
22095,35.3,45741,18331,24236,2207,11341,51040,15710,12168,3542,15710,149000,2012
22097,36.9,83774,46405,34359,1348,21294,36183,30725,21789,8936,30725,85100,2012
22099,36,52343,34046,15959,1092,13238,41137,18761,15026,3735,18761,91200,2012
22101,37.4,54285,31152,17220,2829,14041,40738,20164,13943,6221,20164,90600,2012
22103,39.4,234283,188534,26796,11009,63574,60813,87896,68613,19283,87896,198700,2012
22105,33.5,121209,78083,36459,4158,30250,40491,44286,30102,14184,44286,136000,2012
22107,41.9,5189,2149,2903,128,1461,29888,2107,1329,778,2107,61700,2012
22109,35.1,111666,76616,20507,4357,28074,49545,39226,29092,10134,39226,128500,2012
22111,40.9,22633,15260,6049,920,6069,36507,8356,6629,1727,8356,79400,2012
22113,36.7,58041,46362,8289,1430,15507,44339,21948,16800,5148,21948,94800,2012
22115,30,51542,37107,7103,3802,13472,46260,18100,10064,8036,18100,89300,2012
22117,38.8,47025,30913,14469,876,11570,30490,17420,12765,4655,17420,82600,2012
22119,40.4,41156,26036,13832,671,11294,35896,16367,11303,5064,16367,81700,2012
22121,35.8,23748,13801,8707,585,6269,50788,8700,6373,2327,8700,135500,2012
22123,40.1,11587,9279,1862,301,2890,33665,4179,2959,1220,4179,73500,2012
22125,42.2,15575,7976,6959,237,3083,58212,3991,2960,1031,3991,191000,2012
22127,39.9,15233,10028,4793,239,3809,33853,5469,4053,1416,5469,63200,2012
23001,39.8,107766,99245,1754,1699,28018,44826,44154,29165,14989,44154,156700,2012
23003,45.2,71757,68182,420,697,19353,37434,30432,21796,8636,30432,89900,2012
23005,41.1,282143,258733,7019,5189,71351,57159,117614,80116,37498,117614,243900,2012
23007,43.3,30704,29660,94,149,7814,39416,12243,9357,2886,12243,130300,2012
23009,46.3,54470,52343,153,631,15010,48635,23875,17879,5996,23875,200000,2012
23011,42.7,122022,116464,802,1529,32205,47424,51276,36444,14832,51276,152200,2012
23013,46.6,39848,38455,226,350,10515,47714,16857,13312,3545,16857,204300,2012
23015,48.1,34440,33397,72,290,9886,50494,15050,12735,2315,15050,204500,2012
23017,44.4,57814,55632,247,597,14986,41434,23124,18204,4920,23124,141600,2012
23019,40,153742,145537,1103,1670,39195,43382,62674,42354,20320,62674,138000,2012
23021,48.1,17432,16790,17,169,5067,36606,7765,6096,1669,7765,102700,2012
23023,43.8,35394,33615,336,482,9715,55634,14800,11241,3559,14800,189700,2012
23025,43.9,52098,50306,193,422,14294,38141,21847,17039,4808,21847,109900,2012
23027,44.2,38761,37455,115,359,10511,42238,16493,12943,3550,16493,156100,2012
23029,45.9,32832,29988,125,466,8881,36486,14096,10798,3298,14096,103600,2012
23031,43,197861,188939,1006,2542,53056,56656,80908,59114,21794,80908,232100,2012
24001,41,74645,65921,5636,1089,17336,39087,28537,19918,8619,28537,122000,2012
24003,38.4,538473,389813,80753,32839,138924,86987,198761,147829,50932,198761,349800,2012
24005,39,807318,505425,207790,33958,203327,66068,314823,209260,105563,314823,263900,2012
24009,39.8,88774,70771,12063,2515,23470,92395,30916,25293,5623,30916,368100,2012
24011,38.9,32947,25715,4523,1795,8565,60735,11806,8519,3287,11806,223400,2012
24013,41.1,167249,152299,5405,4380,43994,83155,59684,49690,9994,59684,332200,2012
24015,39,101109,88006,6148,3436,26277,66025,35942,26611,9331,35942,261900,2012
24017,37.2,147107,71321,59279,6422,37970,93063,50845,40580,10265,50845,320400,2012
24019,42.9,32570,21539,9012,1162,9155,46199,13569,9273,4296,13569,200000,2012
24021,38.5,234268,182064,19759,17293,61941,83706,85559,64670,20889,85559,316800,2012
24023,42.9,30079,29245,288,227,8420,45354,12354,9412,2942,12354,169500,2012
24025,39.5,245396,194211,30699,8714,66419,80441,90080,72443,17637,90080,290700,2012
24027,38.3,288676,170853,50024,16839,77803,107821,104905,77803,27102,104905,435300,2012
24029,45.3,20184,15687,2995,896,5051,54614,7756,5650,2106,7756,267600,2012
24031,38.4,974824,479708,162939,166124,244586,96985,357579,243751,113828,357579,455800,2012
24033,35,865443,130239,548459,129470,199652,73568,302683,191829,110854,302683,289400,2012
24035,42.2,47894,41834,3377,1428,13172,86013,17165,14574,2591,17165,356800,2012
24037,36,105528,80740,14124,4056,27991,85032,37352,27174,10178,37352,312100,2012
24039,36.9,26402,13834,10700,866,5205,41558,8494,5814,2680,8494,162400,2012
24041,47.3,37746,29886,4888,2030,10854,62942,15856,11699,4157,15856,343800,2012
24043,39.8,147882,122987,14001,5155,37927,54561,55798,37131,18667,55798,218200,2012
24045,35.6,98940,66009,23176,4470,24343,50639,36518,23193,13325,36518,188400,2012
24047,48.1,51398,41367,7321,1586,13881,58138,21194,16856,4338,21194,268500,2012
24510,34.4,620644,173821,392173,25535,126119,40803,240630,117500,123130,240630,161300,2012
25001,49.9,216021,198702,4406,4779,59744,60424,95520,76307,19213,95520,373600,2012
25003,44.6,130866,118401,3438,4524,32534,47513,55612,38144,17468,55612,209200,2012
25005,39.9,548739,470779,17739,33137,139359,55995,209532,133310,76222,209532,287800,2012
25007,45.4,16581,15120,656,75,3844,65896,5782,4567,1215,5782,656000,2012
25009,40.4,744961,565929,20564,123280,189387,66918,285144,183078,102066,285144,354700,2012
25011,44.3,71489,66031,497,2301,18564,53298,30472,20930,9542,30472,221700,2012
25013,38.8,464072,313556,36165,96925,115997,49729,177756,111344,66412,177756,201400,2012
25015,36.2,158850,136732,3751,7589,34544,61264,58932,39477,19455,58932,263500,2012
25017,38.5,1507558,1160104,65529,99041,369928,81420,579209,366125,213084,579209,401300,2012
25019,38.8,10194,8192,575,958,2440,83546,3942,2781,1161,3942,944100,2012
25021,40.6,672078,540382,37666,22270,169105,84087,257138,179413,77725,257138,393000,2012
25023,41.1,495407,417678,39833,15898,127215,74722,179863,139016,40847,179863,339100,2012
25025,31.6,724502,348562,146857,144470,140113,52700,287442,102742,184700,287442,362600,2012
25027,39.2,799277,646235,29665,75159,201432,65968,299350,198725,100625,299350,267600,2012
26001,55.3,10943,10621,18,126,3205,36931,4740,4290,450,4740,110200,2012
26003,47.5,9531,8181,716,112,2237,38348,3558,2973,585,3558,113600,2012
26005,39,111589,99874,1354,7520,30786,51030,41958,34524,7434,41958,142400,2012
26007,45.8,29602,28593,129,322,8605,38900,13098,10338,2760,13098,101600,2012
26009,48,23634,22573,67,410,6690,43171,9719,8272,1447,9719,148100,2012
26011,46.7,15952,15235,250,238,4406,36937,6435,5374,1061,6435,90900,2012
26013,43.3,8808,6531,1030,94,2045,39594,3161,2477,684,3161,83100,2012
26015,41.3,59249,56497,267,1379,16544,53541,22455,19251,3204,22455,137200,2012
26017,41.5,107633,98125,1255,5081,29159,46068,43918,34487,9431,43918,99200,2012
26019,46.4,17554,16667,72,315,5160,47491,7520,6364,1156,7520,155700,2012
26021,40.8,156759,119031,23713,7113,40407,43471,61286,44537,16749,61286,135100,2012
26023,40,44920,40898,1208,1836,11260,42995,16036,12630,3406,16036,104700,2012
26025,39.2,136063,108661,14577,6137,34732,42164,53290,37565,15725,53290,102800,2012
26027,42.5,52412,45813,2702,1571,14394,45462,19801,16517,3284,19801,133000,2012
26029,45.3,26057,24690,139,364,7482,47177,10699,8922,1777,10699,154400,2012
26031,47.1,26195,24347,121,236,7532,38166,11459,9425,2034,11459,116600,2012
26033,39.1,38919,27755,1905,566,9267,41114,14662,10415,4247,14662,102400,2012
26035,45.5,30924,29547,149,472,8461,33334,13301,10684,2617,13301,84100,2012
26037,38.5,75274,68321,1503,2944,20054,58231,28642,23281,5361,28642,159200,2012
26039,47.5,14119,13586,147,197,4005,39982,5921,4812,1109,5921,105000,2012
26041,45.5,37075,34885,95,330,10511,42504,16071,12602,3469,16071,99600,2012
26043,45.4,26286,25353,75,278,7583,44272,11322,9209,2113,11322,87000,2012
26045,40.4,107861,91571,6046,5139,28878,55301,43300,31909,11391,43300,143300,2012
26047,43.1,32799,30175,190,433,9172,50686,13541,10403,3138,13541,175700,2012
26049,38.4,425337,309430,85862,12938,108321,42730,166386,117000,49386,166386,99900,2012
26051,47.5,25736,24889,140,315,7634,38571,11111,9432,1679,11111,108300,2012
26053,46.8,16297,14845,739,154,4187,34397,7234,5510,1724,7234,67500,2012
26055,40.8,87483,81603,1024,1959,22687,51641,34362,26348,8014,34362,169800,2012
26057,38.5,42340,37059,2148,2264,10144,40224,14721,11357,3364,14721,88200,2012
26059,40.8,46617,44673,231,849,12619,42668,17557,14173,3384,17557,106900,2012
26061,33.1,36519,34083,253,443,8213,34453,14130,9957,4173,14130,85700,2012
26063,46.8,33001,31719,68,644,9084,40349,14012,11511,2501,14012,97800,2012
26065,31.3,281323,204023,30562,20463,61721,45567,108445,65206,43239,108445,125400,2012
26067,36.5,64149,56942,2390,2827,16103,47580,22448,17546,4902,22448,113600,2012
26069,51.1,25880,24670,96,418,6874,35396,10878,9172,1706,10878,93700,2012
26071,51.6,11837,11370,139,165,3188,35551,5276,4469,807,5276,75100,2012
26073,25.3,70186,61310,1700,2288,13722,35927,24752,14585,10167,24752,122100,2012
26075,39.5,160257,137405,12650,4859,40529,46572,59949,44548,15401,59949,116800,2012
26077,34,250704,200248,27496,10035,60425,46011,99720,65001,34719,99720,141200,2012
26079,43.2,17231,16516,93,219,4745,39849,7276,5965,1311,7276,102400,2012
26081,34.3,605244,459422,56343,58464,153732,51030,228204,160286,67918,228204,141000,2012
26083,51.8,2168,2094,50,8,630,42406,1012,883,129,1012,99500,2012
26085,50,11543,9878,1034,253,2594,30390,4139,3399,740,4139,83600,2012
26087,41.6,88626,82365,956,3682,24304,52369,32783,27601,5182,32783,145700,2012
26089,50.5,21677,19670,87,819,6636,53982,9316,7943,1373,9316,237100,2012
26091,40.2,99878,87433,2394,7588,25776,48528,37591,29378,8213,37591,124400,2012
26093,40.9,181678,172989,750,3532,50874,72396,67399,57867,9532,67399,191000,2012
26095,43.5,6590,5277,746,159,1533,42414,2404,1887,517,2404,83300,2012
26097,49.1,11144,8448,88,184,3183,38507,4940,3807,1133,4940,121500,2012
26099,40,841769,704957,72365,19226,221646,53628,330596,253156,77440,330596,134700,2012
26101,47.1,24753,22402,681,655,6827,41228,10648,8451,2197,10648,113100,2012
26103,39.5,67178,62486,1064,786,15953,45349,26324,18716,7608,26324,126300,2012
26105,45.1,28672,26564,166,1136,8353,40957,12336,9165,3171,12336,121500,2012
26107,34.1,42947,39662,1215,766,10024,38332,15695,11397,4298,15695,112500,2012
26109,46.2,24041,22674,50,292,7022,40865,10869,8710,2159,10869,96700,2012
26111,40.3,83744,77730,1065,1741,23129,52947,33696,25773,7923,33696,130200,2012
26113,41.9,14945,14301,46,318,4143,40406,5855,4757,1098,5855,106800,2012
26115,40.3,151944,140462,3017,4697,41952,54588,58292,46228,12064,58292,147600,2012
26117,39,63357,58583,1464,1948,16633,40707,23361,18774,4587,23361,99400,2012
26119,52.3,9709,9406,29,99,2741,34955,4312,3679,633,4312,96700,2012
26121,38.5,171755,132925,23806,8289,45401,40843,65247,48761,16486,65247,105700,2012
26123,40.7,48517,44110,601,2650,13184,43180,18478,15506,2972,18478,109200,2012
26125,40.2,1207097,905208,159981,42251,319765,65637,482978,349839,133139,482978,177600,2012
26127,42,26636,22285,98,3645,6901,39667,9654,8033,1621,9654,107900,2012
26129,47.5,21674,20842,62,319,5530,35320,8490,7058,1432,8490,97000,2012
26131,53.1,6703,6464,45,64,1943,33769,3333,2861,472,3333,73100,2012
26133,41.7,23486,22468,145,355,6366,37825,8964,7067,1897,8964,95700,2012
26135,49.8,8709,8436,6,87,2486,33942,3842,3262,580,3842,84100,2012
26137,42.7,24175,23184,34,310,6661,47140,9807,7952,1855,9807,117500,2012
26139,34.6,264835,226513,3133,23062,69438,55760,94389,74499,19890,94389,156400,2012
26141,51.6,13368,12932,38,116,3986,39109,6123,5443,680,6123,98900,2012
26143,53.3,24447,23581,89,276,7078,34765,11423,9502,1921,11423,97600,2012
26145,39.6,200017,141017,36402,15543,50451,42828,77426,56694,20732,77426,101600,2012
26147,41.3,162978,150217,3845,4727,44152,47877,64083,49760,14323,64083,131900,2012
26149,38.6,61314,54027,1610,4038,15645,44214,22258,17266,4992,22258,110900,2012
26151,42.7,43096,40800,185,1468,10979,40019,16413,13409,3004,16413,102500,2012
26153,48.3,8455,7369,28,66,2399,37468,3651,3125,526,3651,86300,2012
26155,40.4,70402,66949,395,1711,19579,47106,27378,21409,5969,27378,114500,2012
26157,41.6,55616,52400,560,1596,15187,43463,21243,17394,3849,21243,101000,2012
26159,40.1,76149,62802,3117,7734,19840,44425,28378,22312,6066,28378,122300,2012
26161,33.1,346010,249368,41676,13999,78474,59063,134883,82938,51945,134883,200300,2012
26163,37.2,1822469,903177,734110,95163,424714,41504,674263,441743,232520,674263,97100,2012
26165,40.8,32694,31211,150,523,8342,40660,12305,9482,2823,12305,105200,2012
27001,51.8,16166,15332,76,154,5075,41191,7761,6411,1350,7761,173400,2012
27003,37.1,331649,282532,13698,11995,86735,69916,121596,99555,22041,121596,203700,2012
27005,42.6,32600,28573,113,443,9282,49159,13454,10727,2727,13454,170500,2012
27007,33.5,44652,33188,343,708,10930,44038,16688,11812,4876,16688,147600,2012
27009,34.1,38560,36018,825,651,9949,51365,15421,10955,4466,15421,160500,2012
27011,48.7,5250,5130,17,45,1596,45545,2329,1859,470,2329,85700,2012
27013,29.9,63991,58197,1571,1633,14057,49306,24259,16145,8114,24259,161700,2012
27015,43.1,25772,24533,74,861,6722,47915,10818,8496,2322,10818,121500,2012
27017,41,35304,31423,538,488,9267,52943,13739,10781,2958,13739,160900,2012
27019,36.3,91355,82722,968,3574,25203,83275,33017,26924,6093,33017,273600,2012
27021,47,28519,24289,75,362,8914,43992,12926,10547,2379,12926,179200,2012
27023,42.7,12327,11252,43,608,3208,46579,5188,3762,1426,5188,99300,2012
27025,38.6,53526,50616,621,863,14430,66592,19669,16748,2921,19669,211200,2012
27027,32.1,58937,53317,874,2130,14508,52136,22357,15617,6740,22357,154100,2012
27029,42.3,8672,7514,51,117,2497,41896,3639,2824,815,3639,116500,2012
27031,49.8,5206,4551,28,36,1687,50309,2630,1889,741,2630,236500,2012
27033,43.6,11665,10398,63,728,3230,43225,4830,3901,929,4830,83700,2012
27035,42.7,62521,59966,446,674,18027,46822,26916,20187,6729,26916,184000,2012
27037,36.8,399443,328654,18870,23839,106650,73288,153160,117762,35398,153160,229400,2012
27039,37,20071,18776,112,920,5454,66959,7358,6344,1014,7358,160400,2012
27041,43.6,36167,35100,206,373,10488,50365,15919,11971,3948,15919,190500,2012
27043,45.9,14546,13513,74,808,4132,43835,6340,5057,1283,6340,87000,2012
27045,42.9,20880,20381,35,203,5747,48717,8525,6733,1792,8525,136400,2012
27047,44.4,31188,27616,239,2717,8512,43962,13297,10221,3076,13297,107900,2012
27049,41.9,46144,43041,502,1318,12596,55603,18690,14444,4246,18690,184700,2012
27051,46.4,6016,5829,30,94,1739,47333,2636,2069,567,2636,98100,2012
27053,35.9,1158039,831188,133791,77271,277252,63559,478563,307530,171033,478563,238300,2012
27055,44,19001,18455,39,137,5308,53453,7811,6323,1488,7811,151100,2012
27057,47.1,20372,19087,46,330,5746,45623,8579,7042,1537,8579,170800,2012
27059,37.9,38004,36152,207,599,10063,58775,13768,11307,2461,13768,185400,2012
27061,45.2,45052,41920,139,431,12951,46180,18968,15265,3703,18968,153200,2012
27063,44.4,10273,9684,28,286,3045,49886,4520,3526,994,4520,95100,2012
27065,42.1,16255,15604,88,225,4414,46323,6346,5172,1174,6346,151900,2012
27067,39.8,42150,35907,886,4653,11794,50156,17287,12707,4580,17287,162200,2012
27069,47.8,4547,4417,26,21,1225,49301,1935,1604,331,1935,66600,2012
27071,46.2,13293,12485,29,144,3532,40167,6154,4667,1487,6154,96800,2012
27073,49.1,7240,7007,29,118,2126,50203,3059,2578,481,3059,78700,2012
27075,48.4,10849,10443,10,85,3244,47210,5091,4137,954,5091,147100,2012
27077,48.5,4039,3856,45,0,1182,41979,1749,1568,181,1749,126000,2012
27079,40.2,27744,25706,110,1449,7736,57831,10992,9076,1916,10992,183500,2012
27081,46.5,5876,5734,13,79,1632,47778,2542,2118,424,2542,81300,2012
27083,34.4,25714,22564,534,1539,6157,47256,10191,6867,3324,10191,138700,2012
27085,39.1,36527,33877,166,1841,10190,55275,14937,11446,3491,14937,161000,2012
27087,37.2,5442,2706,26,114,1382,39442,2047,1520,527,2047,96800,2012
27089,44.2,9475,8977,39,343,2740,51000,4082,3355,727,4082,87800,2012
27091,45.6,20727,19620,72,763,5771,46790,8887,6716,2171,8887,102200,2012
27093,41.4,23262,22170,57,752,6732,52705,9402,7626,1776,9402,161500,2012
27095,39.5,26004,23539,121,389,6969,46363,10457,7944,2513,10457,153900,2012
27097,40.6,33173,32096,146,416,9024,47110,13564,10841,2723,13564,156400,2012
27099,38.6,39115,32945,783,4075,10303,46239,15990,11702,4288,15990,108000,2012
27101,47,8690,8283,21,244,2599,50039,3861,3202,659,3861,91500,2012
27103,33.3,32689,29861,721,1203,8157,59490,12163,9090,3073,12163,169200,2012
27105,36.7,21349,14252,743,4808,5604,47539,7937,5807,2130,7937,104900,2012
27107,45.1,6796,6236,7,278,1735,45000,2782,2241,541,2782,81900,2012
27109,36.3,144507,120545,6794,6071,37655,66667,56840,42757,14083,56840,172400,2012
27111,46,57381,54266,456,1518,16567,47579,24394,19278,5116,24394,161900,2012
27113,39.5,13950,12875,189,387,3480,47880,5783,4347,1436,5783,100800,2012
27115,42.4,29564,26751,579,713,7955,44291,11967,9632,2335,11967,151400,2012
27117,42.6,9536,8816,49,353,2627,44817,3879,2843,1036,3879,87200,2012
27119,40.3,31426,28341,242,1722,8450,49859,12569,9049,3520,12569,123200,2012
27121,45.8,10978,10699,46,95,3170,51148,4757,3793,964,4757,145300,2012
27123,34.6,510885,342069,54016,36471,119222,53152,204787,123273,81514,204787,208100,2012
27125,41.6,4100,3873,17,104,1161,48750,1691,1393,298,1691,82400,2012
27127,42.6,16006,14122,91,338,4291,46071,6562,5047,1515,6562,88300,2012
27129,43.9,15653,14254,78,1051,4286,49800,6418,5070,1348,6418,101400,2012
27131,34.9,64171,54386,1978,5051,15803,60438,22432,17083,5349,22432,197100,2012
27133,41.4,9620,9170,76,197,2698,45660,3967,3007,960,3967,111300,2012
27135,40.3,15665,14736,52,120,4480,50620,6380,4953,1427,6380,102900,2012
27137,40.8,200150,184721,2802,2466,50641,46231,85478,60841,24637,85478,140500,2012
27139,34.9,130689,110353,3347,5823,34237,84571,45133,38527,6606,45133,253100,2012
27141,34.3,88558,82145,1536,1935,22583,72041,29968,24575,5393,29968,202600,2012
27143,40.6,15189,13799,67,1097,4092,52996,6111,4872,1239,6111,143900,2012
27145,33.4,150307,136227,4556,4150,37131,53861,56467,40913,15554,56467,169000,2012
27147,38.8,36524,32498,779,2290,9672,58403,14190,10964,3226,14190,157500,2012
27149,34.3,9712,8893,39,336,2263,52819,3691,2676,1015,3691,121100,2012
27151,44.4,9764,9209,133,355,2747,45984,4308,3193,1115,4308,91000,2012
27153,41.9,24783,22984,70,1237,7023,45287,10109,8355,1754,10109,130200,2012
27155,47.6,3549,3311,2,50,974,44025,1569,1273,296,1569,66300,2012
27157,43,21636,20676,96,595,6136,53537,8846,7347,1499,8846,159300,2012
27159,43.4,13808,13216,57,178,3748,35767,5833,4372,1461,5833,114900,2012
27161,39.3,19089,17242,326,1000,5128,53433,7367,5872,1495,7367,140700,2012
27163,38.2,238721,204217,8131,8195,65144,80747,88216,72218,15998,88216,249300,2012
27165,40.4,11177,8571,12,2337,3046,49210,4463,3396,1067,4463,95100,2012
27167,42.8,6584,6283,15,141,1872,52970,2679,2213,466,2679,105700,2012
27169,33.1,51481,47809,567,1222,11635,46900,19254,13780,5474,19254,160400,2012
27171,34.6,124737,116620,1115,3100,33770,70930,44816,37801,7015,44816,204100,2012
27173,42.7,10357,9503,30,392,2910,52134,4125,3288,837,4125,100900,2012
28001,40.4,32391,12532,18633,879,7433,27486,12243,8341,3902,12243,81800,2012
28003,39.4,37027,31221,4284,992,9702,32846,14164,9917,4247,14164,86300,2012
28005,44.3,13139,7477,5576,38,3213,30471,5191,4331,860,5191,68600,2012
28007,39.9,19454,10800,8200,329,5122,31102,7249,5407,1842,7249,73200,2012
28009,40.2,8725,5254,3133,153,2164,26899,3213,2611,602,3213,84400,2012
28011,34.2,34239,11187,22478,160,7918,27768,12410,6738,5672,12410,82500,2012
28013,39.3,14903,9778,4181,800,3898,30768,6005,4211,1794,6005,59700,2012
28015,42.3,10553,6825,3536,0,2659,30568,3814,3188,626,3814,65000,2012
28017,38.4,17458,9203,7283,645,4629,31028,6673,4793,1880,6673,64600,2012
28019,42.4,8506,5731,2714,27,2192,30180,3377,2510,867,3377,72600,2012
28021,31.7,9681,1386,8112,74,2019,24078,3257,2523,734,3257,52000,2012
28023,40.8,16688,10615,5905,106,4763,31831,6446,5300,1146,6446,63000,2012
28025,38.8,20633,8197,12101,118,5814,31228,7873,5567,2306,7873,81900,2012
28027,32.8,26099,5952,19522,314,6204,25574,9276,5011,4265,9276,57400,2012
28029,36.4,29324,13307,14969,777,6702,36645,10014,7522,2492,10014,70100,2012
28031,37.2,19571,12141,7020,205,4665,32345,6821,5744,1077,6821,76600,2012
28033,35.1,161536,113506,32542,7916,43643,58851,57518,43933,13585,57518,153000,2012
28035,31.1,75378,44095,27298,2570,16918,35459,27964,15995,11969,27964,114800,2012
28037,41.4,8055,5155,2787,5,2323,31819,3263,2692,571,3263,64900,2012
28039,36.3,22579,19949,1900,471,6026,46263,8031,6655,1376,8031,99800,2012
28041,36.3,14352,10251,3416,154,3173,38836,4131,3399,732,4131,84400,2012
28043,39.3,21886,12304,9305,15,5761,35912,8483,6021,2462,8483,84900,2012
28045,40.5,44044,37915,3321,1472,12582,43727,17712,13612,4100,17712,142400,2012
28047,35.4,188110,126105,41502,9786,47478,43593,71418,45220,26198,71418,143900,2012
28049,33,246335,69132,169745,3681,58071,38152,88197,52640,35557,88197,109500,2012
28051,32.2,19207,3063,16027,19,4254,22335,6604,4723,1881,6604,51300,2012
28053,35.1,9399,2144,7046,205,2094,24783,3159,1800,1359,3159,61500,2012
28055,40.2,1556,518,1033,5,301,24474,488,362,126,488,60400,2012
28057,39.1,23362,21363,1473,304,6513,36235,8897,7023,1874,8897,81900,2012
28059,37,139430,97384,29962,6365,35125,49750,50180,35880,14300,50180,126600,2012
28061,41.2,17033,7809,8795,240,4606,30998,6891,5526,1365,6891,69900,2012
28063,38.6,7743,1057,6674,6,1634,20281,2578,1794,784,2578,64900,2012
28065,41.4,12364,4778,7472,23,3320,27201,4851,3950,901,4851,76400,2012
28067,36.8,67868,44491,19124,3157,17833,38233,24657,18086,6571,24657,86300,2012
28069,37.4,10391,3663,6101,158,2445,27471,3786,2949,837,3786,65900,2012
28071,27.3,47586,33580,11447,1054,9141,42688,15301,9542,5759,15301,159900,2012
28073,33.1,55580,42454,10700,1184,14871,50743,21473,14388,7085,21473,160900,2012
28075,36.9,80204,43348,33889,1475,20376,36814,29715,19908,9807,29715,87300,2012
28077,40.1,12832,8439,4259,45,3413,38364,4825,3866,959,4825,77700,2012
28079,32.7,23563,11494,9592,1008,5716,30862,7977,6049,1928,7977,71900,2012
28081,35.9,83235,56930,22662,1994,22656,41242,31759,21969,9790,31759,108700,2012
28083,32.5,32196,7979,22949,763,7053,23659,10942,5541,5401,10942,67400,2012
28085,37.5,34850,23620,10634,342,9708,37176,13184,10120,3064,13184,80100,2012
28087,36.2,59584,31737,26014,921,15628,37508,23429,14762,8667,23429,112500,2012
28089,36.1,95481,53543,36441,2712,24711,60195,35774,25076,10698,35774,196600,2012
28091,37.8,26810,17441,8790,340,7007,31865,9786,7639,2147,9786,79500,2012
28093,38.5,37019,18005,17587,1157,9275,34459,13019,10297,2722,13019,86100,2012
28095,39.2,36912,24837,11405,353,10536,35370,14393,11154,3239,14393,80100,2012
28097,41.1,10866,5720,5086,0,2852,30440,4216,3088,1128,4216,68600,2012
28099,35.3,29682,17795,6191,507,7514,37893,10614,7923,2691,10614,73200,2012
28101,37.8,21687,13572,6622,303,5937,35907,7977,6253,1724,7977,68400,2012
28103,36.5,11511,3126,8274,93,2866,22652,4173,2936,1237,4173,61300,2012
28105,25.2,47486,27579,17473,702,9983,29430,18482,9255,9227,18482,119400,2012
28107,36,34675,16896,17107,505,8161,36147,12078,9206,2872,12078,76400,2012
28109,39.2,55886,45943,7067,1633,15030,41940,20519,15979,4540,20519,115700,2012
28111,39.4,12217,9462,2719,0,3526,35942,4629,3994,635,4629,80200,2012
28113,37.1,40300,18489,20805,505,10085,35212,14867,10410,4457,14867,81000,2012
28115,36,29962,23578,4257,1780,7100,40260,9962,7864,2098,9962,79900,2012
28117,38.7,25384,21245,3365,308,7077,33294,9673,7398,2275,9673,73800,2012
28119,38.5,8171,2371,5700,67,2060,23115,3155,2086,1069,3155,47400,2012
28121,36.2,142136,108345,26882,3662,38785,57593,52870,39995,12875,52870,148000,2012
28123,35,28207,14357,10647,2923,6814,35074,9765,7883,1882,9765,65100,2012
28125,38.2,4835,1353,3442,33,1112,32340,1663,1060,603,1663,65800,2012
28127,38.1,27476,17118,9673,417,7009,37977,9979,7657,2322,9979,77000,2012
28129,39.2,16425,12295,3851,203,4693,36519,6244,5321,923,6244,78100,2012
28131,35.5,17657,13685,3414,247,4303,42862,5873,4811,1062,5873,103700,2012
28133,33.4,29230,7397,21224,405,5848,26611,8369,4832,3537,8369,66900,2012
28135,35.4,15262,5552,8158,1344,3201,27689,4637,3398,1239,4637,60700,2012
28137,36.2,28580,18897,8764,638,7063,43277,10003,7237,2766,10003,116900,2012
28139,38.1,22095,17327,3263,992,6287,34523,8495,6648,1847,8495,72300,2012
28141,42.5,19573,18298,629,552,5512,32878,7569,5941,1628,7569,73400,2012
28143,32.2,10716,2460,7828,239,2390,30463,4081,1881,2200,4081,72200,2012
28145,37.1,27175,21682,3704,1188,7704,36582,10286,7510,2776,10286,81800,2012
28147,36.8,15405,8079,6992,238,3706,32260,5466,4461,1005,5466,79600,2012
28149,37.9,48419,24013,22666,925,12156,40876,18702,12296,6406,18702,98900,2012
28151,35.2,51010,13729,36158,565,12553,27610,18395,10031,8364,18395,73700,2012
28153,37.5,20754,12287,8063,252,5879,30783,8296,6991,1305,8296,64700,2012
28155,40.5,10162,7923,1985,113,3030,35391,4032,2971,1061,4032,75200,2012
28157,36.2,9778,2828,6897,43,2367,35960,3497,2641,856,3497,61000,2012
28159,39.4,19160,9902,9039,183,4966,32094,7441,5547,1894,7441,79100,2012
28161,40.2,12647,7570,4809,159,3253,32343,4716,3478,1238,4716,63900,2012
28163,35.4,28220,10507,15853,1393,5991,26769,8656,5246,3410,8656,64800,2012
29001,29.1,25542,23636,492,540,5476,33284,9597,5937,3660,9597,99300,2012
29003,41.9,17205,16503,101,294,4887,57406,6698,5278,1420,6698,130300,2012
29005,46.1,5664,5507,62,56,1553,46059,2447,1730,717,2447,76900,2012
29007,38.6,25617,22676,1632,659,6348,41387,9275,6839,2436,9275,85300,2012
29009,41.8,35680,31564,10,2776,9481,38153,13656,10304,3352,13656,105900,2012
29011,40.5,12428,11720,13,242,3485,39576,4932,3767,1165,4932,84400,2012
29013,41.5,17003,16240,71,289,4512,39371,6733,5021,1712,6733,104300,2012
29015,51.5,19021,18187,35,295,5516,33349,8085,6854,1231,8085,104300,2012
29017,42.5,12389,12057,73,101,3419,37016,4803,3901,902,4803,97000,2012
29019,29.6,163266,131992,14282,4919,36702,47786,64577,37184,27393,64577,158900,2012
29021,36.6,89162,76753,3973,4687,21209,44181,33582,22073,11509,33582,108300,2012
29023,40.6,42792,38435,2343,678,11245,34343,17067,11427,5640,17067,88300,2012
29025,41.7,9302,8909,65,144,2687,41324,3732,2732,1000,3732,88200,2012
29027,37.6,44157,40091,1823,726,11563,50516,16828,13159,3669,16828,133200,2012
29029,48.7,43731,41656,174,1007,12383,44577,17620,14118,3502,17620,181500,2012
29031,36.3,75690,66557,5325,1514,19551,46154,29502,20003,9499,29502,137600,2012
29033,41.8,9279,8861,169,119,2523,44858,3659,2905,754,3659,79700,2012
29035,40.3,6225,5933,42,52,1571,27209,2432,1811,621,2432,100300,2012
29037,38.3,99394,88914,3217,3937,27662,60595,37220,29088,8132,37220,155400,2012
29039,44.6,13941,13380,29,215,3995,31677,6061,4513,1548,6061,88000,2012
29041,45.3,7759,7466,193,44,2023,40538,3011,2364,647,3011,76800,2012
29043,36.7,77474,72926,467,1965,22469,53549,29360,21829,7531,29360,145000,2012
29045,43.1,7082,6915,45,35,1790,40466,2781,2139,642,2781,67800,2012
29047,36.4,222048,186482,10866,13118,59033,60560,86701,62049,24652,86701,154600,2012
29049,40.6,20687,19544,288,336,5735,53234,8031,5910,2121,8031,147800,2012
29051,37.8,75813,62765,8451,1811,19607,55465,29556,19772,9784,29556,142200,2012
29053,37.6,17542,15676,989,238,4535,45200,6508,4734,1774,6508,114300,2012
29055,40.2,24753,23851,44,377,6435,35794,9600,7246,2354,9600,106400,2012
29057,46.3,7811,7406,54,119,2133,34000,3144,2418,726,3144,74400,2012
29059,41.7,16825,15991,23,268,4771,40286,6532,5240,1292,6532,99500,2012
29061,40.3,8341,8105,33,90,2233,42617,3078,2375,703,3078,107900,2012
29063,40.2,12878,11021,1126,227,2576,43898,3823,2540,1283,3823,111300,2012
29065,42.9,15595,14940,45,157,4195,36288,5927,4454,1473,5927,82800,2012
29067,44.9,13690,13398,9,115,3625,31277,5077,3925,1152,5077,108400,2012
29069,39.5,31970,26493,3154,1751,8203,30379,12664,7733,4931,12664,69200,2012
29071,39.4,101440,97303,1191,1406,27422,48322,39038,29775,9263,39038,150100,2012
29073,45.1,15160,14713,47,161,4197,41304,6310,4916,1394,6310,115500,2012
29075,42.1,6773,6633,38,39,1826,38465,2751,2035,716,2751,76000,2012
29077,35.6,275671,246781,7688,8302,69860,41458,114944,68826,46118,114944,128700,2012
29079,41.8,10256,9840,92,123,2641,37533,4181,3003,1178,4181,77700,2012
29081,42.6,8901,8599,63,144,2353,36909,3620,2687,933,3620,73000,2012
29083,43.9,22234,21159,267,378,6180,39551,9548,6799,2749,9548,101000,2012
29085,52.7,9554,8731,36,99,2850,29400,4259,3563,696,4259,97300,2012
29087,46.1,4840,4701,34,12,1468,42706,2233,1681,552,2233,78900,2012
29089,39.7,10160,9255,533,127,2527,42104,3826,2885,941,3826,96200,2012
29091,39.6,40330,38396,136,698,10824,34148,15606,10968,4638,15606,101100,2012
29093,42.8,10563,10088,121,131,2831,33333,4208,3076,1132,4208,75000,2012
29095,36.2,672784,426354,159259,55470,164788,47023,270645,167144,103501,270645,128400,2012
29097,35.1,116493,100389,2178,7891,29878,39908,45005,29316,15689,45005,97200,2012
29099,37.7,218628,208509,1476,3443,59344,55743,81159,67341,13818,81159,154200,2012
29101,29.7,52964,46589,2324,1687,13158,47960,19765,12386,7379,19765,137100,2012
29103,43.9,4111,3993,25,16,1111,32500,1806,1338,468,1806,54000,2012
29105,39.1,35507,33571,234,707,10250,39101,14169,10096,4073,14169,92300,2012
29107,40.3,33278,30927,865,740,9526,51917,13250,9995,3255,13250,119600,2012
29109,39.3,38559,35052,125,2420,10346,38568,14907,10845,4062,14907,95300,2012
29111,38.7,10203,9513,306,157,2688,41758,3882,2873,1009,3882,80100,2012
29113,35.6,52637,49472,881,1057,13662,53822,18664,15057,3607,18664,151000,2012
29115,43,12668,12201,75,196,3132,39028,4873,3667,1206,4873,72400,2012
29117,41.5,15068,14246,385,181,3644,42241,5549,3937,1612,5549,94800,2012
29119,36.5,22970,18572,193,2542,5752,36719,8257,5679,2578,8257,86100,2012
29121,42.1,15532,14700,384,158,4141,37405,6366,4890,1476,6366,85900,2012
29123,41.2,12334,11885,19,233,3427,36197,4783,3706,1077,4783,82400,2012
29125,43.1,9140,8833,41,83,2708,44885,3696,2937,759,3696,118600,2012
29127,39.3,28703,26128,1646,396,7530,42756,11180,7784,3396,11180,102000,2012
29129,43.7,3763,3656,19,39,1039,38125,1566,1210,356,1566,72000,2012
29131,40.3,24822,23797,168,364,6863,34763,10188,7670,2518,10188,110900,2012
29133,39.8,14231,10416,3405,239,3246,29606,5261,3439,1822,5261,63000,2012
29135,37.4,15587,13762,709,616,3881,49394,5506,4104,1402,5506,114000,2012
29137,44,8876,8367,295,85,2461,40707,3550,2710,840,3550,85700,2012
29139,42.9,12181,11585,96,174,3564,40565,5072,3807,1265,5072,106600,2012
29141,47,20479,19503,144,358,5606,35446,8243,6812,1431,8243,111400,2012
29143,39.7,18780,15221,2944,224,5043,35174,7517,4726,2791,7517,71300,2012
29145,39.1,58314,51203,464,2574,15701,42644,21853,16397,5456,21853,105000,2012
29147,28.1,23305,21797,550,505,4681,37815,8635,4932,3703,8635,100900,2012
29149,45.1,10885,10388,16,140,2815,26926,4538,3509,1029,4538,71700,2012
29151,39.2,13857,13627,109,85,3870,51006,5224,4367,857,5224,122000,2012
29153,49.5,9672,9321,14,132,3112,32126,4143,3322,821,4143,92500,2012
29155,36.9,18288,12712,5039,358,4443,30194,6997,3961,3036,6997,64700,2012
29157,39.5,18986,18265,109,331,5269,45553,7581,5848,1733,7581,122400,2012
29159,37.3,42044,36576,1113,3059,10745,38543,16301,11314,4987,16301,97100,2012
29161,34,44825,40419,882,930,10559,41388,16615,10546,6069,16615,110400,2012
29163,39.8,18574,16510,1207,353,4581,40812,6606,4714,1892,6606,90100,2012
29165,38.5,89567,75512,5196,4495,24398,67419,36104,23722,12382,36104,185600,2012
29167,38.1,31035,29476,248,593,8391,38852,11825,8225,3600,11825,110900,2012
29169,26.6,51620,37337,5676,4672,10304,47251,15718,8531,7187,15718,122000,2012
29171,45.2,4976,4858,25,37,1519,35233,2324,1739,585,2324,91900,2012
29173,44.2,10198,9849,39,103,3021,50145,4121,3381,740,4121,111200,2012
29175,37.9,25388,22705,1644,419,6025,38067,8978,6312,2666,8978,85000,2012
29177,40,23422,22244,311,431,6557,52656,9058,7015,2043,9058,119000,2012
29179,44.8,6682,6403,59,66,1741,33326,2746,2106,640,2746,78100,2012
29181,41.9,14070,13501,49,155,3984,31431,5454,3908,1546,5454,72500,2012
29183,37,360695,321309,15732,10060,98029,71416,134693,109008,25685,134693,193600,2012
29185,48.6,9693,9253,64,167,2880,32075,4365,3434,931,4365,80000,2012
29186,42.6,18066,17506,137,151,5031,47809,7315,6020,1295,7315,125600,2012
29187,38.7,65246,60506,3035,797,16092,36716,24615,17143,7472,24615,100000,2012
29189,39.8,999147,688471,230273,25016,264111,58485,404151,288602,115549,404151,177400,2012
29195,38,23232,19302,1321,1935,5733,39090,8811,6051,2760,8811,82700,2012
29197,41.4,4397,4316,41,3,1104,30896,1756,1249,507,1756,65100,2012
29199,39.4,4843,4760,7,47,1345,40017,1967,1556,411,1967,74400,2012
29201,38.9,39192,33262,4445,706,10543,38968,15284,10376,4908,15284,96700,2012
29203,44.2,8407,7973,49,139,2411,33091,3371,2698,673,3371,78100,2012
29205,43.4,6328,6155,78,46,1652,34219,2643,1852,791,2643,71300,2012
29207,41.4,29902,28815,426,366,8243,37303,12115,8536,3579,12115,83500,2012
29209,49.7,31968,27619,38,568,9716,42084,13216,10404,2812,13216,145000,2012
29211,40.2,6667,5341,22,1212,1721,34247,2628,1769,859,2628,70800,2012
29213,41.1,51596,47014,90,2481,13445,40112,20426,13269,7157,20426,134800,2012
29215,41.9,25840,23828,831,441,6737,34520,9666,7102,2564,9666,92900,2012
29217,40.3,20958,19937,127,342,5289,38138,8160,5864,2296,8160,83600,2012
29219,39.7,32440,30094,540,943,9018,47877,12648,9872,2776,12648,153100,2012
29221,40.1,25120,23885,524,264,6516,34015,9221,7016,2205,9221,75400,2012
29223,45.9,13444,12967,34,151,3723,30427,5660,4140,1520,5660,71100,2012
29225,37.6,36183,34420,419,618,9534,42384,12822,9839,2983,12822,117100,2012
29227,47.5,2146,2117,0,6,674,39946,979,740,239,979,58300,2012
29229,40.6,18732,18014,118,253,5211,29485,7415,5188,2227,7415,89700,2012
29510,34,318527,134581,155495,11005,66156,34384,139840,63757,76083,139840,121700,2012
30001,44,9228,8537,20,337,2456,41039,4110,2552,1558,4110,171600,2012
30003,30.1,12872,3921,1,552,2615,36803,3532,2305,1227,3532,90400,2012
30005,35,6514,3133,0,119,1535,37899,2293,1483,810,2293,74900,2012
30007,45.6,5575,5268,36,58,1672,47480,2417,1872,545,2417,162600,2012
30009,48,10057,9623,6,204,2768,47030,4216,3095,1121,4216,196800,2012
30011,51.5,1276,1252,0,5,387,38750,545,415,130,545,76500,2012
30013,38.7,81248,70888,836,2810,21414,43817,33352,22057,11295,33352,155100,2012
30015,41.5,5811,4415,0,96,1538,41232,2196,1370,826,2196,111100,2012
30017,41.7,11706,11005,28,268,3053,43232,5075,3403,1672,5075,104200,2012
30019,51.7,1734,1625,0,4,535,43563,853,662,191,853,93900,2012
30021,42.1,9022,8517,17,190,2560,49894,3789,2584,1205,3789,115900,2012
30023,46.2,9277,8506,59,262,2329,34716,3900,2786,1114,3900,116100,2012
30025,40.8,3051,2979,0,11,848,49732,1231,918,313,1231,101200,2012
30027,48.1,11507,10989,11,180,3024,39276,4920,3677,1243,4920,116200,2012
30029,41.2,90967,85418,209,2131,24351,45545,36916,26462,10454,36916,231300,2012
30031,32.4,90339,84260,344,2508,22085,52211,36659,22446,14213,36659,270500,2012
30033,48,1100,1072,0,4,300,40125,467,354,113,467,85000,2012
30035,31.4,13422,4202,1,265,3015,36872,4245,2543,1702,4245,81400,2012
30037,50.2,769,757,0,9,205,38289,324,267,57,324,92800,2012
30039,51.8,3083,2964,4,48,931,40511,1487,1098,389,1487,183600,2012
30041,35.2,16157,11718,33,382,4083,42875,6130,4159,1971,6130,116100,2012
30043,46.8,11360,10686,73,220,3187,60459,4549,3859,690,4549,230200,2012
30045,51.3,2052,2011,0,16,533,41100,870,698,172,870,96700,2012
30047,41,28794,19625,60,1028,7819,37211,12023,8236,3787,12023,216200,2012
30049,40.7,63432,58616,254,1611,16314,54535,26598,19408,7190,26598,200600,2012
30051,47.6,2326,2246,8,0,570,40734,847,528,319,847,83000,2012
30053,49.2,19594,18450,54,467,5802,33234,8971,6880,2091,8971,164900,2012
30055,47.1,1808,1764,0,0,508,46528,763,579,184,763,94500,2012
30057,50,7688,7322,15,191,2369,48600,3726,2691,1035,3726,238000,2012
30059,46.9,1900,1869,0,15,458,35000,726,508,218,726,116500,2012
30061,49.6,4203,3922,95,85,981,32618,1641,1168,473,1641,168600,2012
30063,34.3,109402,99452,453,2911,26039,44653,45565,27183,18382,45565,238100,2012
30065,48.2,4597,4330,12,116,1357,43079,1971,1546,425,1971,116400,2012
30067,45.9,15655,14893,24,340,4205,40781,6539,4810,1729,6539,206300,2012
30069,47.6,566,515,12,30,169,40682,248,188,60,248,89200,2012
30071,48.4,4203,3622,0,23,1142,41214,1795,1409,386,1795,82200,2012
30073,42.9,6147,5027,30,88,1534,39223,2303,1566,737,2303,92900,2012
30075,47.4,1639,1548,0,29,469,42500,694,512,182,694,103900,2012
30077,45.4,7067,6444,24,146,1549,40765,2406,1728,678,2406,118400,2012
30079,56.3,1193,1137,0,6,355,34875,524,448,76,524,76500,2012
30081,46.3,40311,37840,111,1203,11210,40525,16657,12503,4154,16657,243500,2012
30083,40.5,9961,9267,43,323,2774,56050,4186,2835,1351,4186,136000,2012
30085,30.9,10477,3758,5,147,2049,40146,3303,2028,1275,3303,64800,2012
30087,37.3,9261,5544,47,318,2315,45977,3285,2257,1028,3285,105800,2012
30089,49.9,11421,10337,26,243,3383,30900,5203,4029,1174,5203,165500,2012
30091,48.2,3447,3269,6,22,969,48148,1606,1152,454,1606,98000,2012
30093,41.7,34164,31484,71,1265,8550,39211,14935,9850,5085,14935,127400,2012
30095,46,9096,8659,15,220,2660,53533,3758,2931,827,3758,180900,2012
30097,43.1,3661,3533,0,85,916,44179,1267,954,313,1267,189200,2012
30099,45.6,6082,5777,5,82,1704,42423,2389,1839,550,2389,140000,2012
30101,42.8,5210,4664,17,146,1338,45057,2041,1337,704,2041,105300,2012
30103,51.9,698,600,0,59,221,38125,336,228,108,336,64700,2012
30105,45.8,7423,6404,9,99,1995,45083,3247,2267,980,3247,94100,2012
30107,48.5,2142,2089,0,9,533,31496,795,639,156,795,82700,2012
30109,50.2,899,883,9,7,256,45625,378,268,110,378,78300,2012
30111,38.5,148191,130270,853,6991,38300,50608,60706,42246,18460,60706,178100,2012
31001,37.8,31299,27743,204,2457,8136,49017,12559,8767,3792,12559,96900,2012
31003,46.5,6655,6400,10,179,1974,40397,2836,2107,729,2836,69800,2012
31005,37.4,490,487,0,0,120,45769,180,118,62,180,72900,2012
31007,45.2,778,724,14,29,211,32292,309,196,113,309,85700,2012
31009,41.3,584,568,0,0,197,41364,244,135,109,244,50400,2012
31011,45.7,5473,5394,1,63,1575,44491,2315,1796,519,2315,79200,2012
31013,40.5,11345,9534,11,1183,3132,44025,4849,3087,1762,4849,90800,2012
31015,50.8,2025,1983,20,12,551,38281,899,734,165,899,55100,2012
31017,46.7,3183,3108,4,23,864,33333,1480,1057,423,1480,56100,2012
31019,32.3,46330,41307,332,3451,11231,50307,17462,11349,6113,17462,136500,2012
31021,47.2,6829,6472,32,145,1986,47786,2938,2250,688,2938,84000,2012
31023,44.4,8345,8028,75,206,2271,50569,3508,2614,894,3508,94600,2012
31025,40.9,25214,24041,163,636,7100,64979,9714,7798,1916,9714,148300,2012
31027,44.5,8807,8607,12,117,2271,43718,3435,2748,687,3435,87300,2012
31029,43.7,3964,3507,1,438,1206,43125,1718,1363,355,1718,83200,2012
31031,47.1,5722,5155,13,195,1667,45172,2534,1778,756,2534,99800,2012
31033,40.3,10038,9123,24,600,2869,50694,4438,2963,1475,4438,101300,2012
31035,43.8,6497,5908,14,486,1837,45711,2647,2091,556,2647,75900,2012
31037,34.4,10453,6012,89,4257,2626,48561,3635,2760,875,3635,85300,2012
31039,43.4,9140,8247,2,759,2567,47325,3750,2802,948,3750,85900,2012
31041,44.7,10904,10508,15,221,3254,44306,4636,3577,1059,4636,75900,2012
31043,32.8,20869,11611,744,7294,5412,44928,7253,4574,2679,7253,98300,2012
31045,34.9,9176,8041,190,318,2137,36974,3772,2364,1408,3772,96100,2012
31047,36.5,24267,15466,768,7671,6301,45208,8853,6128,2725,8853,84500,2012
31049,49.1,1962,1873,7,63,507,40093,854,661,193,854,67300,2012
31051,41,5982,5262,9,630,1738,45814,2373,1769,604,2373,75500,2012
31053,40.2,36590,32142,125,3582,10129,46475,15293,10353,4940,15293,109900,2012
31055,33.6,518271,373503,57937,57608,124815,53295,202215,128281,73934,202215,142900,2012
31057,47.4,1996,1872,3,113,615,39596,906,626,280,906,72500,2012
31059,45.9,5867,5598,37,179,1616,45970,2498,1963,535,2498,77200,2012
31061,48.8,3196,3113,7,36,894,42054,1382,1144,238,1382,50300,2012
31063,44.8,2693,2644,7,18,749,51328,1108,848,260,1108,75900,2012
31065,47.1,4922,4703,7,138,1444,40759,2177,1598,579,2177,56600,2012
31067,43.6,22209,21298,34,395,5733,46164,9027,6512,2515,9027,103100,2012
31069,51.4,2011,1845,0,115,603,40125,869,653,216,869,62100,2012
31071,49.1,2106,2078,13,0,549,39241,882,657,225,882,83900,2012
31073,45.4,2020,1908,12,70,561,44241,784,601,183,784,101900,2012
31075,47.3,608,600,0,7,176,40982,243,167,76,243,48400,2012
31077,46.1,2515,2428,14,67,701,44219,1022,818,204,1022,57300,2012
31079,35.6,58681,42635,1104,13616,14636,48044,22106,14530,7576,22106,113600,2012
31081,42.9,9096,8797,16,191,2473,56809,3408,2650,758,3408,112000,2012
31083,49.9,3419,3342,3,39,972,44801,1525,1219,306,1525,70800,2012
31085,45.5,1037,978,2,51,309,47150,425,288,137,425,65000,2012
31087,49.1,2898,2805,3,51,865,40000,1356,1006,350,1356,58100,2012
31089,45.9,10418,9999,2,310,2901,47768,4314,3304,1010,4314,87500,2012
31091,47.8,689,670,0,11,199,38750,294,238,56,294,62900,2012
31093,43.2,6294,6077,36,118,1809,48293,2629,2091,538,2629,98800,2012
31095,47,7572,7231,5,213,2100,43407,3276,2581,695,3276,72700,2012
31097,43.7,5188,4300,273,454,1161,42689,1943,1492,451,1943,78600,2012
31099,41.9,6514,6167,4,258,1790,54485,2586,2020,566,2586,98700,2012
31101,48.2,8284,7639,15,465,2400,43662,3765,2705,1060,3765,88000,2012
31103,53.7,742,731,0,0,247,33472,369,314,55,369,71300,2012
31105,46.8,3789,3408,30,268,1043,43542,1681,1194,487,1681,77100,2012
31107,46.6,8648,7627,41,161,2502,41372,3768,2791,977,3768,72500,2012
31109,32.6,286425,241832,10055,16766,69837,51810,113724,69321,44403,113724,147500,2012
31111,38.7,36212,32627,242,2638,9567,49382,15028,10634,4394,15028,110300,2012
31113,50.5,724,717,0,7,237,44444,328,249,79,328,91700,2012
31115,47.5,534,495,0,18,157,37708,233,182,51,233,58200,2012
31117,49,348,348,0,0,132,51563,172,117,55,172,95000,2012
31119,37.2,34766,29025,431,4457,8911,45717,13923,9192,4731,13923,106500,2012
31121,43.3,7779,7327,41,274,2269,49609,3266,2371,895,3266,84200,2012
31123,43.1,4993,4222,4,670,1468,42025,2084,1401,683,2084,76900,2012
31125,44.9,3730,3632,4,78,1015,40714,1546,1146,400,1546,63600,2012
31127,41.5,7224,6899,45,138,1863,41929,3052,2127,925,3052,85300,2012
31129,49.3,4490,4325,18,95,1354,33875,2069,1602,467,2069,52100,2012
31131,42.7,15729,14481,23,899,4338,50917,6439,4684,1755,6439,117300,2012
31133,49.3,2753,2692,0,38,801,43634,1309,994,315,1309,59600,2012
31135,45.1,2947,2838,0,93,859,53299,1219,893,326,1219,83700,2012
31137,43.9,9184,8677,11,386,2569,47871,3875,2829,1046,3875,98200,2012
31139,41.9,7231,7052,6,97,2061,52096,2935,2318,617,2935,94400,2012
31141,38.7,32195,27131,33,4449,8277,51395,12467,8958,3509,12467,112000,2012
31143,45.1,5371,5143,8,159,1533,52012,2225,1645,580,2225,93400,2012
31145,42.4,11013,10299,92,456,3030,45206,4799,3325,1474,4799,81100,2012
31147,47.7,8355,7815,7,114,2182,38977,3782,2837,945,3782,61500,2012
31149,49.4,1540,1477,12,19,439,41619,661,568,93,661,57500,2012
31151,36,14278,10879,190,2889,3323,46434,5026,3360,1666,5026,97200,2012
31153,33,159413,133512,6189,11625,43239,69269,58876,41688,17188,58876,161500,2012
31155,41.9,20696,19899,56,424,5850,58785,8149,6581,1568,8149,142400,2012
31157,38.7,36835,27766,176,7783,9679,43113,14886,9961,4925,14886,99500,2012
31159,38.3,16729,16101,82,285,4573,60676,6269,4639,1630,6269,140800,2012
31161,46.6,5432,4541,9,168,1462,37813,2373,1688,685,2373,63300,2012
31163,48.6,3133,3068,30,26,868,43000,1366,1106,260,1366,62000,2012
31165,47.5,1262,1220,0,33,378,43558,559,419,140,559,88100,2012
31167,39,6139,5740,23,152,1810,50962,2392,1899,493,2392,97500,2012
31169,48.8,5195,5035,6,81,1457,43077,2254,1825,429,2254,62400,2012
31171,38.9,831,789,6,0,228,56429,328,242,86,328,74400,2012
31173,28.6,6926,2681,33,243,1495,41961,2045,1394,651,2045,68400,2012
31175,47.3,4322,4211,1,58,1280,44762,1886,1469,417,1886,75800,2012
31177,41,20201,19364,100,422,5440,65803,7596,6098,1498,7596,171400,2012
31179,29.4,9542,8826,137,412,2068,46612,3318,2326,992,3318,99000,2012
31181,47.5,3773,3546,4,130,1022,39722,1564,1218,346,1564,64500,2012
31183,47.3,725,679,0,42,191,39602,329,243,86,329,100400,2012
31185,42.2,13727,12786,86,564,3697,47220,5632,3961,1671,5632,99000,2012
32001,39.2,24779,18837,411,3037,6371,54538,9221,5893,3328,9221,160100,2012
32003,35.5,1954773,937276,197266,569262,459203,54218,706037,393162,312875,706037,186700,2012
32005,47.3,47056,39071,189,5127,12951,61099,19226,14012,5214,19226,303800,2012
32007,33.4,49133,33846,431,11299,12505,70411,17512,12519,4993,17512,183600,2012
32009,51.8,916,725,7,144,213,27500,514,296,218,514,64200,2012
32011,38.5,1809,1601,11,121,441,61331,709,485,224,709,115400,2012
32013,36.6,16511,11386,44,4018,4290,57874,6256,4435,1821,6256,150500,2012
32015,35.4,5751,3949,8,1413,1541,70341,1980,1489,491,1980,111200,2012
32017,35.9,5282,4408,159,380,1368,39293,1976,1386,590,1976,153900,2012
32019,40.6,51797,40379,428,7733,12784,46088,18548,13051,5497,18548,144000,2012
32021,50.4,4718,3348,85,444,1135,33547,2249,1595,654,2249,92400,2012
32023,48.8,43801,34455,1022,5983,12393,39150,18274,12805,5469,18274,124400,2012
32027,39.9,6707,4547,277,1508,1559,51094,2062,1394,668,2062,136600,2012
32029,52.8,4010,3682,15,106,1247,62561,1839,1742,97,1839,195000,2012
32031,37,422010,278383,9678,94144,101810,53994,161892,94891,67001,161892,226800,2012
32033,42,9967,7597,236,1316,2243,46505,3479,2350,1129,3479,111800,2012
32510,41.6,55184,38910,515,11800,13156,53987,21122,12776,8346,21122,221900,2012
33001,44.5,60206,57506,349,770,17190,57163,25127,19080,6047,25127,224600,2012
33003,48.2,47761,46207,63,498,13694,50865,20632,16618,4014,20632,231900,2012
33005,41.1,77106,73500,429,1119,19097,56062,30173,21503,8670,30173,199200,2012
33007,46.6,32872,31596,186,398,9112,41774,14704,10539,4165,14704,129600,2012
33009,41.2,88985,82191,785,1641,21853,53386,34816,24393,10423,34816,212800,2012
33011,39.2,401101,351250,7750,21391,104156,70472,153747,104710,49037,153747,258000,2012
33013,41.5,146742,138263,1485,2408,38335,65487,57224,41226,15998,57224,237500,2012
33015,42.3,295872,278258,2042,6349,81230,77939,115552,89320,26232,115552,288500,2012
33017,36.7,123295,114270,1044,2276,30114,58538,46821,31293,15528,46821,224000,2012
33019,44.2,43534,41834,156,505,12463,53821,18049,13339,4710,18049,177600,2012
34001,40.1,274402,160449,41207,46303,67511,54559,101018,70312,30706,101018,248100,2012
34003,41.2,906781,565170,46744,146451,238896,84255,334527,221504,113023,334527,461400,2012
34005,40.3,449117,316918,70614,29225,115689,78229,165620,129059,36561,165620,259800,2012
34007,37.7,513660,309269,92997,73288,127420,62320,188861,130044,58817,188861,218700,2012
34009,47.3,96987,84300,4493,5975,28604,56370,43514,32376,11138,43514,326400,2012
34011,36.8,156864,78947,29411,42250,35338,51530,50733,34439,16294,50733,174400,2012
34013,36.3,783840,262029,308196,159546,182400,55027,277453,128117,149336,277453,376900,2012
34015,38.7,288187,233131,27841,13801,75573,74915,104091,83949,20142,104091,232400,2012
34017,34.2,636194,194810,72299,268575,149863,58722,243156,80736,162420,243156,360400,2012
34019,43.4,127996,112173,3225,6799,34445,105880,47422,40156,7266,47422,419000,2012
34021,37.8,366442,199493,71618,55297,87973,73759,130292,86612,43680,130292,293100,2012
34023,37.2,811064,398992,71921,149204,202594,79442,280141,186569,93572,280141,340000,2012
34025,41.4,629263,483862,43599,60432,162228,84746,233661,176642,57019,233661,399000,2012
34027,41.2,493472,369189,14583,56653,129878,97979,179712,136374,43338,179712,446800,2012
34029,42.7,575961,494683,16708,47476,150559,61038,222970,182194,40776,222970,275400,2012
34031,36.2,500168,226183,56037,185476,115286,57540,162065,89213,72852,162065,361000,2012
34033,40.9,66007,50557,9207,4510,17046,59336,24950,17941,7009,24950,197200,2012
34035,40.2,323650,201972,27315,41986,83429,98571,115132,90457,24675,115132,407300,2012
34037,41.8,148962,132081,2697,9682,40822,85507,55179,46802,8377,55179,295600,2012
34039,37.9,536383,242046,110667,147010,130257,69347,184743,113247,71496,184743,373700,2012
34041,41.4,108488,92570,3886,7741,29719,73056,41638,31423,10215,41638,281600,2012
35001,36,661924,275166,16329,316307,162529,48398,263530,167406,96124,263530,190200,2012
35003,57.6,3686,2709,0,798,1010,34738,1681,1466,215,1681,151300,2012
35005,34.8,65343,28714,995,34009,16207,38155,23563,15779,7784,23563,92500,2012
35006,37.2,27293,5881,78,10004,5634,35674,8027,5720,2307,8027,81100,2012
35007,46.3,13614,6751,23,6464,3379,38263,5717,3817,1900,5717,112200,2012
35009,31.6,48101,24414,2764,18986,12150,41250,17697,10760,6937,17697,112200,2012
35011,47,2069,1122,2,904,492,32554,751,590,161,751,78000,2012
35013,32.4,208794,62603,2922,137447,51238,38462,73183,48228,24955,73183,142700,2012
35015,37,53693,27897,262,23702,13731,47940,19944,14629,5315,19944,105400,2012
35017,45.8,29602,14297,31,14348,7764,37525,12307,9362,2945,12307,127300,2012
35019,40.1,4655,891,66,3538,956,27242,1374,1114,260,1374,88800,2012
35021,53.8,612,328,0,270,137,31146,243,204,39,243,59400,2012
35023,40.2,4903,2019,67,2769,1232,37531,1824,1189,635,1824,83000,2012
35025,31.6,64670,27697,2308,33141,15649,48793,21002,14672,6330,21002,94900,2012
35027,49.2,20440,13420,82,6146,5440,44149,8666,6878,1788,8666,162100,2012
35028,44,18008,13642,78,2692,5151,106426,7498,5773,1725,7498,285800,2012
35029,38.4,25162,8990,196,15526,5999,29365,9105,6109,2996,9105,90600,2012
35031,30.3,71888,7413,353,9744,12100,30780,17518,12587,4931,17518,81300,2012
35033,46.3,4830,912,1,3874,933,40000,1700,1493,207,1700,100400,2012
35035,36.1,64176,33802,2236,22294,16729,39054,24115,16215,7900,24115,105300,2012
35037,45.5,8956,4750,97,3804,2213,33039,3509,2681,828,3509,68200,2012
35039,39.1,40201,5370,149,28714,10258,40791,14959,11816,3143,14959,125800,2012
35041,29.9,19840,11011,423,7896,4586,39323,6861,4164,2697,6861,110000,2012
35043,38.1,131302,61977,2704,46334,33728,58116,46795,37745,9050,46795,183400,2012
35045,32.8,128600,54218,794,24496,30979,48701,41791,31080,10711,41791,154300,2012
35047,41.4,29225,5752,289,22476,6834,30499,11730,7956,3774,11730,115400,2012
35049,43,144209,63298,895,73005,35678,53642,60954,42442,18512,60954,288200,2012
35051,53.8,11956,8436,36,3343,2365,29185,4261,3194,1067,4261,114600,2012
35053,35.8,17843,6745,166,8652,3433,34337,5474,4057,1417,5474,114000,2012
35055,45.4,32775,11854,158,18376,7955,33835,13373,9755,3618,13373,203800,2012
35057,40.8,16285,9427,82,6391,3733,31538,5574,4562,1012,5574,96300,2012
35059,40.5,4460,2494,94,1772,1078,40507,1672,1124,548,1672,88300,2012
35061,37.4,76172,27543,906,44347,19687,42525,27446,21928,5518,27446,133900,2012
36001,38.2,304511,231180,36157,15091,70159,59359,122674,73741,48933,122674,210200,2012
36003,37.8,48837,46573,556,686,12381,42095,18843,13959,4884,18843,67600,2012
36005,32.7,1386364,151578,419791,741954,310803,34300,473281,94130,379151,473281,380900,2012
36007,40.2,199928,172532,8847,6771,48874,45856,80223,53223,27000,80223,105600,2012
36009,40.8,80166,73650,1068,1385,20617,43202,32419,23520,8899,32419,79600,2012
36011,41.6,79996,73079,3144,1927,20349,50950,31427,22559,8868,31427,101500,2012
36013,40.6,134599,120074,2825,8257,34342,41975,54950,38131,16819,54950,82100,2012
36015,40.9,88779,77618,5332,2288,22453,48128,35452,24064,11388,35452,91800,2012
36017,42.9,50490,48268,279,946,13493,44127,19779,15031,4748,19779,90400,2012
36019,39.1,82054,74688,3132,2096,20105,50522,31820,21562,10258,31820,122500,2012
36021,45.3,62881,55482,2683,2456,16349,56445,25476,18581,6895,25476,223100,2012
36023,35.8,49453,46247,626,1145,10993,47497,17809,11806,6003,17809,101900,2012
36025,45.3,47851,44564,720,1557,12686,43004,19920,14876,5044,19920,132400,2012
36027,40.2,297291,221391,27120,31060,73348,71508,107734,75060,32674,107734,299400,2012
36029,40.3,919542,714236,119034,41901,231367,49977,379980,249822,130158,379980,123400,2012
36031,44.6,39309,36443,1125,1005,10121,47400,16198,11771,4427,16198,149900,2012
36033,39.3,51698,42597,3190,1595,12431,45702,19170,13865,5305,19170,95700,2012
36035,41.7,55358,51947,826,1307,15079,45333,22511,15665,6846,22511,104400,2012
36037,41.6,59992,54953,1383,1609,16086,51734,23962,17616,6346,23962,104800,2012
36039,44,49122,42759,2684,2459,11812,47539,18411,13396,5015,18411,179700,2012
36041,51,4835,4664,39,52,1374,51595,2134,1760,374,2134,165400,2012
36043,42.3,64475,61662,574,1058,17531,44288,26775,18990,7785,26775,92300,2012
36045,32.3,117011,99527,5326,6651,30931,46549,45162,25824,19338,45162,129000,2012
36047,34.1,2512740,896464,809821,497620,582628,45215,911995,271482,640513,911995,562600,2012
36049,40.3,27062,26172,243,355,7446,45187,10657,8284,2373,10657,104700,2012
36051,39.7,65215,60054,1395,1838,15954,54244,24127,18125,6002,24127,118200,2012
36053,39.3,72977,68485,1215,1334,17978,52293,26613,20213,6400,26613,117400,2012
36055,38.4,744746,541857,107569,53985,182328,52700,294726,193789,100937,294726,134200,2012
36057,40.9,50025,42502,674,5681,12817,42830,19898,13498,6400,19898,99500,2012
36059,41.2,1338712,875171,142160,195287,340577,97049,442869,360215,82654,442869,467500,2012
36061,36.4,1596735,762321,207912,409298,302793,68370,738131,166483,571648,738131,827300,2012
36063,41.8,215869,188402,15084,4734,55900,47736,88542,62053,26489,88542,103400,2012
36065,40.9,234336,198819,12529,10884,57897,49148,91500,62218,29282,91500,108600,2012
36067,38.7,466179,369541,48852,18879,113760,53593,185036,121518,63518,185036,131700,2012
36069,42.3,107728,98745,2072,3759,28595,56455,43822,32537,11285,43822,135500,2012
36071,36.7,372951,254662,34472,67082,90249,70712,125180,87281,37899,125180,288800,2012
36073,40.9,42995,37561,2540,1783,10917,50113,15871,12359,3512,15871,89400,2012
36075,38.6,122055,116035,869,2578,30679,47288,45753,33279,12474,45753,92500,2012
36077,40.4,62147,57575,1104,1941,15326,46358,24541,17793,6748,24541,134200,2012
36079,41.7,99702,82530,1980,11596,26712,95259,35088,29222,5866,35088,385600,2012
36081,37.3,2235008,616029,395583,614147,525813,56780,776311,345415,430896,776311,462800,2012
36083,39.6,159464,136628,8775,6135,39653,58959,63952,42083,21869,63952,181600,2012
36085,38.6,468374,300585,44665,80439,121782,73496,163675,113099,50576,163675,449400,2012
36087,36.8,312011,203466,35330,48716,74811,86020,98401,68924,29477,98401,449600,2012
36089,37.2,112060,103921,2780,2224,27374,43745,42076,29681,12395,42076,84100,2012
36091,40.8,219832,203720,2963,5392,57853,67712,87952,64104,23848,87952,227700,2012
36093,40,154466,119671,14102,8818,35326,56445,58263,39034,19229,58263,166600,2012
36095,42.4,32617,30642,419,923,8121,51896,12627,9737,2890,12627,147800,2012
36097,44.3,18472,17740,184,258,4884,47869,7570,6143,1427,7570,91900,2012
36099,41.2,35306,31960,1576,993,8725,49155,13400,10046,3354,13400,92800,2012
36101,41.3,98992,93469,1641,1388,26520,46519,41268,29530,11738,41268,85200,2012
36103,39.8,1492360,1068747,103997,245810,374995,87778,496349,397764,98585,496349,395200,2012
36105,41.8,77340,57720,5926,10526,19285,48050,29664,19721,9943,29664,179500,2012
36107,42.8,51067,48958,287,713,14187,56488,20320,16236,4084,20320,106700,2012
36109,29.8,101570,81147,3690,4379,19831,50539,38545,21431,17114,38545,169300,2012
36111,42.1,182516,148919,9585,16044,44911,58934,70274,48770,21504,70274,237500,2012
36113,44.2,65700,62553,638,1195,18366,54909,28515,19741,8774,28515,189700,2012
36115,42.2,63108,58878,1720,1464,16930,50864,24590,18336,6254,24590,147000,2012
36117,41.8,93476,84992,3177,3462,25990,53497,36646,28287,8359,36646,108500,2012
36119,40.1,950227,545910,126805,207229,237715,81093,344875,214097,130778,344875,533300,2012
36121,40.7,42092,37906,2268,1261,10464,50635,15633,11790,3843,15633,99300,2012
36123,40.4,25351,24362,180,439,6548,48245,9531,7418,2113,9531,117000,2012
37001,38.5,151170,101594,27033,16684,40468,44155,60310,40687,19623,60310,136500,2012
37003,41.1,37014,32471,2021,1569,9234,39544,13753,10648,3105,13753,122200,2012
37005,46,11069,9756,128,991,3195,32449,4794,3547,1247,4794,150000,2012
37007,39.5,26699,12220,12952,797,6649,34772,9619,6559,3060,9619,80600,2012
37009,45.4,27099,25260,109,1278,8234,35670,11937,9307,2630,11937,152900,2012
37011,42.2,17815,15114,687,788,4771,38051,7201,5228,1973,7201,155400,2012
37013,44,47542,31498,12341,3190,13253,40147,19679,13881,5798,19679,113200,2012
37015,43.1,21035,7340,13240,197,5129,31194,7723,5772,1951,7723,80700,2012
37017,41,34922,19119,11873,2418,8953,30031,14082,9597,4485,14082,80800,2012
37019,47.6,107925,87435,11886,5412,33117,46490,47181,36661,10520,47181,187000,2012
37021,40.7,239000,201957,14767,14191,61065,44206,101381,66222,35159,101381,191500,2012
37023,41.4,90821,75230,5973,4758,23632,38062,34650,25194,9456,34650,110800,2012
37025,36.7,178396,127546,27037,16743,45848,54341,64484,47521,16963,64484,168600,2012
37027,41.2,82493,73032,3836,3796,21258,36108,31748,22981,8767,31748,107100,2012
37029,40.1,9965,8007,1305,219,2636,56315,3565,3070,495,3565,223300,2012
37031,45.7,66415,58005,4063,2278,18256,47506,28235,19971,8264,28235,207600,2012
37033,43.6,23615,14432,7915,757,6234,38387,8755,6488,2267,8755,99900,2012
37035,39.7,154201,120326,12779,12916,39554,43657,58695,41835,16860,58695,130200,2012
37037,44.1,63896,45602,8401,8136,18264,57793,25697,20650,5047,25697,210300,2012
37039,48.3,27304,25151,206,687,7982,34981,11238,9168,2070,11238,150100,2012
37041,44.7,14825,9015,5064,480,3832,36385,5867,3903,1964,5867,133100,2012
37043,49.6,10575,10094,82,261,2884,38536,4400,3576,824,4400,156500,2012
37045,40.5,97890,72696,20406,2791,25927,38181,37698,25276,12422,37698,104300,2012
37047,40.4,57612,34829,17499,2579,14477,35182,21542,15407,6135,21542,85100,2012
37049,36.5,102904,69033,22181,6303,28034,47383,40274,25512,14762,40274,153500,2012
37051,30.9,319329,150579,112201,30374,81176,45413,119723,67499,52224,119723,126300,2012
37053,41,23677,20937,1424,721,6579,57446,9171,7363,1808,9171,229600,2012
37055,43.5,34019,30178,1389,2131,9417,55780,15076,10872,4204,15076,307900,2012
37057,40.4,162628,133429,14818,10256,45379,44318,64699,47002,17697,64699,132200,2012
37059,42.6,41183,35134,2799,2494,11935,51844,16219,13282,2937,16219,162000,2012
37061,37.4,58510,30839,14844,12045,14594,33896,21825,15000,6825,21825,86400,2012
37063,33.4,269283,113996,99890,35528,65529,50997,109109,60053,49056,109109,179800,2012
37065,40,56253,21172,32138,2097,14410,33917,21227,13493,7734,21227,81100,2012
37067,37.3,351368,206789,90942,41351,88497,45809,139033,89902,49131,139033,151700,2012
37069,39.8,60470,38474,15534,4673,16727,42920,23319,17993,5326,23319,124800,2012
37071,38.8,206291,156355,30752,12199,55251,43220,79234,53916,25318,79234,124400,2012
37073,42.4,12069,7576,4129,177,3281,45136,4454,3612,842,4454,153800,2012
37075,42.7,8766,7825,48,200,2365,32137,3443,2871,572,3443,124600,2012
37077,39.9,59666,34409,19266,4451,14192,49893,19788,15015,4773,19788,134700,2012
37079,38.1,21386,10117,7902,3006,5197,40833,7136,4956,2180,7136,88800,2012
37081,36.4,489576,265339,157538,34642,122204,46223,193890,121181,72709,193890,155600,2012
37083,41.9,54693,21560,28009,1182,14156,31614,21562,13522,8040,21562,87500,2012
37085,33.5,115559,74197,23682,12403,29186,44242,40530,27917,12613,40530,130700,2012
37087,45.7,58915,55309,554,1944,17691,42089,26469,19725,6744,26469,157700,2012
37089,45.3,106577,89990,3569,10338,30324,46503,44997,34149,10848,44997,187800,2012
37091,40.9,24525,8311,14633,675,5846,33412,8859,5727,3132,8859,83100,2012
37093,30.8,47368,19365,15626,5820,11499,46900,15381,10704,4677,15381,137200,2012
37095,40,5810,3411,1995,359,1454,43608,1982,1454,528,1982,98200,2012
37097,39,159614,124271,19098,10758,43212,50058,59593,44063,15530,59593,166200,2012
37099,36.6,39985,32691,751,1943,9568,36403,15539,10641,4898,15539,169300,2012
37101,36.6,169122,118054,24962,21620,44984,50132,60544,43560,16984,60544,140700,2012
37103,44.4,10144,6208,3216,400,2582,36460,4098,2858,1240,4098,96200,2012
37105,37.6,57876,34303,11379,10645,14552,45284,21148,14541,6607,21148,130600,2012
37107,41,59372,30460,23879,3873,15613,34440,23958,14566,9392,23958,96100,2012
37109,40.8,78052,66869,4263,5343,21662,50065,29801,22673,7128,29801,156100,2012
37111,41.8,44926,39908,1631,2374,11336,36388,17230,12462,4768,17230,100900,2012
37113,48.4,33815,30586,308,2132,10295,38134,15843,11758,4085,15843,166800,2012
37115,43.6,20727,19676,267,430,5683,38658,8228,6210,2018,8228,159400,2012
37117,44.1,24298,12583,10497,782,6438,35585,9526,6598,2928,9526,85200,2012
37119,34,926873,469783,277527,111935,227238,55961,362465,220473,141992,362465,186100,2012
37121,45.3,15539,14600,127,649,4634,36276,6536,4991,1545,6536,114800,2012
37123,39.7,27741,17727,5204,3950,6787,32798,10066,7401,2665,10066,86700,2012
37125,45.1,88314,68609,11592,5244,24417,48238,36473,27120,9353,36473,196700,2012
37127,40.3,95545,51599,35318,5949,25100,43757,37636,23973,13663,37636,118300,2012
37129,37.4,203276,156269,29573,10468,50324,50420,85183,51134,34049,85183,222000,2012
37131,45.4,21959,8530,12546,319,5411,30911,8490,6133,2357,8490,77800,2012
37133,25.8,176461,121089,28222,17985,43258,45812,59074,33390,25684,59074,149900,2012
37135,33.3,133958,94971,15593,10714,31062,55241,51163,30704,20459,51163,272900,2012
37137,48,13145,9799,2537,397,3668,43825,5223,4242,981,5223,154400,2012
37139,36.3,40551,22362,15594,1650,10234,46032,14508,9413,5095,14508,176100,2012
37141,41.2,52447,38725,9590,3176,14115,44071,20217,15798,4419,20217,152000,2012
37143,46.3,13414,9548,3464,278,4079,42410,5403,4253,1150,5403,170000,2012
37145,41.5,39322,26183,10749,1581,10419,43292,15376,11216,4160,15376,118700,2012
37147,30.9,167951,96177,56573,9118,38799,40452,65480,36056,29424,65480,133800,2012
37149,49.5,20386,18037,1038,1105,5901,42762,8769,6559,2210,8769,171800,2012
37151,39.6,141568,115140,7699,14678,39133,41575,55032,40460,14572,55032,122000,2012
37153,38.9,46608,27361,14228,2748,11498,31726,17850,12059,5791,17850,74400,2012
37155,34.3,133920,36212,32159,10771,31765,30167,44989,29718,15271,44989,69400,2012
37157,42.2,93264,68597,17232,5091,25943,38004,37844,27304,10540,37844,100800,2012
37159,39.1,138189,101503,22019,10494,36448,41561,52878,36639,16239,52878,129100,2012
37161,42.1,67446,56838,6686,2359,19013,35941,27412,19871,7541,27412,108700,2012
37163,38.2,63408,33679,16761,10499,16319,37447,23467,16085,7382,23467,91800,2012
37165,37.8,36266,16613,13958,806,8983,30472,13083,8502,4581,13083,75900,2012
37167,40.5,60489,49772,6274,2168,16111,43256,23154,17172,5982,23154,124500,2012
37169,42.5,47224,43298,1992,1253,14030,42476,19326,15193,4133,19326,121000,2012
37171,41.1,73551,62549,2646,7115,20294,36137,29916,21806,8110,29916,107100,2012
37173,40.9,13995,9152,362,557,3668,43426,5476,4275,1201,5476,123900,2012
37175,49.4,32825,29788,1166,923,9228,40678,13893,10764,3129,13893,167400,2012
37177,44.2,4367,2339,1494,298,1191,33605,1666,1308,358,1666,104300,2012
37179,36.3,201617,150325,23286,21054,54117,64953,67520,55573,11947,67520,197600,2012
37181,38.4,45183,18939,22488,3027,11124,34499,16185,10242,5943,16185,103600,2012
37183,34.5,905573,563473,185926,87549,226681,65826,341303,224725,116578,341303,230400,2012
37185,45.1,20860,7883,10603,696,5179,34803,7551,5346,2205,7551,99700,2012
37187,43.6,13085,5912,6561,476,3425,33718,5096,3764,1332,5096,91800,2012
37189,28.1,51103,47354,582,1670,11147,34848,20977,11560,9417,20977,233500,2012
37191,36.7,122419,67974,38538,11983,32152,41233,47482,29269,18213,47482,108200,2012
37193,42.4,69265,61533,2990,3785,19415,32009,27951,20684,7267,27951,111200,2012
37195,38.8,81020,40142,30968,7621,21292,38398,31932,19161,12771,31932,114200,2012
37197,41.8,38254,32842,1275,3745,10309,40316,14892,11645,3247,14892,114900,2012
37199,45.3,17814,16646,172,824,5152,38766,7142,5580,1562,7142,128700,2012
38001,50.2,2325,2241,0,29,740,42830,1100,789,311,1100,89000,2012
38003,44,11047,10559,58,131,3012,48317,4879,3406,1473,4879,85500,2012
38005,32,6677,2899,6,75,1586,34706,2318,1515,803,2318,52600,2012
38007,49.3,838,811,0,4,193,48375,351,279,72,351,78900,2012
38009,47.4,6449,6070,32,70,1840,48289,2990,2375,615,2990,74900,2012
38011,46.3,3154,3031,0,88,879,52821,1358,1061,297,1358,101100,2012
38013,46.2,2011,1917,25,50,613,52031,1007,735,272,1007,59900,2012
38015,37.3,81941,75590,431,1087,21829,59309,33907,24243,9664,33907,164300,2012
38017,31.7,150240,135977,3456,3108,35477,51110,64724,34868,29856,64724,154600,2012
38019,50.7,3974,3858,0,0,1229,54080,1729,1500,229,1729,71600,2012
38021,41.8,5280,5001,60,107,1296,41934,2181,1607,574,2181,69100,2012
38023,51.7,2095,2035,0,21,661,51208,1019,844,175,1019,62600,2012
38025,43.3,3648,3091,5,75,984,54539,1461,1208,253,1461,88300,2012
38027,48.4,2393,2249,5,78,659,40000,1084,829,255,1084,56900,2012
38029,50.5,3544,3513,0,8,996,37304,1623,1295,328,1623,68500,2012
38031,45.7,3368,3282,1,43,999,49516,1530,1147,383,1530,83700,2012
38033,43,1646,1585,1,23,415,35742,737,543,194,737,69500,2012
38035,29.5,66890,59234,1412,2027,14890,46392,27084,14444,12640,27084,148000,2012
38037,49.7,2380,2252,11,1,684,40968,1098,826,272,1098,63300,2012
38039,52,2393,2333,0,21,688,44792,1124,869,255,1124,64200,2012
38041,50.9,2502,2444,9,15,743,45000,1106,911,195,1106,66800,2012
38043,48.5,2426,2309,0,100,786,45478,1145,895,250,1145,63000,2012
38045,48.6,4141,4092,9,22,1208,52813,1966,1619,347,1966,72600,2012
38047,51.1,1972,1944,2,26,569,47857,854,709,145,854,56100,2012
38049,45.4,5478,5285,3,88,1560,41763,2503,1919,584,2503,74200,2012
38051,53.1,2813,2725,5,23,779,36327,1290,1092,198,1290,51900,2012
38053,37.6,6692,5044,12,178,1753,61893,2609,1815,794,2609,104400,2012
38055,49.2,9020,8172,2,120,2661,54539,4006,3081,925,4006,106900,2012
38057,46.8,8400,7970,60,122,2402,63244,3630,2906,724,3630,114800,2012
38059,39.9,27439,25510,89,408,7650,57988,11172,8768,2404,11172,131800,2012
38061,36.9,7830,5044,32,299,2130,65822,3053,2212,841,3053,83200,2012
38063,51.4,3115,3001,40,35,826,43622,1493,1226,267,1493,52000,2012
38065,44,1875,1801,0,38,553,62768,763,652,111,763,88300,2012
38067,47.1,7383,6921,6,193,2183,50422,3341,2620,721,3341,71900,2012
38069,47.4,4378,4086,4,110,1220,45851,1913,1385,528,1913,84800,2012
38071,42.3,11450,9965,90,146,2879,46119,4881,3150,1731,4881,87800,2012
38073,44.5,5498,5321,12,69,1485,47866,2298,1629,669,2298,88800,2012
38075,45.8,2468,2393,0,0,736,57361,1033,814,219,1033,81200,2012
38077,39.9,16295,15318,63,291,4090,51272,6462,4676,1786,6462,99000,2012
38079,30.4,14015,2873,58,80,3403,30641,4748,3399,1349,4748,65500,2012
38081,45.8,3876,3734,28,63,1142,51175,1763,1350,413,1763,69900,2012
38083,53.4,1282,1236,5,0,433,39811,611,530,81,611,49600,2012
38085,26.2,4193,527,11,44,758,30799,1069,474,595,1069,59800,2012
38087,49.3,768,764,0,4,200,55313,288,256,32,288,54400,2012
38089,38,24682,23147,146,530,6373,58793,10087,7197,2890,10087,149200,2012
38091,47.8,1976,1942,0,27,589,50536,882,689,193,882,67800,2012
38093,41.9,20965,19838,91,362,5382,48678,8652,5885,2767,8652,98000,2012
38095,48.8,2264,2191,6,9,645,53594,1018,837,181,1018,59000,2012
38097,42.2,8105,7674,22,206,2083,46398,3374,2464,910,3374,89700,2012
38099,45.6,11131,9795,18,992,3059,48044,4907,3692,1215,4907,68500,2012
38101,32.5,62013,54787,1576,2018,15714,53361,24721,15965,8756,24721,138000,2012
38103,51.4,4228,4147,0,0,1255,41982,1983,1495,488,1983,59100,2012
38105,37.6,23287,21000,54,531,6277,69617,9742,6872,2870,9742,126500,2012
39001,39.8,28524,27693,88,239,7743,34282,10923,8017,2906,10923,94600,2012
39003,38.1,106079,87293,12515,2529,27393,43194,40622,28269,12353,40622,104400,2012
39005,39.5,53203,51403,407,517,14426,44996,20266,15385,4881,20266,124500,2012
39007,41.1,101262,91701,3598,3455,26091,41075,38889,28224,10665,38889,113800,2012
39009,26.4,64592,58654,1859,1048,12256,33836,22221,12629,9592,22221,118700,2012
39011,40.2,45934,44557,142,543,12908,52267,18342,13847,4495,18342,127200,2012
39013,43.5,70182,65640,2446,465,19103,41676,28716,21481,7235,28716,88000,2012
39015,39.9,44666,43263,405,284,11987,45807,16289,12705,3584,16289,119100,2012
39017,36.1,368029,309983,26746,14408,94256,56253,134945,95854,39091,134945,158800,2012
39019,43.2,28828,28042,204,242,7930,43127,11424,8946,2478,11424,110800,2012
39021,39.7,39982,37645,828,472,11049,50214,15240,11346,3894,15240,123000,2012
39023,40.6,138278,117973,11745,3741,36004,43684,54959,37415,17544,54959,108100,2012
39025,38.6,197543,187265,2769,2987,53337,60590,73859,55922,17937,73859,158800,2012
39027,38.4,42161,39511,845,605,11267,46443,16018,10806,5212,16018,121400,2012
39029,42.3,107598,102007,2377,1389,28900,41870,42476,30824,11652,42476,97500,2012
39031,41.3,36880,35557,422,294,10132,41885,14516,10780,3736,14516,96300,2012
39033,42.2,43623,42025,298,529,12067,41877,17664,12521,5143,17664,91400,2012
39035,40.2,1278024,784944,374200,61370,312525,43861,534899,327514,207385,534899,130900,2012
39037,40.8,52776,51163,253,653,14374,44311,20856,15792,5064,20856,111100,2012
39039,39.1,38975,34176,513,3464,10985,46377,15302,11656,3646,15302,108600,2012
39041,37.2,174454,153847,6150,3754,48879,90499,63376,52561,10815,63376,250700,2012
39043,43.3,76952,65345,6397,2620,21025,46906,31712,22185,9527,31712,139100,2012
39045,38.2,146138,130306,8044,2543,39942,58971,54302,40074,14228,54302,166200,2012
39047,39.4,28931,27114,548,524,7510,38864,11474,7075,4399,11474,110000,2012
39049,33.5,1167484,785807,243942,55133,272081,50700,464018,259089,204929,464018,153600,2012
39051,39.6,42635,38535,172,3312,12274,53039,16358,13166,3192,16358,131000,2012
39053,39.8,30877,29071,697,282,8280,39399,11885,8711,3174,11885,99300,2012
39055,43.3,93485,89873,1044,1027,25931,66127,34624,29960,4664,34624,225100,2012
39057,37,161936,137726,11760,3590,42121,57992,62681,42626,20055,62681,159600,2012
39059,40.8,40056,38183,759,363,10641,39293,15808,11588,4220,15808,93900,2012
39061,37.1,801350,542177,204691,20407,194784,49104,326023,196521,129502,326023,146900,2012
39063,38.4,75043,68155,1195,3409,20365,49350,30342,21332,9010,30342,129800,2012
39065,34.8,31986,30681,241,421,7832,40732,11822,8221,3601,11822,99100,2012
39067,44.2,15818,15101,419,91,4190,37088,6324,4916,1408,6324,82200,2012
39069,39.6,28246,25880,126,1870,7829,49423,11151,8738,2413,11151,117200,2012
39071,39,43454,41736,432,97,12199,39641,16969,12154,4815,16969,102700,2012
39073,41.9,29372,28494,212,204,8192,40556,11562,8769,2793,11562,113500,2012
39075,29.7,42501,41731,169,338,9580,44091,12183,9247,2936,12183,152400,2012
39077,37.6,59628,54574,547,3350,16389,48335,22673,16593,6080,22673,119100,2012
39079,39.1,33134,31950,211,272,9183,36903,13411,8883,4528,13411,92200,2012
39081,43.9,69343,63114,3688,782,18622,40115,28608,21024,7584,28608,86500,2012
39083,39,60791,58355,426,752,15710,49323,22483,16371,6112,22483,134300,2012
39085,42.5,229873,208776,7490,7771,61731,56231,94389,71402,22987,94389,154500,2012
39087,40,62441,59438,1506,470,16590,40244,23990,17899,6091,23990,95700,2012
39089,39.1,166135,153536,5311,2335,44954,54247,63781,46720,17061,63781,151300,2012
39091,39.6,45816,43337,658,544,12420,47345,18050,13238,4812,18050,122000,2012
39093,40.1,301108,241380,23896,25301,80177,51756,116391,84372,32019,116391,143600,2012
39095,37.1,441198,313424,82824,26947,109395,41436,178615,112465,66150,178615,114300,2012
39097,39,43213,38829,2751,618,10443,54647,14779,10504,4275,14779,148000,2012
39099,42.9,238352,184815,36837,11135,62114,41112,98460,69597,28863,98460,97400,2012
39101,40,66514,59695,3338,1483,17045,40966,24736,16968,7768,24736,99800,2012
39103,40.5,172334,163235,2091,2799,48076,65768,65272,52488,12784,65272,182700,2012
39105,41.5,23664,22992,316,117,6448,34704,9598,7687,1911,9598,83800,2012
39107,39.4,40866,39530,112,604,11333,52234,15715,12566,3149,15715,123800,2012
39109,40.8,102657,96034,2313,1337,28062,52292,41225,29494,11731,41225,138900,2012
39111,45,14679,14361,36,73,4101,41677,6071,4851,1220,6071,89700,2012
39113,39.2,535626,389265,111574,12192,135893,43895,222892,139554,83338,222892,115800,2012
39115,43.2,15042,13976,458,99,4540,37152,6271,4841,1430,6271,89000,2012
39117,39.6,34895,33811,217,396,9827,51534,13035,10641,2394,13035,130200,2012
39119,39.6,85996,79583,2825,664,23016,40398,33986,23174,10812,33986,110300,2012
39121,44.5,14643,13297,1025,146,3359,39544,4804,3840,964,4804,84000,2012
39123,46.5,41445,38726,381,1797,12440,53850,17688,14440,3248,17688,141600,2012
39125,40.5,19522,18253,148,839,5368,44099,7700,6131,1569,7700,92100,2012
39127,38.3,36086,35203,86,209,9801,42222,13688,10003,3685,13688,94400,2012
39129,38.4,55795,52225,1841,610,14082,53750,19196,14368,4828,19196,147400,2012
39131,39.8,28652,27552,185,211,7602,39735,10730,7745,2985,10730,98500,2012
39133,37.4,161178,147096,6169,2126,40409,51969,61016,42055,18961,61016,153600,2012
39135,41,42240,41078,166,250,11683,48899,16396,12889,3507,16396,116800,2012
39137,38.8,34445,32190,86,1891,9725,60693,13083,11008,2075,13083,133700,2012
39139,41,124286,107604,10889,1754,32315,42894,48636,34102,14534,48636,107000,2012
39141,39.8,77741,70044,3508,777,19056,44089,27966,20236,7730,27966,113800,2012
39143,40.9,60842,52487,1613,5395,16482,46785,23905,18113,5792,23905,111400,2012
39145,38.7,79122,74191,2033,875,19562,34783,29570,20428,9142,29570,89100,2012
39147,38.8,56630,51654,1487,2532,15015,42375,21891,15803,6088,21891,100000,2012
39149,38.3,49359,46386,795,658,13383,51159,18287,13715,4572,18287,122700,2012
39151,41.2,375593,329524,26914,6030,99656,45689,150299,105254,45045,150299,124200,2012
39153,40.2,541788,431033,77170,8781,139790,49227,221296,151347,69949,221296,137700,2012
39155,42.8,209942,185142,16795,2842,55801,42488,86760,63160,23600,86760,98500,2012
39157,40.8,92532,88648,868,1753,25067,43869,36298,26556,9742,36298,110300,2012
39159,36.8,52153,48066,1086,661,13388,65866,18113,13864,4249,18113,172800,2012
39161,40.2,28808,27417,325,737,7904,44602,11296,9215,2081,11296,88600,2012
39163,39.5,13397,13058,8,13,3695,34432,5313,4024,1289,5313,77800,2012
39165,37.5,213146,189681,7020,4815,57644,72055,75875,59595,16280,75875,191800,2012
39167,42.7,61751,59217,476,487,16746,43829,24975,19204,5771,24975,108800,2012
39169,38.4,114644,108637,1717,1762,30267,49241,42354,31525,10829,42354,136600,2012
39171,40.6,37779,35415,366,1410,10362,43176,15033,11228,3805,15033,100300,2012
39173,35.1,126254,113564,2887,5781,30892,53441,48789,33551,15238,48789,152500,2012
39175,41.4,22626,21730,65,508,6266,46129,9281,6686,2595,9281,105400,2012
40001,36.8,22470,9508,67,1221,5905,31287,7916,5615,2301,7916,74600,2012
40003,46,5631,4700,129,238,1342,41943,2047,1605,442,2047,62100,2012
40005,39.3,14133,10285,566,430,3740,36755,5330,3977,1353,5330,73700,2012
40007,40.9,5587,4296,33,1110,1512,50466,2068,1493,575,2068,70900,2012
40009,35.1,22519,17618,772,2730,5274,51506,7898,5141,2757,7898,93600,2012
40011,40.4,10651,7485,605,1592,2622,43356,4016,2858,1158,4016,66200,2012
40013,36.8,42494,31369,649,2114,10431,37883,16398,10659,5739,16398,87500,2012
40015,38.1,29403,17447,829,2978,7356,38155,10404,7438,2966,10404,71900,2012
40017,35.7,116299,92579,2697,7998,31505,63884,41657,32210,9447,41657,137600,2012
40019,38.3,47603,34484,3218,2594,11638,41039,17359,12169,5190,17359,88700,2012
40021,34.5,47165,23681,674,2983,11152,35182,16801,11071,5730,16801,98400,2012
40023,40.6,15172,9624,1506,448,3984,29015,6083,4290,1793,6083,72100,2012
40025,44.3,2451,1889,14,497,752,37261,1073,761,312,1073,58900,2012
40027,32.7,256550,193805,10242,18027,63495,54883,95424,65361,30063,95424,138500,2012
40029,40.5,5906,4275,13,167,1538,33512,2354,1708,646,2354,66900,2012
40031,31.5,123101,72409,20449,13876,29665,46320,44317,25587,18730,44317,110900,2012
40033,40.2,6171,4874,131,370,1708,48596,2355,1745,610,2355,73700,2012
40035,42,14922,9755,468,380,3938,40496,5730,4511,1219,5730,87300,2012
40037,40.1,69934,54653,1556,2245,18862,43363,26426,19947,6479,26426,105700,2012
40039,31.1,27583,20134,874,3932,6670,43917,10421,6514,3907,10421,103600,2012
40041,44.9,41332,27195,132,1242,11608,36423,16395,12795,3600,16395,99600,2012
40043,42.3,4775,4084,13,242,1257,43583,1807,1410,397,1807,74500,2012
40045,44.8,4095,3690,12,258,1254,47933,1778,1399,379,1778,74000,2012
40047,37.5,60272,48497,1665,5372,15903,43458,23859,15887,7972,23859,88600,2012
40049,39.7,27471,21659,701,1737,7124,38356,10268,7608,2660,10268,80200,2012
40051,38.2,52451,43705,1171,2479,14484,48963,19672,15112,4560,19672,107600,2012
40053,45.1,4536,4138,26,161,1307,43405,1934,1458,476,1934,60500,2012
40055,42.1,6185,4820,439,623,1467,40827,2168,1470,698,2168,60900,2012
40057,41.2,2888,1813,215,742,783,28194,1107,737,370,1107,43000,2012
40059,40.5,3672,2981,11,634,1058,46437,1510,1220,290,1510,67500,2012
40061,39.6,12761,9361,92,420,3162,37771,4703,3558,1145,4703,76800,2012
40063,39.9,13762,9180,708,534,3496,34656,5016,3892,1124,5016,64300,2012
40065,34.3,26275,17267,1755,5539,6963,41563,10478,6510,3968,10478,85500,2012
40067,41.6,6445,5169,35,544,1789,35682,2492,1868,624,2492,62100,2012
40069,39.4,10938,7829,148,441,2867,36209,4221,3032,1189,4221,72000,2012
40071,39.3,46288,35824,820,3045,12093,41026,18430,12741,5689,18430,76200,2012
40073,38.3,14965,11988,94,1988,4167,53466,5690,4312,1378,5690,109500,2012
40075,41.8,9421,7252,441,860,2549,35426,3892,2635,1257,3892,52900,2012
40077,39.9,11099,7668,98,306,2961,40585,4224,3042,1182,4224,70600,2012
40079,38.5,50056,36626,1082,3397,12861,36084,18562,13586,4976,18562,76400,2012
40081,40.4,34106,28826,649,844,9402,42953,12985,10100,2885,12985,89800,2012
40083,37.4,41982,32956,3685,2172,10659,52031,14682,11476,3206,14682,131400,2012
40085,41,9404,7145,218,1128,2559,41517,3492,2617,875,3492,80400,2012
40087,38.2,34471,27930,251,2408,9481,54554,12510,10197,2313,12510,126300,2012
40089,38.8,33144,21742,2841,1564,9271,32134,13074,9020,4054,13074,70600,2012
40091,46.7,20266,14012,696,402,5490,32669,8000,6301,1699,8000,77300,2012
40093,43.6,7563,6638,20,572,2191,48698,3132,2419,713,3132,82200,2012
40095,42.7,15774,10955,169,2249,3810,36727,5928,4614,1314,5928,79700,2012
40097,39.2,41162,27470,117,1141,11616,41475,16199,11781,4418,16199,94400,2012
40099,41.4,13460,10183,139,662,3455,43781,5062,3927,1135,5062,81200,2012
40101,38,70635,41183,7887,3663,17959,37748,27051,18070,8981,27051,88800,2012
40103,40.1,11540,9599,211,303,3290,43980,4636,3425,1211,4636,82300,2012
40105,41.5,10627,7169,232,258,3004,38990,4053,3213,840,4053,72700,2012
40107,40.3,12203,7736,956,369,2939,34258,4218,2993,1225,4218,67700,2012
40109,34.3,721088,428335,107157,108092,176571,45082,283168,171628,111540,283168,124100,2012
40111,38.7,39770,25652,3410,1332,10322,39142,15229,10714,4515,15229,79000,2012
40113,41.6,47650,30808,5409,1409,13090,42536,18522,14709,3813,18522,93500,2012
40115,38.7,31940,21557,218,1515,8362,36280,12137,8938,3199,12137,80400,2012
40117,41.7,16573,13151,139,363,4402,43152,6366,4943,1423,6366,81400,2012
40119,27.2,77125,61246,2529,3001,16688,36762,29823,15519,14304,29823,125200,2012
40121,41.2,45570,32747,1512,1810,12444,41206,18612,13295,5317,18612,85300,2012
40123,35.5,37438,25964,901,1515,9508,40680,14692,9833,4859,14692,97300,2012
40125,37.3,69676,51884,1879,2919,17987,42467,25492,18393,7099,25492,95600,2012
40127,44.4,11449,8442,107,294,2995,28587,4851,3545,1306,4851,71600,2012
40129,41.8,3678,3206,28,176,976,53952,1326,1050,276,1326,80100,2012
40131,38.5,87031,64252,687,3281,24694,58761,32526,25625,6901,32526,142500,2012
40133,39.2,25394,16984,1223,931,6536,33377,9503,6912,2591,9503,70400,2012
40135,38.9,41945,27328,764,1468,11149,36191,15566,11050,4516,15566,85200,2012
40137,40.1,44848,36987,929,2800,12348,44918,17740,12651,5089,17740,86300,2012
40139,31,20620,10762,199,8741,5164,47983,7138,4521,2617,7138,87600,2012
40141,40.5,7981,5137,563,1802,1954,34550,2875,2078,797,2875,53700,2012
40143,35.3,602692,393582,61964,65889,152829,47845,240809,147843,92966,240809,133300,2012
40145,38,73067,53777,2516,3493,20724,56821,26690,22118,4572,26690,137400,2012
40147,41,51112,38665,1213,2568,14133,47959,21442,15751,5691,21442,108100,2012
40149,39.3,11616,9961,101,939,3160,45417,4575,3241,1334,4575,73000,2012
40151,35.6,8741,7491,267,419,2048,50690,3507,2278,1229,3507,76900,2012
40153,37.2,20232,16732,238,2071,4983,52048,7398,5297,2101,7398,99300,2012
41001,48.1,16092,14897,32,559,4781,40348,7074,4827,2247,7074,156800,2012
41003,32.1,85501,71390,818,5486,18825,48635,33502,19342,14160,33502,272000,2012
41005,40.6,377206,318687,2679,29137,100694,63951,145004,100759,44245,145004,313100,2012
41007,43.5,37068,32308,204,2820,9825,44330,15757,9814,5943,15757,255600,2012
41009,41.5,49317,44513,111,2035,13440,55358,19060,14383,4677,19060,220400,2012
41011,47.2,62937,54647,200,3456,16171,37853,26567,17672,8895,26567,190000,2012
41013,45.7,21102,18772,46,1544,6050,40263,8745,6313,2432,8745,204100,2012
41015,53.2,22344,19755,27,1258,6298,38401,10320,7162,3158,10320,259400,2012
41017,40.4,158884,140410,458,11827,43686,51468,64459,42620,21839,64459,271600,2012
41019,46.1,107391,96074,339,5042,29279,40096,43678,30362,13316,43678,179500,2012
41021,50.2,1904,1716,15,120,543,45833,894,561,333,894,118100,2012
41023,50,7366,6857,16,217,2213,34337,3376,2368,1008,3376,133500,2012
41025,46.1,7359,6581,16,299,2119,39674,3186,2045,1141,3186,119600,2012
41027,37.8,22207,14662,105,6546,5341,56355,8027,5498,2529,8027,314400,2012
41029,42,203613,170315,1063,21894,53966,43664,83370,51646,31724,83370,242300,2012
41031,40.1,21746,13354,146,4286,5604,43330,8005,5161,2844,8005,170600,2012
41033,47.1,82636,73175,288,5274,22211,36699,34373,22861,11512,34373,231800,2012
41035,41.6,66350,53730,419,6990,18411,41066,27747,18395,9352,27747,161800,2012
41037,48,7886,6860,22,560,2228,40049,3566,2405,1161,3566,141800,2012
41039,38.8,351794,297479,3125,26125,86939,42628,145474,86739,58735,145474,226200,2012
41041,49.6,45992,38730,129,3662,12725,41996,21039,13945,7094,21039,242600,2012
41043,39,116871,101743,496,9097,30389,47129,44566,29735,14831,44566,176800,2012
41045,36.2,31057,19735,293,9793,6971,37191,10134,6522,3612,10134,141100,2012
41047,35.1,315391,215437,2865,76429,78115,46654,113227,68766,44461,113227,201100,2012
41049,36.6,11146,7196,16,3515,2737,48457,3791,2769,1022,3791,115600,2012
41051,35.9,737110,532082,40843,79791,164793,51582,303654,166200,137454,303654,276900,2012
41053,37.4,75448,60811,313,9122,19244,52365,27973,18681,9292,27973,227300,2012
41055,46.7,1865,1676,2,112,476,44583,788,525,263,788,140200,2012
41057,47.9,25254,21904,153,2262,6990,41869,10843,7598,3245,10843,232400,2012
41059,35.7,75846,52782,545,17966,18553,48452,26786,17391,9395,26786,143500,2012
41061,40.1,25670,23284,84,1016,6852,41784,10299,6666,3633,10299,153500,2012
41063,50.8,6938,6553,38,157,1824,40204,2980,2140,840,2980,192000,2012
41065,41.8,25113,19442,88,3784,6546,43601,9748,6412,3336,9748,182800,2012
41067,35.4,531818,371106,8883,83085,134176,64375,200160,123442,76718,200160,290900,2012
41069,56,1287,1225,0,24,397,36357,626,461,165,626,115200,2012
41071,37.1,99119,78468,735,14598,24862,53950,33920,23638,10282,33920,235300,2012
42001,41.3,101352,91623,1531,6081,27581,58465,38291,29342,8949,38291,204000,2012
42003,41.2,1224772,986370,158292,19487,305041,50664,524392,344826,179566,524392,120300,2012
42005,44.6,68942,67311,635,393,19728,44478,28724,22112,6612,28724,92300,2012
42007,44.2,170614,154234,10166,2039,47035,48311,70715,52153,18562,70715,114100,2012
42009,43.8,49680,48450,275,461,14136,41512,20159,15990,4169,20159,118800,2012
42011,39.4,411094,315714,16326,67258,106998,55021,153977,111016,42961,153977,173400,2012
42013,42.1,127133,121510,2209,1260,33355,42687,51490,37206,14284,51490,103700,2012
42015,43.1,62628,60525,317,748,16601,44650,24445,18247,6198,24445,114300,2012
42017,41.9,625485,542919,21904,26768,165687,76859,229933,179829,50104,229933,315600,2012
42019,41.3,183946,176240,2015,1985,49961,58226,72867,55954,16913,72867,167100,2012
42021,43.7,143305,133658,4890,2059,37672,41668,58502,43188,15314,58502,87300,2012
42023,47.9,5058,4949,31,23,1329,41409,2184,1577,607,2184,71600,2012
42025,44,65101,61015,736,2196,18071,49951,26256,20889,5367,26256,147100,2012
42027,28.9,153758,134923,4477,3789,32294,49706,56526,33462,23064,56526,189800,2012
42029,39.4,499548,410125,29502,32149,130429,86184,183793,140502,43291,183793,329700,2012
42031,39.6,39991,38719,503,257,10135,43059,15638,11122,4516,15638,105000,2012
42033,42.8,81668,76998,1687,1913,21873,40768,32435,24947,7488,32435,85100,2012
42035,38.7,39261,37640,574,440,9635,40682,15286,10856,4430,15286,105700,2012
42037,39.7,66984,63162,1140,1400,16755,44680,26012,18412,7600,26012,134700,2012
42039,41.7,88492,84552,1412,860,23387,41664,35232,25775,9457,35232,102700,2012
42041,40.5,235314,210212,7031,6507,61924,60883,94776,68017,26759,94776,183500,2012
42043,39.2,267891,187130,46013,18828,67740,54066,107996,70155,37841,107996,159100,2012
42045,38.8,558874,397231,108782,16560,137815,64242,206021,145833,60188,206021,236600,2012
42047,45.1,31981,31323,153,189,9003,44741,13631,10976,2655,13631,92300,2012
42049,38.5,280181,242541,19020,9512,69896,45249,109006,74020,34986,109006,115400,2012
42051,43.3,136914,127147,5764,1111,36258,38108,54730,39741,14989,54730,83500,2012
42053,43.1,7664,5974,1235,326,1217,36686,1958,1673,285,1958,81000,2012
42055,40.2,149554,134973,4896,6423,40063,52167,58044,42318,15726,58044,178200,2012
42057,42,14829,14369,172,128,4193,47470,5973,4634,1339,5973,159300,2012
42059,41.3,38614,35275,2004,671,9505,42837,14119,10294,3825,14119,85500,2012
42061,41.5,45931,42145,2395,742,11622,44455,16882,13042,3840,16882,112800,2012
42063,38.2,88648,83654,2207,984,22132,43408,34483,24565,9918,34483,104600,2012
42065,43,45051,44059,145,295,12220,40719,18313,13937,4376,18313,85100,2012
42067,41.1,24664,23615,156,613,6733,44991,9266,7122,2144,9266,137400,2012
42069,42.1,214353,192431,4674,10546,55264,45483,86155,57565,28590,86155,144500,2012
42071,38,519913,440648,16199,45177,136556,56172,193306,135310,57996,193306,189600,2012
42073,43.7,90885,84610,3509,938,24980,44079,36712,28103,8609,36712,96800,2012
42075,40.8,133578,115786,2169,12492,36338,54259,52144,38013,14131,52144,164100,2012
42077,39.3,350165,249834,17068,66074,90673,54645,133302,90269,43033,133302,203000,2012
42079,42.7,320555,282555,10038,21679,82609,43486,131000,88760,42240,131000,119500,2012
42081,41.2,116447,106998,5029,1595,30397,44557,46476,32236,14240,46476,129200,2012
42083,41.8,43451,41032,1017,769,11479,41351,17394,12716,4678,17394,73200,2012
42085,42.8,116474,106048,6365,1260,30970,43589,46389,34559,11830,46389,103700,2012
42087,42.5,46694,45228,302,533,12686,38671,18952,14010,4942,18952,95900,2012
42089,40,169346,119007,19665,22338,43897,57773,59299,47513,11786,59299,198400,2012
42091,40.6,799886,632040,67668,33775,208803,78984,308083,225549,82534,308083,296000,2012
42093,43.7,18243,17117,267,337,5048,49845,7268,5400,1868,7268,150100,2012
42095,40.9,297519,240627,12810,31405,77145,59551,112242,82989,29253,112242,218100,2012
42097,43.2,94441,89050,2019,2284,25822,40963,39220,28126,11094,39220,97500,2012
42099,41,45791,44233,312,602,13124,56205,18160,14356,3804,18160,155300,2012
42101,33.5,1525811,561646,644938,188061,312290,37016,580509,314076,266433,580509,142300,2012
42103,43.8,57437,47659,2833,5188,15941,58474,21980,18256,3724,21980,206700,2012
42105,44.8,17466,16997,63,177,4811,40970,7057,5398,1659,7057,94700,2012
42107,43.2,147935,137912,3665,4106,39477,45441,60121,45457,14664,60121,92500,2012
42109,39.2,39620,38042,401,667,10284,47059,14355,11021,3334,14355,133300,2012
42111,44.4,77638,74172,1749,837,20453,42424,29992,23801,6191,29992,95100,2012
42113,49.7,6453,6101,126,86,1563,38981,2376,1961,415,2376,135800,2012
42115,45.1,43171,41927,199,578,11821,46815,17139,13479,3660,17139,134500,2012
42117,42.3,42081,40656,345,450,11888,42607,17098,12797,4301,17098,113300,2012
42119,38.4,44944,38245,3056,2376,10417,46737,15303,11376,3927,15303,152000,2012
42121,44.4,54865,52912,419,494,15066,41814,22525,16798,5727,22525,79900,2012
42123,45.1,41613,40610,186,319,11573,43108,17453,13524,3929,17453,87500,2012
42125,43.5,207916,194369,6556,2394,56116,53326,84123,64381,19742,84123,141000,2012
42127,45.6,52299,48112,1485,1815,13332,50153,19216,15508,3708,19216,182400,2012
42129,45.1,364877,345745,8265,3252,102416,49734,153064,116487,36577,153064,131800,2012
42131,42,28221,27187,204,439,7657,48626,11037,8544,2493,11037,150000,2012
42133,40.1,434579,374577,21259,24401,118274,58747,168128,126532,41596,168128,177200,2012
44001,43,49796,46904,199,1021,12913,71086,19317,13856,5461,19317,345300,2012
44003,42.6,166066,151808,2339,5429,43037,61884,68722,49007,19715,68722,231800,2012
44005,43.5,82503,72500,2847,3550,21532,69826,34729,21599,13130,34729,369300,2012
44007,37,627414,415657,47471,118206,145896,49213,238523,129640,108883,238523,236700,2012
44009,41.9,126692,116933,1739,3110,32722,72391,49348,37115,12233,49348,331300,2012
45001,42.4,25387,17523,7144,267,6687,35067,9878,7675,2203,9878,90300,2012
45003,40.1,160169,108696,39693,7794,43176,44399,63245,46303,16942,63245,124900,2012
45005,38.3,10399,2459,7668,248,2313,25966,3442,2204,1238,3442,67700,2012
45007,40,187228,147252,29685,5496,51491,42659,73010,53771,19239,73010,121900,2012
45009,38.9,15941,5669,10017,128,3681,31015,5760,4254,1506,5760,74300,2012
45011,38.9,22523,11674,10136,426,5569,35748,8203,6096,2107,8203,73500,2012
45013,41.2,162316,107613,30851,19056,44267,56581,64042,46043,17999,64042,279400,2012
45015,34.6,179773,114871,44706,10513,45853,51476,63390,44752,18638,63390,150900,2012
45017,43.9,15134,7986,6426,452,4277,39843,6096,4945,1151,6096,98400,2012
45019,35.8,352548,219204,104406,18392,83068,50289,140932,86515,54417,140932,240600,2012
45021,38.2,55351,40962,11119,2020,14171,33512,21100,13885,7215,21100,81900,2012
45023,40.3,33028,19510,12329,496,8569,32718,12472,9519,2953,12472,82700,2012
45025,39.2,46462,28668,15154,1646,11745,31279,17453,12391,5062,17453,78400,2012
45027,41.9,34746,16079,17364,921,8825,33267,12215,8759,3456,12215,86000,2012
45029,41,38665,21532,15414,1071,10175,31289,15119,11207,3912,15119,92900,2012
45031,39.3,68500,37962,28228,1146,18593,37490,26525,19037,7488,26525,84600,2012
45033,37.5,31733,14946,14871,821,8223,26668,11774,7411,4363,11774,63300,2012
45035,35.6,136836,89967,34237,6021,36626,54912,49393,35718,13675,49393,169800,2012
45037,40.6,26763,15022,10123,1397,6399,44208,9016,7102,1914,9016,106900,2012
45039,42.5,23804,9087,14372,82,6180,35452,9475,6900,2575,9475,92500,2012
45041,37.5,136714,74003,56012,3036,36101,41738,51671,34322,17349,51671,112300,2012
45043,45.6,60285,37448,20382,1844,15467,42472,22361,17450,4911,22361,165700,2012
45045,37.2,452931,318543,80959,36453,115667,48438,174224,117589,56635,174224,152100,2012
45047,38.3,69531,42674,21082,3773,17858,37911,26288,17662,8626,26288,105100,2012
45049,38.9,20987,8687,11278,748,5177,35713,7288,5496,1792,7288,77600,2012
45051,41.4,270943,209283,36423,16365,73654,42183,113412,78888,34524,113412,164000,2012
45053,35.5,24792,9254,11172,3609,5200,36504,8079,5989,2090,8079,93800,2012
45055,40.8,61583,42842,15465,2281,17392,44068,23950,18690,5260,23950,113600,2012
45057,40.1,76364,53252,18194,3378,20501,42107,28949,21625,7324,28949,136600,2012
45059,40.1,66623,45976,16649,2707,17805,38829,25014,17867,7147,25014,84200,2012
45061,38.4,19160,6239,12340,368,4234,27755,6576,4758,1818,6576,66800,2012
45063,37.7,262424,202091,36919,14255,70736,53644,103377,77172,26205,103377,138900,2012
45065,49.9,10140,4885,4938,88,2872,38385,4016,3162,854,4016,113700,2012
45067,39.1,33038,13226,18657,826,8609,30562,12125,8178,3947,12125,82400,2012
45069,39.1,28750,11574,14535,798,6398,28612,9881,6376,3505,9881,63600,2012
45071,39.9,37432,22628,11036,2733,9838,42005,14176,10255,3921,14176,101900,2012
45073,43.2,74038,63648,5568,3288,21149,41854,30300,22641,7659,30300,133800,2012
45075,37.9,92229,31262,57308,1729,23017,33661,34590,23625,10965,34590,83700,2012
45077,34.8,119167,103852,7586,3735,29196,41947,44227,31047,13180,44227,124000,2012
45079,32.8,384596,174074,174644,18412,87925,48420,143212,86840,56372,143212,150800,2012
45081,40.4,19758,11536,5211,2814,4906,39541,6854,5065,1789,6854,100700,2012
45083,38,284540,198956,57712,16640,74734,43421,106821,74291,32530,106821,119600,2012
45085,35.6,107279,50484,49819,3551,26964,40726,39347,26150,13197,39347,105400,2012
45087,42.4,28804,19050,8886,286,7997,32459,11831,8584,3247,11831,74800,2012
45089,40.6,34361,10734,22617,691,7599,25174,11341,8346,2995,11341,66500,2012
45091,37.2,226576,164707,41959,10125,61167,52571,85805,61645,24160,85805,160900,2012
46003,41.7,2726,2532,6,114,706,46071,1058,842,216,1058,70200,2012
46005,41,17372,14903,86,1289,4426,43778,7296,4873,2423,7296,87700,2012
46007,27.8,3432,919,24,71,815,36429,1106,624,482,1106,56300,2012
46009,43.5,7041,6260,50,209,1687,41139,2523,2037,486,2523,70700,2012
46011,26.1,31973,29509,247,639,6787,47093,11660,6862,4798,11660,144900,2012
46013,39.4,36562,33824,259,527,9123,49504,15325,10857,4468,15325,132500,2012
46015,41.5,5236,4590,0,82,1446,46107,2096,1454,642,2096,89400,2012
46017,26.4,1950,339,9,0,447,30439,566,230,336,566,61900,2012
46019,40.1,10122,9369,47,310,2481,38980,4013,2983,1030,4013,116100,2012
46021,50.5,1419,1400,0,0,423,36563,652,537,115,652,45100,2012
46023,39,9127,5872,0,174,2066,38475,3193,2270,923,3193,71500,2012
46025,45.4,3653,3467,29,66,863,48438,1368,1085,283,1368,62800,2012
46027,25.5,13966,12584,123,286,2539,38377,5142,2870,2272,5142,131900,2012
46029,38.2,27284,25793,85,429,6991,46383,11593,8295,3298,11593,133200,2012
46031,29.8,4046,1241,7,106,833,29451,1164,641,523,1164,46400,2012
46033,50.5,8219,7596,26,187,2304,46984,3602,2776,826,3602,167700,2012
46035,38.4,19513,18265,77,315,5110,47493,8395,5414,2981,8395,118900,2012
46037,47.7,5673,4975,0,57,1556,40095,2462,1756,706,2462,71200,2012
46039,43.6,4376,4226,28,93,1233,47302,1796,1508,288,1796,92300,2012
46041,29.1,5358,1152,24,115,1217,34797,1734,987,747,1734,55200,2012
46043,48.1,2992,2874,0,25,892,48836,1247,974,273,1247,69000,2012
46045,45.9,4050,3952,0,37,1047,51379,1586,1249,337,1586,83800,2012
46047,51.2,7028,6141,19,185,1725,33703,3110,2147,963,3110,88000,2012
46049,45.6,2374,2302,0,58,607,39714,941,741,200,941,59000,2012
46051,45,7324,7033,52,168,2098,46273,3160,2411,749,3160,104300,2012
46053,48.4,4251,3805,0,40,1196,36447,1955,1468,487,1955,56300,2012
46055,48,1852,1790,4,14,542,48571,782,621,161,782,80300,2012
46057,37.4,5875,5653,15,144,1493,50473,2049,1617,432,2049,105300,2012
46059,49.3,3394,3361,0,22,986,45399,1475,1068,407,1475,85200,2012
46061,35.6,3366,3267,0,38,751,53860,1051,882,169,1051,92900,2012
46063,40.6,1367,1293,3,16,402,48036,530,402,128,530,68900,2012
46065,40.6,17064,14300,94,348,4404,59117,7048,4945,2103,7048,151700,2012
46067,46.9,7283,7022,2,116,1975,44153,2930,2359,571,2930,71800,2012
46069,42.6,1437,1253,0,14,375,46694,566,448,118,566,59600,2012
46071,33.8,3067,1561,0,45,782,43967,1032,648,384,1032,55900,2012
46073,49.3,2047,1936,0,79,624,45587,895,629,266,895,63900,2012
46075,40.2,1084,1023,13,2,285,44531,436,310,126,436,73800,2012
46077,46.8,5159,4977,14,83,1559,50060,2319,1769,550,2319,77400,2012
46079,41.2,11364,10839,70,187,2872,46071,4594,3270,1324,4594,111400,2012
46081,41.2,24063,22257,57,642,6429,43733,10743,6988,3755,10743,166700,2012
46083,33.2,45055,42803,289,622,12833,73340,16849,12955,3894,16849,181900,2012
46085,36.8,3752,2174,0,3,923,46339,1397,878,519,1397,68800,2012
46087,42.4,5592,5412,5,106,1558,47392,2203,1760,443,2203,92900,2012
46089,50.1,2485,2415,1,48,699,36314,1059,821,238,1059,55300,2012
46091,43,4631,3918,2,303,1024,44516,1701,1270,431,1701,88200,2012
46093,36.1,25456,22866,208,820,7094,50077,10023,7121,2902,10023,160500,2012
46095,31.5,2057,778,0,36,486,35563,654,402,252,654,50900,2012
46097,47.1,2365,2288,1,20,627,47019,1071,852,219,1071,58800,2012
46099,34.7,170342,146761,6423,7096,43013,52530,66900,43189,23711,66900,148600,2012
46101,40.3,6474,5223,0,116,1868,50949,2644,1909,735,2644,105300,2012
46103,36.7,101240,82710,1027,4131,26098,50253,40543,26524,14019,40543,156000,2012
46105,49.5,2890,2800,0,25,796,37521,1307,912,395,1307,57600,2012
46107,50.2,2327,2281,0,0,665,45511,991,807,184,991,62100,2012
46109,39.7,10158,6188,44,135,2482,42893,3615,2579,1036,3615,82100,2012
46111,45.8,2357,2298,0,42,639,46200,1004,748,256,1004,67700,2012
46113,23.5,13683,451,18,347,2354,26282,2829,1466,1363,2829,19400,2012
46115,44.2,6483,6287,0,78,1659,46884,2631,1974,657,2631,61900,2012
46117,43.5,2940,2549,0,41,849,56553,1268,1034,234,1268,109700,2012
46119,47.2,1382,1297,0,20,381,51563,576,435,141,576,76200,2012
46121,22.9,9711,918,20,270,2032,30972,2662,1255,1407,2662,50700,2012
46123,44,5608,4650,44,13,1727,40920,2528,1816,712,2528,65600,2012
46125,43.7,8344,8054,30,118,2344,50565,3442,2779,663,3442,88400,2012
46127,40.4,14377,13533,93,329,3815,64496,5736,4279,1457,5736,145700,2012
46129,46.8,5443,4468,0,13,1487,42711,2278,1628,650,2278,72800,2012
46135,41.1,22434,20493,401,628,5540,53589,8548,6202,2346,8548,122700,2012
46137,26.3,2796,639,14,86,637,32422,815,440,375,815,69600,2012
47001,42.4,75039,68016,2834,1749,20334,44154,30870,21370,9500,30870,126400,2012
47003,36.5,45060,35407,3061,5036,11757,39635,16142,11164,4978,16142,117100,2012
47005,46,16420,15460,413,306,4674,33663,7030,5606,1424,7030,76700,2012
47007,42.2,12898,11946,539,263,3278,31388,4570,3596,974,4570,105200,2012
47009,41.6,123086,113172,3599,3417,34303,46347,48695,36114,12581,48695,164600,2012
47011,38.3,99229,87758,4109,4674,25796,40614,37426,25021,12405,37426,138500,2012
47013,41.8,40629,39365,190,481,10898,31312,16033,11191,4842,16033,89900,2012
47015,40.4,13797,13169,200,220,3937,40998,5323,4143,1180,5323,114300,2012
47017,42,28486,24422,2899,594,7074,35595,10855,8399,2456,10855,80700,2012
47019,42.3,57531,54976,726,901,16163,32908,23998,17585,6413,23998,98800,2012
47021,39.5,39103,36895,597,930,10931,53363,14499,11787,2712,14499,153400,2012
47023,37.6,17043,14724,1734,366,4462,42097,6034,4439,1595,6034,107600,2012
47025,41.5,32025,30806,282,284,8566,33568,12707,9784,2923,12707,94200,2012
47027,45.1,7842,7507,213,122,2356,30184,3289,2534,755,3289,94700,2012
47029,42.8,35631,33487,620,659,10142,29764,14791,10527,4264,14791,99200,2012
47031,38.8,52853,47564,1400,2012,14419,38151,21056,14430,6626,21056,119200,2012
47033,40.3,14567,11181,1976,1292,4067,37601,5595,3942,1653,5595,86400,2012
47035,48.3,56144,53698,138,1349,15864,37963,23432,18497,4935,23432,141100,2012
47037,33.9,629113,362161,173601,60357,142821,46676,255887,141805,114082,255887,167200,2012
47039,44.3,11732,10901,301,315,3310,34146,5147,4072,1075,5147,80400,2012
47041,40.2,18770,17036,301,1235,4954,36713,7102,5214,1888,7102,105400,2012
47043,38.4,49704,44923,2099,1510,13869,45109,18743,13737,5006,18743,138000,2012
47045,39.5,38234,30919,5594,1009,10961,38167,14953,9590,5363,14953,96500,2012
47047,41.8,38370,26125,10778,885,10997,56297,14412,11807,2605,14412,173700,2012
47049,42.4,17945,17496,39,120,4998,27773,7390,5756,1634,7390,95100,2012
47051,41.6,40972,36766,1964,1031,11201,41625,16000,12254,3746,16000,107300,2012
47053,40.1,49594,38430,9286,1039,12760,36981,19379,14056,5323,19379,86800,2012
47055,42.2,29439,25163,3195,473,8096,38014,11672,8633,3039,11672,96700,2012
47057,42.1,22613,21682,108,524,6352,33185,8999,7367,1632,8999,90100,2012
47059,42.6,68755,64552,1504,1720,20506,35613,28891,21143,7748,28891,109100,2012
47061,41.8,13751,11347,95,122,3537,26644,5296,4198,1098,5296,79300,2012
47063,39.1,62528,51949,2571,6597,16818,39316,24292,17305,6987,24292,123000,2012
47065,39.1,337023,242892,67889,14854,86943,46544,134737,87897,46840,134737,154600,2012
47067,42.3,6759,6616,20,14,1933,22205,2889,2110,779,2889,80000,2012
47069,39.7,27193,15100,11235,376,6038,31963,8846,6344,2502,8846,87100,2012
47071,42.9,25987,24047,895,491,6972,33044,10186,7851,2335,10186,97500,2012
47073,42.3,56725,54343,773,685,16507,36419,23467,17916,5551,23467,107500,2012
47075,39.9,18673,8409,9150,720,4710,32827,7104,4447,2657,7104,89600,2012
47077,39.5,27835,24553,2257,541,7913,37784,11103,8512,2591,11103,93900,2012
47079,44.1,32271,28407,2574,576,9075,36593,13314,9934,3380,13314,89700,2012
47081,40.4,24481,22451,1280,340,6394,42330,8770,7113,1657,8770,99800,2012
47083,41.3,8375,7858,159,141,2301,34595,3526,2510,1016,3526,88400,2012
47085,40.7,18428,17378,541,303,5160,41943,7523,5730,1793,7523,109800,2012
47087,44.5,11526,11147,37,173,3135,33363,4530,3443,1087,4530,97100,2012
47089,40.5,51541,47891,1320,1625,13398,38800,19573,14735,4838,19573,121500,2012
47091,43.5,18199,17314,501,271,4980,30063,7233,5597,1636,7233,101300,2012
47093,37.2,433207,362900,39142,14991,108439,47270,181120,119139,61981,181120,156800,2012
47095,39.7,7780,5327,2026,245,1468,26212,2351,1317,1034,2351,68500,2012
47097,36.2,27772,17005,9788,576,6796,32987,9826,6414,3412,9826,80300,2012
47099,39.8,41779,39624,710,702,11419,36663,16089,12201,3888,16089,97000,2012
47101,41.1,12050,11392,263,273,3286,33956,4725,3509,1216,4725,89600,2012
47103,41.9,33295,29341,1594,878,9190,40904,13413,9985,3428,13413,110300,2012
47105,45.9,48586,43798,398,3344,14205,49602,19662,15305,4357,19662,175900,2012
47107,41,52325,47392,2143,1479,14546,38944,20612,15195,5417,20612,109800,2012
47109,42,26001,23604,1462,405,6698,33066,9908,7219,2689,9908,88000,2012
47111,38.3,22265,20853,79,940,6048,35452,8422,6128,2294,8422,91800,2012
47113,36.8,97976,56883,35375,3290,23750,42348,36060,24077,11983,36060,112200,2012
47115,42.3,28184,26224,388,361,7907,39817,11214,8340,2874,11214,118200,2012
47117,39.3,30585,26500,1714,1397,8406,40687,11686,8554,3132,11686,107800,2012
47119,37.9,80965,64833,10010,3935,21934,45603,31977,22612,9365,31977,136800,2012
47121,43.2,11696,11195,195,37,3377,33492,4636,3796,840,4636,99300,2012
47123,41.5,44680,41248,844,1484,12454,36430,17409,12760,4649,17409,115300,2012
47125,30.2,173138,116026,32675,14019,45545,49459,63062,39777,23285,63062,139000,2012
47127,43.2,6349,5931,148,25,1676,44977,2393,2025,368,2393,135700,2012
47129,40,21882,20535,698,197,5463,37522,7646,6147,1499,7646,88300,2012
47131,41.2,31721,26927,3315,1015,8672,40516,12511,8785,3726,12511,91300,2012
47133,41.3,22040,21391,150,217,6328,34119,8868,7156,1712,8868,88000,2012
47135,43.1,7856,7422,295,65,2054,32101,3263,2345,918,3263,82000,2012
47137,47.3,5108,5049,23,0,1800,34255,2440,1833,607,2440,100900,2012
47139,42.5,16756,16168,30,240,4529,37235,6526,5270,1256,6526,99500,2012
47141,35.9,72172,64937,1634,3841,18039,34107,28289,18131,10158,28289,134900,2012
47143,40,31817,29322,806,1177,8049,36470,11891,8418,3473,11891,105700,2012
47145,44.9,54027,50620,1441,737,15167,43017,22468,16720,5748,22468,119500,2012
47147,37.7,66143,56065,4935,3866,17715,52588,24105,18504,5601,24105,153800,2012
47149,32.4,263815,199593,33185,17587,66262,55105,95347,65020,30327,95347,160100,2012
47151,37.9,22196,21759,21,194,5665,29161,8439,6480,1959,8439,79700,2012
47153,40.6,14173,12709,31,455,3840,33181,5493,4168,1325,5493,115700,2012
47155,41.2,90218,82732,557,4639,26802,43300,37056,24655,12401,37056,159300,2012
47157,34.5,929437,359705,480367,51719,221599,46251,341948,205791,136157,341948,135500,2012
47159,40.2,19157,17978,523,170,5167,44116,7256,5443,1813,7256,116300,2012
47161,42.8,13262,12378,224,264,3807,40200,5252,4221,1031,5252,110600,2012
47163,43.5,156675,147842,2631,2329,44914,40025,66595,49759,16836,66595,118100,2012
47165,38.7,161206,140264,10723,6227,44849,55560,60529,44009,16520,60529,175500,2012
47167,37.2,61038,46625,11092,1296,16386,51847,21383,15814,5569,21383,139900,2012
47169,38,7827,6726,773,34,2052,43613,2849,2205,644,2849,116800,2012
47171,44.7,18287,17286,186,699,4874,35415,7520,5753,1767,7520,117500,2012
47173,40.1,19179,18819,11,245,5132,33456,7404,5868,1536,7404,97300,2012
47175,43.5,5552,5369,40,20,1478,31940,2080,1757,323,2080,76400,2012
47177,38.7,39767,34674,1111,3245,10388,34008,15332,10845,4487,15332,91400,2012
47179,39.6,122840,110899,4708,3575,32756,42995,51260,34204,17056,51260,145800,2012
47181,41.7,17015,15511,972,402,4329,35377,6056,5085,971,6056,74400,2012
47183,36.8,34802,30495,2732,695,9086,35509,13902,9038,4864,13902,88500,2012
47185,41.4,25863,24489,465,440,6879,34717,9735,7515,2220,9735,101900,2012
47187,38.5,184225,159609,7907,8203,51586,91146,64946,53086,11860,64946,337000,2012
47189,39.3,114618,100251,7681,3706,32042,61353,42578,34117,8461,42578,191300,2012
48001,38.8,58269,35593,12344,9277,11519,41471,16245,11833,4412,16245,80600,2012
48003,33.8,15006,7067,174,7432,3904,55327,5183,4181,1002,5183,90200,2012
48005,36.2,86550,54716,13163,17128,22169,40150,30846,20960,9886,30846,83700,2012
48007,48.3,23391,16381,150,5850,6765,44769,9825,7512,2313,9825,121500,2012
48009,42.9,8944,8055,37,692,2574,56250,3330,2680,650,3330,101400,2012
48011,44.8,1820,1586,18,185,527,56974,668,514,154,668,91800,2012
48013,35.8,45091,16299,268,27942,11450,45702,14995,11457,3538,14995,83300,2012
48015,40.4,28372,18600,2716,6680,7503,51340,10600,8082,2518,10600,153200,2012
48017,33.9,7096,2982,129,3971,1714,41075,2357,1584,773,2357,57200,2012
48019,48.5,20477,16571,138,3433,5895,47927,8495,6657,1838,8495,141400,2012
48021,38.3,74023,42318,5753,24082,18756,52516,25471,20030,5441,25471,121200,2012
48023,50.2,3706,3263,59,370,1053,34688,1735,1284,451,1735,71100,2012
48025,35.4,32083,10860,2815,18090,5920,40707,8681,5619,3062,8681,72000,2012
48027,29.7,310155,157080,62800,67384,75114,50085,103715,59136,44579,103715,119800,2012
48029,32.9,1719902,520225,118165,1010015,404241,49141,596862,363373,233489,596862,122600,2012
48031,46.1,10425,8199,93,1950,2810,46881,4104,3274,830,4104,162300,2012
48033,40,642,549,0,86,183,69688,239,153,86,239,95600,2012
48035,45.6,18114,14603,250,2918,4891,44860,6883,5303,1580,6883,93300,2012
48037,37.6,92460,61251,21592,6103,22975,42346,33920,22576,11344,33920,92800,2012
48039,35.2,313813,166698,37432,87042,79539,68008,105920,78939,26981,105920,147300,2012
48041,24.5,194087,114703,20705,45163,38546,37638,68936,31971,36965,68936,151300,2012
48043,40.6,9175,4893,117,3943,2325,40086,4106,2516,1590,4106,109300,2012
48045,43.9,1674,1145,9,444,441,35078,657,564,93,657,44800,2012
48047,32,7236,491,6,6636,1665,21445,2465,1635,830,2465,44700,2012
48049,39.6,38018,28338,1428,7505,9476,40821,13302,9631,3671,13302,86900,2012
48051,41.6,17160,11616,1970,3176,4488,43976,6293,5020,1273,6293,91100,2012
48053,44,42946,32707,868,8648,11954,49047,16648,12278,4370,16648,148200,2012
48055,35.1,38152,16798,2746,18041,8176,43393,11640,7721,3919,11640,105600,2012
48057,38.2,21366,9744,534,9959,5581,45122,7827,5593,2234,7827,92700,2012
48059,42.2,13521,11967,88,1089,3500,46812,5182,4274,908,5182,75500,2012
48061,30.6,405819,43439,1358,357174,93501,32558,116839,79010,37829,116839,76600,2012
48063,38,12389,7268,2245,2619,3139,36495,4350,3010,1340,4350,105000,2012
48065,40.6,6215,5444,52,551,1810,60813,2337,2097,240,2337,89000,2012
48067,43.8,30324,23366,5212,1085,7932,35932,11739,8282,3457,11739,75500,2012
48069,33.8,7984,2733,162,4755,1884,35301,2597,1769,828,2597,64600,2012
48071,36.2,34562,24233,2672,6678,9601,75200,11822,10021,1801,11822,145000,2012
48073,37.7,50690,31818,7651,10445,12445,37508,17273,12511,4762,17273,72800,2012
48075,35.2,7047,4553,808,1606,1698,44455,2431,1873,558,2431,53500,2012
48077,44.8,10718,9859,59,503,2996,54298,4272,3680,592,4272,78300,2012
48079,34.2,3087,1278,115,1661,811,40406,1069,853,216,1069,36600,2012
48081,48.6,3298,2582,42,632,961,40844,1411,1021,390,1411,64500,2012
48083,45.8,8817,7011,187,1449,2406,30690,3511,2399,1112,3511,62600,2012
48085,35.1,788580,496688,65028,116000,208722,83238,283025,196686,86339,283025,204900,2012
48087,36.7,3050,1869,111,960,786,41940,1197,929,268,1197,66300,2012
48089,43.1,20784,12436,2772,5430,5569,43273,8048,6216,1832,8048,104000,2012
48091,42.7,108985,77358,1755,27415,30902,63480,41112,31218,9894,41112,202200,2012
48093,43.4,13875,10061,63,3580,3535,36599,5296,4095,1201,5296,79800,2012
48095,40.9,4073,1856,23,2167,699,50278,918,736,182,918,71800,2012
48097,38.8,38427,30132,994,5996,10309,49735,14489,10123,4366,14489,108600,2012
48099,29.9,75728,46643,12210,12203,16324,50104,20464,11955,8509,20464,98300,2012
48101,49.4,1600,1108,217,195,524,34770,719,570,149,719,40800,2012
48103,38,4359,1750,123,2412,1225,49974,1551,1263,288,1551,62800,2012
48105,38.1,3669,1550,0,2097,901,49850,1273,833,440,1273,51800,2012
48107,37.6,6100,2614,199,3205,1564,36768,2195,1489,706,2195,52500,2012
48109,38.1,2386,444,13,1854,519,33500,854,569,285,854,43800,2012
48111,31.4,6734,3758,75,2726,1648,42781,2339,1454,885,2339,75200,2012
48113,32.5,2379214,788657,515041,908199,555311,49159,849874,452993,396881,849874,129100,2012
48115,33.4,13761,5342,914,7354,2992,40152,4382,3225,1157,4382,50200,2012
48117,31.1,19275,5889,63,13007,4642,42577,6268,4049,2219,6268,81400,2012
48119,43.6,5240,4338,417,302,1321,41406,1955,1592,363,1955,63200,2012
48121,33,667934,429832,53298,121560,168703,72939,237732,156580,81152,237732,182200,2012
48123,42.7,20156,11576,1786,6513,4654,45457,6890,5365,1525,6890,76400,2012
48125,45.4,2399,1616,116,659,584,33950,875,716,159,875,39200,2012
48127,37,10054,1398,32,8624,2517,32960,3428,2410,1018,3428,47900,2012
48129,40.7,3652,3096,175,317,937,41875,1348,955,393,1348,55900,2012
48131,37.2,11821,1236,62,10411,2755,35167,3843,2860,983,3843,50700,2012
48133,41.2,18519,15141,315,2712,4561,35044,7145,5090,2055,7145,67300,2012
48135,31.2,138193,56329,5656,73284,34520,50851,49065,32510,16555,49065,88300,2012
48137,45.1,2023,892,5,1126,547,41613,854,755,99,854,62400,2012
48139,35,149712,98029,12959,35244,40204,62832,50327,37653,12674,50327,139000,2012
48141,31.2,801115,107028,21818,655623,192617,39699,252426,158164,94262,252426,111000,2012
48143,30.9,38192,29537,399,7300,8777,40176,14223,8500,5723,14223,116900,2012
48145,39,17756,9330,4362,3698,3816,33744,5738,3999,1739,5738,61200,2012
48147,40.4,33867,27301,2276,3270,8471,43382,11783,8807,2976,11783,91700,2012
48149,47.2,24557,18098,1763,4573,7092,45478,10470,7969,2501,10470,131000,2012
48151,42.1,3963,2634,171,1100,1073,42900,1484,1126,358,1484,57600,2012
48153,38.2,6439,2732,144,3442,1910,35323,2598,1792,806,2598,58800,2012
48155,44.4,1273,1022,10,234,319,32443,535,365,170,535,37700,2012
48157,35.1,587666,212865,124038,139823,153442,84211,184182,146143,38039,184182,179800,2012
48159,42.5,10593,8569,503,1348,2976,45684,4207,3395,812,4207,89400,2012
48161,41.4,19631,13467,3190,2705,4678,45510,7028,5414,1614,7028,81800,2012
48163,31.8,17265,3247,504,13418,3731,38161,4831,3202,1629,4831,59400,2012
48165,29.2,17572,10575,178,6528,4120,50850,5402,4230,1172,5402,83100,2012
48167,37.3,292874,172872,40188,65767,74846,61555,109142,75026,34116,109142,146700,2012
48169,38.4,6295,2459,290,3502,1177,41750,1659,1237,422,1659,72800,2012
48171,49.8,24777,19371,81,4983,7309,55017,10694,8005,2689,10694,204600,2012
48173,39.8,1255,872,33,350,309,76563,431,299,132,431,108000,2012
48175,44.6,7223,4269,265,2515,2078,50635,3056,2402,654,3056,101900,2012
48177,36.9,19773,8825,1474,9352,4933,39115,6804,4690,2114,6804,78400,2012
48179,38.4,22731,15618,1080,5424,5846,44455,8465,6350,2115,8465,75100,2012
48181,39.4,120641,94791,6861,13564,32566,46587,46600,32141,14459,46600,103200,2012
48183,35.4,121451,74090,24184,19839,30802,45233,45083,28549,16534,45083,117300,2012
48185,39.1,26564,16066,4292,5680,6241,43810,8716,6631,2085,8716,92700,2012
48187,36.5,131945,72021,7948,47280,34806,63889,45411,35404,10007,45411,154300,2012
48189,32.4,36153,13492,1636,20262,8659,40521,11709,7495,4214,11709,68900,2012
48191,43.5,3337,1980,191,1097,851,32097,1270,832,438,1270,41900,2012
48193,46.6,8448,7465,39,891,2150,39709,3081,2388,693,3081,91700,2012
48195,36.5,5556,3057,9,2408,1421,49626,1918,1526,392,1918,70500,2012
48197,42.3,4124,2877,347,831,1181,35332,1740,1225,515,1740,44700,2012
48199,38.4,54497,47893,3190,2459,15154,54275,20468,16035,4433,20468,97800,2012
48201,32.2,4101752,1354869,760521,1671262,968252,53160,1412895,805652,607243,1412895,132200,2012
48203,37,65958,42808,14931,7253,17166,46718,23147,16926,6221,23147,109900,2012
48205,39.2,6015,4112,424,1402,1305,63407,1717,1177,540,1717,137900,2012
48207,43.5,5891,4133,255,1424,1753,40247,2480,1804,676,2480,42800,2012
48209,30.4,158464,92516,5184,56102,35667,57834,54543,36765,17778,54543,174100,2012
48211,36.3,3863,2574,5,1171,973,53295,1405,1054,351,1405,104300,2012
48213,42.7,78558,63428,4915,8554,20337,41100,30311,23100,7211,30311,87700,2012
48215,28.3,774820,60160,2784,702135,176120,33218,214396,147971,66425,214396,76900,2012
48217,41.2,35079,25733,2313,6454,9331,39405,13503,9786,3717,13503,83500,2012
48219,32.9,22988,11694,611,10116,6080,51054,7978,5739,2239,7978,80600,2012
48221,46.2,51161,44291,291,5299,14777,54902,20631,16060,4571,20631,148600,2012
48223,39.1,35088,26492,2652,5314,9763,42257,13262,9551,3711,13262,93600,2012
48225,44,23512,14623,6194,2365,5240,32859,7883,5659,2224,7883,68800,2012
48227,37.5,34927,18598,1809,13386,7480,43393,11079,7421,3658,11079,63400,2012
48229,36.1,3407,633,54,2700,796,22083,1097,907,190,1097,38900,2012
48231,37.6,85955,64104,7514,11800,20832,45170,30682,21963,8719,30682,93700,2012
48233,37.2,21992,16233,547,4420,5663,46677,8318,6574,1744,8318,67500,2012
48235,39.3,1596,1067,47,460,451,48646,587,469,118,587,70200,2012
48237,39.4,9027,7249,407,1303,2009,43902,3010,2243,767,3010,75600,2012
48239,39,14075,8807,1035,4113,3654,47591,5191,3917,1274,5191,85700,2012
48241,40.3,35703,26890,5891,2035,9726,40603,13722,10737,2985,13722,79100,2012
48243,50.2,2319,1229,3,1033,636,49375,879,692,187,879,99200,2012
48245,36,251627,112240,83688,42769,60573,43750,92754,59854,32900,92754,95600,2012
48247,38.3,5257,156,78,4909,1306,36919,1784,1282,502,1784,43600,2012
48249,34.5,41014,8046,171,32365,10030,40723,13515,9851,3664,13515,67800,2012
48251,36.2,151174,115663,3867,27366,39841,57016,51776,38817,12959,51776,114900,2012
48253,39.5,20137,11823,2836,5056,3663,38896,5566,4274,1292,5566,60100,2012
48255,36.9,14936,5967,1321,7466,3145,39706,4496,3122,1374,4496,75000,2012
48257,35.3,103385,72220,9727,17768,27316,61564,34597,27066,7531,34597,127800,2012
48259,43.1,33745,25945,140,6962,9872,71553,12742,9641,3101,12742,272800,2012
48261,45.1,451,113,1,337,116,37206,168,65,103,168,53200,2012
48263,45.6,829,761,0,65,220,38750,394,273,121,394,63800,2012
48265,47.3,49469,35675,847,11922,13618,43849,20376,14501,5875,20376,147000,2012
48267,51.3,4577,3347,5,1199,1250,46786,1950,1418,532,1950,87000,2012
48269,53.9,227,207,0,20,68,63750,103,61,42,103,90700,2012
48271,46.4,3574,1425,46,2057,880,34083,1185,967,218,1185,70000,2012
48273,28.7,31925,7399,1131,22377,7509,38058,11024,6421,4603,11024,73500,2012
48275,41.4,3713,2333,248,1117,984,33667,1598,1045,553,1598,40700,2012
48277,40.1,49740,37867,6537,3212,13621,39630,19260,12845,6415,19260,86900,2012
48279,36.1,13996,6010,534,7281,3539,35265,4890,3560,1330,4890,57800,2012
48281,40.3,19837,14941,705,3478,5131,47968,7091,5389,1702,7091,122500,2012
48283,33.9,6850,993,77,5743,1274,26731,1884,1285,599,1884,47700,2012
48285,45.2,19269,14644,1414,3124,5549,42934,7879,6310,1569,7879,87300,2012
48287,40.7,16591,10828,1805,3690,4312,50860,6026,4540,1486,6026,113400,2012
48289,45,16827,13055,1262,2242,4568,43534,6434,5364,1070,6434,89400,2012
48291,36.1,75662,52096,8381,13650,18169,48408,24461,19239,5222,24461,83200,2012
48293,38.9,23350,14421,4082,4448,5615,40213,7928,5996,1932,7928,84800,2012
48295,36.3,3324,2238,9,946,794,56131,1129,800,329,1129,78800,2012
48297,42.8,11526,6628,531,4137,2769,42182,3829,3080,749,3829,86800,2012
48299,55.3,19115,17069,157,1573,5443,45533,8536,6722,1814,8536,157800,2012
48301,47,85,43,0,32,15,39375,35,21,14,35,83600,2012
48303,30.4,278339,159437,18763,89120,66109,43993,104791,62187,42604,104791,107300,2012
48305,40.6,5886,2962,99,2735,1634,45066,2173,1596,577,2173,67000,2012
48307,40.8,8281,5533,89,2502,2001,36560,3053,2420,633,3053,69800,2012
48309,32.8,234626,138247,34058,55370,56076,41589,83966,50505,33461,83966,106600,2012
48311,41.9,696,396,0,291,154,38438,289,234,55,289,66200,2012
48313,34.3,13590,7937,2838,2721,2609,41202,3588,2751,837,3588,84200,2012
48315,48.8,10544,7527,2538,338,3096,32226,4620,3474,1146,4620,71400,2012
48317,35.1,4804,2522,120,2155,1171,41964,1531,1109,422,1531,69600,2012
48319,49.8,3978,3117,0,848,1203,44408,1690,1431,259,1690,162900,2012
48321,38.1,36653,17350,3861,14055,9762,43146,13338,9628,3710,13338,90400,2012
48323,30.1,54107,1610,47,51692,12664,30959,15448,10868,4580,15448,83300,2012
48325,37.9,46009,21258,1003,22941,12179,52206,15413,11874,3539,15413,109800,2012
48327,43.7,2232,1490,25,667,582,35048,869,623,246,869,62100,2012
48329,33.3,138472,73350,8775,52702,35944,59391,49898,34440,15458,49898,141100,2012
48331,40.6,24691,16131,2266,5807,6522,39170,9398,6470,2928,9398,85000,2012
48333,47.2,4880,4012,28,830,1337,34984,1855,1488,367,1855,87300,2012
48335,35.4,9367,4693,929,3471,1972,41082,2747,2114,633,2747,56200,2012
48337,42.6,19737,17326,24,1928,5511,45287,8058,6083,1975,8058,86000,2012
48339,36.2,458339,326244,18025,94933,119577,66422,160190,117703,42487,160190,164200,2012
48341,30.8,21765,8249,345,11470,5228,48489,6799,4883,1916,6799,84200,2012
48343,43,12914,8621,2972,1015,3435,39122,5028,3764,1264,5028,70600,2012
48345,43,1153,983,24,138,266,35313,457,338,119,457,49600,2012
48347,29.7,64647,39878,11910,11293,14652,35641,23247,13703,9544,23247,96600,2012
48349,37.1,47739,28614,6910,11309,12354,41511,17441,12056,5385,17441,79000,2012
48351,40.4,14372,10688,2950,424,3684,38574,5185,4147,1038,5185,75900,2012
48353,38.2,15104,9071,590,5116,3742,37671,5709,3894,1815,5709,55200,2012
48355,35,340568,111696,12442,206798,83017,46499,122305,72630,49675,122305,109900,2012
48357,31.1,10314,5092,32,5032,2797,50881,3732,2682,1050,3732,77700,2012
48359,39.3,2048,1698,20,216,499,50993,727,525,202,727,81200,2012
48361,38.7,82306,68243,7254,4866,22216,48864,31105,24031,7074,31105,87400,2012
48363,40.3,28010,21837,660,5012,7414,43041,10556,7465,3091,10556,84900,2012
48365,39.3,23814,17544,3962,1950,6467,50508,8870,7040,1830,8870,81800,2012
48367,38.9,116820,99302,2056,12451,31395,65299,41640,33148,8492,41640,153100,2012
48369,32.2,10172,3933,93,6069,2569,44925,3299,2285,1014,3299,90000,2012
48371,36.1,15510,4086,809,10427,3367,43529,4745,3197,1548,4745,54900,2012
48373,43.2,45618,33042,5098,5958,11899,37194,17038,13579,3459,17038,77700,2012
48375,32.8,121099,59315,11664,42878,27299,37848,42430,25036,17394,42430,84000,2012
48377,39,7678,1172,40,6365,1632,29400,2654,1845,809,2654,57300,2012
48379,45.9,10976,9531,292,872,3046,45099,4256,3612,644,4256,91200,2012
48381,35.3,121090,94239,2739,20070,32238,57509,47312,32783,14529,47312,137600,2012
48383,34.4,3384,1095,93,2188,913,55968,1172,854,318,1172,63100,2012
48385,51.8,3326,2630,2,675,923,31713,1218,962,256,1218,83400,2012
48387,44.5,12795,9450,2203,848,3355,34430,4945,3542,1403,4945,68100,2012
48389,36.4,13606,2703,477,10088,2444,39577,3474,2643,831,3474,42800,2012
48391,43.7,7352,3292,394,3494,2005,42589,2784,2149,635,2784,69100,2012
48393,41.9,992,944,0,31,275,64688,347,293,54,347,110200,2012
48395,40.7,16596,9709,3616,3029,4290,40711,5989,4330,1659,5989,76500,2012
48397,35.8,78749,58336,3945,12582,21219,82725,26141,21638,4503,26141,194000,2012
48399,43.1,10473,6778,214,3402,2899,39115,3976,2840,1136,3976,61400,2012
48401,39.3,53211,35176,9468,7620,12811,46220,18060,13820,4240,18060,87300,2012
48403,50.2,10642,9316,946,335,2800,33053,4269,3740,529,4269,69600,2012
48405,47.6,8898,6175,2271,319,2004,27580,3368,2577,791,3368,72200,2012
48407,43,26482,20281,2866,2849,7104,46413,9238,7686,1552,9238,84800,2012
48409,35.8,65352,27604,1186,35419,16812,51104,22235,15000,7235,22235,91200,2012
48411,41.7,6037,4061,134,1702,1372,37230,2054,1637,417,2054,71100,2012
48413,36.1,3327,1736,12,1560,852,50417,1114,872,242,1114,81500,2012
48415,37.2,16855,9656,754,6156,4644,46340,6148,4319,1829,6148,81800,2012
48417,43.1,3346,2933,46,334,922,46181,1354,1038,316,1354,66600,2012
48419,37.9,25602,16683,4482,4155,6958,35732,9768,7173,2595,9768,68400,2012
48421,35.4,3040,1770,5,1237,777,47500,996,754,242,996,81100,2012
48423,35.8,209691,130494,37736,36002,53631,47312,77916,52526,25390,77916,119300,2012
48425,39.4,8444,6680,107,1600,2191,51618,3221,2333,888,3221,133500,2012
48427,29,60882,803,49,59862,13175,24653,15671,12396,3275,15671,59300,2012
48429,40.5,9561,7226,236,2002,2586,38424,3552,2668,884,3552,68400,2012
48431,43.5,1223,835,2,386,372,44239,464,330,134,464,70000,2012
48433,45.8,1447,1222,40,169,440,52917,615,482,133,615,52700,2012
48435,35.3,4123,1551,42,2527,999,62321,1328,924,404,1328,81000,2012
48437,36.4,7816,3988,424,3154,1835,40227,2622,1952,670,2622,61600,2012
48439,33.4,1814667,939447,265263,484241,451651,56859,651877,406171,245706,651877,136300,2012
48441,32.6,131425,87738,9095,29150,32484,44372,49423,30614,18809,49423,95400,2012
48443,47.1,1001,346,0,616,249,37750,439,312,127,439,53200,2012
48445,35.5,12561,5622,607,6227,2663,35537,4096,2919,1177,4096,62900,2012
48447,49.2,1626,1513,2,102,471,41019,758,574,184,758,53800,2012
48449,32.8,32045,15762,3094,12652,7882,40909,10631,7679,2952,10631,90900,2012
48451,34.2,110434,63644,4210,39629,28184,44310,41796,27089,14707,41796,96200,2012
48453,32,1034842,522664,84942,345955,233949,56403,405406,210468,194938,405406,215900,2012
48455,46.5,14466,11653,1510,1156,3175,37223,4707,3943,764,4707,80200,2012
48457,42.2,21638,17341,2373,1481,5615,36785,8179,6686,1493,8179,75300,2012
48459,40.4,39386,32280,3345,2600,10681,45696,14643,11482,3161,14643,89400,2012
48461,37.1,3300,1676,83,1527,885,52042,1179,903,276,1179,46700,2012
48463,35.2,26434,7671,139,18351,6315,34110,8660,6218,2442,8660,74300,2012
48465,32.6,48578,8440,632,38989,11384,40509,14903,10187,4716,14903,88400,2012
48467,42.3,52507,44957,1240,4877,13625,42668,19330,14911,4419,19330,98100,2012
48469,36.2,87188,41704,5054,38323,22782,50097,31927,21134,10793,31927,106500,2012
48471,35,67447,39361,15224,11351,11619,38654,20151,11963,8188,20151,110600,2012
48473,32.3,42894,19205,10234,12402,9787,51576,13492,9278,4214,13492,134900,2012
48475,36.5,10705,4898,482,5156,2765,40222,3934,2976,958,3934,52200,2012
48477,41.1,33628,22311,5915,4586,8423,44162,12279,8092,4187,12279,142200,2012
48479,27.8,250320,8759,346,239295,55288,38421,67003,42668,24335,67003,107700,2012
48481,37.3,41153,19567,5698,15443,9866,40988,14638,10125,4513,14638,87900,2012
48483,40.5,5414,3847,126,1339,1646,49615,2354,1735,619,2354,67800,2012
48485,34.1,131019,89567,13342,21835,31904,45589,48135,30935,17200,48135,89600,2012
48487,37.8,13451,8468,1058,3514,3357,42271,5125,3427,1698,5125,58800,2012
48489,31.9,21983,2178,392,19179,4226,26369,5382,4038,1344,5382,49300,2012
48491,34.4,426296,271314,25882,98808,110495,70849,151352,103279,48073,151352,177000,2012
48493,39.8,42999,25150,679,16558,12234,62870,15122,12828,2294,15122,139300,2012
48495,34.4,7137,3048,173,3854,1826,47167,2672,2180,492,2672,43000,2012
48497,38.5,59351,47298,594,10079,15819,55492,20352,16271,4081,20352,121400,2012
48499,47.5,41927,35566,2027,3537,11393,42404,15904,12716,3188,15904,103800,2012
48501,31.8,7918,3067,69,4668,2042,48611,2610,2086,524,2610,71300,2012
48503,42.4,18368,14792,244,2989,4951,42008,7209,4952,2257,7209,82800,2012
48505,27.9,14014,955,7,13052,3727,28617,4357,3502,855,4357,55000,2012
48507,31.1,11753,766,20,10967,2683,25206,3557,2465,1092,3557,42400,2012
49001,31.5,6527,5731,10,688,1547,45948,2062,1592,470,2062,145700,2012
49003,30.9,49660,43828,109,4146,13195,55918,16117,12949,3168,16117,168200,2012
49005,25.5,112095,95676,582,11151,26413,49203,35234,22603,12631,35234,190400,2012
49007,34.6,21153,17775,90,2624,5365,47240,7760,5451,2309,7760,123300,2012
49009,48.2,897,798,0,57,214,44792,343,237,106,343,167100,2012
49011,29.4,306664,262989,3446,25821,76114,69355,94149,73447,20702,94149,226100,2012
49013,29.8,18537,16135,71,1138,5496,55724,6827,5121,1706,6827,169500,2012
49015,33,10902,10036,47,651,2786,51372,3651,2906,745,3651,120600,2012
49017,40.8,5107,4674,17,237,1406,44345,1995,1602,393,1995,160300,2012
49019,40,9183,7730,33,859,2191,42208,3690,2521,1169,3690,220400,2012
49021,26.6,45984,40124,181,3549,11294,42296,15497,9692,5805,15497,186200,2012
49023,29.6,10233,9595,11,394,2612,53314,3049,2428,621,3049,165800,2012
49025,45.5,7093,6757,10,264,1983,46979,3210,2615,595,3210,171100,2012
49027,34,12436,10540,49,1592,3140,47235,4115,3085,1030,4115,129500,2012
49029,31.9,9485,9092,0,231,2416,77159,2804,2466,338,2804,266300,2012
49031,42.2,1699,1554,3,131,413,37273,558,469,89,558,158500,2012
49033,33,2264,2179,3,51,588,49803,708,583,125,708,158700,2012
49035,30.8,1032226,764255,14685,176023,240308,59626,341841,231020,110821,341841,237500,2012
49037,30.2,14707,6561,22,721,3032,40186,4152,3344,808,4152,121900,2012
49039,28.9,27645,24019,235,2574,5936,46214,7777,5912,1865,7777,161800,2012
49041,32.9,20759,19230,94,943,5279,45599,7117,5667,1450,7117,152500,2012
49043,36.7,36598,31291,101,4162,9869,86515,13304,10065,3239,13304,469600,2012
49045,29.5,58158,49059,532,6712,14395,61933,18218,13639,4579,18218,183800,2012
49047,29.4,32809,27161,41,2334,8197,61850,10957,8178,2779,10957,187500,2012
49049,24.5,516571,434416,2710,55498,115417,59864,141252,96751,44501,141252,228800,2012
49051,31.9,23661,20074,57,3057,5937,65012,7372,5661,1711,7372,313900,2012
49053,32.5,139484,119625,590,13528,35648,49145,46526,32130,14396,46526,223100,2012
49055,36.9,2756,2586,23,114,768,44821,987,821,166,987,170100,2012
49057,30.9,230940,180546,3043,38643,57870,54923,79601,57520,22081,79601,171600,2012
50001,41.8,36814,34681,313,674,9439,57785,14141,10471,3670,14141,235500,2012
50003,45.1,36990,35317,163,554,9956,48938,15610,11226,4384,15610,206300,2012
50005,42.3,31170,29857,179,344,8244,44435,12525,9012,3513,12525,161400,2012
50007,36.4,156696,142596,2812,2945,37057,63900,62267,40899,21368,62267,266400,2012
50009,46.7,6316,6087,29,63,1827,37214,2831,2335,496,2831,123300,2012
50011,39.6,47853,45222,207,582,13001,55051,18629,13979,4650,18629,205300,2012
50013,45.8,7032,6658,10,90,2205,60433,3130,2555,575,3130,251100,2012
50015,40.1,24471,23393,133,320,6231,54064,9975,7070,2905,9975,215600,2012
50017,43.5,28980,27884,77,306,7946,53627,11824,9615,2209,11824,184900,2012
50019,43.9,27198,26123,204,308,7022,41618,10991,8362,2629,10991,153200,2012
50021,44.3,61599,59368,288,706,16419,48968,26047,18055,7992,26047,176300,2012
50023,42.5,59462,56399,522,1009,15107,57276,24706,18054,6652,24706,206700,2012
50025,44.9,44310,41730,430,828,11862,51113,19254,13371,5883,19254,209500,2012
50027,45.5,56607,54035,255,723,15406,53124,24900,17740,7160,24900,215500,2012
51001,44.5,33454,20430,9620,2902,9156,40780,14286,10070,4216,14286,153800,2012
51003,38.2,99484,77470,9487,5343,24110,67797,37549,24648,12901,37549,332400,2012
51005,46.1,16297,15057,801,165,4777,46133,6851,5617,1234,6851,117700,2012
51007,41.6,12674,9200,3052,84,3544,50596,4777,3867,910,4777,201100,2012
51009,42.4,32301,24374,5992,636,8565,45020,12683,9614,3069,12683,151800,2012
51011,42.3,14952,11448,3206,20,4285,50092,5902,4512,1390,5902,145200,2012
51013,33.7,209077,133346,17518,31505,41738,102459,92992,42696,50296,92992,577300,2012
51015,43.3,73662,67911,2959,1576,20948,50971,28297,23005,5292,28297,195200,2012
51017,45.4,4713,4367,169,143,1383,51528,2008,1606,402,2008,147900,2012
51019,44,68750,61964,3813,1125,19696,56906,27017,22899,4118,27017,195300,2012
51021,44.2,6827,6598,189,20,1809,42658,2464,2031,433,2464,98700,2012
51023,45,33074,31074,1074,386,9936,66053,12822,11217,1605,12822,215500,2012
51025,41,17372,6956,9955,306,4039,33859,6029,4257,1772,6029,102100,2012
51027,43.9,24071,23114,478,90,6547,29821,9384,7339,2045,9384,63900,2012
51029,41.4,17071,10432,6166,189,4132,37843,5728,4301,1427,5728,117500,2012
51031,41.4,54797,44433,7922,936,14897,45432,21581,16504,5077,21581,146800,2012
51033,38.6,28510,18141,8412,992,7777,58044,10649,8830,1819,10649,203000,2012
51035,45,29989,28749,247,791,8619,33600,12622,9872,2750,12622,100200,2012
51036,47.1,7226,2940,3563,99,1896,48208,2777,2279,498,2777,150200,2012
51037,43.5,12546,8338,3758,247,3425,33562,4803,3621,1182,4803,98900,2012
51041,37.5,316895,207288,69010,22613,83424,72363,113090,88028,25062,113090,233400,2012
51043,44.7,14143,12448,799,493,4069,80186,5580,4387,1193,5580,348000,2012
51045,45,5186,5080,10,0,1498,47691,2073,1772,301,2073,153900,2012
51047,37.9,46894,33616,6867,4121,11841,65567,15826,11654,4172,15826,265600,2012
51049,41.8,9951,6235,3399,121,2712,43137,4016,3103,913,4016,143700,2012
51051,43.5,15877,15621,68,74,4436,32622,6404,5034,1370,6404,74500,2012
51053,40.8,27926,17575,9225,690,7227,51582,9788,7409,2379,9788,164600,2012
51057,43.8,11130,6216,4300,350,2737,42446,4351,3309,1042,4351,165700,2012
51059,37.5,1083770,592200,96134,167774,275386,109383,388452,270928,117524,388452,480200,2012
51061,41,65495,53516,5341,4237,17150,88687,23031,18216,4815,23031,363600,2012
51063,44.2,15268,14385,186,410,4130,44038,6076,4725,1351,6076,151500,2012
51065,41.1,25749,20317,3896,763,7005,71181,9419,8254,1165,9419,234700,2012
51067,44.3,56012,48994,4749,1424,17006,45049,23552,18310,5242,23552,164300,2012
51069,39.2,78397,67394,3145,5257,21763,67694,29146,23162,5984,29146,234100,2012
51071,43,17149,16443,230,206,4912,45231,7126,5516,1610,7126,103900,2012
51073,41.9,36821,31516,3277,954,10407,60752,13874,11639,2235,13874,229100,2012
51075,45.3,21496,16442,4408,447,6347,82683,7909,7247,662,7909,341300,2012
51077,47,15535,14617,354,425,4485,31931,6807,5282,1525,6807,96200,2012
51079,39.5,18453,15858,1244,785,4880,58804,6884,5347,1537,6884,228500,2012
51081,42.1,12127,4565,7211,176,2489,38423,3310,2327,983,3310,105300,2012
51083,44.6,36140,21717,13484,597,9809,35191,14685,10856,3829,14685,104900,2012
51085,41.2,99964,85173,9197,2172,27861,76719,36444,30543,5901,36444,271700,2012
51087,37.5,307576,175827,88616,14907,79223,61300,123392,81193,42199,123392,226500,2012
51089,44.5,53971,38562,11741,2594,15160,34373,22734,17218,5516,22734,94500,2012
51091,56.5,2317,2295,0,5,772,50136,1052,881,171,1052,184700,2012
51093,43.7,35240,24959,8720,683,10464,64491,13585,10929,2656,13585,252000,2012
51095,44.9,66939,51949,8921,3078,19135,76767,26579,20306,6273,26579,336600,2012
51097,44.7,6968,4582,2142,197,2053,49410,2924,2261,663,2924,161300,2012
51099,36.5,23739,17679,4411,863,5996,82195,8166,6132,2034,8166,281900,2012
51101,39.3,15861,12041,3003,321,4482,63151,6035,5021,1014,6035,210500,2012
51103,54.2,11371,7902,3209,111,3424,49516,5395,4309,1086,5395,240300,2012
51105,41.4,25528,23848,929,410,6745,31729,9841,7385,2456,9841,78200,2012
51107,34.8,314980,196435,22756,38826,80849,122068,104195,81476,22719,104195,448700,2012
51109,43.1,33083,25561,5917,752,9427,55765,13023,10471,2552,13023,199100,2012
51111,43.8,12838,7656,4502,478,3130,34455,4601,3446,1155,4601,105200,2012
51113,44.7,13270,11269,1524,81,3795,54510,5069,4014,1055,5069,227700,2012
51115,50.3,8965,7741,875,119,2806,55590,3815,3029,786,3815,227800,2012
51117,45.9,32548,19186,11962,804,7888,35399,12642,9204,3438,12642,124000,2012
51119,51.2,10855,8497,2146,173,3107,55625,4393,3653,740,4393,260300,2012
51121,26.5,94179,80677,3625,2527,19172,44166,34739,18851,15888,34739,200900,2012
51125,47.7,15000,12266,2370,160,4331,48888,6415,4951,1464,6415,190700,2012
51127,42,18460,14816,2949,208,5061,70978,6719,6019,700,6719,255500,2012
51131,47.3,12408,6736,4734,873,2880,34304,5025,3487,1538,5025,172700,2012
51133,53.5,12389,8696,3592,92,3730,51911,5557,4712,845,5557,246500,2012
51135,43,15875,8771,6310,621,3657,38209,5504,3741,1763,5504,126400,2012
51137,42.7,33625,27119,4342,1176,9418,59501,12617,9778,2839,12617,228400,2012
51139,43,24038,22837,356,397,6676,43745,9469,7076,2393,9469,178600,2012
51141,46.1,18513,16687,1250,450,4882,35599,7519,5873,1646,7519,108100,2012
51143,44.3,63318,47003,13783,1355,18483,42229,26249,21011,5238,26249,109700,2012
51145,42.1,28003,23214,3877,496,7418,76495,9429,8380,1049,9429,280400,2012
51147,33.4,23017,14250,7829,516,4650,36743,7227,4979,2248,7227,150900,2012
51149,37.6,36013,20861,11475,2189,8636,63031,10811,8058,2753,10811,208600,2012
51153,33.5,404011,195815,77814,82387,100266,96160,129643,94406,35237,129643,330700,2012
51155,44.2,34869,31904,1818,455,9993,43072,14874,10668,4206,14874,129200,2012
51157,48,7440,6676,366,224,2162,57837,3276,2536,740,3276,417700,2012
51159,43.2,9234,5720,2790,508,1753,48958,2754,2006,748,2754,161000,2012
51161,42.9,92432,81631,4809,2015,26187,61686,37876,28865,9011,37876,195700,2012
51163,46.8,22357,20931,687,301,6206,45859,9093,6622,2471,9093,179400,2012
51165,40.3,76353,69667,1207,4085,21353,51721,29616,22730,6886,29616,196200,2012
51167,42.9,28773,27978,403,119,7545,32637,11140,8590,2550,11140,89800,2012
51169,44.7,23061,22469,150,238,6783,37544,9610,7516,2094,9610,90500,2012
51171,42.7,42076,37997,793,2560,11674,49953,17261,12252,5009,17261,213100,2012
51173,43.3,32103,30547,625,516,8545,34394,12567,8899,3668,12567,91900,2012
51175,43.9,18576,11072,6910,207,4707,46703,6532,4770,1762,6532,148700,2012
51177,36.4,122854,88536,18982,9399,33054,79402,41380,32285,9095,41380,264600,2012
51179,34.5,129446,87496,21936,12060,33418,96355,41204,32278,8926,41204,309300,2012
51181,45.3,6988,3543,3273,88,1791,52955,2572,1991,581,2572,173600,2012
51183,40.5,12095,4675,7041,266,2216,39603,3639,2387,1252,3639,128500,2012
51185,43.4,44846,42428,1201,310,12904,36080,18136,13098,5038,18136,85600,2012
51187,39.8,37567,33363,1467,1322,9907,61693,14349,10272,4077,14349,231700,2012
51191,43.2,54691,52610,673,712,16107,42844,22913,17266,5647,22913,133800,2012
51193,46.5,17468,11080,5120,1006,4542,48672,7077,5409,1668,7077,179000,2012
51195,39.5,41361,38177,2092,477,10659,35120,15673,10873,4800,15673,82400,2012
51197,42.9,29203,27584,1098,279,7909,40564,11610,8381,3229,11610,111700,2012
51199,39.6,65503,48550,8820,3023,19205,82454,24008,18199,5809,24008,324200,2012
51510,35.7,140337,75252,29577,22438,30415,83996,64729,28403,36326,64729,475900,2012
51515,44.7,6103,4542,1314,106,1759,35863,2723,1653,1070,2723,140200,2012
51520,40.8,17747,16028,1053,147,4849,30636,7757,4546,3211,7757,102800,2012
51530,38,6679,6012,535,65,1691,35921,2732,1819,913,2732,121100,2012
51540,28.1,43223,28701,8511,2134,7261,44535,17319,7061,10258,17319,286400,2012
51550,36.7,223233,134475,65883,9754,59688,70244,79380,57875,21505,79380,267700,2012
51570,41.6,17426,13968,2039,703,4486,51612,7004,4612,2392,7004,190200,2012
51580,43.8,5903,4891,715,110,1411,36067,2584,1774,810,2584,65600,2012
51590,42.7,43185,20063,20819,1235,11178,30505,18986,10295,8691,18986,89500,2012
51595,39.2,5825,1808,3729,197,1402,29093,2486,1100,1386,2486,95500,2012
51600,38.5,22712,13866,1031,3536,5854,98563,8519,5958,2561,8519,465100,2012
51610,36.9,12300,9074,634,1095,3073,122844,4857,3024,1833,4857,645600,2012
51620,40.1,8531,3333,4905,57,2412,33447,3532,1515,2017,3532,195400,2012
51630,28.8,24932,15038,5716,2607,4896,45951,9705,3650,6055,9705,323600,2012
51640,44.7,6942,5618,270,976,1775,24059,3354,2168,1186,3354,107000,2012
51650,35.5,137471,56639,67918,6317,33622,51584,52547,31664,20883,52547,197300,2012
51660,22.7,49043,35353,3049,7816,7937,36853,15334,5587,9747,15334,215400,2012
51670,35.9,22501,11985,8724,1415,5077,37029,8686,4420,4266,8686,141600,2012
51678,21.7,6990,5448,601,386,923,36511,1801,980,821,1801,271000,2012
51680,30.3,75657,47785,21736,2275,15961,37774,28466,15488,12978,28466,147100,2012
51683,32.3,37943,18103,5198,11898,8891,70634,12011,7842,4169,12011,247100,2012
51685,31,14409,6072,1837,4819,3249,71810,4277,2816,1461,4277,233100,2012
51690,44.1,13854,6751,6135,550,3433,28840,6005,3326,2679,6005,88300,2012
51700,32.3,180831,83369,71497,13440,43850,50744,69467,35748,33719,69467,205800,2012
51710,29.6,243056,107835,102437,16202,49451,44164,85247,38889,46358,85247,210100,2012
51720,39.8,3971,3576,290,55,959,38983,1701,888,813,1701,86400,2012
51730,39.8,32226,4894,25564,1192,7180,35126,12236,5715,6521,12236,120700,2012
51735,43.3,12110,11360,51,221,3623,85033,4592,3888,704,4592,316000,2012
51740,35.3,95786,38606,50307,2940,23716,46269,36788,21687,15101,36788,183600,2012
51750,21.9,16511,14130,1338,388,2551,29757,5624,2730,2894,5624,139200,2012
51760,32.2,205348,80335,102038,12539,39608,39445,83775,36905,46870,83775,198500,2012
51770,38.4,96742,60048,26685,5153,23279,38265,42644,23738,18906,42644,134300,2012
51775,39.8,24792,21635,1779,615,6113,47776,9953,6681,3272,9953,170400,2012
51790,42.6,23906,19716,2940,532,6121,42918,10613,6249,4364,10613,171900,2012
51800,38.2,84216,42927,35008,2466,22545,66479,30502,22789,7713,30502,248900,2012
51810,34.8,439528,283418,81852,29365,112794,65980,164226,106510,57716,164226,272700,2012
51820,38.2,21030,16714,2276,1345,5536,43884,8734,5208,3526,8734,166800,2012
51830,24.1,14207,10064,2038,933,2293,50865,4281,1859,2422,4281,326200,2012
51840,35.6,26330,18337,2838,3984,5852,45959,10454,5171,5283,10454,241900,2012
53001,29.2,18575,7223,24,10992,4576,41798,5722,3662,2060,5722,131600,2012
53003,43.3,21658,19976,104,665,5730,42305,9046,6154,2892,9046,172300,2012
53005,35.7,175424,130743,2397,32471,44678,60300,64660,44674,19986,64660,174800,2012
53007,39.8,72431,51207,247,18658,18510,50582,27048,17936,9112,27048,260600,2012
53009,49,71411,60482,565,3659,18828,46431,30877,21930,8947,30877,234000,2012
53011,36.8,426984,349159,8057,32401,109834,58764,158365,104323,54042,158365,243300,2012
53013,48.9,4001,3586,9,247,1111,45417,1713,1303,410,1713,159100,2012
53015,40.1,102138,87539,454,7902,26571,46568,39683,26266,13417,39683,189900,2012
53017,36.8,38369,26095,43,10869,10519,52285,14056,9992,4064,14056,213900,2012
53019,47,7584,5675,51,260,1997,35742,2877,2053,824,2877,154400,2012
53021,28.4,78680,34155,1350,40090,17406,51770,22847,14963,7884,22847,158200,2012
53023,52.6,2246,2087,0,55,698,51325,1001,733,268,1001,129400,2012
53025,32.1,88885,51160,696,33901,21700,45531,30067,18262,11805,30067,156000,2012
53027,42,72272,58828,758,6255,17713,42440,27905,19302,8603,27905,161400,2012
53029,43.6,78707,64871,1432,4444,22898,59500,33190,23285,9905,33190,301200,2012
53031,53.8,29802,26592,279,876,8478,46870,14181,10321,3860,14181,293400,2012
53033,37.1,1940777,1257665,115660,171701,466381,71175,796555,469030,327525,796555,388700,2012
53035,39.3,251400,198293,6632,15837,66107,61776,97668,66378,31290,97668,276500,2012
53037,32.4,40954,35194,311,3164,9498,41739,16499,9274,7225,16499,252500,2012
53039,45.3,20421,17076,107,2198,5817,40171,8294,5634,2660,8294,195500,2012
53041,42,75399,64838,459,6540,19556,43490,29486,20423,9063,29486,188600,2012
53043,47.8,10536,9824,30,248,3135,45563,4610,3634,976,4610,154800,2012
53045,44.5,60545,50135,609,4800,15581,48878,23274,18350,4924,23274,222100,2012
53047,42.2,40959,27932,192,7204,10739,40924,15740,10697,5043,15740,167100,2012
53049,50.7,20945,17688,94,1700,5938,40873,9363,6923,2440,9363,162100,2012
53051,47.6,12976,11667,13,399,3726,37582,5434,4150,1284,5434,201500,2012
53053,35.7,798528,561274,52546,73070,200706,59105,299334,186195,113139,299334,251400,2012
53055,52.9,15740,14207,73,853,4888,52712,7963,5529,2434,7963,494700,2012
53057,40.2,117087,89980,632,19542,31212,56457,45474,31161,14313,45474,271000,2012
53059,44.5,11053,9815,11,579,3148,55319,4378,3343,1035,4378,262200,2012
53061,37.2,714443,531207,15936,63586,183376,68338,268546,180653,87893,268546,311600,2012
53063,36.8,470375,407597,7960,21372,119436,49615,187397,120428,66969,187397,190300,2012
53065,45.1,43498,38266,180,1207,12241,42746,17634,13987,3647,17634,178000,2012
53067,38.3,252410,198760,6523,17982,66628,63224,100766,68044,32722,100766,251000,2012
53069,48.8,4003,3693,7,154,1167,45335,1699,1364,335,1699,191500,2012
53071,37,58643,43483,933,11599,14119,47166,21497,13442,8055,21497,206300,2012
53073,36.5,201404,164724,1779,15845,48611,51639,79244,49946,29298,79244,281400,2012
53075,24.1,44997,36743,901,2121,8362,34169,16424,7679,8745,16424,186400,2012
53077,32.4,242454,115823,1537,108920,57899,44256,79478,49965,29513,79478,157300,2012
54001,41.4,16472,15882,68,100,4365,36087,6206,4768,1438,6206,85900,2012
54003,37.6,104410,89617,7149,3940,28044,53332,39992,29982,10010,39992,171900,2012
54005,41.2,24617,24187,232,88,7017,42819,9755,7552,2203,9755,78100,2012
54007,43.4,14531,14205,86,91,3823,31623,6009,4522,1487,6009,79500,2012
54009,44.9,24021,23199,412,153,6592,42307,9911,7726,2185,9911,83600,2012
54011,39,96240,87440,4433,1074,24544,37238,40484,24995,15489,40484,103100,2012
54013,45.4,7613,7443,17,1,2136,29282,3182,2484,698,3182,76000,2012
54015,41.9,9432,9284,17,15,2442,33165,3441,2787,654,3441,81900,2012
54017,41.9,8147,7866,45,142,1958,31261,2773,2355,418,2773,78500,2012
54019,42.3,46000,42591,2257,409,11917,34891,17733,13629,4104,17733,70900,2012
54021,38.8,8623,6936,932,373,1567,35524,2539,1899,640,2539,70300,2012
54023,44,11929,11602,69,84,3242,40250,4673,3652,1021,4673,108700,2012
54025,44.8,35572,33367,1010,431,10077,36539,15397,11457,3940,15397,99200,2012
54027,42.7,23791,22914,254,247,5017,28573,10563,5934,4629,10563,129700,2012
54029,45.1,30594,29066,548,316,8706,37465,12989,9968,3021,12989,86300,2012
54031,42.1,13912,13040,344,470,2856,34184,4764,3696,1068,4764,133700,2012
54033,41.7,68959,65499,1047,879,18789,41799,27761,20419,7342,27761,94100,2012
54035,41.5,29206,28545,149,190,7796,41087,11399,9130,2269,11399,106800,2012
54037,39.2,53545,45511,3308,2509,13939,64314,19824,15049,4775,19824,223700,2012
54039,42.3,192572,170370,7911,1945,50690,45642,82961,58905,24056,82961,100100,2012
54041,44,16389,15965,44,40,4294,35179,6570,4639,1931,6570,90000,2012
54043,41.3,21714,21409,51,15,6269,34066,8500,6734,1766,8500,73000,2012
54045,42.2,36508,35037,823,273,10532,36698,14802,10951,3851,14802,76000,2012
54047,44,21966,19496,2288,21,5504,22972,8348,6335,2013,8348,33900,2012
54049,41.3,56460,52885,1925,549,14940,40827,22761,17228,5533,22761,88300,2012
54051,44,32993,32119,209,269,9468,40288,14068,10919,3149,14068,83900,2012
54053,42.2,27242,26532,174,123,7088,37877,10381,8252,2129,10381,82400,2012
54055,42.1,62251,56653,3566,493,16394,34517,25784,18693,7091,25784,77300,2012
54057,42.1,28049,26569,920,200,6499,32968,11183,7620,3563,11183,114500,2012
54059,41.7,26660,25734,593,67,7378,34518,10873,8421,2452,10873,62300,2012
54061,29.3,96417,86381,3200,1739,18516,41326,35777,20136,15641,35777,158700,2012
54063,44.9,13528,13121,117,88,3933,39877,5614,4633,981,5614,102600,2012
54065,44.9,17507,16894,131,187,3695,35350,7306,4674,2632,7306,157800,2012
54067,43.9,26201,25618,3,50,7645,38780,10366,8426,1940,10366,75300,2012
54069,43.2,44307,41090,1664,382,10798,40652,18508,12826,5682,18508,96000,2012
54071,47.6,7666,7304,229,43,2107,34087,3355,2587,768,3355,96600,2012
54073,42.1,7630,7383,69,25,1842,42300,2726,2240,486,2726,95700,2012
54075,47.5,8750,8490,119,22,2545,32381,3783,3076,707,3783,100100,2012
54077,41.7,33471,31593,1042,423,8891,45538,12780,10337,2443,12780,104300,2012
54079,41.2,55660,53543,655,493,15814,56081,21130,18280,2850,21130,141900,2012
54081,40.7,78852,69159,6631,1023,20767,39325,31500,23479,8021,31500,89400,2012
54083,43.6,29361,28412,292,202,7576,37350,11238,8534,2704,11238,94300,2012
54085,44.4,10391,10212,27,60,2702,35634,4120,3207,913,4120,76800,2012
54087,43.3,14884,13918,1,111,3746,27174,5817,4404,1413,5817,78400,2012
54089,46.2,13813,13125,428,113,3490,33066,5270,4294,976,5270,84200,2012
54091,42.4,16889,16357,176,97,4952,40720,6800,5287,1513,6800,85700,2012
54093,46.2,7109,6979,24,28,2156,36445,3129,2517,612,3129,102800,2012
54095,45.1,9188,9042,24,52,2553,37919,3635,3059,576,3635,76700,2012
54097,41.3,24210,23445,185,210,6320,41214,9084,7085,1999,9084,100400,2012
54099,41.7,42273,41472,69,224,11153,36575,16783,13057,3726,16783,82100,2012
54101,44.7,9158,8994,4,67,2904,25634,4115,3174,941,4115,62600,2012
54103,44.9,16526,16251,48,69,4727,37897,6980,5535,1445,6980,82500,2012
54105,43.9,5769,5585,20,0,1559,36602,2303,1876,427,2303,68800,2012
54107,41.8,86835,83239,967,739,23574,42734,35783,26347,9436,35783,104300,2012
54109,42.4,23668,23150,244,72,6683,36010,9146,7599,1547,9146,55800,2012
55001,48.9,20898,19011,634,783,5791,42781,8733,7269,1464,8733,135900,2012
55003,41,16113,13456,59,303,4136,39157,6804,4862,1942,6804,110400,2012
55005,42.7,45882,43487,484,896,12731,44149,19010,13897,5113,19010,135500,2012
55007,49.3,15078,12989,70,167,4498,44626,6931,5669,1262,6931,158200,2012
55009,36.2,248526,208123,4978,17930,64167,53419,98171,65791,32380,98171,159000,2012
55011,44,13544,13103,36,241,3798,47119,5706,4404,1302,5706,139300,2012
55013,49.3,15528,14133,93,205,4892,39382,7361,5847,1514,7361,153600,2012
55015,38.2,48960,45334,96,1703,13910,64982,18350,15164,3186,18350,163100,2012
55017,40.2,62362,58947,904,782,16593,50327,24436,17808,6628,24436,149000,2012
55019,37.1,34610,32772,77,1263,9097,43147,13083,10283,2800,13083,112400,2012
55021,41.3,56596,53367,728,1443,15870,57869,22990,17335,5655,22990,178400,2012
55023,44.5,16677,16003,328,157,4432,41743,6841,5174,1667,6841,117900,2012
55025,34.4,490379,401585,23938,28848,118309,61790,204008,122688,81320,204008,231300,2012
55027,40.6,88741,81273,2403,3532,22911,53782,33766,25128,8638,33766,156000,2012
55029,49.6,27872,26567,140,671,8560,48707,13695,10210,3485,13695,192300,2012
55031,40,43963,40676,577,511,11816,45370,19166,13026,6140,19166,132000,2012
55033,33.6,43788,41135,222,635,10440,47847,16348,11092,5256,16348,157800,2012
55035,33.2,98952,91026,921,1899,23430,47821,39710,25383,14327,39710,150600,2012
55037,48.5,4486,4226,0,34,1351,44652,1872,1588,284,1872,140300,2012
55039,40.3,101577,93371,1003,4373,27665,53399,41057,29333,11724,41057,145800,2012
55041,44,9361,7666,79,144,2620,40215,3853,2988,865,3853,121600,2012
55043,36.5,51055,49140,569,637,12268,46138,19377,14226,5151,19377,122900,2012
55045,41.3,36800,35099,202,992,10078,55380,14526,11140,3386,14526,155800,2012
55047,44.4,19064,17970,91,761,5263,48772,7925,6121,1804,7925,138500,2012
55049,41.4,23712,22927,70,338,6577,55900,9612,7415,2197,9612,158200,2012
55051,51,5978,5822,27,27,1796,37112,3003,2312,691,3003,111200,2012
55053,41.6,20436,17938,474,545,5360,43098,8167,6081,2086,8167,124600,2012
55055,38.1,83751,75960,536,5574,21673,54705,31925,22808,9117,31925,183300,2012
55057,43.2,26701,24741,406,699,7252,45461,10787,8219,2568,10787,118500,2012
55059,36.5,166373,129738,11118,19510,42167,55117,62301,42422,19879,62301,174300,2012
55061,41.8,20600,19744,91,469,5616,55611,8170,6624,1546,8170,146400,2012
55063,35.3,114718,104549,1775,1755,27781,50771,46058,30124,15934,46058,153600,2012
55065,41,16836,16063,80,533,4535,49263,6598,5225,1373,6598,121800,2012
55067,46.1,19951,19066,102,340,5792,42958,8794,6730,2064,8794,111800,2012
55069,44.8,28710,27721,232,342,8647,48293,12754,9770,2984,12754,131600,2012
55071,43.3,81266,75059,387,2530,22024,50091,34224,26028,8196,34224,126400,2012
55073,39.2,134041,120848,668,2966,36333,53762,52893,39046,13847,52893,142600,2012
55075,45.8,41704,40171,98,540,11736,41533,18855,14622,4233,18855,108100,2012
55077,47.2,15366,14633,46,394,4528,44879,6598,5205,1393,6598,145100,2012
55078,32.6,4274,591,35,105,917,37644,1284,918,366,1284,86900,2012
55079,33.7,946584,514826,247324,125377,218244,43599,379711,197164,182547,379711,162900,2012
55081,38.7,44714,41290,504,1648,11913,48768,17444,12116,5328,17444,134400,2012
55083,43.8,37632,36118,65,527,11118,50763,16033,13284,2749,16033,146900,2012
55085,48.2,36029,34568,159,396,10534,44181,16226,13211,3015,16226,166800,2012
55087,37.3,176777,158364,1856,6337,46869,57584,69396,50406,18990,69396,156600,2012
55089,43,86429,80515,1136,2000,24344,75854,34093,26808,7285,34093,255600,2012
55091,43.8,7458,7286,31,77,2019,49544,3017,2296,721,3017,142100,2012
55093,34.6,40842,39029,234,632,10187,61153,14975,11191,3784,14975,195600,2012
55095,42.8,44094,42346,136,658,12760,49595,18304,14446,3858,18304,164100,2012
55097,35.8,70027,64822,205,1883,17858,51422,27982,19217,8765,27982,145300,2012
55099,48.8,14141,13614,37,155,4455,42206,6890,5430,1460,6890,113600,2012
55101,39,195024,144968,20465,22474,50148,54900,75775,52621,23154,75775,174600,2012
55103,42.9,18020,17288,73,366,5013,44821,7391,5527,1864,7391,122900,2012
55105,38.3,160356,135656,6176,12092,42917,50316,63006,45442,17564,63006,136700,2012
55107,46.1,14670,14182,91,172,4226,38629,6542,5059,1483,6542,106300,2012
55109,36.8,84363,79853,653,1677,23322,68139,32026,25279,6747,32026,213100,2012
55111,39.9,61953,57361,316,2618,16661,52355,25461,18118,7343,25461,168500,2012
55113,47.2,16580,13028,39,267,5248,39814,7720,5842,1878,7720,163300,2012
55115,43.2,41820,36860,159,919,11896,45901,17219,12971,4248,17219,128200,2012
55117,40.2,115377,100422,1568,6300,30518,52967,46211,33406,12805,46211,153800,2012
55119,41.8,20631,20034,65,324,5960,44578,8810,6925,1885,8810,126300,2012
55121,40.9,28853,26812,76,1615,7945,48624,11673,8861,2812,11673,133300,2012
55123,41.6,29827,28911,96,398,7961,44676,11737,9364,2373,11737,136800,2012
55125,50.9,21489,18609,184,277,6845,40743,10668,8220,2448,10668,190800,2012
55127,37.9,102310,88533,939,10526,26268,54443,39407,27426,11981,39407,198600,2012
55129,47.6,15893,15177,53,215,4758,40892,7410,5991,1419,7410,148500,2012
55131,40.9,131840,124226,1296,3391,37757,66485,51881,40476,11405,51881,229100,2012
55133,42.2,389740,352795,4760,16200,108845,75689,152995,117369,35626,152995,257700,2012
55135,43.4,52377,50113,165,1302,14330,49777,21387,16399,4988,21387,138000,2012
55137,46.3,24565,22334,459,1366,6766,43582,9963,8044,1919,9963,138300,2012
55139,37.8,166984,151472,2799,5793,40846,51603,67232,45509,21723,67232,141100,2012
55141,42.5,74591,70029,357,1649,20960,46999,32012,23982,8030,32012,118000,2012
56001,26.8,36186,30694,369,3200,7178,42882,15021,7620,7401,15021,199900,2012
56003,41.8,11636,10383,2,985,3197,51002,4587,3414,1173,4587,123900,2012
56005,31.8,45840,40767,250,3464,12093,77090,16937,12902,4035,16937,201100,2012
56007,39.4,15781,12582,124,2633,4040,57787,6044,4425,1619,6044,141900,2012
56009,40,13779,12536,29,886,3775,62554,5608,4155,1453,5608,183100,2012
56011,44.2,7036,6847,4,146,2023,51319,2946,2289,657,2946,161200,2012
56013,38.3,40103,28616,143,2312,10403,48565,15538,11096,4442,15538,177300,2012
56015,42.8,13277,11623,38,1319,3502,43401,5277,3812,1465,5277,135200,2012
56017,49,4791,4576,11,112,1303,41786,2172,1429,743,2172,149900,2012
56019,44.9,8564,8021,1,295,2461,57175,3754,2868,886,3754,215300,2012
56021,37.3,91719,73793,2413,12141,24123,54596,36736,25255,11481,36736,177600,2012
56023,37.5,17960,16799,13,748,4922,62542,6346,5282,1064,6346,204600,2012
56025,36.7,75876,67282,639,5352,20295,55786,30406,21285,9121,30406,179100,2012
56027,44.5,2478,2289,21,55,636,39107,1013,665,348,1013,122900,2012
56029,43.7,28203,26051,87,1387,7690,51449,11956,8490,3466,11956,206000,2012
56031,47.8,8677,8039,1,591,2328,44917,3662,2913,749,3662,133300,2012
56033,42.5,29097,26959,100,1050,7842,52352,12446,8713,3733,12446,223900,2012
56035,38.2,10065,8648,1,683,2683,79776,3522,2675,847,3522,282400,2012
56037,32.9,43890,35446,191,6654,11714,72139,16535,11792,4743,16535,174600,2012
56039,36.6,21326,17611,40,3107,4398,69020,7327,4461,2866,7327,692700,2012
56041,34.3,20942,18547,18,1816,5273,59714,7249,5402,1847,7249,180200,2012
56043,41.6,8425,7049,30,1154,2192,44519,3439,2386,1053,3439,157700,2012
56045,41.7,7152,6684,4,223,1921,53802,2958,2330,628,2958,131200,2012
72001,36.3,19458,140,0,19300,4468,13095,5764,3693,2071,5764,111500,2012
72003,38,41876,1897,48,39424,10336,15106,13327,10440,2887,13327,94100,2012
72005,37.8,60714,1634,25,58090,14243,15302,19447,13029,6418,19447,123000,2012
72007,35.7,28573,174,1,28397,6828,13994,8792,5854,2938,8792,94600,2012
72009,37.1,25823,50,0,25772,6396,16235,8618,6750,1868,8618,117100,2012
72011,38.6,29236,146,0,29044,6997,16771,9262,7166,2096,9262,126200,2012
72013,38.7,96176,561,7,95505,24080,17077,31901,23725,8176,31901,104100,2012
72015,35.2,19542,153,0,19342,4336,16114,6059,4305,1754,6059,91700,2012
72017,35.6,24815,153,23,24624,6057,15034,8038,6254,1784,8038,109700,2012
72019,32,30322,18,5,30239,6992,14907,8935,6207,2728,8935,102800,2012
72021,38,207337,1280,316,205005,52604,24609,71383,50424,20959,71383,145600,2012
72023,39.3,50866,200,13,50653,10565,16003,15348,11114,4234,15348,119700,2012
72025,37.2,142549,816,64,141599,36003,23845,48332,34573,13759,48332,140200,2012
72027,37.5,35085,106,47,34806,8654,17762,10987,8306,2681,10987,97900,2012
72029,35.4,47656,1,40,47615,10725,22746,14219,11110,3109,14219,120700,2012
72031,37.8,176157,1554,249,173589,44162,29470,61700,44430,17270,61700,155100,2012
72033,35.1,28049,161,9,27802,7056,17780,9395,5820,3575,9395,122800,2012
72035,37.6,48008,137,31,47779,11633,20912,15886,11296,4590,15886,112000,2012
72037,38.4,13726,74,47,13605,3073,20455,4355,3364,991,4355,99100,2012
72039,35.8,18712,54,0,18658,4378,13722,5559,4009,1550,5559,106900,2012
72041,36.2,43414,121,1,43238,10549,23804,13290,10105,3185,13290,114000,2012
72043,35.1,40577,126,12,40421,10014,16658,13052,10550,2502,13052,88800,2012
72045,35,20745,81,0,20664,4804,12481,6191,4071,2120,6191,91400,2012
72047,34.8,37074,167,0,36838,8280,15828,10563,7653,2910,10563,109000,2012
72049,39.9,1535,90,17,1425,295,16375,463,332,131,463,124200,2012
72051,36.9,38179,805,73,37208,9244,28530,12185,10038,2147,12185,141300,2012
72053,37.5,36857,206,61,36491,9086,21194,13005,9573,3432,13005,107300,2012
72054,35.5,12657,32,0,12625,3096,16150,3955,3050,905,3955,104300,2012
72055,36.7,19363,198,0,19165,4287,13567,5805,4119,1686,5805,84900,2012
72057,34.8,45250,46,14,45190,10550,17496,14372,10158,4214,14372,92900,2012
72059,35.8,21493,215,0,21278,5360,14679,6587,5196,1391,6587,82600,2012
72061,39.7,97639,931,119,96371,24397,34638,34400,25990,8410,34400,210700,2012
72063,35.8,45540,191,57,45259,10454,27817,13532,11225,2307,13532,161900,2012
72065,37.1,41945,149,0,41585,10475,18669,13109,9627,3482,13109,138300,2012
72067,42,17217,191,26,16942,4581,20428,6334,4691,1643,6334,99000,2012
72069,38.3,58333,415,59,57819,13262,19918,18423,14212,4211,18423,111300,2012
72071,38,45567,206,10,45261,11094,14570,14913,9422,5491,14913,107700,2012
72073,33.7,16600,58,0,16542,3940,17137,4819,3309,1510,4819,97500,2012
72075,34.5,50695,101,3,50568,12492,16938,16063,12645,3418,16063,107400,2012
72077,34.4,40292,292,16,39921,9512,18946,12450,9372,3078,12450,118300,2012
72079,39.1,25671,127,0,25544,6073,13698,8246,5064,3182,8246,98600,2012
72081,37.5,30628,124,0,30463,7621,12094,9897,6248,3649,9897,103300,2012
72083,36.6,9853,34,0,9819,2487,14460,3255,2171,1084,3255,101600,2012
72085,35.4,38687,38,0,38635,8799,19345,11655,8522,3133,11655,118800,2012
72087,33.2,29997,1,17,29969,6478,19100,8866,6812,2054,8866,106200,2012
72089,37.6,20050,263,87,19686,4838,20084,6714,4823,1891,6714,111200,2012
72091,37.2,43974,399,0,43575,11284,17513,15500,10912,4588,15500,112300,2012
72093,36.7,6546,0,12,6534,1226,12288,1725,1192,533,1725,99200,2012
72095,37.7,12201,67,0,12134,2920,16043,4001,2950,1051,4001,96600,2012
72097,37.2,88664,857,107,87385,20829,15060,31288,18456,12832,31288,95900,2012
72099,35.2,40044,324,0,39598,8704,14384,11441,8760,2681,11441,99800,2012
72101,33.3,32617,13,2,32572,7504,14596,9138,7139,1999,9138,104900,2012
72103,34.2,26761,285,1,26464,6081,16706,8453,6612,1841,8453,102000,2012
72105,35.2,30385,16,0,30333,6616,16007,8134,5828,2306,8134,93500,2012
72107,34.5,23386,114,0,23223,5249,14296,6893,5145,1748,6893,113000,2012
72109,38.3,19225,72,81,19071,4268,14777,6173,4787,1386,6173,92000,2012
72111,33.4,24193,201,48,23912,5905,15541,7404,5863,1541,7404,84700,2012
72113,36.6,165602,897,72,164556,39755,17459,55702,37121,18581,55702,107000,2012
72115,36.9,25874,69,0,25769,6533,14255,8533,5127,3406,8533,110300,2012
72117,41.2,15182,912,145,13861,3873,16548,5476,4283,1193,5476,121100,2012
72119,36.9,54203,215,55,53932,13008,22491,16868,13233,3635,16868,117200,2012
72121,38.5,25216,324,0,24892,5687,15958,7470,5720,1750,7470,96900,2012
72123,34.9,31019,102,41,30806,7842,13386,10608,7903,2705,10608,90000,2012
72125,39.7,35441,151,1,35289,8128,15470,11932,8524,3408,11932,97300,2012
72127,39,393633,5233,1205,385745,91476,23100,148578,82389,66189,148578,168300,2012
72129,36.8,40979,173,1,40708,10133,17875,13131,9291,3840,13131,133500,2012
72131,38.8,42291,359,3,41905,8890,13658,12011,8547,3464,12011,113700,2012
72133,33.7,23261,0,18,23243,5646,18024,7646,5832,1814,7646,96700,2012
72135,34.3,74178,233,10,73935,18313,27211,21992,18058,3934,21992,147800,2012
72137,35.7,89294,504,139,88425,21663,23572,30110,22975,7135,30110,129300,2012
72139,36.4,74655,422,16,74210,18031,31354,24644,17649,6995,24644,162200,2012
72141,38,33033,243,37,32647,7697,14752,10224,6810,3414,10224,98900,2012
72143,35.3,39913,762,3,39120,8947,17616,11542,9320,2222,11542,118700,2012
72145,36.6,59444,1099,17,58328,13536,16462,17282,14287,2995,17282,114400,2012
72147,41.9,9293,282,20,8981,1928,16598,2921,2419,502,2921,116600,2012
72149,33.5,25983,38,1,25851,6047,16014,7625,5823,1802,7625,99500,2012
72151,36.7,37823,86,78,37646,8920,17926,11650,8704,2946,11650,97200,2012
72153,38.4,41876,358,27,41464,9322,14728,12038,9025,3013,12038,93800,2012
01001,37.5,54907,41994,10002,1365,14132,53682,20071,15418,4653,20071,136200,2013
01003,41.5,187114,156039,17642,8322,51903,50221,73283,53225,20058,73283,168600,2013
01005,38.3,27321,12653,12652,1339,6062,32911,9200,6227,2973,9200,89200,2013
01007,39.4,22754,17034,4929,443,5337,36447,7091,5599,1492,7091,90500,2013
01009,39.6,57623,50953,780,4800,15667,44145,21108,17108,4000,21108,117100,2013
01011,39.6,10746,2390,7614,611,2389,32033,3741,2781,960,3741,70600,2013
01013,40.6,20624,11113,9024,220,5346,29918,8235,5788,2447,8235,74700,2013
01015,38.7,117714,86504,24214,3953,29999,39962,45196,31028,14168,45196,100600,2013
01017,42.4,34145,19788,13734,174,8999,32402,13722,9324,4398,13722,81200,2013
01019,45,26034,23940,1214,357,8384,34907,11656,8866,2790,11656,99400,2013
01021,38,43744,35444,4273,3356,12109,41250,16232,12093,4139,16232,102600,2013
01023,44.2,13687,7615,5861,39,3552,33941,5518,4620,898,5518,58200,2013
01025,40.3,25573,13723,11336,118,6219,29357,9631,7019,2612,9631,85600,2013
01027,42.1,13703,10973,2090,415,3920,34002,5649,4237,1412,5649,79900,2013
01029,41.3,14945,13871,530,320,4036,38019,5601,4347,1254,5601,100800,2013
01031,37.8,50468,36326,8464,3217,12998,43768,18820,13153,5667,18820,131000,2013
01033,41.7,54456,43186,8826,1201,15112,39077,22260,16048,6212,22260,99300,2013
01035,43.2,13104,6693,5856,191,3438,24658,4994,3950,1044,4994,69600,2013
01037,44.7,11198,7368,3424,229,2891,37277,4506,3740,766,4506,75100,2013
01039,42.4,37847,31710,4786,544,10292,35869,15041,11293,3748,15041,88800,2013
01041,40.6,13955,9905,3172,231,3700,36275,5601,3916,1685,5601,70800,2013
01043,40.4,80499,74440,782,3451,22418,38847,31342,23497,7845,31342,106100,2013
01045,36.1,50102,35311,9495,2845,12785,44889,19345,11825,7520,19345,99400,2013
01047,38,43091,12416,29584,340,9770,26519,16173,9847,6326,16173,75700,2013
01049,38.8,71076,57799,1172,9790,18179,37851,24923,19022,5901,24923,93400,2013
01051,37.8,79895,59401,16246,2152,20863,54766,28324,21397,6927,28324,144600,2013
01053,39.4,38169,23311,12316,756,9321,30687,13681,9915,3766,13681,84100,2013
01055,40.3,104260,82379,15848,3604,27863,38013,40217,29123,11094,40217,100000,2013
01057,43.5,17110,14652,1945,229,4814,33838,6956,5207,1749,6956,71400,2013
01059,38.3,31666,25137,1330,4766,8797,36415,12437,8644,3793,12437,82300,2013
01061,41.9,26791,22612,2518,923,7684,35625,10945,7888,3057,10945,78100,2013
01063,42.4,8934,1583,7217,47,1991,24226,3264,2389,875,3264,72700,2013
01065,40.7,15594,6202,9205,52,3923,30051,5969,4655,1314,5969,79900,2013
01067,42.7,17308,11745,4741,408,4835,41650,7001,5441,1560,7001,97000,2013
01069,38.6,102326,69826,26220,3146,26581,40948,39250,25369,13881,39250,122300,2013
01071,42,53171,47789,1732,1371,14635,37634,20765,15624,5141,20765,93400,2013
01073,37.2,658552,338647,277535,25048,166244,45429,259634,167953,91681,259634,140800,2013
01075,42.9,14396,12380,1687,190,4435,36028,6084,4351,1733,6084,66800,2013
01077,40.8,92666,79011,9308,2135,25263,42844,38458,26878,11580,38458,114300,2013
01079,41.2,34009,26058,3722,633,9576,38551,13382,10725,2657,13382,94200,2013
01081,29.9,144405,99838,32786,5076,33438,43542,55864,34453,21411,55864,146900,2013
01083,38.5,85264,66680,10830,4785,23059,48619,31794,24342,7452,31794,134500,2013
01085,41,11086,2796,8179,82,2621,26230,4212,3156,1056,4212,71400,2013
01087,36.8,20803,3286,16753,295,5079,30724,8107,5329,2778,8107,75700,2013
01089,37.4,339279,224119,80794,15561,87328,58434,132975,92166,40809,132975,164500,2013
01091,41.8,20669,9470,10668,389,5734,35079,8464,6031,2433,8464,89600,2013
01093,43.5,30615,28244,1215,683,8912,32888,12700,9633,3067,12700,78700,2013
01095,38.4,93699,78195,1458,11594,24209,39526,34250,24617,9633,34250,114000,2013
01097,36.7,413188,242823,143421,10221,104815,43028,155178,103339,51839,155178,124300,2013
01099,40.4,22778,12480,9522,233,5653,29203,8333,6166,2167,8333,76900,2013
01101,34.8,228980,86718,125733,7971,57030,44790,88844,54517,34327,88844,122900,2013
01103,39,119673,92560,14042,9151,31975,44800,46192,33039,13153,46192,120500,2013
01105,35.8,10390,3109,7097,67,2307,28209,3400,2277,1123,3400,58000,2013
01107,42.1,19516,10912,8063,349,5221,28741,7926,5707,2219,7926,81900,2013
01109,31.6,32977,18904,12003,754,7900,33090,12959,7494,5465,12959,101000,2013
01111,41.5,22819,17173,4609,667,6133,35213,9013,6513,2500,9013,88600,2013
01113,35.2,55544,28462,23059,2359,13510,36143,21142,12962,8180,21142,104400,2013
01115,38.9,84521,73421,7606,1816,23181,50786,31353,25546,5807,31353,134600,2013
01117,37.3,198366,157776,22153,11678,53404,68770,74144,58555,15589,74144,193000,2013
01119,37.2,13552,3311,9910,112,3179,22186,5060,3275,1785,5060,74100,2013
01121,40,81845,52607,26063,1698,22367,35439,31486,22403,9083,31486,92600,2013
01123,42,41428,28693,11258,1030,11634,39130,16373,11828,4545,16373,94900,2013
01125,31.4,196824,126497,59154,6133,44487,45408,67882,43713,24169,67882,153300,2013
01127,41.8,66622,60032,3566,1404,18082,37566,25751,19303,6448,25751,82100,2013
01129,39.8,17284,11300,4162,185,4834,42156,6620,5725,895,6620,83900,2013
01131,39,11531,3106,8395,18,2572,23642,3866,2880,986,3866,67000,2013
01133,43.6,24342,23050,138,652,6560,32900,9489,7105,2384,9489,82500,2013
02013,41.4,3141,421,370,424,279,61250,435,238,197,435,118500,2013
02016,38.6,5538,1674,348,591,623,81853,1033,376,657,1033,218400,2013
02020,32.8,295237,182537,16452,23573,69974,77454,105208,63745,41463,105208,282800,2013
02050,26.2,17356,1942,97,238,3226,51689,4358,2796,1562,4358,189600,2013
02060,40.9,933,496,1,51,261,79531,384,220,164,384,175000,2013
02068,39.2,2020,1767,13,53,414,72500,716,493,223,716,192500,2013
02070,28.7,4923,881,18,114,875,54150,1339,774,565,1339,194000,2013
02090,30.7,98656,72072,4362,6492,22895,69223,35588,21082,14506,35588,212500,2013
02100,44,2546,2042,10,22,673,52866,1245,799,446,1245,171900,2013
02105,46.4,2141,1016,9,49,578,49545,930,590,340,930,200500,2013
02110,37.3,31897,21296,357,1774,8012,81490,12099,7805,4294,12099,309900,2013
02122,40.7,56163,46328,334,1846,14479,61793,21720,15798,5922,21720,204900,2013
02130,38.7,13595,8895,31,601,3343,62519,5295,3099,2196,5295,265600,2013
02150,31.9,13850,7211,90,1084,3403,68718,4501,2562,1939,4501,224500,2013
02164,29.8,1454,322,7,24,381,51786,508,327,181,508,136400,2013
02170,34.7,91519,75168,760,3696,22437,71037,31123,23878,7245,31123,218900,2013
02180,27.9,9695,1605,91,149,2077,49974,2797,1542,1255,2797,142800,2013
02185,33.5,9484,3047,40,284,1432,80761,1990,962,1028,1990,154600,2013
02188,25.7,7624,876,46,87,1464,61607,1828,1024,804,1828,131000,2013
02195,42.4,3806,2656,60,204,955,63934,1643,1137,506,1643,215100,2013
02198,39.4,5672,2776,11,154,1436,46071,2240,1583,657,2240,162500,2013
02220,38.5,8945,5683,72,475,2308,69405,3554,1997,1557,3554,323200,2013
02230,44.3,1080,834,0,12,228,71667,412,244,168,412,305600,2013
02240,35.9,7047,5489,108,283,1563,56801,2326,1546,780,2326,175000,2013
02261,38,9682,6861,38,382,2571,74878,3424,2552,872,3424,177700,2013
02270,22,7678,274,15,17,1451,40176,1744,1240,504,1744,109300,2013
02275,53.3,2371,1560,3,62,646,45841,1149,820,329,1149,157400,2013
02282,41,607,214,39,11,161,72500,254,126,128,254,147500,2013
02290,35.3,5656,1233,8,80,1222,34710,2056,1448,608,2056,106500,2013
04001,32.7,71978,14266,269,4352,12996,31476,19055,14585,4470,19055,83100,2013
04003,39.8,131038,75811,4749,43170,32607,45755,49174,33832,15342,49174,146200,2013
04005,31,134795,74109,1635,18415,29860,49555,46198,27500,18698,46198,220400,2013
04007,47.9,53335,34645,270,9702,13546,39954,20601,15619,4982,20601,134000,2013
04009,31.9,37168,19451,704,11472,8050,44943,11031,8193,2838,11031,122200,2013
04011,33.6,8679,4131,79,4120,2431,47992,3386,1561,1825,3386,81000,2013
04012,53.8,20408,12574,192,4941,6348,35776,10221,7566,2655,10221,88800,2013
04013,35,3889161,2264665,188113,1155592,930395,53596,1411727,882862,528865,1411727,176500,2013
04015,48,201680,159446,2002,30474,51645,39200,80230,55669,24561,80230,133900,2013
04017,35.2,107326,46570,377,11650,24763,36927,34343,24712,9631,34343,112200,2013
04019,37.8,986891,539713,32322,345072,238028,45841,384041,240615,143426,384041,167500,2013
04021,36.1,379128,220844,17111,109232,89831,50027,123733,92077,31656,123733,120200,2013
04023,35.7,47122,7482,141,38978,11376,37745,15078,10003,5075,15078,140000,2013
04025,50.1,211968,173253,1117,29107,56865,42987,91349,63903,27446,91349,184100,2013
04027,33.4,199026,69087,3671,119671,54380,41595,70122,48778,21344,70122,118000,2013
05001,41.1,18957,13396,4674,539,5206,39633,7883,5321,2562,7883,75500,2013
05003,39.7,21645,14738,5510,1079,6078,35683,8656,6546,2110,8656,62500,2013
05005,50.9,41281,39431,160,742,12120,35343,18155,13880,4275,18155,120000,2013
05007,34.7,227439,172751,2738,35600,61061,54515,82150,56388,25762,82150,147500,2013
05009,41.5,37099,35176,100,769,10732,38506,15086,10953,4133,15086,106400,2013
05011,40.2,11418,6571,3173,1553,3234,30409,4789,3294,1495,4789,62900,2013
05013,42.7,5319,3896,1341,45,1357,30980,2046,1637,409,2046,58300,2013
05015,44.2,27531,22819,43,3725,7501,36584,11019,8065,2954,11019,120000,2013
05017,42.4,11621,4642,6256,573,2942,26201,4510,2990,1520,4510,54700,2013
05019,33.5,22912,16061,5460,951,5354,32721,8341,5293,3048,8341,86600,2013
05021,42.9,15790,15237,35,242,4397,31502,6814,4948,1866,6814,62400,2013
05023,46.4,25856,24676,174,558,7166,40246,10286,7912,2374,10286,117900,2013
05025,40.3,8648,7356,1126,55,2496,39420,3346,2592,754,3346,78300,2013
05027,36.1,24512,14546,8949,592,6505,35128,9449,6506,2943,9449,78900,2013
05029,40.6,21235,17449,2497,788,5747,35225,8154,6030,2124,8154,86100,2013
05031,33.1,98398,78021,13314,4438,25840,41393,37834,22057,15777,37834,120700,2013
05033,38.3,61796,53364,811,3895,17580,39479,23368,17352,6016,23368,102800,2013
05035,34.4,50447,22717,25420,1069,12749,37751,18309,10313,7996,18309,99500,2013
05037,39.4,17760,13161,3908,280,4736,38085,6818,4457,2361,6818,78400,2013
05039,43,8045,4332,3310,199,2072,28931,3269,2171,1098,3269,59200,2013
05041,39.3,12774,5963,6113,574,3381,28680,5305,2968,2337,5305,55100,2013
05043,37.4,18686,12601,5290,487,4984,31171,7496,4586,2910,7496,83300,2013
05045,31.4,115928,95179,12251,4558,28430,50314,42413,27638,14775,42413,137800,2013
05047,40.9,18063,16847,148,434,4764,36766,6769,5012,1757,6769,93000,2013
05049,47.3,12266,11796,22,124,3468,35522,5140,4014,1126,5140,88200,2013
05051,44.2,96547,80743,7934,4791,25627,39162,39881,27360,12521,39881,130500,2013
05053,39.6,17922,16783,433,414,5031,49004,6855,5336,1519,6855,100800,2013
05055,37.6,42580,40474,284,993,11548,38413,16603,10514,6089,16603,99100,2013
05057,38.8,22509,12676,6658,2739,5525,32056,8296,5640,2656,8296,73100,2013
05059,40.1,33182,27741,3803,989,8485,41193,12231,8863,3368,12231,81300,2013
05061,36.9,13748,9193,2944,1375,3701,35879,5208,3299,1909,5208,74500,2013
05063,38.3,36786,32917,971,2166,10017,35026,14544,10271,4273,14544,88900,2013
05065,47.5,13560,12834,138,217,3870,30661,5682,4430,1252,5682,73900,2013
05067,41.2,17809,13954,2895,457,4248,30284,6541,4395,2146,6541,56500,2013
05069,37.5,75782,31151,41878,1270,18108,37140,28367,18287,10080,28367,81100,2013
05071,38.6,25655,21239,434,3229,7072,31003,10046,6654,3392,10046,88700,2013
05073,43.7,7501,4498,2800,138,1708,29732,2722,1980,742,2722,52200,2013
05075,40.6,17227,16623,132,179,4376,32239,6580,4653,1927,6580,59800,2013
05077,39.8,10267,4244,5795,204,2169,25034,3491,1989,1502,3491,54700,2013
05079,36.9,14148,9249,4115,481,2992,32697,4188,2917,1271,4188,59300,2013
05081,41.3,12992,9624,2588,370,3844,39673,5315,4147,1168,5315,80900,2013
05083,41.9,22221,20436,393,538,5650,34996,8233,6204,2029,8233,81100,2013
05085,35.4,69266,60671,4308,2443,18783,52582,25052,18346,6706,25052,120600,2013
05087,40.7,15671,14354,24,783,4305,35771,6048,4628,1420,6048,92800,2013
05089,50.8,16605,15798,34,325,4722,34494,7036,5596,1440,7036,92700,2013
05091,37.4,43515,30659,10385,1168,11334,41319,16950,11389,5561,16950,92900,2013
05093,35,45912,27673,15616,1702,11680,36428,17058,10028,7030,17058,75300,2013
05095,43.8,8002,4459,3299,153,2169,27263,3393,2156,1237,3393,52200,2013
05097,46.9,9387,8690,47,354,2633,31345,3873,3089,784,3873,76400,2013
05099,41.3,8948,5780,2745,248,2382,33694,3622,2646,976,3622,64600,2013
05101,46.5,8211,7776,23,32,2413,30038,3507,2895,612,3507,74600,2013
05103,42.6,25651,14398,10327,437,6927,32015,10733,7116,3617,10733,70000,2013
05105,42.4,10381,9676,290,264,2811,42455,3903,3104,799,3903,77700,2013
05107,37.4,21253,7424,13270,301,5465,26737,8339,4543,3796,8339,59500,2013
05109,40.7,11250,9881,353,738,3177,32206,4325,3163,1162,4325,75200,2013
05111,39.8,24403,21617,1847,588,6353,32089,9369,5853,3516,9369,71300,2013
05113,43.4,20540,18382,22,1223,5638,32835,8069,6216,1853,8069,82700,2013
05115,35.3,62248,53763,1847,4497,15877,40453,22603,15788,6815,22603,110200,2013
05117,45,8573,7323,1085,80,2485,34855,3737,2724,1013,3737,72400,2013
05119,36,386106,212303,135353,22280,94427,46013,153720,92840,60880,153720,140500,2013
05121,41.7,17896,17117,80,301,5215,34418,7244,5457,1787,7244,74100,2013
05123,37,27914,11696,14384,1179,6263,30873,9358,5174,4184,9358,65600,2013
05125,38.8,109844,96925,5519,4299,29595,55348,41287,32098,9189,41287,138600,2013
05127,41.3,11111,9430,16,795,3210,37448,4324,3155,1169,4324,82100,2013
05129,46.6,8101,7668,32,89,2112,30779,3296,2554,742,3296,85100,2013
05131,36.9,126536,91557,7153,15953,32107,40471,49294,30950,18344,49294,114500,2013
05133,34.1,17137,10331,703,5392,4142,35153,5745,4000,1745,5745,68800,2013
05135,46.6,17203,16295,57,302,4584,30861,7023,5616,1407,7023,73800,2013
05137,46.9,12517,11989,13,180,3262,29832,5135,4020,1115,5135,88100,2013
05139,39.9,41307,25495,13575,1453,11691,37435,16596,11506,5090,16596,75000,2013
05141,46.7,17147,16114,139,475,4822,32517,7063,5519,1544,7063,86700,2013
05143,31.2,207911,152484,6804,32544,50143,41248,79214,44311,34903,79214,148800,2013
05145,36.4,77767,69445,3295,3011,20938,42487,29632,20261,9371,29632,100100,2013
05147,43.6,7180,4988,1995,48,2001,28259,3070,1932,1138,3070,58400,2013
05149,39.6,22014,16791,441,4208,5344,35535,7917,5258,2659,7917,91200,2013
06001,36.8,1535248,517764,181315,345847,354289,72112,545071,289960,255111,545071,493800,2013
06003,44.3,1165,823,7,87,263,58636,394,321,73,394,333600,2013
06005,49.1,37422,29928,893,4710,9525,53684,14262,10859,3403,14262,270500,2013
06007,37,220542,164932,2795,32084,51029,43752,84816,51005,33811,84816,225900,2013
06009,50,45147,37570,378,4794,12989,55295,18702,14666,4036,18702,254800,2013
06011,33.9,21366,8338,174,11953,4994,52158,6853,4335,2518,6853,181600,2013
06013,38.6,1065794,503167,93777,261427,265305,78756,375855,247843,128012,375855,404000,2013
06015,39.1,28357,18205,889,5217,5954,37909,9593,5774,3819,9593,198400,2013
06017,44.1,180982,144293,1480,22034,48981,69297,67885,50797,17088,67885,359500,2013
06019,30.9,939605,302091,45457,477078,211170,45563,289811,155858,133953,289811,195400,2013
06021,37.2,28054,15447,196,10726,6809,43023,9628,6074,3554,9628,217700,2013
06023,37.5,134613,103483,1552,13584,30562,41426,53296,29777,23519,53296,288300,2013
06025,31.8,175201,23456,4938,141709,37969,41807,48099,27107,20992,48099,147300,2013
06027,45.7,18482,12051,170,3684,4462,44796,7873,5047,2826,7873,236100,2013
06029,30.8,848204,321424,45164,422395,191608,48552,255271,148163,107108,255271,161700,2013
06031,31.1,151806,53046,9843,78236,31566,48133,40785,21127,19658,40785,176900,2013
06033,45.1,64260,47227,1480,11323,16540,36548,26505,16616,9889,26505,183600,2013
06035,37.3,34018,22540,2824,6084,6442,53107,9945,6259,3686,9945,185500,2013
06037,35.1,9893481,2721187,803913,4741492,2170631,55909,3230383,1515098,1715285,3230383,420200,2013
06039,33.2,151435,56775,4641,82456,32854,45625,42516,25838,16678,42516,182000,2013
06041,44.8,254643,185230,6682,39540,64282,90839,102912,64596,38316,102912,781900,2013
06043,50.1,18061,14939,158,1717,4805,49820,7238,5185,2053,7238,235000,2013
06045,41.8,87497,59274,591,19856,20585,43469,33878,19727,14151,33878,323600,2013
06047,30,258707,80708,8873,143858,58319,42591,75409,40398,35011,75409,146400,2013
06049,46.9,9468,7420,125,1353,2397,36212,3983,2741,1242,3983,164100,2013
06051,37.2,14217,9603,45,3817,3168,61757,5268,2930,2338,5268,344500,2013
06053,33,420569,136539,11222,235119,90557,59168,125428,62398,63030,125428,362400,2013
06055,39.8,137837,76851,2771,44942,33934,70443,49431,29969,19462,49431,428600,2013
06057,48.5,98509,84987,329,8598,26204,57353,40991,29768,11223,40991,357300,2013
06059,36.4,3051771,1327507,45900,1032879,712753,75422,995512,584250,411262,995512,519600,2013
06061,40.4,355924,268514,4147,46425,94036,72725,132709,93656,39053,132709,342000,2013
06063,49.9,19586,16628,238,1591,5381,45794,8997,6275,2722,8997,243700,2013
06065,33.9,2228528,867859,131246,1025543,504705,56529,683144,454455,228689,683144,231000,2013
06067,35.1,1435207,688052,139014,312797,337868,55064,517243,293263,223980,517243,234200,2013
06069,34.5,56115,21025,477,31930,13458,66237,16995,10465,6530,16995,343000,2013
06071,31.9,2056915,667933,170307,1026596,459664,54090,603879,373813,230066,603879,222300,2013
06073,34.8,3138265,1505595,150348,1015362,714977,62962,1076483,579661,496822,1076483,402100,2013
06075,38.5,817501,341100,45909,124167,156742,75604,345344,126394,218950,345344,744600,2013
06077,32.9,693177,245469,46840,272529,160476,53380,215563,125680,89883,215563,208000,2013
06079,39.5,272094,191906,5558,57503,64756,58697,102154,59648,42506,102154,426600,2013
06081,39.3,729543,305350,18486,184742,174540,88202,257941,153318,104623,257941,722200,2013
06083,33.5,427288,202598,7118,184851,92720,62779,141720,74579,67141,141720,453000,2013
06085,36.4,1812208,628410,43760,485593,435873,91702,609377,350367,259010,609377,645600,2013
06087,36.9,264808,156844,2488,85703,58406,66519,93504,55007,38497,93504,557500,2013
06089,42.1,177966,145932,1636,15419,45221,44651,68980,44252,24728,68980,220000,2013
06091,51.3,3127,2727,18,281,769,39009,1253,975,278,1253,231400,2013
06093,47.1,44503,35153,564,4799,12192,37709,19417,12180,7237,19417,200800,2013
06095,37.1,417258,168938,57321,102082,100840,67177,141464,87267,54197,141464,262400,2013
06097,40.2,487469,320511,6875,122818,117130,63356,185660,111634,74026,185660,407400,2013
06099,33,518321,238928,13305,220267,124157,49297,166883,97004,69879,166883,172900,2013
06101,34.8,94787,47206,1637,27538,23276,50408,31725,18898,12827,31725,188500,2013
06103,39.9,63241,45080,410,14226,16089,41924,23374,15775,7599,23374,177100,2013
06105,49.8,13638,11337,127,957,3390,36890,5668,4035,1633,5668,257400,2013
06107,29.9,446644,142669,5765,273533,103015,42708,131642,75688,55954,131642,163100,2013
06109,48,54728,44507,1122,5982,14834,48426,22025,15401,6624,22025,269400,2013
06111,36.6,829017,398921,13336,337773,196812,76544,267076,173340,93736,267076,442200,2013
06113,30.7,202288,99870,4534,62047,43818,55918,70347,37232,33115,70347,314300,2013
06115,31.9,72574,42013,2173,18692,17731,44902,24300,14356,9944,24300,171000,2013
08001,32.6,452030,239023,13247,172472,108342,56270,152803,100221,52582,152803,186600,2013
08003,31.3,15933,7827,181,7265,3676,34520,5891,3622,2269,5891,137300,2013
08005,35.9,585333,369435,56891,107841,148229,60651,225552,141460,84092,225552,230700,2013
08007,47.8,12109,9444,15,2183,3397,48933,4881,3598,1283,4881,279700,2013
08009,47.8,3761,3278,16,348,1101,38829,1651,1228,423,1651,73500,2013
08011,40.4,6141,3334,663,1893,1213,37340,1873,1190,683,1873,75500,2013
08013,35.7,301072,237899,2219,40484,70777,67956,120521,76101,44420,120521,350900,2013
08014,35.9,57171,44904,498,6775,14691,77998,22016,15031,6985,22016,275900,2013
08015,47.8,18063,15548,396,1769,5124,46504,7832,5965,1867,7832,262300,2013
08017,38.6,2189,1851,6,297,549,51641,839,642,197,839,81700,2013
08019,46.8,9048,8289,44,462,2364,67259,4024,3272,752,4024,268500,2013
08021,38.2,8256,3539,6,4541,2220,34526,3099,2397,702,3099,109700,2013
08023,49.5,3552,1115,0,2314,821,29145,1361,1083,278,1361,93800,2013
08025,38.9,5629,3336,412,1654,780,31477,1173,934,239,1173,78800,2013
08027,54.6,4245,3982,30,174,1278,32427,2048,1651,397,2048,216200,2013
08029,46.7,30659,25334,384,4360,8432,42078,12671,9591,3080,12671,191200,2013
08031,33.8,619297,326215,59829,194513,128046,50313,266069,133651,132418,266069,249100,2013
08033,48.2,1709,1570,0,77,499,37750,780,630,150,780,121800,2013
08035,36.9,293014,248624,2673,22751,81035,101591,103780,83925,19855,103780,335600,2013
08037,34.7,52151,35100,239,15629,11315,74456,17966,11856,6110,17966,453300,2013
08039,43.8,23295,20998,56,1340,6369,82118,8240,7449,791,8240,333600,2013
08041,33.8,634423,453927,35201,97572,160830,57125,237039,150987,86052,237039,213500,2013
08043,43.4,46850,35832,2922,5894,10994,39943,16938,11980,4958,16938,159500,2013
08045,35.1,56687,39091,248,15976,14164,57022,20163,13072,7091,20163,302700,2013
08047,44.8,5477,4897,26,369,1429,63885,2504,1891,613,2504,281700,2013
08049,41.5,14535,12902,87,1102,3311,64664,5227,3915,1312,5227,282000,2013
08051,34.1,15421,13640,70,1315,3407,52332,6293,3718,2575,6293,329500,2013
08053,56.5,809,778,0,21,254,56667,388,306,82,388,261700,2013
08055,52.6,6625,3831,92,2332,1835,33298,3059,2217,842,3059,152400,2013
08057,46.7,1371,1186,1,170,390,43606,648,468,180,648,123200,2013
08059,40.4,540669,430100,5168,78924,143318,68984,219562,155022,64540,219562,262400,2013
08061,40.9,1423,1331,2,67,386,40813,559,407,152,559,79400,2013
08063,38.8,8189,6270,247,1549,2038,44157,3046,2004,1042,3046,121600,2013
08065,34.9,7332,4530,74,2481,1714,44610,3079,2019,1060,3079,164400,2013
08067,38.3,52039,41658,192,6312,13083,58080,20947,13932,7015,20947,339400,2013
08069,35.5,305798,257027,2397,32682,76873,58626,121423,79646,41777,121423,247100,2013
08071,44.4,15136,8123,134,6348,3931,42261,5992,4156,1836,5992,151500,2013
08073,39.3,5442,4018,531,690,1162,41910,1845,1260,585,1845,115000,2013
08075,37.2,22607,18223,294,3579,5142,40415,8015,5564,2451,8015,119800,2013
08077,38.2,147432,121988,913,19859,39244,49471,58598,41990,16608,58598,210100,2013
08079,60.8,761,720,6,22,236,47083,393,329,64,393,275000,2013
08081,36.3,13447,11065,32,1914,3323,53231,5062,3841,1221,5062,176500,2013
08083,42.9,25512,19041,9,2946,7221,43188,10688,7539,3149,10688,189400,2013
08085,42.8,41020,31665,161,8183,11391,45718,16586,12132,4454,16586,193700,2013
08087,36,28308,17338,730,9687,7531,43774,10446,6631,3815,10446,137000,2013
08089,40.5,18817,10541,98,7673,4833,33848,7427,4804,2623,7427,91800,2013
08091,52.5,4475,4240,0,153,1313,64601,1943,1465,478,1943,383900,2013
08093,47.5,16131,14725,5,811,4732,61570,7038,6227,811,7038,247300,2013
08095,40.4,4383,3196,2,1087,1162,43011,1668,1154,514,1668,132700,2013
08097,43.3,17173,14944,47,1594,3933,72745,7507,5155,2352,7507,611200,2013
08099,37.1,12473,7730,19,4449,3279,34391,4935,3245,1690,4935,86100,2013
08101,38.9,160048,85809,2777,66756,40011,41777,62439,41032,21407,62439,138700,2013
08103,38,6770,5767,32,732,1757,60128,2638,1814,824,2638,200400,2013
08105,41.4,11913,6438,62,5154,3147,38993,4722,3184,1538,4722,129500,2013
08107,39.7,23409,21234,98,1557,6117,62002,9647,6812,2835,9647,390100,2013
08109,44.6,6200,3464,18,2501,1594,34600,2692,1800,892,2692,135400,2013
08111,43.2,659,499,0,128,147,39583,321,192,129,321,242300,2013
08113,38.9,7496,6599,1,675,1702,63594,3234,2083,1151,3234,448000,2013
08115,47.2,2376,1891,7,359,612,40221,943,647,296,943,81400,2013
08117,36,28091,22937,204,3987,6300,63697,11138,7340,3798,11138,460000,2013
08119,48,23276,20965,208,1328,6628,59040,9434,7681,1753,9434,226900,2013
08121,44.2,4796,4254,30,436,1408,44683,2019,1479,540,2019,110500,2013
08123,33.5,258780,174446,2303,73372,64965,57180,90465,63441,27024,90465,191500,2013
08125,35.8,10093,7830,3,2121,2331,44308,3811,2567,1244,3811,136600,2013
09001,39.7,926233,606763,95159,161055,230308,82283,332655,229486,103169,332655,432100,2013
09003,40,895827,584584,110594,141471,227127,64967,347874,227954,119920,347874,241500,2013
09005,44.9,188629,171430,2182,8954,51016,71338,75755,59147,16608,75755,263600,2013
09007,43.4,165690,141883,7281,8326,43850,76994,66141,50396,15745,66141,292000,2013
09009,39.4,862611,575787,102072,134072,213700,61996,328013,208964,119049,328013,256900,2013
09011,40.5,274090,212889,14130,24425,70367,66583,107066,72293,34773,107066,252900,2013
09013,38,152366,132721,4269,6924,37387,80529,54327,40397,13930,54327,254800,2013
09015,39.7,118115,100344,2071,11712,29822,59333,44018,30851,13167,44018,211100,2013
10001,36.7,165030,106653,38630,10062,40853,55149,58524,42334,16190,58524,199500,2013
10003,37.2,542784,330987,127190,48301,134103,64537,200739,140533,60206,200739,246300,2013
10005,45.9,200632,150921,24533,17744,51828,52710,76444,60356,16088,76444,236600,2013
11001,33.8,619371,217331,305877,59479,112278,65830,263649,111070,152579,263649,445200,2013
12001,30.3,249848,158134,49300,21481,51365,42149,96043,52002,44041,96043,167900,2013
12003,36.2,27069,22272,3766,586,6298,49236,8216,6548,1668,8216,124300,2013
12005,39.7,170704,134536,17238,8574,43685,47461,67561,42215,25346,67561,157600,2013
12007,39.9,27981,20693,5461,1025,6165,40259,8857,6891,1966,8857,108000,2013
12009,45.9,545667,420289,53243,46170,142130,48039,220277,161976,58301,220277,144900,2013
12011,39.8,1784889,757268,468715,461392,418780,51251,663458,437074,226384,663458,181500,2013
12013,40.1,14700,11395,2088,785,3169,32780,4696,3712,984,4696,70000,2013
12015,56.7,161276,137862,8796,9869,46164,44378,70545,55763,14782,70545,143700,2013
12017,54.6,140214,125248,4037,6710,38553,39100,60319,49808,10511,60319,117400,2013
12019,38.7,192665,147125,18928,15643,50998,59482,67805,51932,15873,67805,158600,2013
12021,47.6,328209,214311,21205,85400,82474,55843,122972,91073,31899,122972,261300,2013
12023,39.9,67568,50084,11795,3435,15313,38070,23604,16705,6899,23604,108700,2013
12027,38.6,34651,19349,4448,10385,7408,34963,10622,7626,2996,10622,89900,2013
12029,45.6,16234,13971,1372,388,3848,33981,6130,4810,1320,6130,85300,2013
12031,35.8,872598,489958,252045,68646,207670,48323,330897,203796,127101,330897,151400,2013
12033,37.4,300795,198578,65892,14856,69084,43918,111689,71575,40114,111689,130100,2013
12035,48.2,97301,73718,10580,8775,25206,47233,35647,28577,7070,35647,169300,2013
12037,42.7,11554,9134,1705,542,2923,38328,4294,2993,1301,4294,143900,2013
12039,39.4,46860,15598,25791,4648,10853,35380,16662,11867,4795,16662,111200,2013
12041,40.6,16917,14822,946,839,4430,38406,6240,4972,1268,6240,102300,2013
12043,43.8,13080,8005,1600,2786,2547,34694,3843,2771,1072,3843,87700,2013
12045,44.2,15793,11735,2900,707,3717,40455,5414,3859,1555,5414,120200,2013
12047,40,14655,8055,5105,1312,3062,37716,4657,3496,1161,4657,73500,2013
12049,33.7,27336,13083,1956,11719,5700,37125,7463,5259,2204,7463,85800,2013
12051,33,38346,13257,4752,18966,7844,35425,11223,7810,3413,11223,81400,2013
12053,48,173119,141128,8587,18416,47915,41024,70210,55684,14526,70210,117400,2013
12055,51.8,98275,68881,9024,17381,25565,35560,39931,31122,8809,39931,93600,2013
12057,36.3,1257913,667570,198292,317679,300804,49596,471340,282929,188411,471340,160000,2013
12059,42.3,19864,17504,1082,499,4721,35511,6808,5402,1406,6808,83400,2013
12061,49.6,139356,107433,12293,15867,37230,44772,58038,43482,14556,58038,157400,2013
12063,40.6,49326,32591,12894,2194,10652,36809,16244,12075,4169,16244,88100,2013
12065,44.2,14469,8302,5266,562,3638,44170,5347,4039,1308,5347,121100,2013
12067,35.3,8745,6366,1298,1030,1737,39722,2710,2165,545,2710,116600,2013
12069,46,300926,220263,28512,37954,81205,45035,117250,88280,28970,117250,142700,2013
12071,46,633968,446493,50749,118027,159917,47439,241531,171124,70407,241531,149400,2013
12073,29.7,278624,163244,84364,16197,61657,46369,110377,59432,50945,110377,183300,2013
12075,45.8,40289,32475,3796,3051,10482,34348,15582,12081,3501,15582,92200,2013
12077,37.7,8308,5910,1427,583,1494,39681,2305,1814,491,2305,78800,2013
12079,40.9,19070,10429,7219,926,4710,33833,6739,5111,1628,6739,81000,2013
12081,45.9,329487,240702,28588,49388,84432,47876,131197,93683,37514,131197,165400,2013
12083,47.6,333503,244879,40778,37383,89901,39453,134002,102790,31212,134002,119400,2013
12085,50.1,147786,117872,7719,18432,37275,49846,59891,45618,14273,59891,197900,2013
12086,38.5,2549075,396762,436385,1653390,567717,43100,828031,461562,366469,828031,201000,2013
12087,46.5,74213,52168,4649,15639,16587,53607,28503,17586,10917,28503,381200,2013
12089,43.4,74163,64778,4786,2589,20621,55315,28044,21986,6058,28044,181100,2013
12091,37.4,185852,141757,16261,13839,49332,54684,73253,48423,24830,73253,182100,2013
12093,39.6,39642,25700,3503,9606,8998,34570,12999,9607,3392,12999,105300,2013
12095,34,1175416,529755,231311,324636,267140,47581,415790,238762,177028,415790,167800,2013
12097,35.6,279837,108863,26100,131066,67632,43891,90413,57066,33347,90413,129900,2013
12099,43.7,1339221,793240,228074,261279,324859,52432,526007,374397,151610,526007,199700,2013
12101,44,468194,370861,20043,57214,121121,43888,182707,139855,42852,182707,120000,2013
12103,46.6,920015,703115,93099,75821,223360,45535,401708,268957,132751,401708,151500,2013
12105,40.1,610295,389541,87958,110968,151736,43113,219540,154872,64668,219540,111400,2013
12107,43.7,73683,53266,11822,6790,18305,32497,28047,21408,6639,28047,89600,2013
12109,42.5,197115,167427,10056,10850,52435,64876,75558,58210,17348,75558,242900,2013
12111,42.9,281015,170520,52362,47255,72781,43413,106060,77410,28650,106060,122900,2013
12113,39.2,155579,130636,8226,7264,42102,57703,57368,42240,15128,57368,162300,2013
12115,53.1,383094,322876,16598,31343,103411,49052,170555,127053,43502,170555,175000,2013
12117,38.6,427184,280083,45520,75876,99156,58175,147529,104012,43517,147529,184300,2013
12119,63.8,98409,81927,8845,5808,30455,48493,43507,39256,4251,43507,194100,2013
12121,41.8,42865,32606,5155,3780,10902,35698,15712,11347,4365,15712,98400,2013
12123,41.4,22660,16486,4757,831,5253,36356,7672,5991,1681,7672,87400,2013
12125,39.2,15307,10866,3128,777,2825,42660,3807,2531,1276,3807,89200,2013
12127,45.7,496268,371027,50616,57079,122373,42457,195907,140992,54915,195907,142800,2013
12129,39.6,30824,24482,4570,1051,7609,52691,10455,8230,2225,10455,138300,2013
12131,43.1,56590,47831,3016,3177,14632,43640,22639,16597,6042,22639,159500,2013
12133,40.5,24702,19259,3590,784,5690,38501,8533,6706,1827,8533,85900,2013
13001,38.4,18354,12789,3572,1721,4669,36786,6934,4825,2109,6934,75600,2013
13003,34.7,8332,4724,1428,2030,1882,30049,2758,1929,829,2758,75000,2013
13005,36,11159,8410,1874,817,2764,33757,4036,2724,1312,4036,77000,2013
13007,42,3410,1334,2060,11,856,27353,1374,989,385,1374,72700,2013
13009,34.1,46018,24841,18983,947,9831,32751,16338,9348,6990,16338,103900,2013
13011,38.8,18333,16361,516,1090,5006,41141,6772,5238,1534,6772,140200,2013
13013,34.2,69933,52019,7779,6269,17814,53274,23413,18309,5104,23413,127000,2013
13015,36.7,100382,79826,10144,7709,25801,47197,34567,23386,11181,34567,128500,2013
13017,37.7,17576,10030,6123,1056,4038,28547,6110,3932,2178,6110,79700,2013
13019,38.1,19174,15804,2093,927,4999,32258,7040,5409,1631,7040,80100,2013
13021,35.4,155524,64699,80597,4648,36231,37550,56585,30803,25782,56585,123000,2013
13023,37.4,12961,8952,3472,318,2675,36073,3955,2821,1134,3955,79900,2013
13025,38.5,18409,17137,632,373,4979,36070,6550,5266,1284,6550,68500,2013
13027,40.9,15885,9250,5571,844,4211,34419,6573,4446,2127,6573,101400,2013
13029,35.6,31410,23923,4319,1665,8676,64707,11230,7880,3350,11230,182400,2013
13031,25.9,71190,46125,19697,2509,15066,35840,25254,12852,12402,25254,134900,2013
13033,35.9,23223,10856,11518,641,5438,31494,7881,5531,2350,7881,80000,2013
13035,38.3,23563,15913,6574,651,5492,49754,7776,5846,1930,7776,125400,2013
13037,38.7,6592,2194,3917,355,1097,26986,1804,1274,530,1804,53000,2013
13039,31.4,50799,36088,9712,2782,13834,51990,18386,11594,6792,18386,154500,2013
13043,37.3,11045,6935,2672,1219,2696,35070,3861,2471,1390,3861,86700,2013
13045,33.7,111160,80652,20155,6998,27795,46147,39494,26328,13166,39494,118500,2013
13047,38.8,64606,59441,1675,1585,17570,47087,23941,17391,6550,23941,130200,2013
13049,39,13080,8277,3343,1378,2590,40111,3727,2902,825,3727,76100,2013
13051,34.1,271102,135956,107564,15326,63273,45794,102484,58886,43598,102484,174500,2013
13053,23.5,12193,7549,2126,1666,2101,48758,2613,752,1861,2613,97100,2013
13055,39.9,25670,21255,2860,1121,6509,33228,9457,6591,2866,9457,72400,2013
13057,36.7,218277,176244,12583,21360,57631,67261,76144,60249,15895,76144,190400,2013
13059,26.2,118864,67763,31154,12459,20623,33060,41358,18154,23204,41358,156600,2013
13061,40.7,3133,1099,1809,161,713,21192,1235,823,412,1235,72300,2013
13063,32,262455,37488,169832,35084,56280,40606,86274,47723,38551,86274,97500,2013
13065,37.4,6766,4527,1844,247,1676,30345,2586,1776,810,2586,62900,2013
13067,35.7,699235,389809,173597,86525,176700,63920,261242,173358,87884,261242,196700,2013
13069,35,42841,25724,11833,4457,10234,35693,14497,10054,4443,14497,80700,2013
13071,34.9,45781,26539,10642,7938,11736,32484,15918,10533,5385,15918,83500,2013
13073,36.7,128213,93227,19966,6884,34619,69306,43975,34682,9293,43975,170400,2013
13075,36.5,17066,11083,4728,1013,4708,34985,6308,4633,1675,6308,83100,2013
13077,37.1,129397,93573,22560,8695,34992,60813,46912,34926,11986,46912,176400,2013
13079,41.8,12607,9260,2927,100,3383,41586,4620,3649,971,4620,90800,2013
13081,37.8,23521,12110,10195,767,6338,35240,8832,5279,3553,8832,95600,2013
13083,39.4,16580,15649,183,322,4771,43205,6325,4924,1401,6325,112800,2013
13085,40.8,22387,20803,53,902,6499,53525,8506,6269,2237,8506,186000,2013
13087,37.8,27676,14321,11443,1470,7102,30619,10525,6765,3760,10525,102900,2013
13089,34.6,700308,207895,373259,66099,156378,50856,264496,149940,114556,264496,168900,2013
13091,39,21502,14026,6243,749,5454,37292,8186,5380,2806,8186,70000,2013
13093,41.1,14554,6288,7261,917,3259,29012,5133,3423,1710,5133,67600,2013
13095,33.6,94220,26705,63197,2233,22758,31671,35661,16864,18797,35661,101700,2013
13097,35.3,133486,64174,52571,11402,34404,52691,46295,32314,13981,46295,135700,2013
13099,39.4,10787,5107,5512,77,2614,28853,4030,2609,1421,4030,82400,2013
13101,30.5,4053,2847,79,1013,1090,31375,1382,866,516,1382,71600,2013
13103,36,52961,42516,7195,1613,13919,63030,17830,13666,4164,17830,155400,2013
13105,41.5,19907,12760,6023,1005,5380,35817,7635,5220,2415,7635,84500,2013
13107,37.1,22669,13692,7583,995,5522,32046,8026,5266,2760,8026,69900,2013
13109,35.6,10902,6191,3212,1358,2554,36788,4067,2590,1477,4067,89700,2013
13111,48.9,23614,22627,73,446,6905,34239,9940,7775,2165,9940,161300,2013
13113,42.7,107105,71838,21129,7022,29756,79977,37930,31451,6479,37930,231500,2013
13115,38,96147,70165,13787,9228,23558,40821,34646,22252,12394,34646,114800,2013
13117,37.3,182916,144974,4933,17350,46617,86569,58080,49730,8350,58080,258200,2013
13119,40.2,21998,18731,1922,895,5903,34830,8618,6301,2317,8618,114800,2013
13121,34.3,948554,386845,413677,73564,206393,56857,368184,198367,169817,368184,238200,2013
13123,43.5,28308,24677,142,2853,8163,39140,11513,8448,3065,11513,142200,2013
13125,39.9,3094,2742,221,54,855,37760,1189,842,347,1189,70000,2013
13127,40.1,80280,51846,20424,5155,21764,46407,31547,19530,12017,31547,162900,2013
13129,36.3,55409,44028,2309,7917,13438,40926,19066,12738,6328,19066,116100,2013
13131,38.4,25143,14905,7226,2616,6524,30571,9290,5437,3853,9290,110800,2013
13133,46.9,16091,8910,6009,957,4538,42565,6353,4802,1551,6353,145200,2013
13135,34,825911,355319,194819,166754,203575,60445,266952,182548,84404,266952,171300,2013
13137,38.7,43181,34175,1700,5552,10647,39306,14805,11303,3502,14805,137900,2013
13139,34.9,182841,115532,13262,48429,45552,50853,61220,41508,19712,61220,165300,2013
13141,42.7,9233,2189,6883,108,1573,25000,2742,2130,612,2742,67800,2013
13143,39.8,28594,26200,1302,348,7882,39993,10806,7596,3210,10806,106800,2013
13145,42.5,32267,24868,5491,941,8968,69223,11426,9910,1516,11426,203800,2013
13147,42.9,25348,19225,5072,844,6693,35615,10009,7373,2636,10009,118400,2013
13149,39.9,11708,10008,1123,242,2906,39909,4321,3286,1035,4321,93200,2013
13151,35.6,206349,106146,75870,12372,52906,60781,69238,51922,17316,69238,147500,2013
13153,34.4,143205,85634,41278,8934,36314,54893,52330,35098,17232,52330,132900,2013
13155,37.6,9571,6620,2704,123,2455,40771,3277,2371,906,3277,83400,2013
13157,37.5,60577,50432,4336,3882,16431,53179,21293,16425,4868,21293,161300,2013
13159,37.9,13748,9935,2905,540,3632,42192,5132,3903,1229,5132,120200,2013
13161,35.9,15042,10987,2357,1593,3950,36296,5509,3930,1579,5509,79900,2013
13163,38,16696,6952,9121,526,4183,26968,6220,4072,2148,6220,67200,2013
13165,40,8642,4909,3035,472,2233,26104,3354,2334,1020,3354,63400,2013
13167,40.6,9903,6154,3368,64,2316,36722,3250,2564,686,3250,65000,2013
13169,38.5,28650,20802,7140,339,7692,51497,10384,8214,2170,10384,138900,2013
13171,38.1,18139,11796,5637,367,4430,41016,6393,4484,1909,6393,122600,2013
13173,33.9,10250,6986,2284,504,2561,39452,3725,2269,1456,3725,111800,2013
13175,38.2,48203,28765,17304,1142,12244,34793,17632,11588,6044,17632,85200,2013
13177,36.1,28631,21425,5659,623,7400,60104,9773,7444,2329,9773,159000,2013
13179,27.4,64899,27922,25853,6895,17097,43832,23046,11773,11273,23046,126900,2013
13181,45.7,7894,5143,2571,25,2279,35625,3394,2671,723,3394,103700,2013
13183,29.9,15285,9050,4010,1845,3570,42651,4841,3009,1832,4841,111900,2013
13185,29.5,111334,61666,39756,5612,25247,37365,39722,21394,18328,39722,133700,2013
13187,36.1,30428,27832,669,1377,7203,43775,10999,7496,3503,10999,165900,2013
13189,38.4,21697,12112,8847,516,5916,37487,8143,5373,2770,8143,106100,2013
13191,43.8,14142,8595,4847,225,3350,39068,4993,4071,922,4993,103700,2013
13193,39.4,14455,4718,8724,544,3217,30240,4887,3252,1635,4887,65500,2013
13195,39.1,28044,23880,2276,1183,6969,42549,9732,7137,2595,9732,127800,2013
13197,40.8,8673,5068,2767,565,1879,33301,3000,2153,847,3000,87000,2013
13199,42.1,21695,12369,8872,119,5771,37333,8135,5687,2448,8135,91200,2013
13201,42.3,6054,4172,1818,36,1706,32260,2458,1832,626,2458,83200,2013
13205,37.2,23340,10828,11204,1023,5244,32054,8131,5311,2820,8131,77900,2013
13207,41.1,26613,19279,6320,590,7194,48630,9550,7290,2260,9550,148300,2013
13209,37.8,9050,6065,2408,530,2132,32702,3185,2211,974,3185,74300,2013
13211,41.2,17870,12803,4348,501,4875,47729,6513,5022,1491,6513,175700,2013
13213,36.9,39504,33296,304,5304,10660,34888,14092,9706,4386,14092,94100,2013
13215,33.3,194949,84416,86621,13270,46771,41339,72243,37984,34259,72243,133300,2013
13217,34.9,100808,52038,40632,4702,24968,50580,33840,24861,8979,33840,125600,2013
13219,39.1,33240,28501,1633,1499,9209,75004,11485,9060,2425,11485,238200,2013
13221,41.9,14730,11263,2436,570,3736,45729,5201,4003,1198,5201,120800,2013
13223,34.4,143845,107684,24812,7466,38553,61837,47881,39296,8585,47881,135500,2013
13225,33.6,27481,12151,12681,1923,6848,39844,9525,6342,3183,9525,120000,2013
13227,42.8,29486,27751,433,854,8405,51383,11083,8747,2336,11083,166300,2013
13229,38.7,18774,15840,1685,914,5023,39067,6970,5106,1864,6970,79600,2013
13231,38.4,17807,15384,1979,216,4922,53865,6140,5167,973,6140,152800,2013
13233,37.3,41308,30100,5297,5052,10718,39208,14645,10368,4277,14645,107900,2013
13235,42.1,11775,7387,3559,676,2935,41550,4034,2743,1291,4034,87300,2013
13237,44.6,21241,13939,5692,1372,6453,44764,8457,6519,1938,8457,140600,2013
13239,42.8,2396,1014,1352,0,666,31068,932,720,212,932,62300,2013
13241,46.4,16271,14390,201,1300,4487,35423,6997,5125,1872,6997,168300,2013
13243,43.9,7498,2636,4434,41,1957,30023,3020,2151,869,3020,70300,2013
13245,33.2,201081,75447,107551,8655,44318,37749,72281,39395,32886,72281,100900,2013
13247,37.1,85650,34176,39991,8349,21428,52579,29317,20219,9098,29317,149900,2013
13249,40,5017,3276,1357,338,1264,38425,1829,1178,651,1829,93000,2013
13251,40.1,14455,7871,6129,199,3380,34848,5165,3656,1509,5165,77000,2013
13253,44,8831,5560,2945,232,2356,30521,3317,2555,762,3317,71200,2013
13255,37.2,64011,38717,21063,2557,16239,41534,22997,14514,8483,22997,113900,2013
13257,40.7,25910,21699,3284,461,6550,37898,9227,6891,2336,9227,106600,2013
13259,38.3,6007,1655,3533,800,1056,23451,1851,1172,679,1851,50600,2013
13261,34.3,32099,13088,16531,1660,7482,33796,11493,6685,4808,11493,90300,2013
13263,46.3,6689,2608,3965,44,1884,32424,2682,2036,646,2682,76500,2013
13265,42.5,1766,703,968,71,430,25465,704,515,189,704,68300,2013
13267,36.1,25343,14988,7194,2624,5423,37587,7885,5620,2265,7885,86100,2013
13269,40.7,8595,5004,3385,175,2648,27455,3681,2550,1131,3681,60800,2013
13271,39.4,16391,8351,5876,2111,3787,26634,5567,3607,1960,5567,58300,2013
13273,41,9246,3338,5608,183,2327,32628,3351,2125,1226,3351,78800,2013
13275,39.1,44692,25975,16626,1390,11128,34035,17377,9826,7551,17377,127000,2013
13277,34.4,40537,23255,11784,4230,9329,34591,13691,8364,5327,13691,117300,2013
13279,35.9,27229,16821,6813,3085,6857,31189,10310,6435,3875,10310,88100,2013
13281,51.7,10551,10116,143,231,2719,36570,4261,3613,648,4261,164000,2013
13283,38.7,6817,4629,2053,31,1653,37894,2515,1711,804,2515,64300,2013
13285,36.1,67776,40406,22906,2310,17139,41161,24441,14889,9552,24441,121300,2013
13287,40.2,8637,4702,3478,320,2183,28326,3166,2048,1118,3166,83800,2013
13289,45.2,8808,4915,3806,6,2146,31234,3056,2444,612,3056,54700,2013
13291,51.7,21399,20288,122,547,6569,40009,9141,7161,1980,9141,198300,2013
13293,42.1,26918,18352,7509,621,7167,35329,10341,6928,3413,10341,86600,2013
13295,40,68481,62945,2913,1152,18369,39963,26191,19013,7178,26191,104700,2013
13297,37.9,84397,65601,12913,2968,22989,52369,29520,22166,7354,29520,157100,2013
13299,38.2,36008,23364,10855,1248,8912,34572,13460,8794,4666,13460,79600,2013
13301,43.4,5706,2115,3446,2,1350,27796,2208,1455,753,2208,66700,2013
13303,39.1,20982,9258,11046,426,4995,33652,7119,5161,1958,7119,82300,2013
13305,37.4,30187,21667,6426,1796,7328,35830,10171,7026,3145,10171,80400,2013
13307,39.7,2769,1468,1258,33,735,35718,1129,900,229,1129,48800,2013
13309,36.7,7746,4459,3170,81,1495,24382,2096,1395,701,2096,54200,2013
13311,43,27400,25558,838,704,8185,40670,11788,8757,3031,11788,169600,2013
13313,34.3,102556,63105,3755,33048,25735,40471,34450,22618,11832,34450,122800,2013
13315,40,9110,5420,3386,168,1895,32928,2705,2045,660,2705,71200,2013
13317,43.8,10265,5351,4395,368,2486,28983,4083,2945,1138,4083,95200,2013
13319,40.8,9520,5499,3574,227,2307,36173,3348,2619,729,3348,71600,2013
13321,39.6,21670,14790,6157,396,5706,35792,7851,5816,2035,7851,75400,2013
15001,40.7,187044,57743,1116,22156,43012,51250,64909,42661,22248,64909,309800,2013
15003,37.4,964678,186133,20597,83045,217400,72764,309803,172043,137760,309803,556300,2013
15005,53.8,71,33,0,3,12,59375,46,0,46,46,NA,2013
15007,41.6,67872,20672,311,6707,15609,62052,22390,14010,8380,22390,484500,2013
15009,39.8,156633,49596,671,16260,36025,63512,52623,30556,22067,52623,523700,2013
16001,35.2,401673,345959,3810,29167,102874,55210,151600,103279,48321,151600,183600,2013
16003,51,3937,3703,0,68,1187,35434,1707,1393,314,1707,150500,2013
16005,32.1,83091,71496,553,5908,20010,43534,30271,20831,9440,30271,142600,2013
16007,40.1,5957,5608,7,229,1802,44964,2442,1986,456,2442,129700,2013
16009,45.3,9186,7797,145,260,2653,39049,3888,2924,964,3888,136000,2013
16011,32.3,45485,34115,125,7902,11297,47941,14650,10963,3687,14650,135400,2013
16013,41.6,21294,16589,7,4262,6063,64042,9207,6451,2756,9207,375000,2013
16015,49.6,6944,6450,31,250,1858,41056,2994,2343,651,2994,195600,2013
16017,46,40743,38402,46,973,11470,41414,17388,12709,4679,17388,222200,2013
16019,32,105580,89513,577,12462,26721,50872,36066,26317,9749,36066,154700,2013
16021,42.8,10866,9968,20,429,2900,37003,4144,3085,1059,4144,174300,2013
16023,42.6,2786,2539,38,104,680,41131,1022,812,210,1022,110300,2013
16025,37.8,1267,1046,0,204,321,41154,464,314,150,464,163000,2013
16027,32,192153,138607,685,46240,46991,42105,63442,43959,19483,63442,122800,2013
16029,37.9,6867,6467,4,344,1950,53586,2644,2224,420,2644,116300,2013
16031,32,23054,16671,59,5861,5514,42039,7653,5277,2376,7653,125900,2013
16033,37,751,400,0,351,227,33200,304,181,123,304,111700,2013
16035,49.7,8638,7916,25,283,2347,40134,3545,2841,704,3545,138300,2013
16037,49.1,4331,4149,0,106,1147,39541,1870,1561,309,1870,150600,2013
16039,30.3,26528,19782,599,4131,6684,42842,9555,5958,3597,9555,136800,2013
16041,32.2,12801,11736,17,846,3161,44962,4150,3359,791,4150,156800,2013
16043,34.3,13088,11159,6,1649,3441,44520,4549,3751,798,4549,147600,2013
16045,42.7,16722,14821,4,1342,4539,44432,6323,4715,1608,6323,150400,2013
16047,35.6,15278,10578,5,4312,3948,37050,5552,3915,1637,5552,123800,2013
16049,48.4,16269,15006,21,456,4509,37349,6534,5109,1425,6534,150900,2013
16051,30.5,26389,23079,21,2716,6690,52023,8058,6754,1304,8058,157500,2013
16053,31.5,22391,14733,36,7143,5686,40126,7676,4876,2800,7676,135200,2013
16055,39.2,140785,129162,411,5572,38681,49002,55679,39323,16356,55679,188800,2013
16057,28.5,37636,34061,182,1388,8474,41735,14941,8471,6470,14941,189100,2013
16059,50.3,7853,7416,9,200,2317,34122,3832,2733,1099,3832,186900,2013
16061,47.9,3851,3397,0,139,1051,36000,1660,1230,430,1660,116600,2013
16063,33.3,5221,3603,17,1480,1254,42433,1617,1159,458,1617,120300,2013
16065,22.9,37542,33842,228,2310,8084,32059,10323,5071,5252,10323,169600,2013
16067,35.4,20104,13067,15,6548,5233,43266,6994,5090,1904,6994,108500,2013
16069,41.2,39458,34861,118,1191,10304,46503,16019,11105,4914,16019,165900,2013
16071,38.9,4257,4040,0,84,1124,40842,1579,1282,297,1579,126100,2013
16073,36,11474,7866,0,2947,2786,32175,3911,2511,1400,3911,121200,2013
16075,38.1,22629,18243,13,3493,5771,43649,8056,6010,2046,8056,132700,2013
16077,34.1,7756,5051,5,2356,2031,44212,2568,1818,750,2568,125600,2013
16079,46.8,12729,11838,23,404,3576,38440,5714,3909,1805,5714,123200,2013
16081,34.5,10141,8415,0,1723,2357,53931,3583,2584,999,3583,222700,2013
16083,34.6,78067,64239,405,10964,19950,43886,28166,18808,9358,28166,148900,2013
16085,47.6,9698,9164,0,384,2394,50473,3519,2737,782,3519,221200,2013
16087,44.3,10094,8014,0,1720,2589,37453,3938,3006,932,3938,122700,2013
17001,40.6,67152,62347,2413,858,17503,45073,26912,19373,7539,26912,104200,2013
17003,41.2,7980,4788,2814,165,1937,26972,2860,1881,979,2860,54400,2013
17005,40,17665,15625,369,562,4264,48163,6373,4758,1615,6373,103300,2013
17007,37.3,54068,40640,1294,10925,14042,60893,17938,14803,3135,17938,158800,2013
17009,37.3,6904,5391,997,344,1367,42194,2105,1647,458,2105,83600,2013
17011,43,34594,31008,231,2755,9216,48977,13998,10595,3403,13998,101200,2013
17013,45.1,5062,4967,5,13,1447,50436,2061,1680,381,2061,112300,2013
17015,47,15199,14355,97,464,4369,47985,6671,5101,1570,6671,100100,2013
17017,39.1,13530,10582,442,2369,3522,45734,5134,3707,1427,5134,76100,2013
17019,29.1,202428,142577,24868,10892,42670,45808,79137,43458,35679,79137,149500,2013
17021,41.7,34651,33070,627,502,9071,45145,14138,10559,3579,14138,82400,2013
17023,43.1,16284,15831,52,197,4596,47405,6568,4964,1604,6568,87800,2013
17025,43.2,13744,13284,108,38,3616,40640,5486,4366,1120,5486,75300,2013
17027,40,37891,34818,1282,1093,9800,61720,14051,11579,2472,14051,127300,2013
17029,32,53732,49132,1933,1187,11880,37040,21046,13053,7993,21046,90200,2013
17031,35.5,5212372,2275759,1256346,1262156,1186609,54548,1933335,1127937,805398,1933335,231200,2013
17033,42,19707,18055,528,377,5177,46216,7731,6179,1552,7731,76600,2013
17035,40.2,11015,10751,39,86,2878,43958,4184,3379,805,4184,83800,2013
17037,29.6,104820,82991,6432,10855,22964,53375,37844,22784,15060,37844,173000,2013
17039,42.2,16511,15790,143,351,4539,51051,6802,5239,1563,6802,107100,2013
17041,38.3,19902,18249,81,1289,5306,52741,7509,5881,1628,7509,99300,2013
17043,38.4,922803,643794,41195,124689,238824,78487,336028,250115,85913,336028,286500,2013
17045,43.4,18339,17881,67,194,5383,42133,7893,5790,2103,7893,72900,2013
17047,43.4,6695,6516,29,48,1735,39075,2728,2179,549,2728,65800,2013
17049,39.6,34274,33075,54,613,9212,52108,13544,10606,2938,13544,115200,2013
17051,39.8,22088,20494,508,333,5602,44722,8124,6542,1582,8124,82900,2013
17053,42.6,13991,13363,68,341,3542,48866,5651,4330,1321,5651,89600,2013
17055,41.7,39470,38132,64,530,10304,36273,16110,12180,3930,16110,64300,2013
17057,42.3,36829,34076,978,926,9627,45130,14610,11036,3574,14610,80600,2013
17059,45.1,5516,5331,26,18,1554,40330,2369,1855,514,2369,61100,2013
17061,41.9,13778,13395,145,125,3905,43502,5790,4388,1402,5790,75200,2013
17063,36.7,50064,44314,651,4230,12791,64541,18082,13775,4307,18082,182200,2013
17065,43.3,8413,8218,46,110,2369,38417,3512,2692,820,3512,72800,2013
17067,45.1,18949,18410,64,216,5470,43925,8101,6341,1760,8101,81600,2013
17069,47.1,4273,4032,38,21,1124,37071,1800,1431,369,1800,72600,2013
17071,48,7186,6899,29,79,2162,49389,3202,2549,653,3202,83700,2013
17073,41.8,50260,45985,844,2503,13991,52940,20393,15925,4468,20393,109800,2013
17075,43.4,29446,27025,338,1695,8108,47079,11892,8959,2933,11892,96500,2013
17077,29.4,60055,45333,8390,2457,11948,33479,23567,12576,10991,23567,100600,2013
17079,43.3,9680,9464,8,99,2772,52233,3904,3279,625,3904,88100,2013
17081,40.6,38769,33698,3021,847,10024,42981,15288,11119,4169,15288,86300,2013
17083,41.4,22850,22112,94,246,6492,53954,8752,6991,1761,8752,117900,2013
17085,47.4,22602,21521,75,655,6620,50817,9616,7528,2088,9616,138000,2013
17087,42.2,12665,11074,1124,289,3006,40760,4362,3545,817,4362,89800,2013
17089,35.1,518380,305002,27358,159688,127489,69530,170358,128377,41981,170358,223100,2013
17091,36.9,112991,82675,16588,10321,28271,50102,41245,28405,12840,41245,145900,2013
17093,33.4,116366,85819,6452,18543,29479,81765,38075,31847,6228,38075,210800,2013
17095,41.8,52545,44487,4218,2628,12809,40667,21481,14692,6789,21481,81100,2013
17097,37,702099,454790,46043,141538,179071,77469,241072,183009,58063,241072,254800,2013
17099,41.3,113295,99496,2072,9390,29720,52640,44257,33550,10707,44257,125200,2013
17101,39.8,16702,12120,3415,912,3322,40145,4872,3805,1067,4872,65900,2013
17103,41.5,35535,31246,1630,1861,9026,50060,13504,9977,3527,13504,112100,2013
17105,40.9,38687,34499,2152,1592,9767,54614,14446,10671,3775,14446,110200,2013
17107,39.5,30177,24424,3518,929,7189,47133,10963,7569,3394,10963,97200,2013
17109,29.5,32549,28804,1674,862,6853,36031,12620,7692,4928,12620,86400,2013
17111,38.4,308060,256616,3210,35899,82541,76145,108852,89602,19250,108852,220500,2013
17113,32.2,171240,139225,12494,7731,39616,62089,64016,43059,20957,64016,157200,2013
17115,40.2,110262,86026,17400,2149,28016,46559,45142,31252,13890,45142,93300,2013
17117,41.9,47462,45914,269,449,13273,49590,19254,14760,4494,19254,93900,2013
17119,38.8,268373,232124,21103,7620,71740,53633,107238,77735,29503,107238,124600,2013
17121,41.5,39070,36020,1367,596,10463,41010,15893,11920,3973,15893,70300,2013
17123,45.5,12454,11888,72,339,3238,51504,5021,4117,904,5021,100600,2013
17125,44.6,14508,14098,168,114,4164,42260,6310,4882,1428,6310,82100,2013
17127,42.8,15282,13684,898,67,3906,43615,6053,4575,1478,6053,80200,2013
17129,43.2,12687,12250,106,138,3433,58190,5071,4098,973,5071,119100,2013
17131,44,16325,15771,45,317,4871,53136,6716,5288,1428,6716,98100,2013
17133,40.7,33181,32162,10,481,9420,68482,12506,10139,2367,12506,193900,2013
17135,41.9,29878,26419,2306,711,7523,41952,11192,8433,2759,11192,79500,2013
17137,41,35424,31798,2142,741,9038,46809,13926,9731,4195,13926,91000,2013
17139,41.3,14869,14508,70,151,4018,46622,5676,4469,1207,5676,95400,2013
17141,41,53092,46950,417,4786,13890,54541,20745,15780,4965,20745,149500,2013
17143,36.7,187117,135039,32890,7566,46921,50712,75892,49709,26183,75892,123200,2013
17145,40.2,22182,19191,1931,630,5049,42078,7982,6119,1863,7982,78000,2013
17147,42.9,16620,16138,37,173,4717,63027,6546,5397,1149,6546,120800,2013
17149,42.3,16337,15681,222,189,4484,39845,6708,5225,1483,6708,74700,2013
17151,48.2,4383,4037,159,115,1153,38371,1736,1408,328,1736,98900,2013
17153,43.5,6035,3831,2000,101,1501,33717,2419,1889,530,2419,55300,2013
17155,45,5927,5546,12,274,1666,54196,2471,1966,505,2471,126500,2013
17157,41.4,33218,28661,3336,886,8041,47427,11889,9033,2856,11889,92100,2013
17159,43.1,16213,15609,66,142,4198,44070,6620,4961,1659,6620,78100,2013
17161,40,147477,110727,13232,17444,37698,48702,60456,42428,18028,60456,113800,2013
17163,37.3,268939,169011,80511,9197,69284,50578,102885,69175,33710,102885,123700,2013
17165,41.8,24950,22975,977,364,6640,37800,10174,7343,2831,10174,70500,2013
17167,39.5,198269,162673,24004,3798,51964,55449,82807,57980,24827,82807,126200,2013
17169,44.1,7490,7180,99,121,2166,48138,3056,2475,581,3056,76600,2013
17171,43.2,5288,5248,0,7,1444,49669,2113,1603,510,2113,82900,2013
17173,43.9,22266,21790,83,189,6314,47188,8991,7298,1693,8991,86100,2013
17175,44.8,5942,5762,23,63,1655,54203,2416,1980,436,2416,88300,2013
17177,43.7,47315,40152,4060,1444,12450,43472,19408,13931,5477,19408,101800,2013
17179,40.1,135747,128628,1272,2705,37329,56067,54428,41378,13050,54428,132000,2013
17181,43.2,17722,16325,341,871,4672,41848,6852,5187,1665,6852,87500,2013
17183,39.8,81147,64881,10648,3572,20166,41400,31575,22285,9290,31575,75300,2013
17185,42.5,11848,11388,3,157,3329,47365,4785,3765,1020,4785,80900,2013
17187,39.7,17762,15503,423,1523,4530,43536,6972,5119,1853,6972,81500,2013
17189,42.5,14626,14121,100,216,4080,52832,5882,4738,1144,5882,107900,2013
17191,42.5,16674,16196,76,198,4952,43605,7063,5587,1476,7063,75700,2013
17193,44.5,14630,14238,91,168,4253,42914,6240,4904,1336,6240,72200,2013
17195,42.1,58150,49820,731,6555,15709,47667,23370,17676,5694,23370,99400,2013
17197,35.8,679688,453732,73290,107830,171130,76147,222652,184498,38154,222652,219400,2013
17199,40.8,66606,60819,2584,1381,17749,43125,26819,19301,7518,26819,93700,2013
17201,38.8,293384,211498,35449,32948,74655,47072,113449,75867,37582,113449,123400,2013
17203,40.3,38903,37437,297,584,10979,66639,14362,11725,2637,14362,158600,2013
18001,34.3,34424,32468,195,1450,8671,46695,12127,9564,2563,12127,116100,2013
18003,35.5,358324,272446,42196,23857,90579,49370,138212,96539,41673,138212,112700,2013
18005,37.9,77930,67107,1533,4841,20674,54165,30041,21297,8744,30041,134900,2013
18007,40.2,8823,8232,70,450,2336,48711,3444,2563,881,3444,84300,2013
18009,41.9,12665,12241,54,151,3625,39225,5190,3894,1296,5190,70400,2013
18011,38.7,58009,54037,660,1385,16166,67255,21908,16819,5089,21908,179000,2013
18013,48,15128,14597,28,199,4141,51568,5889,4889,1000,5889,157400,2013
18015,41.3,20109,19071,102,765,5551,50542,7995,6301,1694,7995,103900,2013
18017,39,38802,32095,620,5029,10077,41940,14827,11249,3578,14827,81900,2013
18019,38.3,111221,94558,7413,5441,28306,50496,42502,30425,12077,42502,127400,2013
18021,40.8,26865,26066,91,320,7356,46430,10230,7792,2438,10230,91300,2013
18023,37.9,33086,28060,260,4545,8408,48953,11745,8470,3275,11745,97300,2013
18025,42.1,10656,10295,39,145,2889,39700,4237,3474,763,4237,83300,2013
18027,35.5,31928,29856,280,1373,7936,47165,11160,8462,2698,11160,105500,2013
18029,40.9,49975,48328,354,538,13262,56946,18556,14287,4269,18556,160400,2013
18031,39.1,25939,24925,106,443,6830,48047,9792,6918,2874,9792,112000,2013
18033,38,42253,40370,40,1069,11486,47247,16032,12618,3414,16032,107800,2013
18035,34.8,117575,103367,5609,2234,27873,37474,46325,29551,16774,46325,89600,2013
18037,40.5,42103,38856,160,2617,11401,54780,15890,12423,3467,15890,133200,2013
18039,35.1,198662,152564,11242,28544,50812,45693,70130,50183,19947,70130,121700,2013
18041,41.5,24112,23179,333,244,6461,37391,9536,6863,2673,9536,81700,2013
18043,39.2,75120,66933,3422,2080,20169,53961,29087,20880,8207,29087,150400,2013
18045,42.2,17108,16429,65,393,4715,45884,6925,5297,1628,6925,88800,2013
18047,40.2,23042,22523,42,228,6452,49516,8551,6786,1765,8551,150100,2013
18049,40.7,20698,19230,219,928,5796,40168,8221,6285,1936,8221,95600,2013
18051,40.2,33514,31693,640,473,9167,49329,13094,10187,2907,13094,104400,2013
18053,39.9,69671,60157,4610,2610,17507,39747,26981,18801,8180,26981,80100,2013
18055,41.7,33001,32117,87,349,8979,43980,12894,10105,2789,12894,88800,2013
18057,35.8,282977,242600,9802,10017,76696,82468,103234,81811,21423,103234,215600,2013
18059,39.4,70466,66101,1512,1277,19490,62981,26071,20903,5168,26071,155400,2013
18061,41,39213,37793,220,624,10220,50510,14499,11769,2730,14499,122100,2013
18063,37,148623,130498,7629,4715,40056,68297,52946,43610,9336,52946,159800,2013
18065,42.1,49275,46592,809,740,12399,40679,18367,13472,4895,18367,94200,2013
18067,41,82795,71884,5872,2297,22475,43590,34544,24364,10180,34544,98500,2013
18069,39.8,37044,35548,184,681,9769,46148,14138,10937,3201,14138,97100,2013
18071,38.7,42769,38932,155,2503,11506,46501,16713,12196,4517,16713,117100,2013
18073,38.2,33398,30867,242,1829,9147,57500,11924,9497,2427,11924,146200,2013
18075,39.1,21333,20396,58,608,5506,40235,8179,6212,1967,8179,79300,2013
18077,41,32449,30394,661,751,8478,43795,12668,9198,3470,12668,111500,2013
18079,38.4,28324,27122,297,600,7320,44128,10632,8074,2558,10632,89700,2013
18081,37.1,141796,129827,2161,4524,37560,61231,52239,37935,14304,52239,144300,2013
18083,39.2,38266,35847,1103,632,9529,42119,14738,9938,4800,14738,84100,2013
18085,38.1,77527,69403,468,5817,21184,50859,29705,23089,6616,29705,132200,2013
18087,30.6,37463,35541,35,1379,9255,47617,11833,9338,2495,11833,160200,2013
18089,37.6,494250,272202,123184,84317,122309,49035,182080,126738,55342,182080,136600,2013
18091,39.4,111310,90237,11794,6248,28009,47538,42690,31027,11663,42690,122800,2013
18093,41.2,46053,44399,183,615,13164,42627,18592,14549,4043,18592,98200,2013
18095,39.4,131027,112900,8821,4347,32706,43120,50637,35398,15239,50637,92800,2013
18097,34,912242,539219,242088,85917,213144,42334,360072,201078,158994,360072,118000,2013
18099,38.4,47057,41922,245,4133,12253,45709,17581,13702,3879,17581,124600,2013
18101,42.6,10269,10042,20,37,2709,44740,4146,3337,809,4146,88500,2013
18103,40.1,36624,33034,1768,909,9102,42023,13210,9945,3265,13210,84100,2013
18105,27.9,139634,119572,4259,4242,27437,40052,53914,29087,24827,53914,156300,2013
18107,39.8,38215,35425,400,1736,10259,46797,14590,10539,4051,14590,108300,2013
18109,40.4,69217,66926,228,884,19354,55354,25621,19594,6027,25621,141200,2013
18111,42.7,14151,13148,29,757,3859,50262,5374,4114,1260,5374,112000,2013
18113,37.4,47509,41990,77,4604,12703,47117,17722,13492,4230,17722,112700,2013
18115,44.4,6075,5903,41,96,1679,50377,2422,1803,619,2422,137900,2013
18117,40.2,19829,19082,322,212,5209,38826,7688,5736,1952,7688,88100,2013
18119,43,21467,20831,100,217,6084,43950,8552,6732,1820,8552,101900,2013
18121,41.5,17210,16395,447,223,4142,43870,5893,4941,952,5893,87600,2013
18123,40.8,19450,18455,577,98,4953,47596,7411,5921,1490,7411,97300,2013
18125,42.9,12780,12707,13,6,3696,40680,5149,4279,870,5149,85800,2013
18127,38.8,165168,141172,5069,14462,43450,62794,61502,47630,13872,61502,165700,2013
18129,42,25713,24822,356,252,7432,58750,10050,8538,1512,10050,127900,2013
18131,41.8,13253,12630,18,346,3604,44764,5058,4048,1010,5058,94900,2013
18133,37.7,37799,34921,1493,619,9072,50821,12414,9823,2591,12414,125800,2013
18135,41.2,25975,24649,100,793,7056,40904,10429,7660,2769,10429,76200,2013
18137,40,28636,27660,123,446,7773,47537,10761,8203,2558,10761,132000,2013
18139,40.7,17257,16697,162,197,4933,47401,6874,4942,1932,6874,104700,2013
18141,36.4,266694,200617,33855,20022,65452,44582,101947,70900,31047,101947,115100,2013
18143,39.4,24035,23276,259,369,6353,42898,8914,6524,2390,8914,101400,2013
18145,40,44511,41414,522,1672,11897,51440,17171,12201,4970,17171,125000,2013
18147,42.5,20960,20062,145,537,5795,52991,7984,6556,1428,7984,113300,2013
18149,41.2,23267,22065,79,779,6349,40126,8964,7274,1690,8964,96900,2013
18151,40.5,34190,31156,178,1045,9580,48080,13514,10445,3069,13514,123000,2013
18153,39.9,21321,19744,1065,330,5462,43510,7764,5605,2159,7764,77600,2013
18155,40.6,10534,10217,24,157,2990,44143,4099,3129,970,4099,110800,2013
18157,28,175628,140082,7238,13454,38212,44246,66667,36153,30514,66667,130900,2013
18159,42.7,15834,15202,35,380,4845,52686,6622,5114,1508,6622,108300,2013
18161,41,7420,7170,33,37,2018,44161,2943,2240,703,2943,103200,2013
18163,37.6,180233,153291,16382,4054,44977,43540,73963,47065,26898,73963,112900,2013
18165,41.7,16098,15695,24,156,4255,42524,6466,5057,1409,6466,75100,2013
18167,36,108084,93501,6989,2551,24490,40692,39597,25287,14310,39597,91600,2013
18169,41.9,32650,31059,202,711,9026,45286,12703,9674,3029,12703,95000,2013
18171,43.2,8464,8249,10,83,2429,52317,3283,2515,768,3283,99500,2013
18173,40,60163,56480,568,976,17003,62351,22454,18713,3741,22454,146300,2013
18175,39.7,28064,27310,100,337,7445,41986,10631,8537,2094,10631,101500,2013
18177,40.6,68557,60896,2957,1803,18814,38350,28185,18832,9353,28185,94100,2013
18179,40.9,27707,26598,94,610,7833,48136,10904,8533,2371,10904,112500,2013
18181,42.3,24542,22257,39,1769,6846,51444,9541,7305,2236,9541,109800,2013
18183,40.3,33274,31979,177,548,9219,51914,13094,10701,2393,13094,126300,2013
19001,45.6,7588,7367,28,61,2071,47892,3295,2540,755,3295,90900,2013
19003,46.9,3973,3861,12,51,1182,45871,1745,1369,376,1745,85200,2013
19005,44.4,14242,13133,59,786,3900,48831,5862,4658,1204,5862,114400,2013
19007,44.6,12808,12356,55,196,3478,39208,5534,4011,1523,5534,77600,2013
19009,47.1,6002,5872,12,36,1692,48313,2684,2159,525,2684,71100,2013
19011,40.4,25971,25149,122,307,7408,56669,10079,8102,1977,10079,131500,2013
19013,34.6,131468,109973,11851,5048,31212,45747,52276,35465,16811,52276,123600,2013
19015,40.7,26310,25136,256,547,6837,51826,10574,7996,2578,10574,117300,2013
19017,38.5,24387,23476,367,265,6546,61216,9258,7525,1733,9258,145300,2013
19019,39.1,20954,20294,173,266,5867,55553,8187,6398,1789,8187,122200,2013
19021,36.5,20350,13477,475,4814,4915,46951,7615,5176,2439,7615,97700,2013
19023,43.5,14909,14554,37,148,4367,52026,6189,4927,1262,6189,100400,2013
19025,47.4,9952,9531,126,142,2902,44484,4356,3443,913,4356,72200,2013
19027,42.2,20732,19956,226,384,5661,48361,8626,6507,2119,8626,105700,2013
19029,44.8,13793,13277,31,294,3930,43481,6081,4367,1714,6081,88100,2013
19031,42.8,18452,17794,42,314,5348,58088,7665,6040,1625,7665,132800,2013
19033,43.9,43932,40569,438,1729,11746,44795,19967,14297,5670,19967,110800,2013
19035,47.2,12013,11407,15,322,3351,48977,5354,4012,1342,5354,80200,2013
19037,43.2,12379,11938,30,274,3664,43971,5364,4297,1067,5364,95900,2013
19039,41,9311,8151,102,981,2263,43216,3672,2608,1064,3672,84900,2013
19041,42.6,16604,15768,29,477,4510,49035,7148,5305,1843,7148,105400,2013
19043,45,17990,17387,59,321,5192,47494,7707,6030,1677,7707,102400,2013
19045,41.8,48896,45100,1416,1316,13047,49559,20008,14884,5124,20008,110300,2013
19047,39.1,17205,12600,101,4401,4392,46548,6300,4783,1517,6300,83100,2013
19049,34.4,69526,61167,741,4293,18882,73847,26262,20326,5936,26262,184100,2013
19051,38,8755,8541,12,96,2162,45040,3115,2499,616,3115,99700,2013
19053,38.3,8308,7783,140,200,2046,36326,3106,2178,928,3106,77700,2013
19055,41.9,17665,17275,35,161,5019,54076,7129,5621,1508,7129,125300,2013
19057,41.8,40301,35883,2134,1093,10871,42451,16993,12427,4566,16993,93900,2013
19059,48.4,16818,16348,37,222,5271,56136,7981,6036,1945,7981,159700,2013
19061,38.8,94411,87562,1253,1898,24280,51475,37366,27263,10103,37366,145900,2013
19063,40.5,10141,9058,126,846,2661,48601,4119,3288,831,4119,82200,2013
19065,42.6,20822,19835,156,411,5256,45542,8328,6463,1865,8328,85400,2013
19067,43.7,16177,15258,387,337,4593,43826,7007,5106,1901,7007,90200,2013
19069,43.4,10623,9259,20,1189,3023,48355,4358,3213,1145,4358,87500,2013
19071,46,7291,6975,19,184,2030,50520,2965,2297,668,2965,94100,2013
19073,45.1,9255,8887,2,203,2606,45865,3969,3018,951,3969,78200,2013
19075,42.3,12416,12128,21,132,3539,56827,5073,4154,919,5073,123700,2013
19077,45.1,10843,10458,66,214,3294,50609,4641,3731,910,4641,97100,2013
19079,42,15486,14145,63,781,4139,43589,6395,4540,1855,6395,91400,2013
19081,44.8,11243,10625,15,403,3140,50105,4648,3725,923,4648,85300,2013
19083,44,17453,16319,152,658,4611,49342,7061,5256,1805,7061,89900,2013
19085,43.1,14729,14302,8,195,4138,54583,5996,4630,1366,5996,108200,2013
19087,40.3,20188,18065,437,838,5090,46376,7493,5545,1948,7493,103700,2013
19089,42.2,9560,9286,54,132,2440,46429,3884,3098,786,3884,91800,2013
19091,44.1,9776,9248,12,356,2832,47897,4222,3238,984,4222,84900,2013
19093,44.5,7099,6878,16,116,2011,43449,3182,2331,851,3182,76400,2013
19095,42.1,16323,15742,65,329,4758,58008,6745,5377,1368,6745,138000,2013
19097,44.1,19737,19047,50,242,5825,46467,8479,6460,2019,8479,110000,2013
19099,42.1,36710,35077,501,561,9983,50513,14826,10567,4259,14826,113100,2013
19101,44.3,16800,14334,214,437,4087,48814,6919,4975,1944,6919,92400,2013
19103,29.5,134034,110725,6442,6671,29043,53424,54005,32220,21785,54005,186000,2013
19105,43.1,20637,19660,354,292,5554,55041,8063,6468,1595,8063,122100,2013
19107,44,10428,10161,65,123,2711,42167,4354,3510,844,4354,75700,2013
19109,46.8,15437,14927,34,244,4368,51812,6728,5418,1310,6728,91100,2013
19111,42.8,35736,32606,1179,1138,9296,42469,14241,10522,3719,14241,83100,2013
19113,36.9,213425,189800,8587,5818,53672,57260,86052,62860,23192,86052,144300,2013
19115,39.7,11348,9172,62,1820,3069,50583,4381,3444,937,4381,95400,2013
19117,44.3,8840,8644,11,63,2474,43288,3734,2893,841,3734,82700,2013
19119,38,11659,11297,3,247,3145,52152,4425,3640,785,4425,105700,2013
19121,40.1,15606,15133,53,206,4219,57581,6092,4678,1414,6092,160700,2013
19123,39.3,22428,21251,311,388,5823,47967,9073,6393,2680,9073,100900,2013
19125,38.6,33318,31763,181,557,9000,54723,12691,9622,3069,12691,132000,2013
19127,38.9,40800,31329,785,7365,10517,51555,15350,11268,4082,15350,105400,2013
19129,41.8,14983,14269,93,383,4034,63076,5375,4501,874,5375,149400,2013
19131,44.6,10739,10500,33,99,2926,51078,4389,3572,817,4389,108100,2013
19133,46.8,9208,8838,30,125,2514,42025,3981,2813,1168,3981,77800,2013
19135,42.3,8010,7680,13,166,2247,45997,3361,2537,824,3361,95200,2013
19137,45.2,10625,10106,0,334,3079,44281,4553,3267,1286,4553,79600,2013
19139,38.2,42798,34328,519,6954,11437,51425,16410,12298,4112,16410,124400,2013
19141,44,14249,13424,53,552,3853,48185,6098,4569,1529,6098,93000,2013
19143,43.7,6335,5838,23,403,1833,48659,2676,2004,672,2676,75600,2013
19145,43.8,15838,14618,292,462,4164,43010,6415,4695,1720,6415,77700,2013
19147,42.9,9352,9004,38,164,2399,44663,3948,3048,900,3948,83400,2013
19149,42.4,24923,23583,97,791,6979,58888,9867,7825,2042,9867,129800,2013
19151,47.4,7243,6921,77,193,1921,44073,3227,2562,665,3227,60600,2013
19153,34.8,438307,352039,25706,33737,112738,59018,173164,119829,53335,173164,154400,2013
19155,38.6,92962,83127,1107,6214,24736,51304,36460,25593,10867,36460,126300,2013
19157,40.9,18804,17541,200,479,4783,50349,7488,5459,2029,7488,117600,2013
19159,46,5107,5045,4,30,1395,44551,2074,1586,488,2074,78500,2013
19161,46.5,10227,9864,80,223,2843,48093,4435,3612,823,4435,79700,2013
19163,37.4,167080,137717,12558,9678,42490,52735,67049,46271,20778,67049,143600,2013
19165,46.2,12088,11660,31,232,3364,48783,5083,3948,1135,5083,104700,2013
19167,33.2,34050,30325,154,3093,8819,57227,11623,9294,2329,11623,131200,2013
19169,26.5,90750,78596,2084,2793,18849,50516,35196,19372,15824,35196,162200,2013
19171,42.2,17661,14788,88,1321,4905,51670,6794,5076,1718,6794,101300,2013
19173,44.4,6256,5757,11,413,1840,43804,2764,2107,657,2764,66400,2013
19175,41.3,12547,11995,178,257,3448,44838,5339,3906,1433,5339,91600,2013
19177,44.1,7517,7320,23,86,2095,43181,3023,2594,429,3023,69700,2013
19179,39.8,35469,30753,477,3306,9445,41425,14534,10585,3949,14534,78800,2013
19181,38.8,46631,44569,241,957,12869,62535,17378,13675,3703,17378,154100,2013
19183,42,21834,20195,138,1137,6045,54554,8948,6778,2170,8948,121800,2013
19185,45.3,6382,6203,4,70,1686,40024,2589,2141,448,2589,62300,2013
19187,40,37626,33722,1348,1470,9052,41624,15458,10596,4862,15458,84300,2013
19189,43.8,10732,10082,91,371,3026,45603,4591,3496,1095,4591,91900,2013
19191,40.6,21038,20100,183,427,5390,53122,8042,6220,1822,8042,151500,2013
19193,35.3,102155,78690,2557,14433,25522,45856,38654,26171,12483,38654,97900,2013
19195,44,7562,7266,51,168,2235,50476,3197,2593,604,3197,96900,2013
19197,44.6,13092,11615,38,1251,3354,45205,5367,4152,1215,5367,71700,2013
20001,40.9,13318,12194,230,395,3588,40554,5505,4122,1383,5505,63300,2013
20003,42.3,8021,7652,17,14,2289,41713,3308,2526,782,3308,96300,2013
20005,36.1,16839,14992,750,426,4063,45212,6216,4516,1700,6216,87000,2013
20007,46.1,4898,4634,9,132,1436,45920,2187,1590,597,2187,61900,2013
20009,39.8,27602,22919,310,3777,7384,44981,11491,8203,3288,11491,75300,2013
20011,37.9,15004,13749,445,326,3850,39591,5636,4092,1544,5636,78400,2013
20013,41.8,9969,8377,140,332,2632,39968,4104,2745,1359,4104,77100,2013
20015,37.5,65786,59560,1032,2697,17274,56454,24270,18458,5812,24270,127800,2013
20017,45.8,2763,2580,28,101,728,36815,1149,845,304,1149,81100,2013
20019,48.7,3614,3199,22,95,1091,39529,1565,1197,368,1565,46500,2013
20021,40.5,21361,19032,85,446,5518,39746,7936,6024,1912,7936,71600,2013
20023,49.6,2708,2510,0,155,820,37875,1343,994,349,1343,76700,2013
20025,43.9,2188,1856,19,223,613,41129,932,675,257,932,59800,2013
20027,44.3,8500,8107,114,188,2239,45233,3407,2609,798,3407,85700,2013
20029,42,9419,8892,46,291,2446,38534,4022,3064,958,4022,66100,2013
20031,44,8516,8061,42,184,2425,51793,3501,2679,822,3501,98200,2013
20033,44.9,1905,1786,0,77,504,39375,791,597,194,791,54100,2013
20035,38.4,36232,29603,949,3425,8964,41878,13867,9544,4323,13867,80600,2013
20037,32.9,39182,34695,743,1851,9244,37378,15370,9364,6006,15370,83800,2013
20039,52.2,2933,2821,28,33,895,39333,1482,1215,267,1482,53500,2013
20041,41.5,19734,18198,76,827,5445,48890,7845,5758,2087,7845,106700,2013
20043,38.3,7905,7191,270,184,2137,46512,3161,2341,820,3161,83300,2013
20045,28.6,112210,91053,3936,5952,23609,49508,43398,22561,20837,43398,180300,2013
20047,44.2,2998,2362,27,563,831,46551,1269,956,313,1269,56500,2013
20049,49.5,2782,2588,13,86,828,34089,1271,1019,252,1271,52100,2013
20051,31.5,28746,26244,291,1418,6431,43085,11824,7437,4387,11824,138400,2013
20053,44,6454,5647,272,349,1616,45865,2528,1946,582,2528,73300,2013
20055,30.6,36920,16818,687,17429,8985,47945,12515,8097,4418,12515,109700,2013
20057,30.3,34217,14787,636,17636,8039,51178,11103,6876,4227,11103,88800,2013
20059,39,25870,23718,261,958,6834,49543,9909,7024,2885,9909,119700,2013
20061,26.8,35583,21239,5586,4753,8797,46908,12532,5844,6688,12532,136500,2013
20063,45.8,2835,2753,18,26,842,44866,1201,955,246,1201,71500,2013
20065,49.7,2604,2348,90,67,738,47500,1192,983,209,1192,63800,2013
20067,33.6,7869,4192,1,3522,2197,53213,2793,2060,733,2793,90900,2013
20069,35.1,6012,5037,0,879,1567,57808,2066,1567,499,2066,105900,2013
20071,49.9,1202,988,9,177,347,52847,493,396,97,493,78500,2013
20073,47,6582,6128,14,229,1859,38346,2855,2178,677,2855,56800,2013
20075,37.8,2645,1854,1,758,743,43357,1076,809,267,1076,75100,2013
20077,43.5,5951,5468,12,322,1662,38313,2595,1898,697,2595,66100,2013
20079,38.5,34722,29317,462,3782,9152,50287,13287,9608,3679,13287,111600,2013
20081,34.7,4219,2953,0,1165,1052,52415,1411,1048,363,1411,103300,2013
20083,48,1946,1733,1,192,596,52375,821,653,168,821,76500,2013
20085,41.3,13430,11467,114,503,3869,54546,5273,4023,1250,5273,118200,2013
20087,43.1,18971,17963,58,393,5338,56875,7421,6304,1117,7421,125800,2013
20089,51.8,3061,2938,4,65,962,39884,1454,1155,299,1454,56500,2013
20091,36.5,552947,451270,23662,39796,146900,74717,216304,151705,64599,216304,210900,2013
20093,35.7,3956,2670,14,1146,958,52264,1301,950,351,1301,91700,2013
20095,45,7860,7456,25,208,2150,47466,3223,2300,923,3223,86700,2013
20097,41.8,2527,2326,13,116,680,44650,1065,694,371,1065,102800,2013
20099,40.7,21369,18255,794,887,5732,40916,8703,6191,2512,8703,66100,2013
20101,46.2,1616,1471,1,107,447,53021,808,629,179,808,58200,2013
20103,37.2,77002,61552,6300,4687,18607,63435,26358,17773,8585,26358,165800,2013
20105,46.4,3199,3063,3,73,898,40811,1414,1116,298,1414,63500,2013
20107,44.5,9580,9099,64,194,3046,45519,4234,3431,803,4234,98000,2013
20109,44.4,2775,2585,0,30,760,41765,1282,908,374,1282,72700,2013
20111,32.2,33624,24524,470,6799,7791,38981,13170,7755,5415,13170,93100,2013
20113,41.8,29297,27182,285,1077,8086,54167,11540,9034,2506,11540,124600,2013
20115,44.5,12491,11763,130,328,3333,45830,4861,3926,935,4861,83000,2013
20117,45,10057,9635,22,210,2786,44032,4345,3306,1039,4345,81700,2013
20119,39.2,4486,3708,64,645,1287,51000,1714,1229,485,1714,85500,2013
20121,40.2,32682,30534,409,888,8986,58936,12334,9782,2552,12334,162500,2013
20123,43.8,6368,6152,12,152,1770,46667,2804,1973,831,2804,74600,2013
20125,39.7,34869,28140,1961,1921,9105,39669,14000,9818,4182,14000,71200,2013
20127,47.4,5869,5486,15,227,1628,47445,2503,1963,540,2503,81900,2013
20129,41.1,3182,2400,43,629,891,46607,1186,835,351,1186,82100,2013
20131,42.1,10149,9774,73,140,2832,47122,4117,3259,858,4117,95200,2013
20133,40.2,16477,15046,178,728,4425,42071,6508,4782,1726,6508,68900,2013
20135,51.6,3095,2794,13,250,899,48800,1340,1106,234,1340,57200,2013
20137,44.6,5640,5102,188,160,1376,46029,2248,1678,570,2248,66000,2013
20139,42.7,16260,15434,63,374,4635,50205,6558,5127,1431,6558,99000,2013
20141,47.9,3846,3722,8,51,1077,37925,1727,1371,356,1727,51200,2013
20143,42.4,6078,5785,18,139,1761,58396,2408,1950,458,2408,93400,2013
20145,43.1,6971,5988,361,476,1601,44078,2545,1839,706,2545,73700,2013
20147,45.5,5573,5237,9,137,1587,43059,2388,1859,529,2388,64400,2013
20149,34.7,22009,19955,304,1053,5627,56854,7974,6218,1756,7974,153700,2013
20151,39.6,9730,8785,87,586,2626,46035,4074,2819,1255,4074,79000,2013
20153,50.8,2545,2401,9,96,785,43482,1224,857,367,1224,66700,2013
20155,39.5,64319,55252,1870,5314,16996,43798,25693,17514,8179,25693,90600,2013
20157,50.7,4919,4778,3,61,1375,39572,2274,1826,448,2274,49200,2013
20159,37.5,10055,8547,55,1039,2688,45336,3914,2860,1054,3914,74200,2013
20161,24.5,73243,57758,4585,5212,13786,43962,25895,11001,14894,25895,170400,2013
20163,44.5,5189,4975,21,29,1473,42449,2349,1759,590,2349,62500,2013
20165,48.7,3233,3106,27,29,928,42610,1529,1146,383,1529,57300,2013
20167,47.1,6945,6571,68,135,2054,37111,3317,2498,819,3317,65000,2013
20169,37.8,55633,45367,1589,5574,14581,47215,22173,14889,7284,22173,119500,2013
20171,43.1,4930,4079,0,747,1453,50605,2121,1554,567,2121,104800,2013
20173,34.4,500768,349320,44592,66040,124837,49865,192651,125055,67596,192651,124000,2013
20175,29.2,23146,8102,710,13251,5462,50185,7429,4749,2680,7429,90000,2013
20177,38.5,178378,134380,13781,19773,45929,48451,72584,46770,25814,72584,120300,2013
20179,46.6,2553,2331,11,92,689,48674,1099,860,239,1099,77900,2013
20181,38.7,6063,5171,128,691,1634,38634,2727,1486,1241,2727,74200,2013
20183,50.4,3790,3647,15,40,1183,45556,1726,1375,351,1726,60800,2013
20185,45.3,4391,3724,19,553,1224,43292,1884,1535,349,1884,60900,2013
20187,34.6,2210,1215,18,901,570,46382,775,602,173,775,81000,2013
20189,34.5,5713,3711,28,1865,1446,54494,1936,1456,480,1936,86200,2013
20191,40.2,23884,21742,85,1145,6113,47894,9110,7048,2062,9110,85500,2013
20193,35.6,7902,7301,71,386,1689,48187,3120,2137,983,3120,97200,2013
20195,46.5,2981,2865,11,58,813,45714,1232,921,311,1232,74500,2013
20197,41.5,7050,6633,45,215,1998,54694,2693,2270,423,2693,112200,2013
20199,42.7,1568,1444,2,118,428,47454,611,474,137,611,61900,2013
20201,46.2,5763,5499,50,155,1620,42515,2487,1974,513,2487,58300,2013
20203,39.3,2231,1588,0,614,621,53018,877,641,236,877,71100,2013
20205,44,9269,8683,9,233,2585,38917,3791,2845,946,3791,63200,2013
20207,48.5,3278,3099,1,76,926,33839,1517,1229,288,1517,50900,2013
20209,33.1,158348,68319,39189,42063,36955,39402,57291,34525,22766,57291,93800,2013
21001,39.9,18696,17553,459,327,4948,32524,7241,5411,1830,7241,78600,2013
21003,39.6,20123,19290,254,324,5629,40008,8061,5942,2119,8061,96800,2013
21005,38.5,21575,20427,562,307,6032,52646,8323,6198,2125,8323,132300,2013
21007,41.7,8282,7771,291,97,2265,44588,3327,2715,612,3327,94400,2013
21009,39.8,42504,38790,1770,1165,11733,38873,16584,11311,5273,16584,105400,2013
21011,40.4,11732,11251,186,166,3072,30797,4447,3511,936,4447,65400,2013
21013,40.9,28409,26961,669,224,7549,26228,11109,7521,3588,11109,67300,2013
21015,36,121214,108366,3386,4469,32123,67225,43255,32649,10606,43255,172700,2013
21017,40.4,19999,17036,1340,1369,5407,40933,7865,4706,3159,7865,139900,2013
21019,41.5,49314,46191,1208,736,13232,40379,19530,13446,6084,19530,96900,2013
21021,41.1,28701,24902,1711,847,7472,41473,11100,7213,3887,11100,130700,2013
21023,40.4,8472,8345,0,110,2164,39196,3252,2545,707,3252,90700,2013
21025,40.3,13776,13457,84,90,3432,24045,5290,3967,1323,5290,47400,2013
21027,41.9,20059,19068,491,213,5178,38907,7213,5769,1444,7213,82700,2013
21029,38.5,75250,72068,523,1118,20986,54836,27874,22901,4973,27874,145500,2013
21031,40.3,12746,12169,61,369,3684,35430,5124,3816,1308,5124,87300,2013
21033,42.6,12946,11870,625,249,3516,37127,5232,3812,1420,5232,86600,2013
21035,33.8,37383,33754,1426,911,8773,39677,14937,9806,5131,14937,114800,2013
21037,37,90606,84042,2466,1548,22673,54306,35203,24643,10560,35203,146300,2013
21039,42.3,5064,4839,61,95,1534,39049,2034,1644,390,2034,73800,2013
21041,36.3,10902,9692,184,754,2863,40160,4269,2684,1585,4269,99500,2013
21043,39.3,27493,26672,189,270,7151,36406,10319,8229,2090,10319,74500,2013
21045,41.7,16006,15313,155,416,4214,29934,6050,4886,1164,6050,70400,2013
21047,28.7,74169,50493,14889,4909,18397,38904,25899,13591,12308,25899,101700,2013
21049,40.7,35608,32317,1837,932,10269,45853,14498,9398,5100,14498,141000,2013
21051,37.7,21633,20083,988,228,4939,21883,7317,5533,1784,7317,57800,2013
21053,40.8,10210,9773,87,249,2585,27100,3960,2995,965,3960,68000,2013
21055,42.4,9283,9007,72,60,2451,34261,3794,2979,815,3794,72500,2013
21057,43.7,6842,6487,217,32,1708,31593,2604,1967,637,2604,63400,2013
21059,39.2,97230,87379,4770,2555,25866,46555,37677,26443,11234,37677,110500,2013
21061,42.2,12148,11728,203,110,3429,37646,4766,3647,1119,4766,90600,2013
21063,41.4,7784,7459,246,67,1773,24246,2618,2068,550,2618,71400,2013
21065,42.1,14601,14319,38,4,3968,29184,5829,4061,1768,5829,71900,2013
21067,33.9,300843,219269,42646,20516,71828,48398,123142,67972,55170,123142,165800,2013
21069,40.6,14435,13918,210,162,3913,32495,5539,4348,1191,5539,78700,2013
21071,39.9,39448,38493,370,250,10638,30476,15422,10671,4751,15422,70000,2013
21073,40.2,49390,40864,5109,1369,12760,46071,21058,13126,7932,21058,139300,2013
21075,42.8,6650,4801,1548,73,1781,33582,2744,1658,1086,2744,60400,2013
21077,38.3,8525,7860,62,396,2052,43793,2995,2047,948,2995,98400,2013
21079,41.3,16896,15947,471,401,4791,44652,6302,4979,1323,6302,121400,2013
21081,36,24685,23516,174,583,6427,46159,8334,6122,2212,8334,124300,2013
21083,40.4,37329,32668,1551,2182,10029,38394,14419,10992,3427,14419,85900,2013
21085,39.5,25833,24905,272,281,6803,32399,9897,7158,2739,9897,87700,2013
21087,43.8,11252,10674,279,104,3221,34406,4495,3449,1046,4495,70100,2013
21089,42.3,36822,35583,272,333,10204,44060,14465,11052,3413,14465,92000,2013
21091,41.5,8608,8290,97,108,2610,51189,3361,2699,662,3361,90800,2013
21093,35.4,106211,81991,12167,5591,28277,48687,39401,24780,14621,39401,140600,2013
21095,40.8,29012,27701,739,224,8039,25906,11343,7914,3429,11343,52000,2013
21097,41.2,18693,17657,312,363,4643,36048,7179,4745,2434,7179,109400,2013
21099,40.5,18345,16897,964,269,5011,33408,7115,5252,1863,7115,78900,2013
21101,39.4,46303,40604,3453,927,12498,41940,18787,12779,6008,18787,99400,2013
21103,40.6,15425,14213,505,478,4351,46016,6008,4327,1681,6008,123300,2013
21105,45.9,4834,4237,408,78,1196,34029,1983,1575,408,1983,62400,2013
21107,40.2,46810,41781,2846,779,12646,40891,18495,13272,5223,18495,83300,2013
21109,39.4,13418,13189,1,97,3985,26156,5712,4307,1405,5712,62100,2013
21111,38,746580,524573,152714,33326,187930,46959,305832,191611,114221,305832,149100,2013
21113,36,49112,44766,1572,1353,13441,49024,18012,11895,6117,18012,154300,2013
21115,40.3,23377,22884,76,130,6635,34090,9154,6791,2363,9154,78700,2013
21117,36.4,160828,144181,7239,4380,40067,54270,61800,42038,19762,61800,144300,2013
21119,40.9,16217,15857,145,109,4067,33889,5892,4716,1176,5892,59600,2013
21121,38.9,31865,30741,320,508,8237,24038,12350,7954,4396,12350,71400,2013
21123,40.3,14149,13040,461,417,3866,39753,5221,3984,1237,5221,101000,2013
21125,38,59178,56870,442,772,16887,36570,22931,16339,6592,22931,91300,2013
21127,39.6,15877,15565,18,36,4136,33525,5823,4427,1396,5823,80200,2013
21129,41.9,7554,7257,122,57,1910,22920,2951,2167,784,2951,62200,2013
21131,42.1,11220,11039,33,9,2992,29293,4206,3273,933,4206,44700,2013
21133,41.3,24202,23765,117,147,6467,31200,9366,7066,2300,9366,54900,2013
21135,39.9,13859,13620,66,81,3630,28388,5003,3967,1036,5003,59900,2013
21137,39.8,24602,23279,652,376,6896,33651,9692,7330,2362,9692,88500,2013
21139,45.2,9467,9166,58,127,2665,40313,3569,2899,670,3569,74400,2013
21141,40.7,26822,23873,2001,666,7455,36590,10912,7765,3147,10912,89100,2013
21143,47.8,8394,7708,495,65,1903,40112,3294,2579,715,3294,105500,2013
21145,42.3,65610,55064,6738,1431,17563,44898,27037,18421,8616,27037,117200,2013
21147,38.6,18163,16415,1064,296,4535,20972,6312,4286,2026,6312,65000,2013
21149,41.9,9524,9225,40,117,2651,38833,3770,2956,814,3770,79000,2013
21151,33.7,83976,75851,3639,1834,20544,42312,31484,19049,12435,31484,141100,2013
21153,39.6,13179,12931,14,79,3530,26877,4931,3876,1055,4931,43700,2013
21155,38.5,19943,17348,1919,493,4755,38719,7368,5664,1704,7368,100200,2013
21157,44.3,31296,30475,78,367,8784,43907,11963,9842,2121,11963,101800,2013
21159,37.7,12835,11826,601,269,3235,26261,4449,2937,1512,4449,84400,2013
21161,40.8,17452,15660,1327,62,4666,41137,6569,4675,1894,6569,99000,2013
21163,35.7,29028,26060,1164,972,7872,46756,10342,7426,2916,10342,120500,2013
21165,41.6,6334,6056,43,138,1608,29108,2379,1776,603,2379,77300,2013
21167,42.5,21313,19596,792,485,5996,45396,8745,6548,2197,8745,128400,2013
21169,42.7,10043,9481,169,127,2717,31750,3919,3066,853,3919,78800,2013
21171,42.3,10874,10208,242,297,2865,29808,4401,3248,1153,4401,72300,2013
21173,38.7,26762,24957,772,688,6773,37312,10168,6642,3526,10168,109300,2013
21175,39.2,13657,12992,443,94,3503,30658,4697,3538,1159,4697,74500,2013
21177,41.1,31427,29135,1401,388,8579,38105,11869,9392,2477,11869,79500,2013
21179,37.5,43905,39928,2307,905,12171,43833,16571,12491,4080,16571,124500,2013
21181,40.2,7085,6936,29,114,1974,43081,2884,2137,747,2884,84900,2013
21183,40.1,23955,22617,311,828,6369,40830,8715,7042,1673,8715,78800,2013
21185,39.4,60940,54335,2623,2162,15915,83391,19532,16571,2961,19532,245700,2013
21187,41.1,10807,10328,138,254,3121,41009,4601,3438,1163,4601,96800,2013
21189,42.7,4738,4591,39,0,1129,19986,1721,1280,441,1721,56200,2013
21191,40.1,14714,14327,51,150,3561,45480,5357,4078,1279,5357,105000,2013
21193,41.5,28488,27371,337,218,7587,33528,10801,7759,3042,10801,65600,2013
21195,40.7,64473,62813,388,465,17962,32961,26362,19276,7086,26362,66400,2013
21197,37.9,12582,12211,85,146,2989,26839,4730,3162,1568,4730,77800,2013
21199,41.5,63369,60171,596,1372,17797,34092,26108,18719,7389,26108,106700,2013
21201,40.9,2254,2244,0,0,552,31786,884,656,228,884,81900,2013
21203,41.5,16997,16646,68,38,4808,30674,6605,5172,1433,6605,74800,2013
21205,31.5,23425,22228,240,317,5350,35236,8305,5412,2893,8305,96700,2013
21207,41.7,17636,16696,75,602,4774,29721,7270,5411,1859,7270,86600,2013
21209,35.5,48149,42272,2405,1982,13054,61893,17989,12961,5028,17989,161300,2013
21211,38.3,42911,34656,3234,3854,11749,57298,15469,10952,4517,15469,165000,2013
21213,38.6,17443,14974,1648,335,4547,39546,6737,4457,2280,6737,115200,2013
21215,39.5,17303,16436,288,284,5122,65209,6230,5281,949,6230,170300,2013
21217,40.5,24585,22361,1139,456,6580,36384,9708,6779,2929,9708,96800,2013
21219,36.9,12505,10772,1077,508,3306,41541,4574,3322,1252,4574,85000,2013
21221,44.4,14289,12630,1112,197,4197,45629,5935,4821,1114,5935,115000,2013
21223,39.6,8818,8474,15,253,2558,49718,3512,2708,804,3512,107300,2013
21225,37,15138,12597,1934,262,4008,39125,5586,4115,1471,5586,74900,2013
21227,32.7,115438,93870,10717,5462,27838,44135,44240,26638,17602,44240,140700,2013
21229,40.7,11774,10396,711,417,3322,40845,4480,3713,767,4480,107300,2013
21231,41.1,20797,19540,313,597,5770,29497,8083,5857,2226,8083,80500,2013
21233,40.1,13564,12154,680,596,3667,41415,5150,3703,1447,5150,70500,2013
21235,38.1,35718,34424,220,335,9379,29769,13172,8878,4294,13172,71500,2013
21237,41.6,7299,7227,13,14,1736,22574,2779,1998,781,2779,52800,2013
21239,41.5,24988,21573,1428,1637,6606,57580,9698,7027,2671,9698,185900,2013
22001,35.5,61847,48242,10893,1125,15841,37587,22527,15834,6693,22527,88600,2013
22003,38.9,25674,18130,4996,1239,5436,38429,8099,5856,2243,8099,79600,2013
22005,34.5,109920,77553,24585,5261,29532,69070,38287,31249,7038,38287,167400,2013
22007,39,23268,15431,6981,494,6162,46116,8571,7027,1544,8571,98100,2013
22009,38.5,41765,27648,12231,648,10887,33942,15332,10749,4583,15332,86600,2013
22011,37.2,35891,28780,4693,1113,9505,46385,12948,9940,3008,12948,93900,2013
22013,41.6,14229,7783,5951,220,3690,31543,5668,4057,1611,5668,58100,2013
22015,34.5,119947,82675,25428,7286,30219,53248,45776,30661,15115,45776,146300,2013
22017,36.3,255551,121099,120826,6461,61452,41053,98554,61269,37285,98554,121700,2013
22019,36,193528,134030,47685,5208,50632,43499,73726,52024,21702,73726,118300,2013
22021,40.5,10083,7982,1757,240,2643,39385,3935,2920,1015,3935,66200,2013
22023,40.7,6789,6528,114,125,1899,64574,2529,2276,253,2529,112900,2013
22025,38.6,10332,6837,3242,103,2634,36165,3767,2906,861,3767,68500,2013
22027,40.7,16964,7941,8463,193,3694,32996,5726,4010,1716,5726,70500,2013
22029,37.9,20652,11769,8448,232,5270,29022,7642,4745,2897,7642,75000,2013
22031,39.6,26813,15272,10318,689,7175,39162,10270,7740,2530,10270,87900,2013
22033,32.7,441901,205580,199566,16471,103104,48506,167422,102381,65041,167422,166000,2013
22035,33.2,7674,2060,5394,191,1620,25321,2488,1398,1090,2488,48500,2013
22037,40.9,20111,10603,9039,233,5043,47225,6991,5588,1403,6991,116600,2013
22039,35.8,33793,22959,9200,1160,8524,31832,11967,8061,3906,11967,80000,2013
22041,38.4,20699,13757,6758,99,5213,31214,7704,5380,2324,7704,75200,2013
22043,37.5,22113,17105,3403,946,4905,39654,7340,5727,1613,7340,78300,2013
22045,35.6,73551,44420,23261,2448,18903,44262,26496,18924,7572,26496,101200,2013
22047,38.3,33360,16000,16114,734,7829,45368,11192,8634,2558,11192,93300,2013
22049,39.2,16217,10873,4890,229,4444,37388,6090,4059,2031,6090,77800,2013
22051,38.6,433477,240446,112502,55342,107787,48261,167251,104529,62722,167251,172500,2013
22053,38.4,31498,24568,5405,576,8334,41622,11634,8612,3022,11634,86600,2013
22055,33.8,224719,150984,56848,8999,54098,51462,86504,56659,29845,86504,162500,2013
22057,36.8,96755,75180,12842,3793,25284,50572,35072,27266,7806,35072,126500,2013
22059,38.1,14843,12428,1837,347,4099,42528,5619,4677,942,5619,73900,2013
22061,27.5,46926,25170,18864,1218,10300,35769,16877,9232,7645,16877,116900,2013
22063,35,130192,116669,7275,4026,34363,56811,46246,36835,9411,46246,152500,2013
22065,34.5,12049,4322,7309,197,2447,25498,4068,2192,1876,4068,69500,2013
22067,38.5,27603,13944,12980,283,7037,28585,10482,6994,3488,10482,74600,2013
22069,33.3,39403,21062,16198,767,9585,33953,14903,9253,5650,14903,97200,2013
22071,35,357013,109009,212208,18984,78318,37146,148398,70175,78223,148398,183700,2013
22073,34.4,154641,91615,56957,3010,37849,38955,57551,34733,22818,57551,118200,2013
22075,36.2,23385,15744,4923,1239,6401,55138,8615,6420,2195,8615,176900,2013
22077,42.6,22736,13739,8200,515,5753,45363,8818,6881,1937,8818,113100,2013
22079,37.3,132034,81820,42216,3516,31097,40930,47606,31443,16163,47606,120400,2013
22081,39.5,9028,5246,3618,47,2362,39346,3320,2526,794,3320,78700,2013
22083,37.8,20816,12737,7532,385,5586,36835,7619,5242,2377,7619,76900,2013
22085,41.2,24286,16735,4083,847,6162,35159,9175,7026,2149,9175,75300,2013
22087,32.9,38850,26042,7383,3699,9908,41353,13714,9484,4230,13714,127200,2013
22089,36.8,52627,34729,13786,2760,14084,58758,18547,14995,3552,18547,186400,2013
22091,39.3,11062,4936,5898,31,2990,33143,4130,3394,736,4130,80600,2013
22093,38.4,21916,10453,11034,300,6049,55443,7786,6344,1442,7786,125000,2013
22095,35.7,45139,17797,24271,2234,11401,50635,15440,11992,3448,15440,149900,2013
22097,36.9,83534,46272,34052,1389,21473,35503,30935,21663,9272,30935,83600,2013
22099,36.6,52559,34177,15917,1150,13059,42186,18756,15058,3698,18756,97300,2013
22101,37.6,54078,30903,16955,3000,14038,41571,20092,13996,6096,20092,88800,2013
22103,39.6,236832,189783,27340,11543,63510,60799,87518,68221,19297,87518,194500,2013
22105,33.7,122665,78728,36733,4406,29928,40654,44418,30461,13957,44418,135400,2013
22107,41.9,5105,2127,2898,76,1369,27543,2049,1301,748,2049,58900,2013
22109,35.2,111868,76644,20279,4624,27821,49960,39279,29240,10039,39279,131600,2013
22111,40.9,22576,15280,5936,941,6012,35828,8532,6846,1686,8532,79700,2013
22113,36.4,58394,46409,8196,1530,15568,44665,21765,16378,5387,21765,96400,2013
22115,29.8,52510,37527,7229,4199,13446,46572,18148,9924,8224,18148,90800,2013
22117,38.8,46935,30884,14240,922,11768,31778,17599,12841,4758,17599,81900,2013
22119,40.7,41039,25909,13843,708,10756,35071,15980,11063,4917,15980,79300,2013
22121,35.5,24012,13918,8732,607,6448,50926,8820,6384,2436,8820,141900,2013
22123,40.7,11540,9250,1826,300,2883,33848,4130,2910,1220,4130,68500,2013
22125,42.2,15522,7991,7098,236,2981,61616,4007,2955,1052,4007,196300,2013
22127,40,15129,9950,4664,251,3873,34322,5402,3940,1462,5402,64300,2013
23001,40.2,107634,98798,1831,1738,27529,44921,44006,28426,15580,44006,154800,2013
23003,45.7,71230,67592,401,717,19203,37855,30597,21820,8777,30597,90800,2013
23005,41.5,283046,259060,7216,5197,72171,57461,117359,80009,37350,117359,241800,2013
23007,43.9,30660,29580,91,329,7937,41626,12098,9390,2708,12098,132400,2013
23009,46.7,54557,52303,190,668,15198,47460,24355,18067,6288,24355,198300,2013
23011,43.2,121757,116141,797,1572,32535,46808,51719,36537,15182,51719,152800,2013
23013,46.8,39694,38241,245,374,10717,49755,16941,13358,3583,16941,195700,2013
23015,48.6,34297,33204,93,296,9670,50181,14817,12374,2443,14817,208000,2013
23017,45,57657,55381,228,621,14635,40674,22890,17986,4904,22890,137200,2013
23019,40.4,153649,145311,1121,1725,39131,43734,62608,41915,20693,62608,137700,2013
23021,48.5,17343,16674,18,178,5113,36646,7769,5978,1791,7769,105000,2013
23023,44.5,35194,33502,229,493,9713,56733,15022,11430,3592,15022,189700,2013
23025,44.3,51942,50082,226,452,14213,38642,21692,17063,4629,21692,111100,2013
23027,44.4,38819,37445,144,383,10519,42221,16448,12912,3536,16448,156000,2013
23029,46.2,32621,29699,137,488,8911,37236,14209,10915,3294,14209,103500,2013
23031,43.4,198220,188951,1167,2715,53010,57348,81293,59332,21961,81293,227800,2013
24001,41.2,74394,65519,5873,1125,17349,39293,28433,19845,8588,28433,121300,2013
24003,38.5,544426,390885,82308,34854,138458,87430,199904,148360,51544,199904,340000,2013
24005,39.1,812261,501786,211707,35842,204449,66486,313912,208904,105008,313912,253300,2013
24009,40.3,89332,71075,11997,2658,23573,95477,30923,25158,5765,30923,357000,2013
24011,39.2,32871,25597,4506,1852,8457,58632,11806,8531,3275,11806,212800,2013
24013,41.6,167261,151942,5227,4566,44526,84790,59909,49228,10681,59909,325900,2013
24015,39.6,101435,87913,6551,3664,26555,66689,36394,26976,9418,36394,254800,2013
24017,37.4,148957,70614,61051,6815,37777,93160,51247,40672,10575,51247,297900,2013
24019,43.1,32617,21451,9010,1240,9199,46361,13386,8819,4567,13386,191100,2013
24021,38.7,236668,182636,19979,17971,62940,84570,86337,65037,21300,86337,307000,2013
24023,43.4,30014,29151,238,240,8314,45206,11974,9041,2933,11974,168600,2013
24025,39.8,246664,194067,30853,9159,66487,80622,90708,72717,17991,90708,281800,2013
24027,38.4,293821,170779,51525,17609,78834,109865,106142,78490,27652,106142,428100,2013
24029,46.1,20130,15690,3030,893,4751,56259,7498,5353,2145,7498,258200,2013
24031,38.4,989474,478667,166210,173135,248311,98221,360563,242592,117971,360563,446300,2013
24033,35.3,873481,128975,553244,134192,200498,73623,303441,189759,113682,303441,269800,2013
24035,42.8,48166,41976,3569,1527,13111,87256,17292,14612,2680,17292,348100,2013
24037,36,107079,81630,14863,4375,28038,85672,37589,27400,10189,37589,304700,2013
24039,36.6,26347,13648,10817,914,4979,38447,8419,5731,2688,8419,153600,2013
24041,48,37859,29864,4857,2105,10866,61597,16013,11615,4398,16013,327400,2013
24043,40,148435,122642,14084,5452,37646,55609,55960,36335,19625,55960,206100,2013
24045,35.4,99683,66004,23561,4711,24644,51092,36405,22949,13456,36405,181900,2013
24047,48.5,51479,41353,7286,1639,13452,57952,20530,16096,4434,20530,253400,2013
24510,34.5,621445,174590,389758,26772,125055,41385,241455,116673,124782,241455,157900,2013
25001,50.4,215449,197710,4824,5036,59553,60526,95398,75412,19986,95398,366700,2013
25003,45.1,130545,117724,3404,4712,32794,48450,55301,37818,17483,55301,206600,2013
25005,40.2,549870,469057,17316,34536,138396,55298,210037,132483,77554,210037,278100,2013
25007,45.6,16739,15380,510,80,3879,66288,5891,4618,1273,5891,665300,2013
25009,40.6,750808,565188,21276,128310,189950,67311,286008,181223,104785,286008,349400,2013
25011,44.6,71408,65777,510,2392,18339,53663,30534,20904,9630,30534,219500,2013
25013,38.7,465144,310859,36042,100015,115839,49094,177990,109983,68007,177990,197900,2013
25015,35.9,159267,136574,3983,7812,34661,61227,58828,39386,19442,58828,262600,2013
25017,38.6,1522533,1161079,66499,104081,371061,82090,581120,364548,216572,581120,398200,2013
25019,39.9,10224,8131,581,1020,2462,85478,4069,2677,1392,4069,929700,2013
25021,40.7,677296,539542,39035,23621,169375,84916,257451,178345,79106,257451,391100,2013
25023,41.5,497386,418092,40798,16442,127961,75092,179617,138462,41155,179617,332100,2013
25025,31.8,735701,350757,147741,150150,141599,53540,288240,102413,185827,288240,358700,2013
25027,39.4,802688,644648,31407,77656,201213,65223,299663,196987,102676,299663,259200,2013
26001,55.8,10785,10444,13,133,3188,37189,4863,4367,496,4863,102800,2013
26003,48.1,9497,8131,672,116,2246,37586,3607,3061,546,3607,117100,2013
26005,39.6,111742,99929,1342,7598,30856,52061,41794,34232,7562,41794,140200,2013
26007,46.4,29399,28353,151,335,8201,38016,12899,10009,2890,12899,96400,2013
26009,48.3,23504,22413,55,425,6805,45362,9731,8276,1455,9731,141300,2013
26011,47.3,15753,15024,172,256,4411,38874,6363,5330,1033,6363,90200,2013
26013,44.4,8787,6496,1343,97,2062,41189,3234,2564,670,3234,84000,2013
26015,41.9,59121,56299,275,1409,16159,52186,22610,18888,3722,22610,133900,2013
26017,41.8,107312,97644,1302,5174,28710,45376,44127,34446,9681,44127,93800,2013
26019,47.4,17474,16540,82,333,5180,47366,7682,6445,1237,7682,149700,2013
26021,41.2,156290,118409,23512,7329,39861,43633,60414,43554,16860,60414,129300,2013
26023,40.1,44398,40528,1125,1828,11054,41856,15862,12366,3496,15862,98000,2013
26025,39.6,135534,107923,14425,6211,34681,42110,53428,37214,16214,53428,98300,2013
26027,43.1,52212,45593,2670,1599,13830,44346,19663,16446,3217,19663,124800,2013
26029,45.9,26030,24643,97,385,7394,45949,10667,8702,1965,10667,151400,2013
26031,48,25985,24090,127,256,7623,38410,11477,9308,2169,11477,112500,2013
26033,39.5,38760,27588,1897,553,9110,41637,14605,10274,4331,14605,101600,2013
26035,45.8,30823,29403,140,506,8468,32668,13215,10622,2593,13215,80000,2013
26037,38.9,75802,68677,1491,3068,20039,60466,28534,23047,5487,28534,156300,2013
26039,48,14017,13465,111,202,3880,40295,5781,4747,1034,5781,96400,2013
26041,46,36967,34737,89,348,10393,42676,15885,12593,3292,15885,100200,2013
26043,45.7,26201,25202,88,306,7672,44136,11432,9284,2148,11432,85500,2013
26045,40.5,107920,91193,6306,5324,28707,54115,43362,31469,11893,43362,138300,2013
26047,43.5,32858,30133,190,453,9190,50929,13545,10480,3065,13545,167700,2013
26049,38.8,421575,306240,85124,13086,107022,42089,165669,116462,49207,165669,91700,2013
26051,48.2,25664,24805,114,322,7522,37626,10895,9203,1692,10895,103300,2013
26053,47.5,16179,14679,633,163,4134,34252,7070,5341,1729,7070,66800,2013
26055,41.1,88182,82065,1069,2071,22743,51766,34655,26147,8508,34655,168300,2013
26057,38.5,42148,36804,2284,2284,10158,40359,14787,11252,3535,14787,86600,2013
26059,41.2,46463,44459,229,877,12378,41759,17642,14109,3533,17642,103700,2013
26061,33.1,36494,34005,256,468,8147,35430,14029,9767,4262,14029,88400,2013
26063,47.3,32751,31438,102,659,9084,40204,13907,11354,2553,13907,96100,2013
26065,31.4,281531,203232,30160,20874,61908,45321,108823,64484,44339,108823,120500,2013
26067,36.8,63909,56666,2346,2889,15764,47892,22152,17319,4833,22152,111000,2013
26069,51.5,25662,24411,128,446,7026,36236,11172,9081,2091,11172,90300,2013
26071,52.1,11723,11235,119,177,3143,34685,5289,4467,822,5289,75100,2013
26073,25.6,70400,61271,1644,2399,13689,36372,24817,14562,10255,24817,119800,2013
26075,39.8,160126,136967,13058,4964,40593,46615,60100,43952,16148,60100,112800,2013
26077,34,252763,200870,27463,10561,60345,45775,100072,64758,35314,100072,136700,2013
26079,43.5,17142,16376,104,242,4461,40140,7035,5714,1321,7035,98800,2013
26081,34.6,609544,461524,56453,59721,154002,51667,229373,160844,68529,229373,137500,2013
26083,52.7,2181,2114,36,6,610,39038,1014,871,143,1014,101700,2013
26085,50.7,11485,9817,963,264,2494,29379,4096,3332,764,4096,79700,2013
26087,42.3,88323,81934,945,3747,24617,52939,32684,27152,5532,32684,137600,2013
26089,51.2,21682,19691,100,817,6354,55018,9103,7743,1360,9103,235600,2013
26091,40.5,99505,86931,2246,7585,25552,47766,37754,29366,8388,37754,116900,2013
26093,41.4,182402,173492,769,3676,51009,72359,67691,57594,10097,67691,183100,2013
26095,43.4,6550,5221,636,189,1552,39469,2427,1823,604,2427,79400,2013
26097,49.6,11099,8364,118,146,3180,38704,5000,3842,1158,5000,119300,2013
26099,40.3,845197,700745,78331,19720,222460,53451,332818,251180,81638,332818,123100,2013
26101,47.6,24626,22199,671,670,6857,41551,10571,8360,2211,10571,109900,2013
26103,39.4,67358,62556,1089,836,15917,45622,26436,18566,7870,26436,126600,2013
26105,45.4,28648,26480,187,1163,8328,41136,12470,9242,3228,12470,117000,2013
26107,34.3,43007,39606,1195,800,10126,39470,15536,11319,4217,15536,112200,2013
26109,46.8,23917,22508,80,316,6981,41739,10787,8717,2070,10787,95300,2013
26111,40.5,83842,77498,1154,1836,22837,53076,33717,25421,8296,33717,128600,2013
26113,42.2,14940,14259,31,333,4111,41061,5891,4760,1131,5891,99400,2013
26115,41,151408,139787,3392,4789,41178,53972,58702,46471,12231,58702,139100,2013
26117,39.4,63234,58378,1476,1976,16596,40451,23400,18537,4863,23400,95000,2013
26119,52.8,9598,9280,25,103,2713,35261,4128,3543,585,4128,93700,2013
26121,38.8,171153,132249,23367,8455,44699,40979,65008,48390,16618,65008,100900,2013
26123,41.5,48280,43799,605,2705,12861,42571,18156,15272,2884,18156,104100,2013
26125,40.5,1213406,903768,164312,43264,320311,65594,486332,347761,138571,486332,170500,2013
26127,42.4,26456,22027,91,3663,6838,40023,9537,7787,1750,9537,106100,2013
26129,48,21537,20668,43,334,5852,34619,8998,7448,1550,8998,89500,2013
26131,53.6,6584,6336,38,65,1927,34620,3269,2804,465,3269,72600,2013
26133,41.8,23404,22338,150,359,6324,37788,8987,7032,1955,8987,90500,2013
26135,50.4,8590,8296,3,87,2457,33239,3781,3226,555,3781,83000,2013
26137,43.3,24127,23074,42,323,6629,47584,9818,7799,2019,9818,116600,2013
26139,34.6,267017,227892,3256,23709,69937,56453,94666,73902,20764,94666,153200,2013
26141,52.1,13234,12796,55,120,4005,39652,6253,5472,781,6253,95000,2013
26143,53.8,24281,23352,93,302,7164,33334,11617,9424,2193,11617,92000,2013
26145,40,198841,139904,36317,15665,49816,42331,77412,56299,21113,77412,97800,2013
26147,41.9,161865,148953,3770,4799,43959,48066,64379,49431,14948,64379,121600,2013
26149,38.8,61111,53677,1630,4125,15645,44051,22326,17052,5274,22326,108900,2013
26151,43.2,42637,40299,207,1483,10746,40478,16329,13201,3128,16329,96500,2013
26153,49.1,8407,7295,36,70,2258,35260,3590,3019,571,3590,86200,2013
26155,40.8,69910,66323,381,1756,19544,46217,27485,21258,6227,27485,108300,2013
26157,42.3,55172,51907,597,1623,14959,43039,21211,17334,3877,21211,95700,2013
26159,40.3,75897,62409,2926,7886,19770,45129,28374,22139,6235,28374,118700,2013
26161,33.3,348560,250102,41704,14532,78436,59055,135800,82581,53219,135800,198400,2013
26163,37.6,1804507,897198,718074,96314,422905,41184,670987,434471,236516,670987,86800,2013
26165,41.4,32690,31152,145,536,8590,40965,12473,9581,2892,12473,100100,2013
27001,52,16032,15189,63,165,4963,41617,7741,6330,1411,7741,168700,2013
27003,37.4,334027,283241,14804,12384,87961,70380,122625,99805,22820,122625,192300,2013
27005,42.6,32800,28664,113,476,9287,50214,13476,10641,2835,13476,171500,2013
27007,33.4,45021,33342,365,764,11033,43231,16781,11863,4918,16781,147100,2013
27009,34.6,38756,36116,826,686,9990,52200,15359,10803,4556,15359,158200,2013
27011,49.3,5209,5079,17,54,1580,46313,2347,1879,468,2347,91300,2013
27013,30,64504,58496,1802,1717,14184,49935,24476,16243,8233,24476,158100,2013
27015,43.1,25643,24355,83,888,6770,48256,10820,8389,2431,10820,121900,2013
27017,41.2,35398,31441,530,517,9210,53016,13789,10785,3004,13789,159000,2013
27019,36.6,92770,83793,896,3699,25455,83773,33486,27356,6130,33486,264700,2013
27021,47.5,28485,24172,77,402,8923,45045,12906,10426,2480,12906,177100,2013
27023,42.8,12272,11149,68,633,3263,49434,5093,3658,1435,5093,101100,2013
27025,39.2,53691,50725,609,902,14248,67157,19569,16561,3008,19569,197000,2013
27027,32.1,59638,53793,881,2224,14801,52410,22463,15567,6896,22463,155200,2013
27029,42.7,8725,7535,10,130,2492,43269,3586,2850,736,3586,118300,2013
27031,50.2,5195,4517,30,43,1716,52215,2614,1910,704,2614,240500,2013
27033,44.4,11658,10327,61,551,3224,45294,4802,3794,1008,4802,86800,2013
27035,43.1,62742,60090,479,721,18056,47058,26963,20084,6879,26963,180300,2013
27037,37.1,402306,328988,19481,24825,107517,73732,154275,116922,37353,154275,223300,2013
27039,37.2,20159,18820,165,936,5404,69301,7326,6289,1037,7326,161100,2013
27041,43.9,36264,35132,158,413,10448,50905,15757,12017,3740,15757,187300,2013
27043,46.2,14430,13361,63,835,4167,44264,6331,4982,1349,6331,85800,2013
27045,42.8,20870,20361,40,213,5746,50657,8422,6617,1805,8422,135200,2013
27047,44.5,31129,27381,285,2789,8385,44683,13230,10228,3002,13230,104000,2013
27049,42.3,46259,43037,555,1373,12610,56836,18711,14435,4276,18711,181800,2013
27051,47,5990,5792,12,99,1728,50030,2580,2071,509,2580,98600,2013
27053,36,1170623,834728,135476,78843,279427,64403,481263,306704,174559,481263,230900,2013
27055,44.6,18915,18342,45,140,5424,52545,7809,6315,1494,7809,156500,2013
27057,47.2,20440,19130,67,345,5938,45961,8670,7060,1610,8670,170400,2013
27059,38.2,38078,36161,231,620,9954,57353,13860,11259,2601,13860,172000,2013
27061,45.5,45219,41961,147,475,12989,46912,18862,15237,3625,18862,152200,2013
27063,44.1,10263,9640,16,309,3032,51681,4469,3524,945,4469,97700,2013
27065,43,16151,15466,78,241,4258,47068,6277,5050,1227,6277,145600,2013
27067,40.1,42265,35784,991,4718,11596,50149,17120,12563,4557,17120,161800,2013
27069,48.1,4528,4382,16,28,1206,48875,1912,1579,333,1912,68700,2013
27071,46.7,13251,12413,103,109,3673,41108,6134,4684,1450,6134,101200,2013
27073,49.2,7184,6933,27,125,2105,48468,3074,2538,536,3074,80200,2013
27075,48.8,10825,10392,12,101,3303,46939,4982,4114,868,4982,153200,2013
27077,48.5,3998,3803,46,0,1090,44069,1665,1468,197,1665,121500,2013
27079,40.6,27758,25663,115,1480,7786,58922,10997,8994,2003,10997,180100,2013
27081,46.7,5854,5699,14,88,1615,47861,2485,2034,451,2485,86100,2013
27083,34.7,25703,22469,640,1562,6292,49594,10083,6805,3278,10083,136000,2013
27085,39.4,36321,33666,151,1842,10098,55170,14716,11190,3526,14716,155400,2013
27087,37.1,5475,2673,32,118,1405,40282,2058,1492,566,2058,97800,2013
27089,44.2,9454,8929,38,360,2663,52198,4080,3295,785,4080,88100,2013
27091,45.5,20634,19500,74,765,5712,48530,8797,6654,2143,8797,102600,2013
27093,41.7,23197,22071,80,767,6528,53904,9288,7519,1769,9288,156000,2013
27095,40,25927,23394,148,417,6913,47862,10312,7626,2686,10312,146600,2013
27097,40.8,33118,31983,137,427,9032,47649,13416,10738,2678,13416,153600,2013
27099,38.6,39252,32759,899,4191,10076,46004,15855,11367,4488,15855,106000,2013
27101,47,8639,8218,26,253,2496,52160,3820,3117,703,3820,95300,2013
27103,34.3,32849,29906,785,1276,8259,60115,12192,9028,3164,12192,169800,2013
27105,36.9,21490,14015,755,5072,5658,48208,7964,5737,2227,7964,107800,2013
27107,45.1,6753,6159,20,290,1735,45389,2737,2215,522,2737,84000,2013
27109,36.4,146063,121144,7087,6350,37863,66252,57262,42893,14369,57262,171100,2013
27111,46.4,57369,54092,590,1596,16549,48961,24356,19218,5138,24356,159700,2013
27113,39.3,14008,12853,225,418,3529,45633,5806,4376,1430,5806,107900,2013
27115,42.9,29449,26565,575,733,7745,43928,11758,9325,2433,11758,145500,2013
27117,42.7,9470,8709,20,382,2618,46019,3924,2853,1071,3924,90600,2013
27119,39.8,31522,28319,315,1763,8343,50695,12663,8953,3710,12663,128100,2013
27121,46,10957,10667,50,98,3176,52350,4758,3794,964,4758,148000,2013
27123,34.6,515732,341287,55365,37150,119801,54247,205395,122732,82663,205395,198200,2013
27125,42.2,4087,3838,22,112,1118,47569,1681,1360,321,1681,87800,2013
27127,42.6,15942,14021,90,365,4183,47447,6507,5064,1443,6507,90500,2013
27129,43.9,15499,14044,97,1079,4282,50802,6400,5028,1372,6400,97600,2013
27131,35.4,64585,54621,1884,5057,15595,59915,22299,16835,5464,22299,187500,2013
27133,41.6,9601,9132,77,212,2724,46623,3970,3028,942,3970,119300,2013
27135,40.9,15587,14620,72,129,4448,50759,6402,4999,1403,6402,103800,2013
27137,40.8,200327,184510,2928,2583,50162,46517,85238,60742,24496,85238,137500,2013
27139,35.1,132774,111638,3534,5987,34831,86112,45630,38688,6942,45630,244400,2013
27141,34.7,89120,82615,1805,1997,22864,73098,29948,24533,5415,29948,193400,2013
27143,40.9,15146,13701,34,1139,4021,54017,6090,4822,1268,6090,136900,2013
27145,33.4,151053,136294,4869,4331,37197,54551,56737,40756,15981,56737,167600,2013
27147,39.4,36512,32328,834,2415,9837,56480,14354,11006,3348,14354,155400,2013
27149,33.3,9723,8832,26,360,2226,54206,3700,2583,1117,3700,127500,2013
27151,44.4,9678,9099,126,377,2719,48026,4315,3170,1145,4315,91700,2013
27153,42.2,24697,22826,84,1282,6837,45000,9904,8223,1681,9904,130000,2013
27155,47.9,3507,3255,2,53,946,45714,1510,1229,281,1510,66400,2013
27157,43.3,21549,20572,103,592,6150,53057,8890,7323,1567,8890,154000,2013
27159,43.4,13772,13147,63,190,3756,36928,5830,4386,1444,5830,114600,2013
27161,39.4,19046,17166,297,1019,5027,53657,7328,5666,1662,7328,142700,2013
27163,38.5,241315,205723,8385,8527,65270,81540,88947,72319,16628,88947,241900,2013
27165,39.6,11173,8501,9,2387,3025,49698,4445,3311,1134,4445,95700,2013
27167,43,6576,6264,19,144,1757,50507,2685,2075,610,2685,107300,2013
27169,33.4,51328,47523,634,1294,11389,47468,18957,13580,5377,18957,158000,2013
27171,34.8,126142,117728,1247,3219,34144,71598,44983,37720,7263,44983,195000,2013
27173,43.2,10294,9401,23,403,2856,52510,4135,3271,864,4135,97600,2013
28001,40.3,32308,12411,18332,1238,7127,27381,12087,8220,3867,12087,80900,2013
28003,40.4,37159,31215,4289,1014,9992,33600,14679,10431,4248,14679,84300,2013
28005,44.4,13061,7447,5534,48,3246,30750,5212,4446,766,5212,70300,2013
28007,40,19383,10724,8117,342,4806,31641,7185,5288,1897,7185,71200,2013
28009,39.5,8682,5222,3082,166,2123,31060,3195,2611,584,3195,81200,2013
28011,34.3,34107,11146,21883,676,7881,28599,12301,6940,5361,12301,83500,2013
28013,40.3,14875,9748,4141,817,3889,30000,5944,4191,1753,5944,61500,2013
28015,42,10501,6814,3433,32,2781,31039,3757,3126,631,3757,68800,2013
28017,38.2,17403,9131,7402,653,4520,31061,6614,4839,1775,6614,64600,2013
28019,42.8,8440,5690,2691,28,2267,29876,3378,2411,967,3378,70600,2013
28021,32,9553,1328,8007,89,1978,23689,3190,2551,639,3190,54500,2013
28023,40.9,16614,10569,5892,110,4600,31362,6305,5300,1005,6305,59900,2013
28025,38.7,20539,8105,11961,124,5699,30764,7750,5526,2224,7750,80600,2013
28027,33.3,25815,5854,19614,136,6470,26407,9464,5046,4418,9464,55600,2013
28029,37.9,29204,13259,14748,792,6698,35421,9897,7550,2347,9897,74100,2013
28031,38.6,19520,12086,7014,211,4813,33381,7036,5837,1199,7036,71800,2013
28033,35.4,163975,114086,34241,8098,44020,58505,57979,43557,14422,57979,152600,2013
28035,31.1,75991,44166,27704,2592,17200,36726,27822,15710,12112,27822,117500,2013
28037,41.7,8013,5109,2832,9,2413,32372,3311,2637,674,3311,63700,2013
28039,35.9,22757,20085,1858,484,5885,43958,7842,6605,1237,7842,94400,2013
28041,36.7,14337,10232,3688,150,3055,36888,4117,3597,520,4117,83200,2013
28043,40.3,21745,12195,9272,4,5164,34129,7941,5839,2102,7941,86500,2013
28045,41,44597,38205,3365,1517,12795,44522,18145,13661,4484,18145,133900,2013
28047,35.3,190756,126699,42732,10173,47656,43124,72253,44061,28192,72253,143000,2013
28049,33.3,246300,67764,171067,3691,57415,37626,87844,52049,35795,87844,106400,2013
28051,32.8,18931,2987,15705,41,4317,22325,6511,4622,1889,6511,49000,2013
28053,34.9,9258,2077,6942,214,2016,23600,3107,1687,1420,3107,63000,2013
28055,39.6,1383,395,987,1,295,24767,461,311,150,461,60800,2013
28057,40,23366,21376,1449,314,6426,36073,8859,7001,1858,8859,79300,2013
28059,36.9,139906,97180,30267,6766,35024,48943,50007,35426,14581,50007,123300,2013
28061,41.7,16827,7738,8744,188,4903,31170,7015,5566,1449,7015,72700,2013
28063,38.3,7690,1056,6628,0,1671,26028,2520,1803,717,2520,61500,2013
28065,41.2,12248,4725,7311,48,3171,27186,4895,3855,1040,4895,78300,2013
28067,36.9,68174,44660,19370,3081,17973,38074,24677,18145,6532,24677,84200,2013
28069,36.5,10383,3634,6057,215,2283,29003,3605,2742,863,3605,65500,2013
28071,27.7,48905,34458,11808,1107,9313,43328,15743,9351,6392,15743,163000,2013
28073,33.3,56763,42972,11256,1276,15165,51154,21678,14268,7410,21678,163900,2013
28075,37,80337,43223,33764,1515,20146,36203,29809,19703,10106,29809,87400,2013
28077,40.5,12734,8373,4150,102,3483,38393,4830,3862,968,4830,79600,2013
28079,33.5,23519,11444,9637,1013,5828,32521,8069,6091,1978,8069,73800,2013
28081,36.3,83964,57077,23018,2035,22676,42074,31898,22624,9274,31898,108300,2013
28083,32.7,31993,7851,22941,765,7043,24480,10887,5518,5369,10887,69200,2013
28085,37.8,34870,23566,10709,373,9817,36498,13045,9659,3386,13045,84900,2013
28087,36.1,59746,31767,26180,984,15132,37868,23178,14394,8784,23178,115700,2013
28089,36.3,97151,54316,37145,2781,25414,59904,36342,25537,10805,36342,201200,2013
28091,37.6,26674,17374,8648,352,7050,29400,9985,7457,2528,9985,77900,2013
28093,39.1,36823,17911,17413,1195,9232,36022,13050,10369,2681,13050,83700,2013
28095,39.5,36652,24669,11363,366,10209,36308,13960,10796,3164,13960,78500,2013
28097,41.7,10754,5673,5081,0,2896,30466,4229,3152,1077,4229,68600,2013
28099,35.5,29655,17675,6243,512,7619,37050,10829,7924,2905,10829,75900,2013
28101,37.6,21645,13549,6605,313,6091,39190,7931,6153,1778,7931,72100,2013
28103,36.7,11358,3045,8171,97,3034,24338,4194,3011,1183,4194,59000,2013
28105,25.3,48198,27884,17744,733,9746,30987,18176,9405,8771,18176,129200,2013
28107,36.5,34558,16763,17510,171,7930,35715,11928,9101,2827,11928,77500,2013
28109,40,55569,45593,7029,1659,14958,42510,20556,15952,4604,20556,111600,2013
28111,39.5,12174,9445,2601,0,3331,36124,4483,3805,678,4483,81200,2013
28113,36.8,40269,18339,20863,515,9712,34841,14614,10244,4370,14614,82200,2013
28115,36,30207,23660,4259,1822,7137,39899,9937,7769,2168,9937,80000,2013
28117,39.3,25354,21192,3428,322,6872,32503,9611,6999,2612,9611,73200,2013
28119,38.5,8028,2308,5603,63,2086,22863,3114,2135,979,3114,49200,2013
28121,36.4,143665,109173,27278,3760,38696,57380,53223,40166,13057,53223,148900,2013
28123,35.3,28255,14354,10638,2996,7000,34534,9692,7334,2358,9692,68600,2013
28125,38.8,4889,1422,3420,47,1178,35125,1725,1111,614,1725,64900,2013
28127,38.2,27439,17030,9689,429,7006,38362,9786,7436,2350,9786,80800,2013
28129,39.8,16414,12272,3852,212,4663,34753,6269,5225,1044,6269,77600,2013
28131,35.6,17854,13812,3409,261,4294,42963,5871,4849,1022,5871,107000,2013
28133,33.7,28722,7227,20848,416,5915,26619,8394,4920,3474,8394,69500,2013
28135,35.2,15231,5523,7809,1590,3253,29853,4640,3388,1252,4640,64000,2013
28137,36.4,28625,18839,8842,666,7013,41494,9936,7405,2531,9936,112600,2013
28139,37.9,22080,17237,3209,1031,6280,34636,8472,6485,1987,8472,74800,2013
28141,42.7,19582,18301,543,538,5779,32592,7643,5802,1841,7643,72900,2013
28143,32.2,10660,2355,7861,247,2341,31446,4116,1794,2322,4116,74000,2013
28145,37.2,27338,21733,3858,1229,7745,38373,10322,7511,2811,10322,85500,2013
28147,37.2,15265,8071,6844,242,3581,31090,5649,4658,991,5649,85100,2013
28149,37.7,48389,23833,22800,934,12237,41025,18404,11939,6465,18404,103600,2013
28151,35.5,50578,13495,35859,594,12412,28093,18123,9923,8200,18123,73700,2013
28153,37.6,20675,12204,8059,264,5561,29925,8105,6754,1351,8105,68400,2013
28155,40.4,10129,7904,1966,115,3050,33524,4084,3004,1080,4084,70900,2013
28157,35.8,9653,2790,6855,8,2351,33618,3496,2710,786,3496,59400,2013
28159,40,19052,9810,8891,190,5229,30821,7635,5446,2189,7635,76300,2013
28161,40.5,12554,7504,4808,112,3270,32930,4797,3577,1220,4797,67800,2013
28163,35.5,28122,10418,15828,1419,5937,26336,8710,5229,3481,8710,64100,2013
29001,29,25573,23619,504,562,5501,34733,9648,5808,3840,9648,102600,2013
29003,41.9,17319,16569,112,336,4687,54336,6691,5134,1557,6691,127700,2013
29005,46.2,5605,5439,33,60,1524,44426,2448,1704,744,2448,76400,2013
29007,38.8,25584,22611,1533,681,6430,43013,9327,6917,2410,9327,90500,2013
29009,42.4,35614,31404,22,2822,9496,38710,13464,10217,3247,13464,107500,2013
29011,40.6,12378,11631,18,259,3650,40580,5065,3815,1250,5065,84700,2013
29013,42.1,16878,16079,206,311,4529,38579,6832,5041,1791,6832,99400,2013
29015,52.1,19008,18164,28,307,5756,32951,8225,6910,1315,8225,106400,2013
29017,42.1,12408,12052,33,107,3337,37716,4758,3842,916,4758,96600,2013
29019,29.7,165776,133741,14354,5128,37372,48627,65649,37458,28191,65649,162200,2013
29021,36.8,89419,76528,3955,4908,21256,44363,33331,21581,11750,33331,109700,2013
29023,40.4,42946,38492,2123,707,11271,34969,17085,11253,5832,17085,89700,2013
29025,41.7,9249,8838,62,156,2667,41169,3743,2659,1084,3743,83600,2013
29027,37.9,44276,40245,1687,752,11233,47964,16548,12599,3949,16548,124500,2013
29029,49.2,43822,41656,190,1050,12558,43458,17647,13802,3845,17647,170200,2013
29031,36,76322,66890,5491,1585,19274,46516,29411,19545,9866,29411,137500,2013
29033,41.8,9216,8768,90,121,2474,46002,3613,2900,713,3613,83900,2013
29035,40.5,6260,5941,28,90,1521,30962,2426,1786,640,2426,98300,2013
29037,38.4,99875,89051,3522,4054,27627,60350,37307,28959,8348,37307,154900,2013
29039,43.7,13903,13316,21,149,3816,30302,5970,4233,1737,5970,88500,2013
29041,45.7,7730,7425,174,50,1961,39385,2958,2254,704,2958,74700,2013
29043,36.9,78724,74014,460,2042,22601,52838,29652,21951,7701,29652,142600,2013
29045,43.4,7035,6860,30,40,1784,40204,2749,2112,637,2749,71300,2013
29047,36.3,225116,187971,11340,13695,59138,60936,86934,61738,25196,86934,153700,2013
29049,40.8,20659,19476,348,351,5806,53826,8089,5872,2217,8089,142900,2013
29051,37.8,76228,62907,8594,1923,19243,53931,29302,19563,9739,29302,142400,2013
29053,38.5,17574,15667,938,246,4635,45992,6568,4817,1751,6568,119800,2013
29055,40.7,24711,23788,63,390,6421,35897,9485,7208,2277,9485,105100,2013
29057,46.9,7734,7314,33,126,2177,35483,3175,2447,728,3175,78200,2013
29059,42.6,16733,15848,18,280,4804,40120,6443,5171,1272,6443,101400,2013
29061,40.8,8347,8090,37,100,2258,42393,3151,2403,748,3151,104700,2013
29063,40.2,12873,10706,1316,235,2531,44092,3769,2458,1311,3769,110400,2013
29065,43.2,15649,14944,26,175,4217,36311,5858,4271,1587,5858,86000,2013
29067,45.8,13647,13370,11,123,3648,32130,5178,4021,1157,5178,102900,2013
29069,39.8,31916,26293,3296,1829,8369,31304,12882,7905,4977,12882,67800,2013
29071,39.6,101569,97276,1196,1480,27726,48857,39263,30080,9183,39263,150500,2013
29073,45.6,15083,14619,71,169,4103,41392,6168,4760,1408,6168,116000,2013
29075,41.6,6774,6621,40,46,1871,39192,2800,2022,778,2800,80400,2013
29077,35.6,278231,248284,7714,8676,69461,40337,115574,68525,47049,115574,128100,2013
29079,42.3,10282,9841,108,99,2692,37964,4148,3001,1147,4148,72700,2013
29081,43,8871,8550,66,151,2319,37739,3515,2610,905,3515,71300,2013
29083,44,22183,21055,290,399,6154,39839,9551,6986,2565,9551,95700,2013
29085,53.3,9499,9120,17,111,2826,29325,4219,3494,725,4219,98700,2013
29087,46.5,4771,4631,31,12,1473,42979,2218,1589,629,2218,78900,2013
29089,39.4,10184,9260,524,132,2478,42747,3825,2832,993,3825,96400,2013
29091,39.6,40458,38454,111,717,10883,32533,15796,11002,4794,15796,97700,2013
29093,43.1,10505,9997,165,143,2817,36387,4126,2983,1143,4126,78800,2013
29095,36.3,675641,427020,159332,56797,164397,47015,271545,165840,105705,271545,126800,2013
29097,35.2,116803,100210,2271,8196,29632,40399,44849,28933,15916,44849,98300,2013
29099,38.1,219636,209199,1587,3573,59036,54845,80812,66761,14051,80812,152100,2013
29101,29.4,53517,46816,2449,1805,13189,47223,20092,12343,7749,20092,139200,2013
29103,43.8,4099,3974,39,14,1121,34481,1724,1290,434,1724,64900,2013
29105,39.1,35535,33527,168,740,10042,39013,13912,9733,4179,13912,96800,2013
29107,40.7,33188,30783,890,780,9248,50527,13117,9776,3341,13117,117300,2013
29109,39.7,38488,34887,166,2511,10280,39334,14817,10808,4009,14817,93700,2013
29111,38.8,10193,9491,268,165,2692,42071,3936,2921,1015,3936,82300,2013
29113,35.9,53051,49794,914,1084,13476,52835,18714,14621,4093,18714,149400,2013
29115,42.9,12592,12098,52,205,3173,38250,4854,3722,1132,4854,68600,2013
29117,41.5,15051,14184,371,193,3684,40116,5660,4007,1653,5660,98500,2013
29119,36.7,22892,18375,269,2577,5687,37997,8221,5710,2511,8221,86300,2013
29121,42.5,15545,14677,467,166,4045,38443,6389,4904,1485,6389,83600,2013
29123,41.2,12350,11863,17,240,3264,35870,4603,3503,1100,4603,86100,2013
29125,43.4,9102,8807,38,90,2601,42566,3749,2897,852,3749,116300,2013
29127,39.5,28804,26171,1582,414,7669,42046,11203,7630,3573,11203,102200,2013
29129,43.8,3749,3640,18,39,1077,40272,1575,1223,352,1575,67600,2013
29131,40.6,24863,23783,46,376,6732,35507,10034,7734,2300,10034,112000,2013
29133,39.3,14271,10414,3425,253,3338,29787,5227,3341,1886,5227,60600,2013
29135,37.8,15657,14128,576,640,3822,47118,5464,4074,1390,5464,112100,2013
29137,44.3,8798,8289,276,49,2294,40657,3497,2654,843,3497,89500,2013
29139,43.1,12128,11524,93,182,3524,40236,5091,3832,1259,5091,101500,2013
29141,46.9,20392,19379,141,370,5514,34797,8164,6541,1623,8164,110500,2013
29143,40.6,18695,15123,2937,244,5066,35793,7423,4616,2807,7423,75400,2013
29145,39.3,58552,51190,499,2688,15801,42268,22045,16504,5541,22045,107700,2013
29147,28.3,23347,21793,601,472,4605,36641,8599,4810,3789,8599,101800,2013
29149,45.2,10935,10401,19,147,2910,27743,4572,3478,1094,4572,72400,2013
29151,39.8,13842,13598,118,88,3800,51408,5168,4247,921,5168,123100,2013
29153,50,9653,9286,14,138,2983,32078,4063,3212,851,4063,89900,2013
29155,37.4,18160,12605,4949,380,4362,28889,6941,3808,3133,6941,64300,2013
29157,39.8,19001,18261,90,352,5305,47876,7511,5847,1664,7511,123100,2013
29159,37.6,42146,36508,1032,3194,10755,38580,16212,11288,4924,16212,98200,2013
29161,33.8,44969,40389,897,980,10685,41964,16699,10229,6470,16699,111700,2013
29163,40.1,18579,16507,1316,365,4524,39850,6559,4859,1700,6559,90100,2013
29165,38.2,90842,76045,5408,4755,24719,67721,36781,23662,13119,36781,184900,2013
29167,38.5,31088,29408,222,614,8347,39512,11937,8147,3790,11937,109800,2013
29169,26.9,52795,37829,5775,5030,10241,49820,15747,8392,7355,15747,121600,2013
29171,45.2,4944,4820,29,42,1425,36713,2230,1664,566,2230,100300,2013
29173,44.4,10206,9832,38,111,2988,47969,4044,3295,749,4044,108400,2013
29175,38,25253,22656,1611,433,5977,37203,8925,6373,2552,8925,84600,2013
29177,40.6,23290,22052,255,458,6306,52698,8735,6818,1917,8735,117600,2013
29179,46,6661,6366,52,112,1785,34496,2664,2067,597,2664,86100,2013
29181,42.1,14071,13486,11,154,3892,32291,5544,3984,1560,5544,76200,2013
29183,37.1,365101,324130,16115,10518,98782,71077,135974,109227,26747,135974,189100,2013
29185,49,9649,9184,67,180,2736,31539,4139,3212,927,4139,81600,2013
29186,42.8,17996,17435,157,158,4998,48433,7235,5944,1291,7235,121600,2013
29187,38.7,65602,60725,2926,838,16013,37238,24654,16927,7727,24654,98900,2013
29189,40,999725,684998,230666,25478,263717,58910,403293,286442,116851,403293,174500,2013
29195,38,23324,19232,1296,2030,5764,39519,8764,5938,2826,8764,85700,2013
29197,41.1,4397,4309,37,8,1190,34688,1773,1258,515,1773,73600,2013
29199,39.2,4859,4769,5,75,1244,39028,1915,1510,405,1915,70900,2013
29201,39.5,39216,33186,4396,755,10796,40651,15169,10496,4673,15169,96600,2013
29203,43.3,8388,7934,25,149,2281,31132,3220,2516,704,3220,80300,2013
29205,42.9,6274,6091,88,50,1639,35938,2597,1843,754,2597,71500,2013
29207,41.9,29860,28724,441,393,8210,37965,12224,8768,3456,12224,83800,2013
29209,50.4,31817,28749,28,574,9596,40850,13320,10468,2852,13320,145000,2013
29211,41,6611,5091,97,1215,1751,36676,2640,1827,813,2640,74200,2013
29213,41.2,52412,47537,295,2632,13618,38461,20698,13088,7610,20698,129100,2013
29215,42.2,25830,23750,668,462,6535,36082,9370,7051,2319,9370,98000,2013
29217,40.8,20990,19927,152,366,5238,38679,7999,5578,2421,7999,83700,2013
29219,40.1,32667,30237,590,982,9085,50830,12572,9981,2591,12572,151300,2013
29221,40.2,25135,23852,492,274,6515,34702,9199,7019,2180,9199,73000,2013
29223,46.4,13437,12941,86,155,3831,33159,5589,4196,1393,5589,75100,2013
29225,37.8,36274,34471,429,627,9512,44596,12668,9616,3052,12668,116800,2013
29227,47.8,2129,2085,0,23,613,39348,940,717,223,940,57900,2013
29229,40.5,18643,17880,95,272,5071,28645,7295,5267,2028,7295,86700,2013
29510,34.2,318955,136088,154400,11390,65731,34582,140652,62716,77936,140652,119200,2013
30001,43.2,9278,8550,23,339,2388,41614,4110,2636,1474,4110,173400,2013
30003,29.6,12939,3897,0,578,2658,39966,3444,2321,1123,3444,89300,2013
30005,34.9,6550,3132,11,127,1485,37151,2237,1463,774,2237,76200,2013
30007,45.5,5666,5343,27,46,1701,45932,2421,1953,468,2421,174000,2013
30009,48.7,10126,9666,9,217,2794,47831,4322,3314,1008,4322,205900,2013
30011,50.8,1241,1216,0,12,340,39659,495,398,97,495,82400,2013
30013,38.8,81621,70955,985,2922,21343,44963,33430,21930,11500,33430,157900,2013
30015,41.3,5827,4410,0,103,1586,40070,2228,1389,839,2228,114200,2013
30017,41.4,11785,11043,26,285,3077,43524,4986,3433,1553,4986,112100,2013
30019,50.3,1778,1671,0,32,514,46100,890,669,221,890,96800,2013
30021,42.3,9132,8582,22,206,2671,50405,3885,2733,1152,3885,122200,2013
30023,45.8,9285,8486,138,274,2298,38958,3855,2802,1053,3855,117800,2013
30025,39,3085,2992,0,15,832,51164,1199,863,336,1199,106700,2013
30027,48.4,11517,10968,1,194,2940,38344,4924,3664,1260,4924,113800,2013
30029,41.7,91536,85807,205,2211,24480,46581,36901,26200,10701,36901,228100,2013
30031,32.8,91499,85148,319,2642,22162,52833,36973,22857,14116,36973,261900,2013
30033,45.3,1145,1121,0,4,320,45096,465,355,110,465,113300,2013
30035,31,13528,4268,8,272,2885,33519,4194,2494,1700,4194,80200,2013
30037,54.2,709,695,0,3,205,39313,323,256,67,323,89300,2013
30039,53,3105,2975,4,51,990,45236,1473,1121,352,1473,200500,2013
30041,34.7,16301,11711,37,434,4068,43726,6139,4160,1979,6139,122600,2013
30043,47.3,11434,10726,43,235,3221,60863,4527,3887,640,4527,230100,2013
30045,50.1,2043,1987,0,37,535,41932,879,663,216,879,106800,2013
30047,41.2,28905,19487,47,1087,7759,38019,11829,8169,3660,11829,218600,2013
30049,40.8,64143,59118,261,1696,16543,56243,26555,19207,7348,26555,203600,2013
30051,48.9,2357,2239,19,14,562,44493,847,527,320,847,102800,2013
30053,49.8,19581,18399,27,479,5402,33333,8872,6956,1916,8872,158200,2013
30055,49.2,1794,1720,0,20,518,46667,760,587,173,760,101600,2013
30057,50.5,7702,7309,40,206,2201,47762,3542,2696,846,3542,239600,2013
30059,44.4,1905,1840,0,29,451,38182,716,515,201,716,115700,2013
30061,51,4219,4072,27,74,969,33033,1629,1155,474,1629,167300,2013
30063,34.3,110243,99904,451,3044,26223,46117,45523,26762,18761,45523,237500,2013
30065,48.2,4729,4425,27,82,1363,43409,1966,1543,423,1966,106100,2013
30067,46,15621,14824,21,357,3872,42426,6445,4841,1604,6445,204500,2013
30069,48.2,538,503,14,14,155,41705,233,177,56,233,83200,2013
30071,48.4,4205,3610,0,23,1206,42632,1800,1376,424,1800,86600,2013
30073,42.9,6166,5026,36,100,1566,41277,2302,1591,711,2302,99000,2013
30075,50.1,1669,1576,0,39,485,46250,720,503,217,720,105200,2013
30077,45.6,7052,6416,25,184,1530,40802,2411,1723,688,2411,120900,2013
30079,55.4,1186,1142,0,7,328,38036,502,436,66,502,69800,2013
30081,46.4,40423,37817,105,1235,10971,38688,16848,12281,4567,16848,233700,2013
30083,39.4,10318,9531,32,377,2746,58112,4270,2949,1321,4270,153000,2013
30085,30.5,10665,3847,5,184,2102,36920,3264,1921,1343,3264,70100,2013
30087,36.6,9310,5540,30,349,2255,48789,3268,2237,1031,3268,110900,2013
30089,50.5,11400,10308,13,255,3357,32881,5149,3942,1207,5149,166500,2013
30091,48.7,3473,3276,1,55,1034,48667,1612,1200,412,1612,109500,2013
30093,41.6,34322,31531,74,1305,8451,38659,15042,9846,5196,15042,121900,2013
30095,47,9173,8698,21,239,2801,57906,3757,3002,755,3757,185900,2013
30097,44.7,3640,3458,0,61,938,45938,1304,952,352,1304,192700,2013
30099,45.3,6063,5748,4,83,1540,43327,2303,1749,554,2303,134700,2013
30101,42.3,5224,4659,17,117,1309,46972,1927,1223,704,1927,106300,2013
30103,51.9,711,620,0,51,222,37105,332,233,99,332,67500,2013
30105,45.9,7465,6425,11,120,2023,47181,3248,2240,1008,3248,102300,2013
30107,48.7,2138,2038,0,19,525,31867,817,584,233,817,78400,2013
30109,49.7,928,910,0,18,273,41875,409,290,119,409,102700,2013
30111,38.3,150156,131743,775,7328,38738,51342,61023,41965,19058,61023,181500,2013
31001,38,31367,27688,238,2559,8030,49440,12578,8774,3804,12578,98000,2013
31003,46.5,6600,6335,6,188,2058,43518,2855,2146,709,2855,74300,2013
31005,37.5,507,505,0,0,114,40568,177,109,68,177,76400,2013
31007,49.2,816,745,10,45,241,36875,330,210,120,330,85000,2013
31009,41,586,572,0,0,179,42917,249,145,104,249,57200,2013
31011,45.9,5441,5353,5,70,1478,45246,2242,1726,516,2242,85000,2013
31013,40.6,11312,9477,15,1224,3059,46373,4860,3201,1659,4860,90000,2013
31015,51.9,2093,2041,21,14,568,41279,938,780,158,938,54500,2013
31017,46.7,3167,3093,1,64,1038,33647,1544,1073,471,1544,58900,2013
31019,32.3,46885,41599,362,3641,11368,50963,17705,11470,6235,17705,139800,2013
31021,47.3,6748,6365,79,80,2000,46817,2899,2220,679,2899,85700,2013
31023,44.4,8334,7997,59,219,2355,50247,3482,2644,838,3482,99200,2013
31025,41.5,25222,23983,176,666,7026,64697,9701,7684,2017,9701,146700,2013
31027,44.6,8790,8570,14,128,2375,48038,3529,2867,662,3529,89100,2013
31029,43.3,3984,3456,1,473,1166,45610,1697,1309,388,1697,86000,2013
31031,45.1,5735,5138,9,83,1792,45464,2618,1755,863,2618,95500,2013
31033,39.9,10022,9066,30,616,2763,51529,4405,2936,1469,4405,104100,2013
31035,43.7,6469,5842,58,514,1848,46784,2647,2059,588,2647,76100,2013
31037,34.8,10495,5899,113,4381,2647,51765,3686,2741,945,3686,87900,2013
31039,43.5,9095,8172,2,783,2630,47500,3822,2698,1124,3822,88300,2013
31041,44.8,10872,10442,56,242,3144,44873,4738,3576,1162,4738,81600,2013
31043,32.6,20920,11320,846,7480,5338,47069,7309,4710,2599,7309,103300,2013
31045,34.7,9172,7998,167,330,2153,40359,3709,2403,1306,3709,100700,2013
31047,36.7,24256,15227,833,7800,6220,46078,8774,5996,2778,8774,88200,2013
31049,49,1952,1834,2,97,498,44922,855,664,191,855,67400,2013
31051,41,5953,5201,15,656,1676,47325,2348,1804,544,2348,76300,2013
31053,40.1,36675,31944,71,3778,10193,48626,15221,10355,4866,15221,109200,2013
31055,33.7,524697,376332,58523,59490,126349,53325,204226,128058,76168,204226,143300,2013
31057,47.8,1994,1850,3,119,635,47431,893,604,289,893,69100,2013
31059,46.4,5818,5544,42,189,1564,48464,2444,1888,556,2444,73300,2013
31061,49.2,3181,3091,8,40,964,43011,1398,1149,249,1398,56200,2013
31063,45,2568,2506,0,25,736,50227,1086,809,277,1086,74200,2013
31065,47,4920,4693,1,141,1416,39603,2215,1602,613,2215,56400,2013
31067,43.9,22055,21110,26,411,5867,47654,9133,6613,2520,9133,101600,2013
31069,53.1,1966,1816,0,94,585,39400,836,649,187,836,61800,2013
31071,50.5,1947,1923,13,6,546,41892,864,641,223,864,86100,2013
31073,45.3,2005,1924,0,56,576,45893,767,586,181,767,104100,2013
31075,47.1,614,605,0,9,175,44167,246,163,83,246,45600,2013
31077,46.3,2507,2446,7,48,688,44950,1011,817,194,1011,57500,2013
31079,35.7,59431,42509,1152,14370,14618,48712,22168,14485,7683,22168,113200,2013
31081,42.9,9090,8765,31,209,2564,56065,3488,2707,781,3488,113300,2013
31083,50,3445,3320,5,65,1004,45920,1573,1226,347,1573,75100,2013
31085,45.8,1142,1087,3,51,353,49125,477,323,154,477,66100,2013
31087,49.1,2884,2781,5,50,839,39702,1366,1001,365,1366,62300,2013
31089,45.8,10435,9972,4,342,2926,44427,4469,3331,1138,4469,90500,2013
31091,51.1,703,688,0,6,199,39327,295,252,43,295,63300,2013
31093,43.2,6308,6076,0,128,1753,49088,2576,2045,531,2576,101200,2013
31095,46.6,7563,7198,1,226,2079,44843,3301,2583,718,3301,70400,2013
31097,44.2,5182,4274,273,466,1173,42364,1926,1425,501,1926,75300,2013
31099,41,6518,6158,4,275,1904,56466,2621,1920,701,2621,96400,2013
31101,48.5,8247,7591,10,484,2445,41970,3786,2649,1137,3786,91500,2013
31103,53.3,698,683,1,0,236,36923,354,288,66,354,80000,2013
31105,45.8,3779,3411,18,248,1042,42180,1641,1084,557,1641,77900,2013
31107,47,8617,7558,25,178,2540,42230,3776,2740,1036,3776,74000,2013
31109,32.7,289873,243529,10501,17513,70561,51574,115237,69302,45935,115237,148600,2013
31111,39.1,36128,32411,271,2721,9503,48158,15067,10338,4729,15067,112800,2013
31113,47.4,787,761,2,20,230,44417,345,250,95,345,101700,2013
31115,45.7,581,543,0,25,172,38125,240,172,68,240,71100,2013
31117,43.7,382,382,0,0,133,54926,169,117,52,169,142300,2013
31119,37,34995,28962,427,4678,9090,46566,13867,9163,4704,13867,109000,2013
31121,42.9,7802,7314,36,293,2301,50859,3316,2410,906,3316,85300,2013
31123,43.6,4958,4163,5,687,1427,43886,2037,1355,682,2037,76300,2013
31125,45.4,3707,3605,3,82,1027,44286,1534,1157,377,1534,67000,2013
31127,40.9,7207,6853,63,151,1778,42672,3001,2049,952,3001,84400,2013
31129,49.7,4462,4291,2,99,1423,37594,2119,1612,507,2119,52300,2013
31131,42.1,15727,14401,20,947,4370,50881,6438,4704,1734,6438,118000,2013
31133,49.4,2759,2658,0,45,774,37321,1314,984,330,1314,57200,2013
31135,45.1,2949,2845,0,97,864,58625,1262,948,314,1262,88500,2013
31137,43.3,9186,8643,12,411,2520,50000,3808,2746,1062,3808,100700,2013
31139,41.9,7211,7019,11,102,2060,51924,2916,2338,578,2916,97000,2013
31141,38.7,32350,26989,72,4723,8261,51213,12477,8926,3551,12477,115400,2013
31143,45.7,5342,5074,11,165,1540,52848,2232,1659,573,2232,95200,2013
31145,42.4,11015,10249,73,488,2916,42345,4732,3377,1355,4732,84200,2013
31147,46.7,8289,7725,3,124,2178,38582,3779,2908,871,3779,62600,2013
31149,49.7,1436,1376,11,0,391,43500,666,553,113,666,65200,2013
31151,35.6,14348,10773,113,3031,3367,44109,5051,3311,1740,5051,94400,2013
31153,33.2,162728,135667,6300,12331,44077,69965,59606,42083,17523,59606,162400,2013
31155,41.8,20800,19977,122,426,5637,59870,8142,6443,1699,8142,147600,2013
31157,38.9,36883,27609,192,7961,9573,43444,14690,9940,4750,14690,102600,2013
31159,38.7,16824,16145,82,310,4344,59435,6165,4529,1636,6165,142600,2013
31161,46.5,5390,4495,14,183,1515,38548,2380,1654,726,2380,65800,2013
31163,48.6,3129,3057,32,29,925,41835,1369,1112,257,1369,82000,2013
31165,49.9,1229,1164,0,54,363,42014,553,428,125,553,86500,2013
31167,39.5,6148,5707,13,296,1817,51493,2336,1908,428,2336,98900,2013
31169,49.5,5187,5010,5,94,1498,44422,2343,1866,477,2343,61200,2013
31171,48.4,734,697,6,0,234,55089,323,238,85,323,79200,2013
31173,28.6,6915,2680,31,246,1469,41400,2050,1373,677,2050,68500,2013
31175,47.3,4256,4141,1,76,1274,40445,1893,1415,478,1893,78100,2013
31177,40.8,20234,19364,99,450,5423,65409,7647,5971,1676,7647,169700,2013
31179,29.9,9499,8711,222,447,2166,52147,3401,2194,1207,3401,103200,2013
31181,47.6,3762,3515,4,146,1001,41045,1548,1226,322,1548,67300,2013
31183,44.2,869,848,0,16,217,38807,379,270,109,379,87100,2013
31185,40.7,13762,12772,105,579,3638,49633,5501,3811,1690,5501,108500,2013
32001,39.2,24572,18539,494,3100,6266,49830,9253,5728,3525,9253,153300,2013
32003,35.8,1976925,933731,201993,582084,461236,52873,710058,386600,323458,710058,165000,2013
32005,47.9,47035,38747,240,5312,13309,60100,19455,13962,5493,19455,271400,2013
32007,33.3,50023,34258,449,11652,12377,70238,17599,12335,5264,17599,184300,2013
32009,47.9,979,774,7,155,248,30284,479,266,213,479,81400,2013
32011,38.3,1804,1676,10,71,437,64632,733,482,251,733,117400,2013
32013,35.7,16800,11486,85,4143,4218,59472,6314,4464,1850,6314,147400,2013
32015,37.3,5844,4028,7,1508,1472,72742,2010,1578,432,2010,103300,2013
32017,35.7,5296,4430,117,376,1382,40143,1969,1239,730,1969,140600,2013
32019,41.6,51648,40065,457,7823,13167,46137,19278,13544,5734,19278,133400,2013
32021,50.1,4700,3091,83,540,1116,35017,2147,1540,607,2147,95500,2013
32023,49.7,43368,33949,1138,6005,12410,39876,18046,12794,5252,18046,112600,2013
32027,40.4,6752,4558,247,1524,1430,52101,2091,1386,705,2091,138100,2013
32029,54.4,3981,3638,20,87,1161,61573,1843,1729,114,1843,167700,2013
32031,37.2,425495,279012,9556,96340,102123,53040,163198,94596,68602,163198,203300,2013
32033,40.9,10023,7557,285,1385,2003,48586,3357,2379,978,3357,113800,2013
32510,41.9,54821,38256,921,11992,13035,51957,21186,12299,8887,21186,198900,2013
33001,45.1,60216,57384,396,814,16960,58654,25049,18812,6237,25049,219900,2013
33003,49,47694,46048,118,550,14028,50866,20922,16863,4059,20922,226200,2013
33005,41.3,76896,73130,493,1168,19162,55155,30458,21718,8740,30458,195400,2013
33007,47.4,32520,31160,208,424,8934,41985,14531,10318,4213,14531,128500,2013
33009,41.4,89166,82036,556,1717,21891,54912,35111,24239,10872,35111,212000,2013
33011,39.5,402017,350521,7874,22063,103750,69829,154324,103941,50383,154324,249900,2013
33013,41.9,146710,137959,1598,2518,37842,65353,56812,41034,15778,56812,231000,2013
33015,42.7,296718,278612,2129,6658,81025,77348,116262,89262,27000,116262,282100,2013
33017,36.9,123836,114465,1004,2371,30512,58825,46968,30797,16171,46968,220600,2013
33019,44.6,43398,41607,158,534,12046,54463,17808,13189,4619,17808,171700,2013
34001,40.2,274960,159438,40649,47698,67697,54235,101091,68914,32177,101091,237400,2013
34003,41.3,912795,560139,47865,153117,239574,83794,335422,220018,115404,335422,451400,2013
34005,40.6,449964,315039,71065,30577,115577,78446,164979,128340,36639,164979,252500,2013
34007,38,513512,306232,92963,75399,126823,61683,187941,128420,59521,187941,210700,2013
34009,47.7,96684,83726,4248,6267,27383,56494,42312,31569,10743,42312,312800,2013
34011,36.7,157342,78098,29800,43401,35417,50750,50676,34026,16650,50676,168900,2013
34013,36.5,785853,258647,307934,163713,182399,55095,277302,127297,150005,277302,364800,2013
34015,39,289098,232699,28085,14498,75480,74524,104145,83578,20567,104145,224700,2013
34017,34.4,644605,194192,72276,273611,150173,58442,243875,79534,164341,243875,347200,2013
34019,44,127047,111272,3007,6961,34083,106143,46816,39576,7240,46816,404300,2013
34021,38.1,368094,197495,71717,57100,88353,73480,130754,86033,44721,130754,286900,2013
34023,37.4,817026,392880,73544,153731,203110,79596,280988,185879,95109,280988,330000,2013
34025,41.7,629735,482074,42951,62174,162846,84526,233909,175948,57961,233909,389900,2013
34027,41.5,495261,367474,14638,58508,129417,98633,179665,136296,43369,179665,432400,2013
34029,42.6,578902,495677,16803,48990,148963,61136,221774,180299,41475,221774,268100,2013
34031,36.2,502854,224264,56219,189842,116967,57654,162543,88252,74291,162543,351000,2013
34033,41.1,65825,50241,9064,4707,17095,59718,25003,17925,7078,25003,190200,2013
34035,40.4,326207,200123,28066,43423,83994,99020,115531,90063,25468,115531,398800,2013
34037,42.3,147924,130755,2773,9877,40633,87335,54746,46382,8364,54746,285800,2013
34039,37.9,540568,238632,110779,151901,131541,68507,185483,111977,73506,185483,362300,2013
34041,41.8,108150,91727,4026,8015,29058,70912,41463,30739,10724,41463,271100,2013
35001,36.1,667092,274547,16798,321352,163349,48801,263135,166175,96960,263135,186800,2013
35003,57.2,3683,2770,22,762,919,39826,1581,1399,182,1581,158900,2013
35005,34.7,65627,28318,1035,34662,16220,39131,23499,15620,7879,23499,96800,2013
35006,37.3,27296,5828,132,10088,5277,37237,8016,5805,2211,8016,83800,2013
35007,47.1,13485,6621,40,6441,3315,37734,5574,3786,1788,5574,117100,2013
35009,30.9,49302,24985,2863,19511,12403,39871,18027,10758,7269,18027,119600,2013
35011,46.7,1975,1094,0,813,453,37660,689,549,140,689,79200,2013
35013,32.2,211175,62794,3061,139372,51262,37933,73797,48269,25528,73797,139100,2013
35015,36.9,54284,27729,603,24262,13603,49165,19866,14474,5392,19866,110400,2013
35017,46.1,29471,14154,69,14333,7640,37899,12216,9397,2819,12216,125300,2013
35019,41.6,4626,837,79,3557,825,29071,1260,1011,249,1260,88400,2013
35021,55.5,687,410,0,264,156,34063,261,215,46,261,66300,2013
35023,39.6,4834,2032,35,2724,1276,34080,1837,1219,618,1837,76800,2013
35025,31.8,65681,27492,1914,34353,15560,50694,21126,14790,6336,21126,97200,2013
35027,49.6,20359,13237,112,6197,5270,43014,8685,6842,1843,8685,156300,2013
35028,43.7,17979,13546,68,2763,5155,106686,7590,5723,1867,7590,284500,2013
35029,38.7,25001,8714,244,15619,5711,29282,8862,6044,2818,8862,89800,2013
35031,30.5,72373,7416,305,9860,12220,30458,17427,12644,4783,17427,74900,2013
35033,46.8,4788,827,5,3910,787,28481,1532,1331,201,1532,96200,2013
35035,35.6,64767,33795,2276,22659,16469,39263,23945,15880,8065,23945,102400,2013
35037,45.9,8890,4660,128,3815,2134,30802,3476,2747,729,3476,68900,2013
35039,39.5,40218,5316,157,28701,9902,40250,14783,11707,3076,14783,133300,2013
35041,29.6,19984,10971,444,7978,4772,38764,7043,4265,2778,7043,111300,2013
35043,38.5,133503,62438,2729,47892,34114,58017,47164,38111,9053,47164,180900,2013
35045,33.2,128476,53630,805,24677,30188,48196,40945,30413,10532,40945,148700,2013
35047,41.5,29093,5650,347,22361,6453,28275,11435,7945,3490,11435,116700,2013
35049,43.4,145400,63491,916,73876,35768,52917,61012,42476,18536,61012,278400,2013
35051,55.4,11898,8061,39,3392,2336,27430,4350,3215,1135,4350,93900,2013
35053,35.6,17756,6604,168,8669,3268,34036,5329,3834,1495,5329,122800,2013
35055,45.8,32899,11885,165,18449,7771,32637,13338,9620,3718,13338,204800,2013
35057,42.3,16185,8959,182,6408,3665,31161,5638,4605,1033,5638,105200,2013
35059,39.9,4458,2468,88,1790,1057,38902,1606,1035,571,1606,86500,2013
35061,37.9,76461,27295,881,44758,19159,42506,26894,21440,5454,26894,133600,2013
36001,38,305279,230007,36532,15744,69328,59394,122700,72784,49916,122700,209300,2013
36003,38.2,48618,46303,636,706,12376,42445,18786,13772,5014,18786,69600,2013
36005,32.9,1397315,150000,419514,753477,312858,34388,474842,92108,382734,474842,374500,2013
36007,40,199298,171110,8959,7036,48410,45958,79763,53052,26711,79763,107900,2013
36009,41,79735,73086,1123,1440,20443,42603,32246,23186,9060,32246,81100,2013
36011,41.8,79767,72761,3216,1957,20230,51581,31311,22536,8775,31311,106600,2013
36013,40.8,134156,119256,3041,8521,34306,42429,54863,37903,16960,54863,83500,2013
36015,41.1,88876,77460,5396,2377,22378,48804,35622,24025,11597,35622,94300,2013
36017,43.1,50121,47825,308,963,13330,43941,19829,14994,4835,19829,90600,2013
36019,39.4,81865,74405,3123,2128,20189,50282,31901,21606,10295,31901,122900,2013
36021,46,62674,55157,2514,2515,16228,57336,25280,18301,6979,25280,221600,2013
36023,35.8,49271,45933,703,1175,10999,47151,18069,11916,6153,18069,105700,2013
36025,45.9,47491,44161,813,1561,12457,44470,19844,14796,5048,19844,133200,2013
36027,40.6,297385,219982,27172,32021,73240,72525,107830,75038,32792,107830,289400,2013
36029,40.4,919230,711466,118476,43061,231215,50653,380152,248379,131773,380152,124300,2013
36031,45.2,39181,34635,1341,1037,10002,47380,15919,11522,4397,15919,146600,2013
36033,39.6,51676,42467,2972,1617,12381,45667,19238,13907,5331,19238,97100,2013
36035,42.1,55165,51698,824,1352,14784,44276,22611,15596,7015,22611,106000,2013
36037,42,59872,54674,1532,1668,15952,49922,23884,17372,6512,23884,105000,2013
36039,44.5,48928,42492,2786,2479,11782,49655,18365,13644,4721,18365,183300,2013
36041,51.6,4813,4639,30,52,1204,51522,1854,1555,299,1854,164700,2013
36043,42.6,64428,61488,640,1132,17474,45047,26815,18903,7912,26815,92500,2013
36045,32,118073,99538,5359,7242,30659,46484,45011,25254,19757,45011,131800,2013
36047,34.2,2539789,908829,809177,500701,583135,46085,916025,272724,643301,916025,557100,2013
36049,40.9,27108,26141,242,391,7501,46840,10677,8220,2457,10677,107200,2013
36051,39.9,65087,59769,1429,1921,15902,53518,24092,17916,6176,24092,119300,2013
36053,39.8,72839,68246,1322,1376,17737,53589,26565,20053,6512,26565,121100,2013
36055,38.4,746548,540188,108107,55990,182478,52394,297040,193265,103775,297040,136000,2013
36057,41,50019,42269,608,5836,12590,44156,19703,13317,6386,19703,101200,2013
36059,41.2,1343765,867878,143551,201257,339120,97690,441955,355915,86040,441955,454500,2013
36061,36.5,1605272,765203,206508,410732,301894,69659,736192,167506,568686,736192,828100,2013
36063,42.1,215465,187648,15300,4971,55500,47955,88376,62218,26158,88376,105200,2013
36065,41,234206,197485,12631,11284,56564,48729,91075,61198,29877,91075,110500,2013
36067,38.8,467202,368313,48994,19630,113831,54242,184855,120866,63989,184855,132300,2013
36069,42.5,108311,98966,2142,4006,28864,56479,43794,32283,11511,43794,138100,2013
36071,36.7,373902,252849,34652,68917,89873,70458,125317,86713,38604,125317,276900,2013
36073,41.3,42663,37242,2442,1810,10755,48502,15725,12169,3556,15725,91100,2013
36075,38.8,121797,115600,941,2647,30580,48051,45325,32797,12528,45325,93000,2013
36077,41.1,62029,57302,1059,2012,15030,47765,24078,17658,6420,24078,137900,2013
36079,42,99718,81996,2011,11968,26518,95117,34496,28667,5829,34496,372200,2013
36081,37.4,2256400,610674,396414,624182,525368,57001,778630,344390,434240,778630,450900,2013
36083,39.9,159565,136128,9269,6364,40006,59432,64242,42208,22034,64242,178200,2013
36085,38.8,470223,299612,45570,82024,121285,72569,164609,112980,51629,164609,441000,2013
36087,36.4,315069,203776,35625,50598,74429,84951,98326,68701,29625,98326,435300,2013
36089,37.5,112097,103847,2344,2265,26777,43647,41839,29619,12220,41839,84400,2013
36091,41.2,221169,204329,3076,5706,58164,69826,88460,63623,24837,88460,230700,2013
36093,39.9,154821,118438,14127,9236,35527,56061,58059,39024,19035,58059,166500,2013
36095,42.8,32404,30407,441,931,8425,53245,12820,9964,2856,12820,146000,2013
36097,44.7,18432,17666,158,275,4871,46976,7684,6031,1653,7684,94400,2013
36099,41.4,35359,31898,1514,1034,8384,47618,13429,9999,3430,13429,94400,2013
36101,41.7,98951,93260,1792,1425,26541,47476,41503,29620,11883,41503,86800,2013
36103,40.1,1495803,1062269,105603,253262,374411,87763,497347,397731,99616,497347,383400,2013
36105,41.7,77134,57303,6126,10712,18488,48089,29531,19287,10244,29531,172100,2013
36107,43,50789,48621,333,738,14112,55726,20202,16057,4145,20202,108400,2013
36109,29.9,102270,81130,3727,4523,20189,51393,38409,21620,16789,38409,169200,2013
36111,42.5,182086,147801,9450,16434,44833,58590,69862,48778,21084,69862,232400,2013
36113,44.6,65584,62272,696,1260,18142,55904,28081,19893,8188,28081,189400,2013
36115,42.4,63237,58936,1707,1485,16882,52361,24499,18027,6472,24499,148300,2013
36117,42.3,93224,84604,3101,3542,25375,52601,36399,28648,7751,36399,109300,2013
36119,40.2,956283,542720,127353,213656,237934,81946,343561,212542,131019,343561,518400,2013
36121,41.1,41923,37713,2304,1262,10512,51100,15624,11777,3847,15624,100200,2013
36123,40.5,25293,24265,205,459,6797,49335,9602,7352,2250,9602,118200,2013
37001,38.8,152472,101972,27327,17223,40615,43043,60139,40380,19759,60139,137000,2013
37003,41.1,37071,32481,2040,1594,9743,40637,14101,10929,3172,14101,121300,2013
37005,46.4,11046,9680,118,1031,3360,35170,4793,3657,1136,4793,156100,2013
37007,40,26569,12122,12903,841,6548,33870,9686,6640,3046,9686,79400,2013
37009,45.7,27180,25290,137,1315,8201,35951,11839,9100,2739,11839,150900,2013
37011,42.5,17756,15123,699,804,4715,36969,7122,5417,1705,7122,140800,2013
37013,44.2,47575,31483,12119,3340,13107,40429,19266,13510,5756,19266,117000,2013
37015,43.8,20879,7282,13061,310,4991,30768,7629,5747,1882,7629,79100,2013
37017,41.4,34969,19086,12079,2510,9221,30164,14256,9666,4590,14256,81800,2013
37019,48.3,110324,89422,11841,5497,33548,46438,47600,36363,11237,47600,186600,2013
37021,40.8,241801,203809,14783,14729,60303,44713,100838,65042,35796,100838,191200,2013
37023,41.8,90591,74783,5598,4917,23236,37263,34664,24881,9783,34664,110900,2013
37025,37,181415,128601,27998,17296,47049,53551,64713,47286,17427,64713,167800,2013
37027,41.5,82407,72836,3800,3883,20741,34357,31417,22597,8820,31417,105800,2013
37029,40.9,10037,8040,1346,238,2702,56607,3580,3092,488,3580,220200,2013
37031,45.9,67198,58469,4043,2444,18968,46534,29158,20462,8696,29158,199200,2013
37033,43.8,23462,14376,7853,763,6306,35315,8813,6324,2489,8813,98900,2013
37035,40.1,154432,120020,12794,13127,39774,44332,58533,41631,16902,58533,133000,2013
37037,44.8,64886,46339,8171,8295,18494,57091,26017,20797,5220,26017,211400,2013
37039,49,27243,25016,369,716,7470,34432,10722,8807,1915,10722,145000,2013
37041,45.5,14782,9000,4847,472,3831,34420,5945,3949,1996,5945,129100,2013
37043,50.1,10599,10105,92,283,2931,38828,4431,3578,853,4431,154700,2013
37045,40.7,97670,72336,20249,2870,25685,38989,37760,25693,12067,37760,106100,2013
37047,40.7,57761,34872,17439,2659,14303,35761,21758,15561,6197,21758,84500,2013
37049,36,104041,69683,22117,6697,28105,47141,39931,25394,14537,39931,152400,2013
37051,30.9,322033,149841,113215,32078,81041,45231,121226,66427,54799,121226,128700,2013
37053,41.8,23880,21082,1463,760,6548,57159,9121,7318,1803,9121,223800,2013
37055,44,34289,30251,1015,2262,9223,55481,14624,10340,4284,14624,293900,2013
37057,40.6,162975,133380,14982,10457,44918,43083,64580,47157,17423,64580,134000,2013
37059,43.1,41339,35186,2775,2559,11769,50139,16234,13085,3149,16234,162100,2013
37061,37.8,59169,31109,14919,12349,14822,34433,22052,14923,7129,22052,87600,2013
37063,33.7,276494,116447,102474,37021,65984,51853,111276,61223,50053,111276,180600,2013
37065,40.2,56049,21012,32034,2148,14528,33960,21021,13229,7792,21021,80600,2013
37067,37.5,354656,207626,91348,42757,89143,45724,140439,89812,50627,140439,150600,2013
37069,39.6,61154,38930,15664,4776,16647,41696,23313,17829,5484,23313,123300,2013
37071,39,207263,156244,30933,12485,54318,42017,79450,53108,26342,79450,123600,2013
37073,42.4,11982,7500,4075,192,3287,46592,4459,3548,911,4459,150200,2013
37075,42.5,8762,7803,39,215,2423,33903,3462,2837,625,3462,125700,2013
37077,40.2,58188,34045,18055,4274,14181,49852,19953,14953,5000,19953,137100,2013
37079,39.1,21382,10136,7647,3090,4974,40853,7104,4942,2162,7104,88500,2013
37081,36.6,495326,265542,160361,35804,123750,45431,196463,119937,76526,196463,156000,2013
37083,42.1,54251,21336,27774,1260,14062,32329,21550,13324,8226,21550,86100,2013
37085,33.5,118793,75834,24500,13213,29073,44625,40677,27736,12941,40677,132600,2013
37087,46,58951,55210,528,2023,17978,41557,26608,19809,6799,26608,156900,2013
37089,46,107583,90669,3460,10512,30320,44815,45246,33630,11616,45246,185500,2013
37091,41.4,24516,8288,14362,764,5819,33406,8624,5439,3185,8624,84200,2013
37093,31,48842,19996,15872,6020,12068,45489,16161,10968,5193,16161,141300,2013
37095,42.4,5771,3314,2158,256,1502,42279,2148,1667,481,2148,76400,2013
37097,39.4,161297,125049,19463,11164,43150,50329,59468,44075,15393,59468,166700,2013
37099,35.8,40362,32910,784,2046,9714,36951,15609,10589,5020,15609,172800,2013
37101,37,172321,119883,25614,22342,45533,49711,60759,43495,17264,60759,141200,2013
37103,44.4,10194,6275,3215,416,2621,36213,4151,2887,1264,4151,97600,2013
37105,37.1,58735,34611,11301,11053,14698,44819,21204,14657,6547,21204,131300,2013
37107,41.1,59277,30291,23605,4005,15464,35770,23569,14173,9396,23569,94200,2013
37109,41.3,78761,67431,4055,5400,21705,48940,29994,23112,6882,29994,154600,2013
37111,42.2,44963,39869,1664,2431,11539,35297,17252,12330,4922,17252,101200,2013
37113,48.9,33859,30504,406,2214,10216,37892,15340,11352,3988,15340,165400,2013
37115,43.8,20842,19712,298,463,5639,38598,8207,6142,2065,8207,161700,2013
37117,44.7,24147,12582,10393,794,6292,35111,9444,6603,2841,9444,84600,2013
37119,34.2,947135,474465,286750,116194,228213,55444,366689,218240,148449,366689,181900,2013
37121,45.7,15453,14487,139,669,4554,37680,6455,4938,1517,6455,117300,2013
37123,40,27707,17696,5203,4004,6751,31830,10610,7387,3223,10610,88900,2013
37125,45.1,89425,69323,11277,5407,24932,49544,36997,27427,9570,36997,201600,2013
37127,40.4,95571,50977,35593,6103,25043,43084,37726,24186,13540,37726,117300,2013
37129,37.6,206403,158358,29965,10944,49785,49835,86010,50681,35329,86010,215200,2013
37131,46.1,21645,8403,12150,353,5560,31433,8604,6276,2328,8604,80000,2013
37133,25.8,179935,122733,27980,19409,43781,45450,60071,32928,27143,60071,151700,2013
37135,33.2,136057,95854,15679,11101,30718,55569,51403,31108,20295,51403,272600,2013
37137,49,13115,9763,2529,424,3682,43853,5146,4198,948,5146,157500,2013
37139,36.6,40419,22209,15105,1699,9953,46053,14399,9174,5225,14399,171600,2013
37141,41.5,53412,39531,9412,3298,14255,44524,20254,15656,4598,20254,155600,2013
37143,46.7,13463,9603,3353,295,4052,43709,5437,4195,1242,5437,170700,2013
37145,41.7,39361,26196,10784,1621,10337,42317,15320,11011,4309,15320,118800,2013
37147,31.2,170485,97069,57411,9495,39136,40718,66026,35950,30076,66026,134900,2013
37149,50.1,20381,18014,1038,1119,5849,44745,8788,6518,2270,8788,170200,2013
37151,40,142042,115056,7587,15026,38809,41208,54350,40116,14234,54350,121900,2013
37153,39,46534,27210,14039,2810,11669,32384,18254,11756,6498,18254,77500,2013
37155,34.7,134535,36230,32244,10859,31892,29806,45154,29311,15843,45154,66800,2013
37157,42.5,92974,68160,17045,5227,25815,38567,37693,26628,11065,37693,102900,2013
37159,39.5,138265,101509,22126,10766,35990,41495,52300,35982,16318,52300,130200,2013
37161,42.6,67403,56714,6724,2462,19275,36334,27214,19442,7772,27214,108600,2013
37163,38.5,63687,33718,16532,10846,15852,36496,23336,16147,7189,23336,89200,2013
37165,38.2,36201,16434,13967,861,8765,29592,13047,8300,4747,13047,77100,2013
37167,41.1,60529,49718,6291,2245,15994,42518,23108,16924,6184,23108,125100,2013
37169,43.4,47063,43136,1805,1263,13666,42703,18969,15247,3722,18969,118100,2013
37171,41.6,73486,62316,2580,7214,20315,35641,29967,21807,8160,29967,109900,2013
37173,40.6,14017,9095,356,580,3536,36094,5368,4021,1347,5368,132500,2013
37175,49.7,32894,29367,1089,964,9137,41781,13981,10668,3313,13981,171600,2013
37177,42.3,4272,2414,1200,430,1071,34216,1480,1116,364,1480,107100,2013
37179,36.6,205426,152508,24019,21773,54975,65892,68211,55974,12237,68211,194300,2013
37181,38.9,45120,18850,22349,3074,11094,34987,16640,10399,6241,16640,99600,2013
37183,34.8,929214,574146,190161,91016,231753,66006,348627,227376,121251,348627,229000,2013
37185,45.1,20792,7907,10570,743,5142,34285,7731,5455,2276,7731,98300,2013
37187,44.3,12958,5866,6485,496,3198,34936,5056,3658,1398,5056,89000,2013
37189,28.8,51557,45867,1085,1747,11025,34293,20909,11474,9435,20909,228700,2013
37191,36.7,123382,68165,38260,12537,32212,41731,47330,28721,18609,47330,108600,2013
37193,42.9,69184,61375,2901,3834,19353,33159,27512,20339,7173,27512,111700,2013
37195,39.1,81365,39970,30985,7843,21274,39204,31690,19314,12376,31690,111500,2013
37197,42.1,38217,32726,1188,3834,10416,40371,14926,11586,3340,14926,121100,2013
37199,45.7,17724,16530,188,826,5163,38579,7278,5595,1683,7278,135100,2013
38001,50.2,2328,2217,6,33,739,47798,1101,809,292,1101,106300,2013
38003,43.8,11085,10530,55,146,3057,50274,4871,3416,1455,4871,87900,2013
38005,31.7,6721,2888,5,96,1605,36491,2291,1477,814,2291,52800,2013
38007,48.2,876,848,0,3,228,57083,350,273,77,350,108900,2013
38009,47.1,6529,6115,25,98,1835,51667,3028,2328,700,3028,84200,2013
38011,45.5,3168,3018,3,106,869,56964,1354,1045,309,1354,115100,2013
38013,39.9,2094,1948,19,90,601,53693,1007,681,326,1007,77900,2013
38015,36.9,83906,77157,502,1192,22057,61811,34703,24713,9990,34703,172800,2013
38017,31.7,154080,138822,3838,3303,36232,52590,65816,35146,30670,65816,158900,2013
38019,50.8,3952,3826,1,0,1167,55904,1754,1485,269,1754,68700,2013
38021,42.8,5264,4961,62,120,1321,47359,2178,1579,599,2178,76700,2013
38023,52.9,2155,2112,0,0,659,55057,1035,882,153,1035,72200,2013
38025,42.9,3786,3184,5,102,994,60500,1438,1184,254,1438,104800,2013
38027,48.7,2382,2220,0,80,630,44250,1104,821,283,1104,58800,2013
38029,51.2,3521,3466,0,8,1004,38477,1634,1322,312,1634,70200,2013
38031,46.1,3355,3265,1,50,1052,50677,1555,1147,408,1555,88700,2013
38033,42.3,1698,1608,1,23,393,36100,754,545,209,754,83800,2013
38035,29.5,67357,59143,1529,2186,15084,46745,27465,14455,13010,27465,152100,2013
38037,51.1,2372,2228,7,9,669,41694,1113,848,265,1113,67200,2013
38039,54.3,2370,2331,4,9,719,45542,1149,877,272,1149,61900,2013
38041,49,2539,2472,17,17,754,47743,1097,912,185,1097,74400,2013
38043,48.5,2429,2271,0,105,847,50000,1146,882,264,1146,71500,2013
38045,49.4,4136,4066,2,28,1221,53691,1955,1567,388,1955,76500,2013
38047,49.7,1966,1904,6,22,547,49076,827,696,131,827,58600,2013
38049,45,5593,5369,3,108,1590,45343,2573,1995,578,2573,77300,2013
38051,52.3,2791,2698,1,8,820,36066,1308,1095,213,1308,55600,2013
38053,35.4,7377,5611,17,245,1883,64866,2666,1790,876,2666,123800,2013
38055,48.9,9163,8258,2,148,2696,53565,4021,3115,906,4021,117000,2013
38057,46.5,8456,7997,62,141,2393,66534,3650,3026,624,3650,113600,2013
38059,39.3,27874,25743,73,497,7768,60065,11416,9057,2359,11416,147900,2013
38061,36,8280,5333,27,363,2207,68722,3069,2216,853,3069,89400,2013
38063,51.8,3101,2972,39,40,893,49839,1474,1219,255,1474,54000,2013
38065,46.1,1840,1754,0,37,568,71250,753,650,103,753,98900,2013
38067,47.1,7327,6855,5,194,2137,49846,3328,2566,762,3328,72200,2013
38069,48.5,4399,4097,5,64,1210,42975,1983,1433,550,1983,83100,2013
38071,42.2,11473,9931,78,183,2766,48604,4826,3120,1706,4826,89600,2013
38073,44.5,5472,5279,26,72,1399,49788,2283,1590,693,2283,87400,2013
38075,44.7,2512,2449,6,3,728,60847,1041,821,220,1041,95200,2013
38077,39.3,16258,15201,63,322,4267,53759,6614,4800,1814,6614,101800,2013
38079,30.5,14176,2857,47,84,3450,31336,4750,3333,1417,4750,63400,2013
38081,45.6,3859,3706,21,72,1143,53381,1741,1346,395,1741,72500,2013
38083,53.6,1313,1268,4,3,435,43250,614,531,83,614,58300,2013
38085,26.7,4258,556,1,108,813,36111,1116,498,618,1116,70700,2013
38087,48.9,738,733,0,5,216,61667,296,257,39,296,61100,2013
38089,37.2,25666,23833,214,687,6539,62559,10439,7587,2852,10439,166200,2013
38091,46.9,1976,1921,0,55,595,55735,890,668,222,890,73700,2013
38093,41.8,21046,19856,133,377,5465,50120,8873,6197,2676,8873,98600,2013
38095,46.9,2285,2181,13,9,668,55521,1034,834,200,1034,60600,2013
38097,42.1,8125,7673,43,219,1964,48767,3306,2445,861,3306,94400,2013
38099,45.6,11102,9689,19,1061,3112,48592,4948,3774,1174,4948,68100,2013
38101,31.9,64008,56059,1726,2381,15832,56580,25173,16032,9141,25173,155800,2013
38103,51.4,4220,4127,0,6,1310,44132,1949,1494,455,1949,65700,2013
38105,35.6,25024,22357,178,736,6487,76210,10411,7226,3185,10411,151400,2013
39001,40.4,28406,27540,86,246,7729,35678,10816,7914,2902,10816,92900,2013
39003,38.1,105895,86886,12092,2635,27143,42823,40552,27815,12737,40552,105000,2013
39005,39.9,53234,51344,385,551,14282,46548,20207,15090,5117,20207,122100,2013
39007,41.4,100835,91277,3313,3544,25673,40516,38952,28230,10722,38952,110800,2013
39009,26.8,64811,58682,1532,1087,12206,33823,22181,12561,9620,22181,115500,2013
39011,40.2,45906,44429,151,577,12689,52239,18241,13616,4625,18241,129400,2013
39013,43.5,69990,65425,2499,498,18356,41534,28329,21143,7186,28329,88500,2013
39015,40.3,44604,43167,408,303,11943,44341,16380,12708,3672,16380,116300,2013
39017,36.2,369650,309744,27270,15046,94581,56610,134612,94831,39781,134612,157400,2013
39019,43.7,28689,27856,186,268,7856,43779,11107,8753,2354,11107,110400,2013
39021,40.3,39855,37477,811,488,10862,49157,15014,11158,3856,15014,124600,2013
39023,41,137763,117258,11913,3893,35850,43136,54963,36820,18143,54963,106400,2013
39025,39,198417,187776,2590,3131,53000,60365,73728,55465,18263,73728,154500,2013
39027,39,42013,39310,1080,613,11342,46048,15969,10671,5298,15969,118600,2013
39029,42.6,107078,101372,2257,1414,28546,42300,42095,30560,11535,42095,96000,2013
39031,41.3,36862,35489,431,306,10144,41274,14495,10717,3778,14495,93300,2013
39033,42.4,43348,41699,340,550,11839,40783,17655,12349,5306,17655,87300,2013
39035,40.4,1272533,777401,372459,62778,309945,43804,534476,325389,209087,534476,125700,2013
39037,40.7,52666,50994,316,675,14158,43425,20776,15450,5326,20776,110600,2013
39039,39.2,38911,34045,634,3545,10900,47593,15203,11524,3679,15203,106100,2013
39041,37.5,178139,156512,6288,3945,49144,89757,64208,52814,11394,64208,246300,2013
39043,43.6,76634,64959,6127,2712,20995,46498,31972,22063,9909,31972,135200,2013
39045,38.7,147110,130585,8664,2652,39235,58786,54309,39540,14769,54309,163700,2013
39047,40.4,28902,27027,519,522,7619,37619,11514,7188,4326,11514,107000,2013
39049,33.6,1181824,790367,247399,57223,273033,50877,468295,258092,210203,468295,150800,2013
39051,39.6,42601,38356,172,3393,12049,52856,16285,13041,3244,16285,128900,2013
39053,40.1,30859,29016,785,316,8249,39226,11576,8829,2747,11576,95500,2013
39055,43.5,93610,89890,1021,1078,25748,67663,34621,29968,4653,34621,224700,2013
39057,37.5,162588,138104,11721,3774,41855,58080,62836,42601,20235,62836,158000,2013
39059,41.3,39935,38053,721,370,10736,38841,15690,11564,4126,15690,94000,2013
39061,37.2,802481,540615,204511,21239,195106,48593,327914,195255,132659,327914,144400,2013
39063,38.4,75239,68168,1093,3540,20125,49589,30610,21634,8976,30610,127800,2013
39065,35.1,31886,30507,281,440,7757,40415,11504,8066,3438,11504,95600,2013
39067,44.9,15766,15040,393,101,4402,39002,6395,4907,1488,6395,83500,2013
39069,39.8,28164,25703,73,1927,7658,49439,11006,8738,2268,11006,114000,2013
39071,39.6,43395,41637,439,329,11682,39091,16918,11996,4922,16918,101800,2013
39073,41.9,29268,28364,233,215,7964,42089,11478,8747,2731,11478,109800,2013
39075,29.9,42841,42030,170,366,9945,45477,12467,9480,2987,12467,151400,2013
39077,38,59390,54247,499,3396,15795,49404,22361,16293,6068,22361,118800,2013
39079,39.4,33034,31809,181,298,8881,36356,13288,8934,4354,13288,89600,2013
39081,44.1,68928,62648,3865,815,18655,40577,28326,20690,7636,28326,86400,2013
39083,39.3,60925,58382,450,789,15695,49750,22583,16135,6448,22583,133500,2013
39085,42.7,229850,207932,7936,8144,61436,56018,94048,70497,23551,94048,151300,2013
39087,40.6,62309,59256,1061,483,16480,41552,24009,17597,6412,24009,97200,2013
39089,39.4,167065,154016,5317,2482,45087,55114,64009,46665,17344,64009,149500,2013
39091,40,45678,43109,725,565,12572,47542,18143,13438,4705,18143,118600,2013
39093,40.4,301720,241384,23915,25890,80346,51816,116705,83523,33182,116705,140700,2013
39095,37.4,439511,310760,82005,27534,107863,41556,178101,110797,67304,178101,108700,2013
39097,39.6,43221,38803,2717,643,10233,54956,14611,10426,4185,14611,144100,2013
39099,43.1,237033,183330,36079,11482,61683,41058,98201,68533,29668,98201,95800,2013
39101,40.2,66323,59373,3437,1523,16891,42572,24578,16988,7590,24578,98600,2013
39103,40.9,173252,163768,2310,2964,48306,65951,65499,52107,13392,65499,181000,2013
39105,41.8,23659,22978,272,118,6573,35469,9560,7596,1964,9560,82600,2013
39107,39.5,40811,39408,182,635,11452,52535,15851,12541,3310,15851,124200,2013
39109,40.9,102867,96155,2314,1416,28104,52040,41239,29362,11877,41239,133700,2013
39111,45.1,14646,14313,60,88,4258,40573,6111,4830,1281,6111,89100,2013
39113,39.1,536433,388833,110425,12730,134907,43401,222578,138081,84497,222578,112800,2013
39115,43.6,15008,13931,533,103,4453,37865,6204,4794,1410,6204,89000,2013
39117,40.6,34932,33791,184,412,9753,51484,12940,10634,2306,12940,127400,2013
39119,39.8,85872,79267,2741,698,22973,40524,33976,23202,10774,33976,108500,2013
39121,44.4,14639,13399,918,144,3436,38290,4883,3919,964,4883,77300,2013
39123,46.7,41372,38511,360,1853,12200,53202,17614,14184,3430,17614,136000,2013
39125,40.6,19441,18149,124,846,5432,44861,7730,6040,1690,7730,92300,2013
39127,38.8,36051,35125,63,219,10030,41446,13793,9721,4072,13793,93100,2013
39129,38.6,55949,52330,1852,650,14217,54003,19167,14303,4864,19167,149200,2013
39131,40.1,28587,27460,204,218,7586,42165,10859,7803,3056,10859,96200,2013
39133,36.9,163387,148538,6263,2308,40312,52697,60992,41607,19385,60992,150300,2013
39135,41.1,42050,40833,212,267,11644,48405,16238,12625,3613,16238,116700,2013
39137,39.4,34339,32036,125,1922,9630,61192,13022,10953,2069,13022,133500,2013
39139,41.2,123387,106724,10646,1840,31166,41835,48458,33518,14940,48458,103500,2013
39141,39.9,77802,70011,3475,807,19193,43264,28308,20533,7775,28308,111100,2013
39143,41.1,60619,52117,1667,5505,16440,46140,23906,18110,5796,23906,110400,2013
39145,39,78952,73964,2063,913,19186,35379,29452,20484,8968,29452,88200,2013
39147,39.2,56376,51323,1421,2561,15110,43764,21651,15672,5979,21651,97900,2013
39149,38.4,49317,46258,1028,687,13253,50427,18311,13651,4660,18311,123400,2013
39151,41.5,375348,328579,26915,6295,99208,45641,150003,104991,45012,150003,122400,2013
39153,40.4,541592,429361,76909,9194,138430,49669,220375,149549,70826,220375,135600,2013
39155,43.1,208792,183784,17076,2984,55634,42880,86246,62359,23887,86246,97400,2013
39157,40.8,92528,88480,813,1862,25091,43739,36149,26370,9779,36149,108700,2013
39159,37.1,52683,48425,1133,691,13380,65086,18216,13805,4411,18216,171800,2013
39161,41.1,28685,27250,349,754,7933,45355,11442,9039,2403,11442,88600,2013
39163,39.8,13365,13002,0,1,3674,36705,5191,3964,1227,5191,75700,2013
39165,37.9,215274,190730,7085,5021,58384,72487,76546,59662,16884,76546,188500,2013
39167,43,61600,58978,477,517,16431,42834,25029,18843,6186,25029,108600,2013
39169,38.7,114750,108586,1791,1814,30045,49135,42487,31103,11384,42487,135300,2013
39171,41.5,37623,35216,403,1440,10160,43089,14947,11250,3697,14947,98600,2013
39173,35.1,127325,114128,3106,6050,31329,52069,49086,33171,15915,49086,149500,2013
39175,41.4,22582,21645,85,533,6138,44448,9284,6613,2671,9284,103500,2013
40001,36.7,22427,9453,80,1249,5972,32556,8046,5696,2350,8046,75300,2013
40003,45.7,5674,4637,114,258,1300,44811,2031,1566,465,2031,62600,2013
40005,39.4,14070,10191,559,446,3801,37012,5303,3982,1321,5303,79800,2013
40007,41.1,5605,4239,43,1164,1541,51422,2108,1555,553,2108,86200,2013
40009,35,22715,17678,812,2852,5273,48989,7755,4726,3029,7755,103400,2013
40011,40.4,10198,7418,562,1234,2520,44206,3815,2766,1049,3815,68000,2013
40013,37.1,43079,31624,707,2212,10691,38897,16575,10490,6085,16575,88900,2013
40015,37.8,29605,17455,817,3125,7120,39267,10230,7242,2988,10230,74900,2013
40017,35.7,119546,94599,2684,8589,31211,63629,41876,32355,9521,41876,139200,2013
40019,38.2,47904,34521,3305,2755,11573,41401,17411,12013,5398,17411,90600,2013
40021,34.6,47488,23699,547,3035,11120,37260,16875,11224,5651,16875,103900,2013
40023,40.7,15167,9574,1553,479,3910,30201,6043,4446,1597,6043,71600,2013
40025,44.8,2432,1869,10,494,720,38301,1067,766,301,1067,64700,2013
40027,32.7,261047,195743,11061,19096,64188,54989,96701,65166,31535,96701,141300,2013
40029,40.9,5927,4272,23,182,1554,34867,2328,1698,630,2328,68400,2013
40031,31.5,124591,72884,20705,14638,29349,46036,44251,25044,19207,44251,111700,2013
40033,40.2,6166,4831,89,383,1633,46317,2345,1744,601,2345,74600,2013
40035,42.4,14869,9717,465,408,3790,39236,5603,4415,1188,5603,86800,2013
40037,40.2,70246,54717,1646,2370,18902,43026,26296,19670,6626,26296,105800,2013
40039,30.6,28092,20288,831,4185,6939,44972,10562,6632,3930,10562,110600,2013
40041,45.2,41394,27151,108,1278,11582,36588,16589,12902,3687,16589,105200,2013
40043,42.3,4800,4069,16,261,1256,46488,1830,1396,434,1830,77400,2013
40045,44.6,4120,3683,9,279,1198,47344,1734,1348,386,1734,75900,2013
40047,37,60956,48459,1690,5750,15892,44530,23508,15716,7792,23508,89400,2013
40049,39.8,27410,21481,617,1814,7072,38245,10294,7561,2733,10294,83800,2013
40051,38.2,52855,43922,1028,2555,14818,49637,19762,15078,4684,19762,108400,2013
40053,45.3,4522,4101,25,167,1298,46625,1951,1479,472,1951,62800,2013
40055,40.7,6178,4777,428,635,1412,39900,2246,1504,742,2246,63000,2013
40057,40.9,2894,1800,186,752,777,26688,1106,719,387,1106,43400,2013
40059,40,3710,2944,1,679,1030,46117,1492,1201,291,1492,68500,2013
40061,39.7,12849,9358,101,454,3149,35334,4713,3498,1215,4713,78000,2013
40063,40,13838,9167,746,551,3358,34619,4920,3784,1136,4920,66200,2013
40065,34,26280,17154,1785,5637,7027,42824,10455,6459,3996,10455,87400,2013
40067,41.9,6457,5155,32,560,1737,34701,2456,1846,610,2456,59500,2013
40069,39.8,10982,7838,164,450,2852,36192,4248,3050,1198,4248,77200,2013
40071,39,46122,35488,791,3113,11955,41012,18357,12837,5520,18357,75700,2013
40073,38.6,15069,11963,81,2075,4147,54666,5733,4425,1308,5733,115000,2013
40075,42.3,9389,7176,364,885,2535,36281,3886,2643,1243,3886,56600,2013
40077,39.5,11034,7573,100,327,2975,40970,4160,2881,1279,4160,71200,2013
40079,39.3,50062,36489,1091,3409,12664,36542,18412,13650,4762,18412,80100,2013
40081,40.6,34238,28836,615,892,9430,42668,13256,10157,3099,13256,92600,2013
40083,37,42871,33556,3875,2276,10837,53591,14927,11730,3197,14927,135700,2013
40085,39.8,9496,7108,188,1216,2561,43260,3378,2561,817,3378,80500,2013
40087,38.3,35155,28302,315,2524,9698,54426,12749,10430,2319,12749,139300,2013
40089,38.8,33143,21599,2897,1620,9237,31790,13078,8900,4178,13078,71500,2013
40091,46.8,20358,14069,694,441,5518,36096,8092,6460,1632,8092,79600,2013
40093,43,7604,6617,15,612,2147,49905,3084,2332,752,3084,85300,2013
40095,43.6,15860,10911,237,2331,3879,37319,5970,4737,1233,5970,83700,2013
40097,39.4,41110,27330,139,1195,11336,42751,15896,11960,3936,15896,96200,2013
40099,41,13571,10204,178,691,3553,44151,5121,3754,1367,5121,82200,2013
40101,37.7,70657,40984,7766,3802,17882,38502,26802,18070,8732,26802,92200,2013
40103,40.5,11529,9554,221,322,3369,44842,4565,3322,1243,4565,85200,2013
40105,41.9,10580,7163,189,274,2883,39430,4050,3287,763,4050,74300,2013
40107,40.3,12268,7692,947,424,3012,35170,4246,3126,1120,4246,69300,2013
40109,34.2,732118,431326,108111,112705,176868,45215,285320,171023,114297,285320,126500,2013
40111,39,39747,25506,3443,1366,10018,39156,15124,10543,4581,15124,77100,2013
40113,41.6,47800,30821,5333,1447,13203,44195,18512,14617,3895,18512,93900,2013
40115,38.7,32029,21466,232,1537,8376,36473,12134,8832,3302,12134,81000,2013
40117,41.7,16592,13109,159,388,4443,44375,6341,4854,1487,6341,83500,2013
40119,27,77897,61535,2684,3131,16569,36812,30010,15281,14729,30010,130800,2013
40121,41.2,45417,32403,1528,1892,12135,41252,18456,13296,5160,18456,86800,2013
40123,35.3,37700,25926,949,1586,9695,41881,14793,9857,4936,14793,99100,2013
40125,37.4,70144,52031,1784,3073,18095,42764,25658,18445,7213,25658,96400,2013
40127,44.5,11406,8381,115,316,2993,29897,4900,3629,1271,4900,71000,2013
40129,41.6,3713,3208,3,194,911,53885,1305,1028,277,1305,81300,2013
40131,38.6,87730,64456,785,3396,24966,58525,32693,25792,6901,32693,143600,2013
40133,39.3,25443,16951,1228,1011,6515,33819,9327,6893,2434,9327,70500,2013
40135,39,41834,27200,787,1486,11324,35742,15624,11178,4446,15624,85800,2013
40137,40.1,44929,36870,962,2881,11921,43885,17690,12526,5164,17690,89300,2013
40139,31.3,21157,10667,269,9233,5271,49901,7180,4637,2543,7180,89000,2013
40141,40.4,7898,5027,571,1841,2055,36354,3013,2214,799,3013,52800,2013
40143,35.3,609610,395223,62041,68260,153790,48181,241915,147424,94491,241915,134100,2013
40145,38,74077,54261,2530,3676,20663,55723,27016,22275,4741,27016,138400,2013
40147,40.5,51329,38564,1293,2677,14183,48687,21332,15545,5787,21332,111000,2013
40149,39.3,11631,9900,104,989,3368,46686,4630,3273,1357,4630,76500,2013
40151,34.8,8849,7525,327,451,1948,51619,3439,2278,1161,3439,80700,2013
40153,36.4,20483,16897,227,2198,4975,51867,7382,5297,2085,7382,104300,2013
41001,47.9,16055,14826,45,569,4603,41500,7120,4768,2352,7120,147700,2013
41003,32.3,85989,71478,866,5688,18698,48604,33384,19346,14038,33384,270500,2013
41005,40.9,380532,320108,2667,30012,101963,64352,146527,100826,45701,146527,300600,2013
41007,43.7,37157,32313,232,2889,9878,44683,15749,9870,5879,15749,256500,2013
41009,42,49333,44372,112,2119,13725,54968,19069,14084,4985,19069,213200,2013
41011,47.6,62753,54306,203,3526,15899,37940,26072,17238,8834,26072,177000,2013
41013,46.8,20894,18611,30,1512,6041,38795,8880,6260,2620,8880,173000,2013
41015,53.8,22361,19707,28,1307,6164,39516,10355,7022,3333,10355,230100,2013
41017,40.8,160565,141616,521,12082,43353,50209,64568,42301,22267,64568,249500,2013
41019,46.4,107286,95744,281,5184,29217,40524,43846,30163,13683,43846,171300,2013
41021,49.4,1915,1702,10,157,532,44743,883,559,324,883,116400,2013
41023,50.5,7359,6829,24,229,2126,35051,3319,2335,984,3319,136400,2013
41025,46.1,7314,6509,34,314,2158,38113,3113,2020,1093,3113,112300,2013
41027,37.6,22427,14714,109,6687,5453,56725,8144,5383,2761,8144,321700,2013
41029,42.5,205117,170611,1280,22749,53998,44005,83140,51747,31393,83140,225100,2013
41031,40.2,21461,13099,136,4223,5506,43373,7882,5156,2726,7882,165900,2013
41033,47.5,82783,73112,280,5402,22009,37733,34390,22777,11613,34390,220900,2013
41035,42,66211,53278,453,7216,18313,39627,27378,18017,9361,27378,155000,2013
41037,48.3,7862,6802,38,574,2148,33611,3566,2361,1205,3566,144100,2013
41039,39,353382,297374,3093,26959,86248,42931,144912,86324,58588,144912,218900,2013
41041,49.8,46070,38628,145,3736,13045,42365,20913,13694,7219,20913,237200,2013
41043,39.1,117648,102068,533,9371,30845,46939,44722,29852,14870,44722,173600,2013
41045,36.6,30898,19460,266,9904,6879,35578,10136,6248,3888,10136,132600,2013
41047,35.3,318441,216030,2894,78446,78306,46885,113285,68266,45019,113285,192200,2013
41049,36.9,11218,7143,19,3622,2811,49940,3741,2737,1004,3741,119800,2013
41051,36.1,747641,538073,40811,81535,166106,52511,305939,165713,140226,305939,271600,2013
41053,37.5,75930,60896,316,9412,19535,52808,28239,18456,9783,28239,217400,2013
41055,48.6,1865,1683,2,84,484,42639,827,537,290,827,135400,2013
41057,48.2,25300,21812,114,2349,6575,43676,10236,7150,3086,10236,226500,2013
41059,35.7,76306,52601,454,18548,18424,48389,26744,17051,9693,26744,142700,2013
41061,39.9,25741,23239,140,1061,6763,42542,10235,6491,3744,10235,156600,2013
41063,51.5,6924,6524,30,169,1847,41994,2996,2214,782,2996,199900,2013
41065,41.4,25281,19454,98,3937,6484,43765,9612,6234,3378,9612,181600,2013
41067,35.6,539608,373709,9135,85405,135468,64180,201771,122999,78772,201771,282400,2013
41069,55.5,1292,1218,0,34,410,37974,625,450,175,625,123700,2013
41071,37.7,99802,78765,824,14890,24954,54535,34138,23494,10644,34138,224900,2013
42001,41.9,101496,91583,1489,6301,27482,59492,38141,29258,8883,38141,198200,2013
42003,41.1,1226933,985235,158178,20358,304369,51366,526004,344618,181386,526004,122400,2013
42005,44.9,68614,66936,656,411,19424,45241,28525,21828,6697,28525,94100,2013
42007,44.5,170382,153762,9997,2142,46783,49217,70867,52018,18849,70867,115400,2013
42009,44.4,49490,48203,267,482,14168,43290,20198,16126,4072,20198,120200,2013
42011,39.5,412078,313498,16409,70021,105671,55170,153897,110864,43033,153897,170600,2013
42013,42.4,126940,121156,2276,1292,33328,42992,51433,37232,14201,51433,106500,2013
42015,43.5,62624,60428,347,800,16738,46963,24213,18142,6071,24213,119900,2013
42017,42.2,625977,540699,22157,27837,165708,76555,230366,179645,50721,230366,309900,2013
42019,42,184535,176508,1992,2108,50064,58230,73213,56253,16960,73213,169700,2013
42021,43.9,142448,132597,4891,2130,37228,41730,58208,43014,15194,58208,87100,2013
42023,48.4,5000,4879,38,28,1340,41410,2144,1533,611,2144,69500,2013
42025,44.5,65074,60776,854,2308,17872,48900,25903,20439,5464,25903,146700,2013
42027,29.3,154460,135260,4624,3918,32597,50336,57197,34070,23127,57197,192600,2013
42029,39.7,503075,410898,29411,33473,130385,86050,184788,139815,44973,184788,325200,2013
42031,39.9,39720,38433,487,259,10090,42389,15776,11183,4593,15776,106200,2013
42033,43,81536,76626,1731,2024,21512,41030,32192,24723,7469,32192,85100,2013
42035,38.2,39501,37759,533,471,9698,42184,15067,10803,4264,15067,110900,2013
42037,39.8,67021,63072,1267,1482,16717,44807,26225,18263,7962,26225,135000,2013
42039,42,88173,84215,1432,906,23012,42504,34831,25670,9161,34831,102700,2013
42041,40.5,237449,210819,7431,6984,61683,60826,95286,67794,27492,95286,184500,2013
42043,39.3,269035,186941,45905,19750,67882,54066,108831,70079,38752,108831,158800,2013
42045,38.8,559771,394256,110949,17412,137038,64041,204771,144471,60300,204771,234100,2013
42047,45.6,31799,31106,162,200,8923,45767,13478,10821,2657,13478,92100,2013
42049,38.6,280518,242036,19101,9868,69788,45202,109675,73979,35696,109675,115100,2013
42051,43.6,136145,126222,5631,1181,35194,39115,54363,39560,14803,54363,84200,2013
42053,41.5,7696,5777,1369,430,1189,36556,2001,1662,339,2001,83600,2013
42055,40.5,150594,135287,4988,6780,39765,52637,58273,42567,15706,58273,177500,2013
42057,42.5,14779,14295,179,138,4230,48461,5965,4615,1350,5965,159300,2013
42059,41.5,38362,35242,1971,482,9520,44388,14417,10526,3891,14417,89400,2013
42061,41.9,45874,42019,2399,759,11722,44183,17193,13157,4036,17193,115000,2013
42063,38.7,88404,83274,2168,1055,21857,43997,34310,24549,9761,34310,103000,2013
42065,43.1,45015,43978,156,306,12282,41262,18503,13777,4726,18503,86800,2013
42067,41.7,24737,23631,180,656,6580,46163,9248,7070,2178,9248,138200,2013
42069,42.1,214275,191112,5185,11296,54388,46044,85769,57278,28491,85769,144100,2013
42071,38.2,523306,441413,17002,47079,136782,56483,194082,134847,59235,194082,188200,2013
42073,44,90374,83874,3531,980,24769,43546,36823,27711,9112,36823,96700,2013
42075,41,134411,115626,2078,13296,36337,54818,52023,37439,14584,52023,164300,2013
42077,39.4,352068,248018,17482,68947,89929,54923,133289,89966,43323,133289,196600,2013
42079,42.8,320827,280093,10196,23829,83178,44402,130880,88744,42136,130880,121000,2013
42081,41.2,116604,106840,5466,1711,29847,45430,46046,32229,13817,46046,131000,2013
42083,42.2,43294,40769,1065,807,11462,41834,17450,12773,4677,17450,72700,2013
42085,43.1,116059,105429,6679,1328,30551,44301,46187,34399,11788,46187,104600,2013
42087,42.9,46698,45179,319,558,12606,40384,18711,13766,4945,18711,95700,2013
42089,40.6,168947,117741,20542,22919,43483,57408,58875,47129,11746,58875,191800,2013
42091,40.8,804621,631549,69229,35284,208752,79183,307488,225139,82349,307488,292600,2013
42093,43.8,18379,17164,291,364,4786,51482,7233,5339,1894,7233,153200,2013
42095,41.2,298439,239474,13174,32700,77529,60097,112189,82042,30147,112189,212100,2013
42097,43.4,94444,88720,2129,2422,25777,41208,39348,28040,11308,39348,98200,2013
42099,41.4,45808,44161,328,645,13061,57375,18173,14442,3731,18173,158400,2013
42101,33.6,1536704,562222,645702,194714,308924,37192,580017,308931,271086,580017,142500,2013
42103,44.8,57179,47209,2875,5320,15528,59340,21581,18174,3407,21581,193100,2013
42105,45,17487,16988,63,188,4800,41547,7077,5436,1641,7077,96500,2013
42107,43.3,147700,137193,3705,4432,39176,45012,59658,44787,14871,59658,93500,2013
42109,39.3,39711,38058,383,714,10421,46513,14397,11037,3360,14397,133700,2013
42111,44.7,77341,73744,1757,886,20615,43597,29791,23498,6293,29791,98400,2013
42113,50.5,6419,6181,96,92,1528,40964,2402,1996,406,2402,137000,2013
42115,45.5,42948,41628,225,621,11782,48231,17163,13425,3738,17163,139000,2013
42117,42.4,42267,40772,336,499,11753,44187,17058,12680,4378,17058,116000,2013
42119,38.5,44932,38155,2988,2429,10255,48528,15062,11034,4028,15062,154300,2013
42121,44.7,54590,52558,399,526,15124,41977,22547,16818,5729,22547,81000,2013
42123,45.5,41429,40377,181,337,11223,43764,17257,13280,3977,17257,88700,2013
42125,43.7,208047,194112,6403,2574,55569,53693,84098,63973,20125,84098,143600,2013
42127,46,52212,47879,1645,1908,13399,49313,19558,15581,3977,19558,179900,2013
42129,45.4,364090,344449,8347,3457,101612,50736,152109,116000,36109,152109,133600,2013
42131,42.4,28177,27091,193,466,7487,48482,10992,8529,2463,10992,155100,2013
42133,40.3,436339,374402,21603,25621,117774,58745,167592,125926,41666,167592,174200,2013
44001,43.3,49426,46437,227,1050,12912,71238,19174,13877,5297,19174,341000,2013
44003,43,165628,150759,2310,5809,43043,62279,68880,49157,19723,68880,220200,2013
44005,43.7,82545,72067,2807,3807,21413,71713,34774,21773,13001,34774,355800,2013
44007,37.1,627469,410712,48154,121381,146971,49297,237800,129163,108637,237800,224100,2013
44009,42.3,126627,116541,1767,3270,32740,72138,49430,36844,12586,49430,321900,2013
45001,42.8,25233,17421,7308,144,6621,35947,9809,7491,2318,9809,91200,2013
45003,40.3,161710,109367,40074,8065,42977,44509,63388,46481,16907,63388,124600,2013
45005,38.5,10214,2392,7552,255,2257,25252,3424,2173,1251,3424,65400,2013
45007,40.1,188480,147662,30540,5782,51641,41579,73296,53412,19884,73296,123400,2013
45009,39.4,15814,5637,9876,164,3727,31483,5883,4464,1419,5883,74700,2013
45011,38.9,22399,11591,10075,456,5745,35231,8416,6281,2135,8416,72400,2013
45013,41.5,165354,109937,31090,19464,44768,57316,64417,46019,18398,64417,275500,2013
45015,34.8,184366,117905,45452,11039,46590,52427,65392,45944,19448,65392,150400,2013
45017,44,15109,8030,6320,468,4386,40704,6163,4939,1224,6163,100600,2013
45019,36,358736,224274,104408,18755,83901,50792,143717,87119,56598,143717,236100,2013
45021,38.4,55587,41007,11094,2109,14189,34202,20762,13897,6865,20762,83600,2013
45023,40.6,32879,19432,12209,507,8511,33103,12368,9356,3012,12368,82500,2013
45025,39.9,46452,28627,15259,1702,12032,31252,17622,12292,5330,17622,79400,2013
45027,42.2,34652,16127,17075,952,8782,31410,12690,9250,3440,12690,85900,2013
45029,41.2,38453,21503,15412,1086,10418,33233,14905,11085,3820,14905,89900,2013
45031,39.8,68346,37863,27886,1188,18520,36323,26609,18553,8056,26609,87200,2013
45033,37.4,31661,14895,14744,807,8129,28817,11744,7476,4268,11744,64400,2013
45035,35.7,139802,91403,35321,6367,36874,53857,50321,35573,14748,50321,167400,2013
45037,41.5,26698,15008,9853,1439,6478,43861,9108,7122,1986,9108,109500,2013
45039,43.1,23589,8952,13920,407,6247,36120,9408,6923,2485,9408,91900,2013
45041,37.5,137393,73944,56530,3177,35462,41910,51332,33764,17568,51332,114900,2013
45043,46.1,60280,37572,20209,1848,15966,40131,23115,17991,5124,23115,158800,2013
45045,37.5,459857,321899,82523,38119,117709,49022,175149,117402,57747,175149,153600,2013
45047,38.3,69727,42580,21348,3870,18085,36540,27004,17816,9188,27004,104900,2013
45049,39.3,20840,8627,11163,764,5277,34233,7470,5670,1800,7470,79400,2013
45051,42,276688,213798,37145,16866,74228,42431,113490,78911,34579,113490,159600,2013
45053,35.9,25408,9673,11583,3704,5716,36413,8563,6081,2482,8563,90200,2013
45055,40.9,61918,42945,15410,2414,17478,43765,24084,18337,5747,24084,116000,2013
45057,40.5,77946,54500,18258,3593,20508,42217,28956,21723,7233,28956,142200,2013
45059,40.1,66457,45719,16516,2758,18090,37383,25184,18055,7129,25184,81800,2013
45061,39.3,18890,6173,11810,370,4372,27373,6737,4933,1804,6737,65000,2013
45063,37.9,266575,204373,38077,14867,70942,54061,103742,77108,26634,103742,140100,2013
45065,50.4,10091,4876,4950,97,2893,40028,4069,3225,844,4069,112500,2013
45067,39.3,32695,13011,18224,871,8440,29149,12049,8080,3969,12049,77800,2013
45069,39.2,28542,11446,14365,827,6445,28297,9779,6461,3318,9779,58200,2013
45071,40.6,37514,22681,11069,2727,9996,41718,14254,10190,4064,14254,107400,2013
45073,43.4,74419,63805,5559,3406,21011,41394,30106,22631,7475,30106,136300,2013
45075,38.2,91836,31009,57008,1793,22605,34110,34180,23320,10860,34180,84700,2013
45077,34.9,119483,103904,7643,3840,28721,41788,43971,30482,13489,43971,123900,2013
45079,32.6,389708,175103,177588,18931,87554,48359,143874,87353,56521,143874,149800,2013
45081,40.9,19895,11588,5212,2888,4921,38514,7020,5109,1911,7020,90400,2013
45083,38.2,286789,199962,58089,17218,75250,42919,107350,74718,32632,107350,121300,2013
45085,35.4,107645,50491,49704,3698,27143,41366,39373,25734,13639,39373,107300,2013
45087,42.7,28594,18871,8734,299,7897,32556,11854,8668,3186,11854,74000,2013
45089,41.2,33944,10616,22346,706,7594,25849,11621,8632,2989,11621,67100,2013
45091,37.4,230934,167178,43351,10641,61755,53740,86483,61937,24546,86483,159300,2013
46003,42.9,2722,2530,14,108,740,46667,1102,888,214,1102,68800,2013
46005,39.1,17663,14892,93,1434,4414,42196,7343,4759,2584,7343,87500,2013
46007,28.4,3431,890,31,81,783,37607,1059,555,504,1059,54300,2013
46009,43.3,7048,6245,56,139,1657,40980,2501,1941,560,2501,69700,2013
46011,26,32295,29660,352,682,6954,46896,11979,6950,5029,11979,147400,2013
46013,38.9,36982,33937,365,621,9516,51398,15590,10943,4647,15590,133900,2013
46015,41.3,5286,4587,0,97,1486,45284,2094,1467,627,2094,92500,2013
46017,24.8,1966,338,10,27,427,30962,542,202,340,542,38800,2013
46019,40,10197,9401,19,329,2480,41332,4015,2890,1125,4015,111900,2013
46021,51,1435,1350,0,0,416,35729,679,536,143,679,52100,2013
46023,38.7,9176,5874,1,188,2054,40102,3191,2258,933,3191,74500,2013
46025,45.6,3635,3344,27,195,877,49055,1431,1129,302,1431,69000,2013
46027,25.3,13953,12501,181,311,2608,38173,5145,2873,2272,5145,133800,2013
46029,37.8,27439,25850,42,455,6875,47214,11566,8034,3532,11566,134800,2013
46031,29.8,4078,1233,6,130,863,30880,1185,627,558,1185,48900,2013
46033,51.1,8306,7633,16,208,2438,50074,3731,2986,745,3731,192000,2013
46035,38,19622,18284,85,355,5203,48341,8471,5294,3177,8471,123300,2013
46037,47.8,5669,4958,0,48,1598,39761,2511,1770,741,2511,76800,2013
46039,43.6,4362,4200,36,107,1218,51632,1789,1521,268,1789,93700,2013
46041,29.2,5419,1178,22,131,1151,30710,1687,981,706,1687,57500,2013
46043,48.4,3000,2870,0,21,876,49200,1258,988,270,1258,70900,2013
46045,47,4051,3955,0,38,1013,49831,1589,1242,347,1589,84000,2013
46047,51.6,7001,6083,38,140,1796,37667,3138,2106,1032,3138,89700,2013
46049,41.5,2370,2282,0,69,582,41453,930,731,199,930,65200,2013
46051,44.9,7307,6980,39,113,2165,48896,3159,2421,738,3159,100500,2013
46053,48,4247,3788,0,45,1233,36719,1986,1414,572,1986,58400,2013
46055,49.4,1944,1800,4,4,561,47198,807,626,181,807,74400,2013
46057,36.5,5925,5679,20,163,1450,55563,2041,1586,455,2041,108100,2013
46059,49.3,3433,3390,0,20,961,47679,1429,1050,379,1429,86400,2013
46061,35.4,3377,3180,77,31,766,55815,1037,866,171,1037,102700,2013
46063,39.4,1330,1256,4,16,370,44353,527,391,136,527,69400,2013
46065,40.4,17238,14433,162,377,4321,59338,6992,4715,2277,6992,160900,2013
46067,47.2,7239,6957,18,124,1953,42451,2937,2266,671,2937,71000,2013
46069,44.8,1387,1192,0,21,351,47813,549,419,130,549,68700,2013
46071,32,3116,1591,5,58,760,46224,1056,662,394,1056,52600,2013
46073,47.4,2055,1926,0,95,640,46591,882,641,241,882,69900,2013
46075,46.9,981,950,10,2,263,44808,438,329,109,438,67600,2013
46077,46.4,5142,4944,14,92,1584,51373,2311,1777,534,2311,82000,2013
46079,41.6,11564,10969,145,212,2932,48936,4655,3377,1278,4655,118500,2013
46081,41,24305,22362,73,700,6361,43273,10597,6862,3735,10597,167100,2013
46083,33.2,46693,44207,374,697,12857,74751,17250,13282,3968,17250,184900,2013
46085,36.3,3804,2200,0,11,943,47596,1423,934,489,1423,74200,2013
46087,42.7,5605,5392,18,128,1503,52703,2186,1751,435,2186,101100,2013
46089,50.1,2432,2282,1,52,691,37240,1045,781,264,1045,55800,2013
46091,42.5,4657,3914,2,314,1038,46597,1683,1229,454,1683,93200,2013
46093,35.8,25914,23129,337,906,7209,49324,10083,7283,2800,10083,157100,2013
46095,34.7,2072,810,0,56,513,35109,698,466,232,698,54100,2013
46097,45.6,2355,2259,2,27,633,48477,1053,807,246,1053,63000,2013
46099,34.7,173108,148215,6731,7503,43559,52345,67623,43534,24089,67623,149600,2013
46101,40.8,6460,5182,47,135,1929,51791,2686,1900,786,2686,101000,2013
46103,36.8,102752,83428,1161,4441,26352,50833,40723,26617,14106,40723,156100,2013
46105,49.8,2943,2843,1,47,800,38362,1364,971,393,1364,56700,2013
46107,51,2323,2254,0,0,662,44556,1051,856,195,1051,60000,2013
46109,39.4,10210,6171,37,160,2606,47191,3646,2544,1102,3646,83000,2013
46111,46.6,2348,2294,0,45,651,48384,1051,775,276,1051,68200,2013
46113,24.1,13829,517,20,150,2367,25648,2867,1506,1361,2867,19900,2013
46115,44.2,6522,6286,0,94,1667,48911,2624,1933,691,2624,64000,2013
46117,40.7,2966,2603,0,59,798,54620,1273,1002,271,1273,110900,2013
46119,46.9,1420,1337,0,23,397,54524,606,439,167,606,88200,2013
46121,23,9783,945,1,285,2023,31934,2680,1245,1435,2680,40200,2013
46123,44.8,5571,4599,1,35,1651,39324,2530,1738,792,2530,72200,2013
46125,44,8344,8035,39,138,2400,51925,3461,2717,744,3461,93200,2013
46127,39.9,14575,13643,106,378,3843,63468,5758,4330,1428,5758,150300,2013
46129,46.7,5477,4475,1,162,1465,41826,2342,1503,839,2342,73000,2013
46135,41.1,22518,20470,424,671,5508,52578,8698,6241,2457,8698,126700,2013
46137,26,2821,651,11,94,626,32708,803,415,388,803,70100,2013
47001,42.6,75263,68054,3012,1796,20235,43620,30548,20911,9637,30548,127000,2013
47003,36.9,45339,35553,2801,5164,12094,40759,16402,11480,4922,16402,114600,2013
47005,46.1,16398,15395,412,316,4540,33033,6892,5423,1469,6892,80100,2013
47007,42.9,12853,11875,510,275,3207,33443,4556,3636,920,4556,106100,2013
47009,41.8,123722,113635,3595,3542,33793,45991,48728,35704,13024,48728,163900,2013
47011,38.5,100070,88078,4315,4976,25858,41083,37603,25203,12400,37603,138900,2013
47013,42,40553,39227,220,499,10999,31943,15959,11046,4913,15959,91500,2013
47015,41.5,13790,13147,209,220,3888,40689,5383,4155,1228,5383,116400,2013
47017,42.3,28525,24368,2821,625,7339,35049,11022,8352,2670,11022,80500,2013
47019,42.8,57438,54839,768,918,16206,31842,24079,17411,6668,24079,101100,2013
47021,39.9,39213,36942,678,959,10683,52446,14421,11686,2735,14421,152900,2013
47023,36.9,17151,14799,1746,388,4328,41875,5936,4309,1627,5936,102300,2013
47025,41.2,31915,30611,281,286,8391,33229,12553,9409,3144,12553,94900,2013
47027,45.3,7816,7467,198,130,2398,29727,3281,2550,731,3281,96400,2013
47029,43.3,35596,33452,538,680,10221,30573,14917,10517,4400,14917,99700,2013
47031,39.4,53011,47605,1255,2026,14084,37618,21019,14253,6766,21019,116900,2013
47033,40.4,14576,11158,1932,1323,3939,36066,5619,3839,1780,5619,85700,2013
47035,48.8,56589,53979,238,1415,16243,37188,23764,18639,5125,23764,142200,2013
47037,34.1,638395,366031,175796,62213,142957,47335,256745,140374,116371,256745,167500,2013
47039,44.8,11695,10833,348,330,3473,36258,5066,3910,1156,5066,83100,2013
47041,40.5,18875,17050,319,1297,4938,37482,7037,5108,1929,7037,115100,2013
47043,39,49926,45078,2007,1537,13861,44318,18647,13715,4932,18647,138500,2013
47045,40.2,38239,30825,5092,1064,10894,38953,15100,9596,5504,15100,99500,2013
47047,42.7,38502,26199,10754,920,11063,56618,14535,11748,2787,14535,175100,2013
47049,43,17943,17468,38,202,4950,29192,7348,5621,1727,7348,93300,2013
47051,41.5,40985,36693,1807,1062,11423,42904,16067,12305,3762,16067,104800,2013
47053,39.9,49664,38554,9162,1081,13054,38343,19205,13963,5242,19205,87700,2013
47055,42.7,29214,24966,3111,491,8143,38495,11766,8557,3209,11766,100000,2013
47057,42.4,22653,21681,178,558,6186,32364,9003,7293,1710,9003,91400,2013
47059,43.2,68679,64359,1537,1775,19872,35545,28677,20857,7820,28677,110800,2013
47061,42.1,13657,11235,52,129,3591,26814,5359,4160,1199,5359,80100,2013
47063,39.3,62721,51926,2428,6753,16949,39596,24315,16914,7401,24315,125000,2013
47065,39.3,340973,245172,68055,15717,88096,46702,135496,87980,47516,135496,154200,2013
47067,44.2,6737,6579,25,13,1856,23892,2835,2118,717,2835,75900,2013
47069,39.7,26897,14880,10995,390,5953,30973,8690,6103,2587,8690,86300,2013
47071,43.5,26011,24029,950,504,6646,33622,9934,7742,2192,9934,98000,2013
47073,42.7,56759,54314,734,711,16557,37357,23348,17961,5387,23348,108900,2013
47075,40.5,18531,8340,9142,741,4522,34542,7099,4318,2781,7099,94500,2013
47077,39.9,27934,24602,2328,565,7824,38280,10930,8276,2654,10930,94400,2013
47079,44.5,32293,28396,2625,614,8966,36950,13473,9857,3616,13473,91300,2013
47081,40.2,24428,22322,1218,396,6320,39581,8846,6889,1957,8846,100400,2013
47083,42.3,8375,7823,191,154,2292,35271,3423,2398,1025,3423,87300,2013
47085,41.4,18392,17293,613,325,5044,42846,7396,5751,1645,7396,108000,2013
47087,45.1,11527,11108,44,181,3067,33386,4493,3591,902,4493,102900,2013
47089,41.1,51759,48004,1284,1692,13813,39745,19797,14758,5039,19797,121800,2013
47091,43.7,18158,16972,672,285,4849,29609,6921,5250,1671,6921,101200,2013
47093,37.2,436983,364988,39689,15640,109025,47694,181100,118150,62950,181100,157400,2013
47095,39.7,7773,5316,1966,296,1394,27115,2201,1220,981,2201,72700,2013
47097,36.4,27794,16953,9723,602,6695,32326,9686,6156,3530,9686,77600,2013
47099,40.2,41927,39691,736,729,11177,37368,15862,11955,3907,15862,97900,2013
47101,41.9,12049,11341,162,231,3223,34397,4750,3532,1218,4750,94400,2013
47103,42.1,33411,29380,2145,944,9379,41571,13438,10238,3200,13438,109400,2013
47105,45.8,49188,44129,525,3556,14577,51074,19543,15017,4526,19543,177600,2013
47107,41.5,52338,47324,2223,1526,14308,39410,20313,15181,5132,20313,119000,2013
47109,41.9,26066,23620,1452,434,6646,33452,9736,7155,2581,9736,86100,2013
47111,38.9,22416,20912,103,1016,6212,35306,8544,6246,2298,8544,97900,2013
47113,37,98261,56660,36002,3344,23701,41617,35713,23687,12026,35713,112700,2013
47115,42.7,28214,26204,488,388,7826,41268,11226,8285,2941,11226,118900,2013
47117,39.6,30818,26664,2112,1432,8261,42291,11578,8652,2926,11578,105900,2013
47119,38,81821,65460,9831,4073,21924,45336,32144,22607,9537,32144,136300,2013
47121,44.5,11706,11166,214,34,3411,35150,4776,3826,950,4776,101800,2013
47123,41.8,44857,41280,852,1553,12840,37595,17523,12903,4620,17523,115300,2013
47125,30.1,177640,118331,33025,15135,46197,49617,64026,39172,24854,64026,141800,2013
47127,44,6347,5927,195,14,1711,46170,2416,2021,395,2416,135200,2013
47129,40.6,21964,20549,801,216,5350,37631,7455,6006,1449,7455,90700,2013
47131,41.5,31566,26694,3355,1044,8754,39467,12462,8521,3941,12462,89100,2013
47133,41.6,22109,21415,145,234,6292,34604,8815,7041,1774,8815,91900,2013
47135,42.3,7861,7391,179,152,2080,32845,3187,2377,810,3187,86800,2013
47137,48.1,5095,5013,35,0,1933,35184,2388,1914,474,2388,96300,2013
47139,43.1,16723,16087,44,262,4769,39074,6740,5354,1386,6740,109300,2013
47141,36.1,72702,65226,1711,3945,18338,33709,28980,18293,10687,28980,135100,2013
47143,40,32080,29460,774,1244,8372,36741,12096,8498,3598,12096,104400,2013
47145,45.4,53765,50282,1468,777,14958,42223,22117,16456,5661,22117,120300,2013
47147,38.1,66623,56301,5035,3948,17697,52792,24136,18507,5629,24136,153100,2013
47149,32.6,269407,202385,35111,18364,67000,55401,96731,65419,31312,96731,159100,2013
47151,38.3,22154,21690,31,187,5426,28401,8206,6363,1843,8206,81500,2013
47153,40.9,14333,12744,33,475,4046,36434,5616,4139,1477,5616,119300,2013
47155,41.3,91295,83424,598,4879,26648,43649,36815,24577,12238,36815,159400,2013
47157,34.6,932919,356856,485579,53164,221657,46250,343517,203331,140186,343517,132700,2013
47159,40.7,19134,17911,349,458,5141,42383,7263,5343,1920,7263,113800,2013
47161,42.8,13313,12349,233,278,3766,39781,5292,4164,1128,5292,118900,2013
47163,44,156741,147614,2973,2436,44690,39479,66239,49109,17130,66239,121700,2013
47165,39.1,163724,141927,10945,6544,45698,55509,60835,44346,16489,60835,176600,2013
47167,37.1,61298,46923,11122,1371,16457,52423,21574,15960,5614,21574,139100,2013
47169,37.8,7843,6728,883,6,2003,43034,2899,2186,713,2899,115500,2013
47171,44.9,18254,17217,133,721,5031,32292,7601,5705,1896,7601,115900,2013
47173,40.6,19177,18581,16,257,5149,34399,7406,6049,1357,7406,95800,2013
47175,45.3,5562,5357,42,17,1491,33547,2097,1790,307,2097,77400,2013
47177,39.1,39861,34681,1077,3267,10341,34641,15366,10748,4618,15366,92400,2013
47179,39.6,123891,111556,4598,3732,33109,42075,51771,34209,17562,51771,145300,2013
47181,41.6,16996,15483,1003,279,4401,33198,6093,5035,1058,6093,74700,2013
47183,36.9,34779,30431,3130,723,9101,35273,13797,9053,4744,13797,88400,2013
47185,42,25986,24544,474,476,6755,34474,9729,7217,2512,9729,98000,2013
47187,38.5,188935,163099,8065,8571,52358,89779,66364,53979,12385,66364,334900,2013
47189,39.5,116948,101929,7709,3947,31656,60390,42800,33877,8923,42800,190100,2013
48001,38.7,58262,35430,12207,9500,11544,40653,16378,11524,4854,16378,82000,2013
48003,34.2,15554,7127,111,7881,3913,57825,5217,4077,1140,5217,88600,2013
48005,36.4,87042,54666,12917,17537,22468,41354,30668,20448,10220,30668,84800,2013
48007,49.3,23627,16466,289,5955,6718,42476,9834,7213,2621,9834,130900,2013
48009,42.8,8853,7930,49,706,2564,56452,3342,2695,647,3342,100300,2013
48011,44.1,1773,1498,26,212,520,61635,647,507,140,647,94100,2013
48013,35.6,45714,16348,295,28454,11835,47543,15095,11223,3872,15095,82900,2013
48015,40.3,28573,18538,2697,6947,7517,53265,10615,8077,2538,10615,150000,2013
48017,33.7,7121,2833,115,4131,1806,46139,2358,1538,820,2358,56500,2013
48019,49.7,20533,16534,120,3484,5660,49215,8405,6751,1654,8405,143600,2013
48021,38.3,74730,42345,5704,24804,18661,51750,25432,19892,5540,25432,117700,2013
48023,48.8,3678,3209,39,328,1013,33445,1798,1313,485,1798,72800,2013
48025,35.4,32281,10861,2799,18293,5868,43690,8539,5587,2952,8539,73000,2013
48027,29.9,316144,158078,64082,70425,75209,50060,104049,59037,45012,104049,122600,2013
48029,32.9,1753238,524906,121081,1031881,410792,50112,604698,360802,243896,604698,123700,2013
48031,47.3,10562,8254,69,2006,2800,49487,4036,3197,839,4036,162500,2013
48033,38.8,649,590,0,52,191,71607,225,150,75,225,100000,2013
48035,45.9,18094,14514,265,2956,5000,44742,7012,5389,1623,7012,90800,2013
48037,37.6,92851,61212,21837,6307,23119,42346,33808,22590,11218,33808,95100,2013
48039,35.3,319493,166966,39274,89904,80021,67603,107717,79652,28065,107717,148000,2013
48041,24.7,197642,115707,20631,46885,39207,38310,70239,32331,37908,70239,151400,2013
48043,41.7,9244,4946,94,3976,2264,40477,4152,2522,1630,4152,111000,2013
48045,46,1615,1068,33,452,441,36250,605,477,128,605,51600,2013
48047,32.1,7225,595,3,6557,1663,21865,2439,1690,749,2439,47300,2013
48049,39.6,37942,28161,1444,7617,9503,39776,13405,9557,3848,13405,87600,2013
48051,42.9,17201,11573,1947,3254,4453,45651,6258,4950,1308,6258,87800,2013
48053,43.8,43230,32719,909,8901,11995,48115,16588,12146,4442,16588,152600,2013
48055,35.6,38465,16779,2718,18386,7861,44152,11593,7716,3877,11593,104000,2013
48057,37.8,21503,9674,549,10115,5815,47027,7870,5586,2284,7870,98100,2013
48059,42.8,13535,11928,108,1122,3437,44902,5201,4268,933,5201,74300,2013
48061,30.8,410710,43054,1528,362277,94157,33179,117836,79188,38648,117836,78300,2013
48063,37.6,12415,7213,2271,2734,3269,37079,4475,3000,1475,4475,103100,2013
48065,41.1,6158,5379,71,557,1775,65026,2337,2088,249,2337,87700,2013
48067,43.5,30344,23356,5040,1149,7926,35598,11836,8483,3353,11836,77400,2013
48069,33.9,8046,2576,183,4878,1873,36402,2588,1777,811,2588,68500,2013
48071,36.1,35570,24839,2750,7010,9839,72489,12147,10065,2082,12147,144900,2013
48073,37.8,50865,31734,7501,10716,12823,38378,17422,12513,4909,17422,76300,2013
48075,34.3,7057,4551,664,1566,1627,47532,2374,1728,646,2374,62700,2013
48077,45.3,10651,9762,59,509,3013,53776,4216,3591,625,4216,81600,2013
48079,34.3,3068,1247,111,1664,759,38650,1039,825,214,1039,35500,2013
48081,48.9,3271,2551,38,646,935,40795,1436,1051,385,1436,70400,2013
48083,45.7,8744,6920,224,1453,2512,31373,3478,2363,1115,3478,60900,2013
48085,35.4,811308,505292,69004,120223,214515,82762,289752,197559,92193,289752,206100,2013
48087,39.2,3061,1887,129,947,761,41576,1174,922,252,1174,66400,2013
48089,43.3,20776,12323,2793,5550,5691,45146,8079,6248,1831,8079,109600,2013
48091,42.4,112083,79021,1983,28555,31217,65839,41954,31912,10042,41954,205000,2013
48093,44.1,13829,9975,41,3614,3443,36020,5162,3976,1186,5162,73700,2013
48095,41.5,4070,1850,20,2193,662,51411,857,678,179,857,76100,2013
48097,39.1,38484,29981,1000,6159,10366,50067,14466,10047,4419,14466,117100,2013
48099,30.2,75966,46492,11533,12565,15830,49819,20416,11696,8720,20416,97400,2013
48101,50.2,1546,1033,226,268,525,34639,709,513,196,709,41400,2013
48103,34.6,4484,1736,142,2545,1153,50417,1571,1191,380,1571,66800,2013
48105,38.5,3840,1416,0,2396,1047,50475,1375,951,424,1375,56200,2013
48107,37.4,6056,2567,214,3209,1606,38187,2164,1455,709,2164,55400,2013
48109,37.5,2345,471,14,1816,568,37105,838,531,307,838,46600,2013
48111,31.3,6854,3724,86,2828,1699,40895,2375,1457,918,2375,70700,2013
48113,32.7,2412481,785993,524707,928418,560243,49481,858332,451047,407285,858332,128300,2013
48115,33,13771,5307,878,7412,3093,39714,4414,3248,1166,4414,55700,2013
48117,31,19307,5719,158,13187,4561,41444,6191,4043,2148,6191,80200,2013
48119,44.2,5237,4304,415,328,1339,40375,1929,1602,327,1929,71600,2013
48121,33.4,687857,437438,56214,126857,172944,74155,243394,159433,83961,243394,184100,2013
48123,42.4,20269,11570,1817,6654,4654,46454,6948,5417,1531,6948,80700,2013
48125,44,2382,1605,103,648,602,38401,913,701,212,913,48400,2013
48127,36.4,10270,1408,52,8810,2472,36681,3542,2474,1068,3542,49900,2013
48129,41.7,3620,3041,187,338,874,42411,1280,982,298,1280,61100,2013
48131,37.3,11740,1213,58,10364,2699,34131,3901,2828,1073,3901,52700,2013
48133,42.7,18465,15018,287,2755,4371,34914,6872,5159,1713,6872,61200,2013
48135,30.9,141542,55868,5669,76718,35011,51466,49962,32822,17140,49962,91200,2013
48137,49,2070,969,6,1095,547,43839,838,768,70,838,70500,2013
48139,35.3,152020,98832,13173,36361,40381,61952,51016,38064,12952,51016,137500,2013
48141,31.2,813015,109106,22979,663256,192989,40157,255573,157814,97759,255573,111800,2013
48143,30.6,38744,29763,473,7555,8974,39586,14383,8613,5770,14383,111100,2013
48145,39.5,17719,9263,4292,3780,3577,32908,5600,4030,1570,5600,60800,2013
48147,40.7,33819,27124,2374,3335,8420,44355,11814,8813,3001,11814,92600,2013
48149,47.4,24662,18087,1741,4682,6762,48015,9999,7635,2364,9999,130300,2013
48151,42.2,3924,2587,125,1161,1042,42125,1518,1080,438,1518,62200,2013
48153,37.7,6371,2658,152,3450,1790,42279,2457,1702,755,2457,61200,2013
48155,44.8,1133,969,10,147,289,33750,491,341,150,491,37500,2013
48157,35.2,608939,218313,128020,145240,158752,85297,191406,150628,40778,191406,183600,2013
48159,42.6,10611,8545,486,1370,2986,45523,4304,3315,989,4304,92800,2013
48161,41.1,19657,13404,3188,2775,5023,44502,7251,5759,1492,7251,76900,2013
48163,31.2,17522,3212,510,13658,3673,35849,4805,3160,1645,4805,62900,2013
48165,29.1,18019,10762,245,6762,4158,52910,5437,4180,1257,5437,93000,2013
48167,37.4,296669,174298,39571,67765,76115,61877,110032,75613,34419,110032,148600,2013
48169,37.8,6356,2549,304,3484,1110,47540,1588,1205,383,1588,72000,2013
48171,50,25003,19404,85,5146,7182,53668,10655,7961,2694,10655,216600,2013
48173,38.8,1176,837,36,303,312,69107,409,283,126,409,119100,2013
48175,44.9,7281,4282,229,2548,2226,50923,3028,2457,571,3028,111600,2013
48177,37,19920,8783,1439,9575,4699,39248,6638,4613,2025,6638,77500,2013
48179,38,22777,15429,909,5640,5633,43504,8388,6244,2144,8388,68000,2013
48181,39.8,121292,94734,6921,14083,32467,46429,46559,31370,15189,46559,104500,2013
48183,35.3,122258,73864,24546,20593,30713,45525,45292,28254,17038,45292,121300,2013
48185,39.2,26663,16065,4331,5815,6160,43994,8848,6755,2093,8848,92900,2013
48187,36.5,135940,73349,8439,49038,35419,61958,46409,36091,10318,46409,156000,2013
48189,32.2,36150,13227,1605,20531,8582,41191,11624,7425,4199,11624,70800,2013
48191,43.4,3310,1931,176,1112,772,33006,1177,793,384,1177,42700,2013
48193,47,8410,7428,54,900,2127,40655,3029,2224,805,3029,91500,2013
48195,36.1,5566,3051,5,2453,1457,49150,1983,1521,462,1983,72900,2013
48197,44.2,4087,2776,359,893,1093,36377,1745,1214,531,1745,46800,2013
48199,38.8,54945,48147,3159,2601,15179,53013,20633,16207,4426,20633,100400,2013
48201,32.3,4182285,1361568,774120,1717940,984120,53137,1434694,810622,624072,1434694,131400,2013
48203,37,66467,42860,14998,7602,17227,45675,23415,17173,6242,23415,108700,2013
48205,39,6076,4094,479,1461,1293,65750,1748,1155,593,1748,143700,2013
48207,43.7,5885,4108,256,1434,1670,36857,2425,1795,630,2425,45200,2013
48209,30.6,164144,94942,5451,58903,36393,58651,56459,37732,18727,56459,175600,2013
48211,35.8,3959,2618,4,1276,1055,56379,1440,1075,365,1440,97800,2013
48213,43,78636,63162,4996,8802,20508,40900,29732,22237,7495,29732,87800,2013
48215,28.4,790646,60223,2972,717559,178186,34146,217691,148948,68743,217691,78100,2013
48217,42.3,35051,25572,2360,6553,9167,40769,13395,9657,3738,13395,83400,2013
48219,32.6,23115,11575,659,10338,5953,50565,7973,5560,2413,7973,79300,2013
48221,46.8,51756,44647,326,5510,14606,55754,20758,16067,4691,20758,150900,2013
48223,39.1,35295,26506,2550,5471,9944,43657,13303,9643,3660,13303,94000,2013
48225,43.8,23365,14499,6202,2394,5212,33119,7889,5617,2272,7889,74300,2013
48227,37.4,35297,18626,1761,13631,7243,45612,11010,7461,3549,11010,65900,2013
48229,37.6,3394,676,17,2682,793,22545,1096,902,194,1096,41400,2013
48231,37.9,86455,64299,7306,12101,21331,44858,30756,21463,9293,30756,93500,2013
48233,37.2,21986,16105,500,4566,5422,44731,8374,6530,1844,8374,63300,2013
48235,43.3,1603,1113,36,433,494,50357,654,493,161,654,76100,2013
48237,40.3,9012,7188,354,1340,2033,49038,2972,2300,672,2972,76700,2013
48239,39.3,14201,8780,1046,4232,3638,49528,5212,4052,1160,5212,84400,2013
48241,40.6,35797,26921,5932,2139,9178,40417,13095,10273,2822,13095,82200,2013
48243,54.8,2311,1311,3,943,693,49056,989,739,250,989,104300,2013
48245,35.9,252157,110878,84003,44342,59438,42568,92634,59354,33280,92634,96200,2013
48247,37.7,5271,134,92,4995,1321,36121,1805,1385,420,1805,50700,2013
48249,34.2,41217,8006,278,32573,10424,40585,13728,9979,3749,13728,69000,2013
48251,36.3,152384,115732,3876,28288,39852,57535,52044,39220,12824,52044,113900,2013
48253,39.4,20079,12249,2405,5123,3667,41297,5641,4522,1119,5641,61500,2013
48255,37.3,14916,5941,1321,7508,3200,42862,4497,3252,1245,4497,75000,2013
48257,35.5,105220,72919,9788,18615,27331,61194,34922,27161,7761,34922,129500,2013
48259,43.4,34951,26679,147,7331,9865,73410,12760,9500,3260,12760,274400,2013
48261,32.8,524,112,0,412,122,43438,159,46,113,159,56200,2013
48263,45.8,913,785,0,128,257,46875,401,300,101,401,64300,2013
48265,47.7,49696,35575,859,12170,13423,43601,20357,14003,6354,20357,150700,2013
48267,51.9,4566,3391,1,1143,1263,43424,1895,1412,483,1895,85100,2013
48269,46.9,321,245,0,76,88,65000,126,53,73,126,91000,2013
48271,46.1,3589,1368,44,2167,805,33257,1195,980,215,1195,65800,2013
48273,28.6,32052,7268,1167,22618,7687,40566,11241,6420,4821,11241,74500,2013
48275,40.8,3731,2304,246,1161,953,34295,1557,1026,531,1557,40900,2013
48277,40.2,49751,37704,6420,3332,13545,40104,19416,12656,6760,19416,85300,2013
48279,36,13921,5874,590,7318,3374,36727,4803,3427,1376,4803,56900,2013
48281,40.7,19937,14893,772,3585,5409,49277,7289,5457,1832,7289,129100,2013
48283,34,6921,1082,71,5761,1197,26756,1864,1326,538,1864,48200,2013
48285,44.9,19351,14605,1393,3227,5517,44149,7711,6133,1578,7711,92800,2013
48287,41.4,16603,10756,1889,3756,4282,51534,6078,4661,1417,6078,118400,2013
48289,45.3,16802,13004,1265,2281,4591,44452,6349,5326,1023,6349,90300,2013
48291,36.5,76013,52098,8288,14196,18535,47228,24844,19400,5444,24844,84400,2013
48293,38.5,23417,14354,4085,4581,5655,38823,7929,5961,1968,7929,83200,2013
48295,35.4,3379,2313,6,938,793,57978,1115,790,325,1115,89400,2013
48297,43.1,11603,6741,463,4192,2842,42829,3882,3177,705,3882,85500,2013
48299,55.5,19223,17052,307,1656,5305,44094,8519,6641,1878,8519,159000,2013
48301,44.4,87,44,0,30,17,68750,33,16,17,33,86000,2013
48303,30.5,282633,160298,19401,91844,65862,44397,105277,61577,43700,105277,108700,2013
48305,38.6,5841,2934,70,2716,1625,44375,2179,1556,623,2179,70200,2013
48307,41.5,8302,5506,80,2536,1957,39194,2967,2277,690,2967,69300,2013
48309,32.9,237316,138871,34157,56996,56760,41922,84862,50569,34293,84862,108300,2013
48311,40.6,616,261,0,350,154,39500,254,206,48,254,63200,2013
48313,34.1,13689,7920,2777,2810,2612,41732,3743,2685,1058,3743,94200,2013
48315,48.8,10439,7456,2463,359,2995,31967,4563,3416,1147,4563,72900,2013
48317,34.2,4956,2538,110,2279,1156,42607,1555,1163,392,1555,72200,2013
48319,50.2,4034,3144,0,863,1220,46865,1699,1410,289,1699,170100,2013
48321,37.7,36639,17173,3757,14272,9440,43096,13260,9307,3953,13260,92000,2013
48323,29.9,54880,1683,48,52347,12950,31395,15714,11167,4547,15714,86300,2013
48325,37.9,46512,21324,1025,23325,12085,55326,15284,11933,3351,15284,112900,2013
48327,43.5,2213,1375,22,749,580,31215,871,628,243,871,56400,2013
48329,32.9,142289,73964,8782,55528,36238,62993,50644,34274,16370,50644,148600,2013
48331,40.9,24503,15919,2152,5856,6261,37391,9330,6386,2944,9330,78400,2013
48333,46.6,4891,4000,16,864,1325,44213,1817,1455,362,1817,104100,2013
48335,35.2,9388,4644,893,3530,1921,42045,2748,2051,697,2748,45800,2013
48337,43.3,19668,17183,30,1965,5544,44231,8038,6073,1965,8038,86000,2013
48339,36.2,472162,333001,19308,100004,121297,67766,163462,119126,44336,163462,166200,2013
48341,30.9,22029,8146,419,11586,5280,51181,6820,4967,1853,6820,85600,2013
48343,43.8,12869,8541,2964,1052,3551,37849,4949,3671,1278,4949,69900,2013
48345,36.6,1182,976,10,189,258,35845,433,287,146,433,59800,2013
48347,29.8,65085,39820,11869,11653,14764,36777,23586,13714,9872,23586,101700,2013
48349,37.3,47883,28432,6860,11645,12600,40795,17466,11838,5628,17466,79500,2013
48351,40.2,14340,10622,3086,442,3312,37246,4865,3737,1128,4865,77500,2013
48353,38.3,15087,8985,609,5179,3627,36806,5527,3850,1677,5527,52200,2013
48355,35,344257,111147,12686,210616,84160,47057,123915,72627,51288,123915,110300,2013
48357,31.3,10467,5058,21,5198,2885,49964,3736,2617,1119,3736,80100,2013
48359,35.8,2064,1658,47,252,490,48929,748,543,205,748,83700,2013
48361,38.7,82372,68014,6848,5087,22027,49507,31162,23681,7481,31162,91900,2013
48363,41.1,28017,21674,657,5160,7185,41670,10491,7509,2982,10491,85200,2013
48365,38.5,23877,17569,4087,2013,6380,52453,8873,7224,1649,8873,83900,2013
48367,39,118478,100377,2231,12860,31696,64515,42322,33504,8818,42322,152900,2013
48369,32,10159,3839,150,6145,2481,44943,3215,2290,925,3215,86400,2013
48371,36.1,15590,4036,840,10504,3157,47019,4588,3001,1587,4588,64300,2013
48373,43.2,45620,32860,5103,6140,12076,37855,16980,13509,3471,16980,78600,2013
48375,33,121526,58652,11486,43618,27762,37951,42751,24989,17762,42751,85900,2013
48377,40.4,7579,1154,26,6224,1811,29634,2616,1881,735,2616,48500,2013
48379,46.8,10989,9510,309,882,3012,44478,4232,3446,786,4232,96300,2013
48381,35.4,123062,94748,2884,21330,32890,58529,48080,33241,14839,48080,141900,2013
48383,34.7,3441,1153,87,2187,922,61250,1178,854,324,1178,66200,2013
48385,52.6,3348,2756,3,579,860,33885,1127,866,261,1127,102200,2013
48387,45,12709,9353,2154,870,3316,31712,5052,3578,1474,5052,69200,2013
48389,35.3,13775,2660,580,10230,2493,40571,3542,2657,885,3542,40100,2013
48391,43.3,7327,3255,407,3514,2044,44548,2818,2186,632,2818,66300,2013
48393,44.8,1030,994,0,23,302,67321,374,337,37,374,104600,2013
48395,40.8,16574,9721,3538,3077,4145,40601,5851,4167,1684,5851,77400,2013
48397,35.8,81020,59664,4331,13158,21825,86119,26820,22412,4408,26820,187800,2013
48399,42.1,10439,6681,172,3432,2895,37667,3818,2800,1018,3818,59100,2013
48401,39.4,53508,35159,9442,7926,12534,45752,17772,13511,4261,17772,93000,2013
48403,50.3,10604,9249,914,358,2622,32963,4161,3630,531,4161,69300,2013
48405,48,8855,6137,2062,562,2059,28390,3275,2544,731,3275,68100,2013
48407,43.3,26669,20335,3074,2988,7356,46107,9425,7824,1601,9425,88200,2013
48409,35.9,65210,27164,1155,35696,16875,50657,22147,15183,6964,22147,89800,2013
48411,43,6050,4097,154,1730,1364,37743,2035,1615,420,2035,71300,2013
48413,35.8,3316,1709,4,1579,814,50648,1078,796,282,1078,86400,2013
48415,37.2,17014,9604,742,6336,4368,47513,5846,4201,1645,5846,87200,2013
48417,43.6,3362,2932,47,345,986,47277,1445,1085,360,1445,66200,2013
48419,37.9,25677,16582,4389,4308,6783,37081,9781,7014,2767,9781,72000,2013
48421,36.3,3048,1771,5,1251,719,48185,949,761,188,949,81900,2013
48423,35.9,212227,131274,37913,37328,53727,47432,78459,52601,25858,78459,120800,2013
48425,40,8537,6632,146,1626,2301,55269,3193,2356,837,3193,139900,2013
48427,28.9,61351,768,30,60389,13430,24927,15949,12489,3460,15949,62900,2013
48429,39.4,9493,7115,271,2041,2499,41728,3509,2634,875,3509,72400,2013
48431,39.8,1358,923,0,435,370,50543,458,303,155,458,71900,2013
48433,47,1363,1067,56,223,368,42429,578,455,123,578,49900,2013
48435,35.4,4058,1617,62,2355,1090,53806,1445,941,504,1445,80700,2013
48437,36.3,7807,3938,451,3190,1825,36753,2604,1903,701,2604,62600,2013
48439,33.5,1848423,945390,272225,499033,457384,56853,659736,407132,252604,659736,136400,2013
48441,32.3,132588,88013,9151,29827,32228,44891,49304,29955,19349,49304,95800,2013
48443,47,837,322,0,504,231,39479,403,291,112,403,57000,2013
48445,35.2,12644,5522,569,6403,2726,37679,4067,2936,1131,4067,64900,2013
48447,47.8,1623,1445,2,153,488,39286,758,551,207,758,57500,2013
48449,33.2,32360,15736,3108,12949,7981,42939,10725,7703,3022,10725,91600,2013
48451,34,111969,63859,4433,40633,28040,44545,42286,27166,15120,42286,99000,2013
48453,32.3,1063248,535206,85576,356705,237213,58025,411876,213191,198685,411876,219200,2013
48455,47.3,14460,11609,1525,1202,3385,34555,5091,4144,947,5091,80100,2013
48457,42.7,21619,17268,2365,1528,5737,39940,8224,6789,1435,8224,75100,2013
48459,40.4,39640,32382,3383,2725,10398,46600,14286,11180,3106,14286,89400,2013
48461,35.9,3323,1565,93,1644,904,51750,1218,900,318,1218,48500,2013
48463,34.4,26578,7607,124,18508,6237,34902,8619,6129,2490,8619,68600,2013
48465,32,48730,8455,550,39080,11599,40450,15082,10060,5022,15082,91900,2013
48467,42.9,52515,44751,1330,4989,13329,43439,19064,14845,4219,19064,96900,2013
48469,36,88068,41764,5033,38980,23053,50364,32072,20975,11097,32072,110200,2013
48471,35,68110,39558,15458,11637,12188,37617,20558,11723,8835,20558,109900,2013
48473,31.2,43836,19280,10535,12749,9834,50097,13601,9231,4370,13601,133400,2013
48475,36.2,10836,4862,501,5299,2637,42568,3938,2843,1095,3938,57300,2013
48477,41.7,33863,22306,5875,4776,8572,44858,12244,8476,3768,12244,147800,2013
48479,27.9,254829,9086,676,243371,55835,39449,67372,43127,24245,67372,108800,2013
48481,37.2,41185,19341,5801,15654,9790,40411,14517,9871,4646,14517,95600,2013
48483,40.4,5526,3875,93,1408,1606,51766,2319,1681,638,2319,76600,2013
48485,34.1,131358,89282,13337,22430,31500,45086,48305,30154,18151,48305,89800,2013
48487,38.2,13371,8326,1048,3565,3383,41658,5161,3526,1635,5161,62000,2013
48489,31.9,22039,2354,325,19250,4395,25886,5499,4282,1217,5499,48800,2013
48491,34.6,441445,278663,26586,103400,113285,71803,154948,106237,48711,154948,178900,2013
48493,40.1,43753,25551,620,16859,12217,64571,15157,12865,2292,15157,143500,2013
48495,34.3,7260,3009,166,4004,1875,48992,2709,2179,530,2709,45100,2013
48497,38.8,59894,47421,629,10459,15937,56005,20487,16517,3970,20487,121900,2013
48499,47.9,42089,35547,2001,3701,11096,43649,15800,12813,2987,15800,99900,2013
48501,32.7,7998,3008,66,4799,2143,49340,2654,2122,532,2654,71100,2013
48503,42.6,18395,14744,223,3070,5043,44429,7186,5157,2029,7186,84300,2013
48505,28.3,14164,939,5,13220,3725,31109,4460,3529,931,4460,55700,2013
48507,30.7,11849,765,33,11045,2645,25625,3654,2505,1149,3654,39900,2013
49001,32.3,6529,5620,11,691,1574,46660,2112,1642,470,2112,144800,2013
49003,31.4,50160,44146,169,4287,13225,57292,16207,12849,3358,16207,166100,2013
49005,25.2,114181,97242,656,11467,26659,49506,35375,22810,12565,35375,189100,2013
49007,34.3,21227,17767,120,2677,5305,44724,7764,5398,2366,7764,122700,2013
49009,48.2,830,780,0,34,195,46917,305,226,79,305,162500,2013
49011,29.6,311886,266681,3525,26712,77025,69707,95238,73966,21272,95238,222600,2013
49013,29.8,19109,16551,32,1284,5496,57683,6850,5198,1652,6850,168000,2013
49015,33.5,10895,10013,49,654,2802,52763,3598,2937,661,3598,122500,2013
49017,39.9,5123,4665,32,258,1310,45357,1890,1479,411,1890,154300,2013
49019,39.1,9269,7761,25,896,1965,45888,3633,2472,1161,3633,218800,2013
49021,27.1,46435,40400,236,3647,11041,42369,15435,9686,5749,15435,168300,2013
49023,29.7,10300,9627,9,418,2582,55247,3016,2422,594,3016,162600,2013
49025,44.9,7176,6644,26,284,2012,48540,3077,2428,649,3077,162300,2013
49027,34.1,12543,10597,53,1624,3122,49238,4101,3044,1057,4101,132800,2013
49029,31.7,9692,9260,0,253,2502,80337,2860,2550,310,2860,264400,2013
49031,39.6,1791,1611,4,160,407,38500,570,476,94,570,152800,2013
49033,35.2,2279,2215,3,54,535,50000,664,554,110,664,156600,2013
49035,31.2,1048314,772326,15560,180774,242705,60555,344089,231666,112423,344089,232100,2013
49037,30.5,14795,6696,16,716,3078,40492,4216,3424,792,4216,127400,2013
49039,29.5,27930,24208,237,2619,5858,48369,7781,5926,1855,7781,164100,2013
49041,33.5,20798,19234,110,967,5361,46229,7146,5645,1501,7146,151400,2013
49043,36.8,37232,31751,125,4242,9878,83336,13627,10139,3488,13627,485700,2013
49045,30,59120,49676,530,6915,14643,61412,18281,13753,4528,18281,177500,2013
49047,29.7,33722,27830,64,2514,8340,62067,11007,8254,2753,11007,187900,2013
49049,24.4,529262,443848,2881,57464,117170,60196,143005,97065,45940,143005,222100,2013
49051,31.9,24542,20745,82,3219,6128,65050,7602,5738,1864,7602,307600,2013
49053,33.2,141902,121408,578,13887,35746,49279,46826,32349,14477,46826,212900,2013
49055,38.3,2760,2562,23,129,760,41458,970,814,156,970,173500,2013
49057,31.3,233871,182058,2974,39706,58530,54974,79525,56944,22581,79525,170000,2013
50001,42.3,36811,34592,303,701,9530,57565,14164,10497,3667,14164,234500,2013
50003,45.4,36871,35121,185,565,10049,50221,15442,10905,4537,15442,214800,2013
50005,42.5,31157,29776,173,366,7980,45395,12491,9166,3325,12491,164300,2013
50007,36.3,157637,143191,3072,3043,37546,63989,62587,40736,21851,62587,267500,2013
50009,47.4,6276,6036,52,70,1792,35916,2774,2247,527,2774,122200,2013
50011,39.7,48019,45411,209,612,12880,56240,18616,14170,4446,18616,204400,2013
50013,46.3,6984,6591,22,93,2142,59509,3023,2455,568,3023,254300,2013
50015,40.1,24670,23514,122,345,6076,52686,10046,7165,2881,10046,218800,2013
50017,44,28966,27851,102,319,7939,52480,11962,9749,2213,11962,183900,2013
50019,44.3,27184,26077,212,319,6986,41953,11043,8546,2497,11043,156300,2013
50021,44.8,61270,58961,295,738,16215,49271,25754,17942,7812,25754,176800,2013
50023,42.5,59427,56289,489,1045,15113,57281,24661,18021,6640,24661,205000,2013
50025,45.3,44216,41561,418,853,11544,50234,19417,13476,5941,19417,206800,2013
50027,45.8,56416,53849,310,734,15483,52460,25024,17462,7562,25024,216300,2013
51001,44.8,33289,20337,9472,2924,9277,39328,14333,9960,4373,14333,153600,2013
51003,38.7,100636,78211,9386,5589,24504,67725,37964,25078,12886,37964,319200,2013
51005,46.6,16240,14977,845,211,4556,44848,6773,5413,1360,6773,114600,2013
51007,42.9,12712,9157,3101,85,3622,52885,4808,3843,965,4808,180700,2013
51009,42.8,32244,24483,5978,642,8570,44945,12680,9402,3278,12680,148700,2013
51011,42.5,15054,11537,3065,174,4273,50167,5803,4654,1149,5803,145400,2013
51013,33.8,214861,136630,17783,32809,43512,103208,94454,42654,51800,94454,584600,2013
51015,43.5,73726,67892,3024,1608,20511,52027,27999,22662,5337,27999,194600,2013
51017,46,4686,4195,240,170,1355,51365,2101,1600,501,2101,152600,2013
51019,44.5,69175,62229,3872,1191,19905,57596,27233,23157,4076,27233,195400,2013
51021,43.9,6795,6419,332,23,1772,42139,2480,2045,435,2480,95200,2013
51023,45.7,33076,31039,1172,408,10037,65935,12825,11296,1529,12825,213100,2013
51025,41.4,17220,6924,9828,311,3943,36293,5826,4207,1619,5826,105600,2013
51027,44.8,23920,22941,510,130,6711,29848,9485,7458,2027,9485,68200,2013
51029,42,17126,10480,6013,313,4230,38648,5817,4420,1397,5817,128800,2013
51031,41.7,54967,44515,7603,977,15458,47162,21774,16545,5229,21774,150300,2013
51033,38.8,28757,18275,8415,1053,7820,57218,10680,8553,2127,10680,188400,2013
51035,45.4,29979,28644,232,849,8613,32853,12572,9889,2683,12572,102900,2013
51036,47.4,7205,2941,3485,109,1869,48428,2850,2294,556,2850,147500,2013
51037,43.8,12478,8317,3723,254,3314,33015,4751,3469,1282,4751,98900,2013
51041,37.9,320430,207449,70505,23612,83188,72088,113637,87479,26158,113637,226500,2013
51043,45.3,14191,12464,753,514,4098,77597,5580,4447,1133,5580,342500,2013
51045,44.7,5199,5041,10,0,1472,47806,2122,1791,331,2122,136500,2013
51047,38.1,47330,33941,6803,4169,11959,64423,16039,11711,4328,16039,250600,2013
51049,42.4,9943,6281,3343,117,2723,40557,4049,3134,915,4049,142400,2013
51051,43.6,15749,15484,74,97,4526,33318,6352,4960,1392,6352,75700,2013
51053,40.9,27977,17606,9103,728,7241,52027,9932,7607,2325,9932,165300,2013
51057,44.1,11180,6221,4158,364,2735,44885,4286,3265,1021,4286,160800,2013
51059,37.4,1101071,593420,98414,173532,277250,110292,389908,269167,120741,389908,476600,2013
51061,41.5,66015,53883,5080,4344,17205,88409,23130,18530,4600,23130,350600,2013
51063,44.5,15371,14459,222,411,4126,44618,6086,4720,1366,6086,144700,2013
51065,41.5,25860,20391,3822,803,6937,68288,9462,8094,1368,9462,225700,2013
51067,44.4,56195,49141,4674,1456,16857,45624,23358,18230,5128,23358,163700,2013
51069,39.4,79453,68175,3326,5377,21660,68424,29172,22852,6320,29172,226900,2013
51071,43.2,17111,16379,199,219,4823,45141,7167,5442,1725,7167,105300,2013
51073,42.4,36868,31554,3309,998,10266,60519,13889,11519,2370,13889,228700,2013
51075,45.8,21565,16591,4395,456,6394,80976,8058,7271,787,8058,338500,2013
51077,47.5,15377,14455,313,422,4378,30710,6618,5140,1478,6618,97900,2013
51079,40,18577,15901,1147,822,4974,59358,6897,5448,1449,6897,237500,2013
51081,41.6,12078,4549,7184,209,2545,39697,3389,2568,821,3389,99600,2013
51083,44.9,35938,21633,13221,621,9658,34659,14770,10672,4098,14770,106600,2013
51085,41.5,100328,85264,9117,2284,27946,75070,36927,30780,6147,36927,262000,2013
51087,37.6,311314,175825,90324,15622,79990,61048,123683,80690,42993,123683,219900,2013
51089,45,53451,38006,11561,2621,15386,34984,22690,16919,5771,22690,94600,2013
51091,58.2,2276,2273,0,0,757,49625,1006,868,138,1006,171700,2013
51093,44.2,35373,25033,8537,737,10191,63942,13560,10926,2634,13560,249600,2013
51095,45.1,68171,52598,9174,3324,19337,76960,26883,20490,6393,26883,327100,2013
51097,45.1,7020,4608,2118,215,2012,48372,2863,2183,680,2863,154200,2013
51099,36.3,24151,17968,4411,913,6034,81753,8314,6114,2200,8314,278900,2013
51101,39.8,15959,12145,2991,338,4584,62670,5998,4982,1016,5998,199700,2013
51103,54.5,11303,7829,3177,150,3142,49248,5182,4106,1076,5182,233400,2013
51105,41.7,25497,24102,711,422,6604,31308,9653,7177,2476,9653,74300,2013
51107,34.9,326477,200673,22904,41283,83146,122238,106997,83100,23897,106997,437700,2013
51109,43.4,33384,25838,5918,804,9398,54518,13046,10422,2624,13046,197700,2013
51111,44.1,12759,7634,4356,500,3033,35237,4572,3444,1128,4572,100400,2013
51113,45.2,13249,11213,1401,108,3528,53459,5024,4032,992,5024,240900,2013
51115,50.6,8943,7779,841,132,2880,55192,3856,3078,778,3856,238500,2013
51117,46.4,32274,19118,11866,804,7934,36261,12650,9282,3368,12650,120900,2013
51119,51,10851,8482,2117,191,2986,53309,4400,3606,794,4400,247100,2013
51121,26.8,94910,81054,3800,2626,19187,45543,34789,19012,15777,34789,200200,2013
51125,47.9,14940,12233,2392,197,4163,48789,6404,4856,1548,6404,192900,2013
51127,42.9,18791,15038,2794,423,5288,70618,6886,6127,759,6886,253700,2013
51131,47.2,12339,6701,4650,917,2984,33635,5149,3533,1616,5149,168800,2013
51133,54,12334,8646,3600,79,3793,51342,5691,4839,852,5691,239000,2013
51135,42.4,15862,8797,6157,627,3722,36607,5673,3674,1999,5673,137600,2013
51137,42.7,33934,27230,4450,1239,9425,60287,12621,9576,3045,12621,230500,2013
51139,43.5,23975,22747,339,406,6908,42906,9623,6930,2693,9623,180200,2013
51141,46.9,18445,16621,1204,464,5185,34864,7846,6041,1805,7846,110500,2013
51143,44.7,63077,46871,13601,1409,18364,42143,26092,20787,5305,26092,109600,2013
51145,42.6,28108,23308,3555,524,7532,76548,9544,8466,1078,9544,269700,2013
51147,31.1,23166,14391,7769,533,4913,37436,7453,4856,2597,7453,153400,2013
51149,37.3,36462,20995,11485,2344,8955,63074,10848,7803,3045,10848,199600,2013
51153,33.5,416668,199094,81305,86314,103008,98071,132442,95506,36936,132442,321400,2013
51155,44.3,34768,31761,1879,467,10148,44312,14875,10816,4059,14875,133900,2013
51157,48.7,7448,6660,332,240,2126,56438,3261,2553,708,3261,394800,2013
51159,43.7,9140,5655,2512,521,1878,47083,2853,2138,715,2853,155700,2013
51161,43.3,92824,81674,5022,2155,25859,60795,37928,29098,8830,37928,193700,2013
51163,47.3,22345,20883,592,313,6291,48313,9234,6761,2473,9234,179500,2013
51165,40.6,76885,69884,1187,4276,21052,52195,29440,22603,6837,29440,195300,2013
51167,43.3,28646,27808,391,78,7684,33872,11191,8750,2441,11191,91100,2013
51169,44.9,22940,22303,130,260,6876,38355,9692,7461,2231,9692,91000,2013
51171,43.3,42270,38013,815,2657,12209,49625,17397,12259,5138,17397,205300,2013
51173,43.6,31979,30360,636,540,8664,37239,12650,8950,3700,12650,91200,2013
51175,44.8,18444,11034,6723,219,4770,46150,6708,4815,1893,6708,150000,2013
51177,36.5,124319,89166,19235,9737,32962,78345,41709,32318,9391,41709,249100,2013
51179,34.6,131885,88454,22153,12745,34311,97110,42178,32435,9743,42178,299300,2013
51181,45.2,6922,3538,3176,96,1855,47292,2602,2080,522,2602,161600,2013
51183,40.7,12007,4664,6849,270,2296,39635,3704,2600,1104,3704,118000,2013
51185,43.5,44664,42163,1134,328,12739,35693,18294,13353,4941,18294,88000,2013
51187,40.1,37836,33488,1541,1379,10147,61610,14387,10436,3951,14387,219000,2013
51191,43.5,54804,52599,696,735,15546,41897,22755,17242,5513,22755,131500,2013
51193,46.8,17532,11137,5196,1031,4440,49157,7130,5553,1577,7130,180900,2013
51195,39.6,41154,37939,2050,488,10510,36218,15406,10913,4493,15406,83900,2013
51197,43.2,29274,27610,1103,295,7989,41275,11656,8585,3071,11656,112100,2013
51199,39.5,65762,48479,8754,3210,19109,82073,24071,18068,6003,24071,316800,2013
51510,35.7,143684,76278,30356,23542,30863,85706,65369,28337,37032,65369,476700,2013
51515,46.5,6052,4559,1269,110,1690,35593,2800,1644,1156,2800,146400,2013
51520,41.7,17713,15940,1159,159,4813,32221,7674,4495,3179,7674,110800,2013
51530,37.6,6699,5990,505,62,1720,36591,2738,1810,928,2738,118900,2013
51540,28.5,43663,29043,8502,2177,7340,44601,17443,7071,10372,17443,293000,2013
51550,36.6,225597,135023,66445,10412,59469,69743,79421,57579,21842,79421,261600,2013
51570,41.1,17481,13843,2181,745,4478,50835,7017,4493,2524,7017,181300,2013
51580,44.3,5880,4838,722,142,1361,34319,2545,1855,690,2545,66900,2013
51590,42.4,42996,19813,20771,1272,11086,30786,18659,10156,8503,18659,87800,2013
51595,42.6,5773,1897,3666,88,1496,32155,2488,1132,1356,2488,104000,2013
51600,39.4,23027,14005,1113,3705,5768,97242,8492,5812,2680,8492,456700,2013
51610,37,12731,9307,678,1190,3092,120000,5020,2981,2039,5020,660900,2013
51620,39.9,8539,3303,4852,91,2283,31928,3551,1509,2042,3551,186700,2013
51630,28.8,25931,15600,5979,2812,5170,47040,9779,3721,6058,9779,314300,2013
51640,43.1,6977,5601,218,1023,1725,30325,3018,1965,1053,3018,112900,2013
51650,35.5,136957,55932,67616,6597,33370,50705,52511,31560,20951,52511,195400,2013
51660,22.9,49926,35431,3099,8343,8135,38048,15701,5680,10021,15701,208100,2013
51670,36.2,22429,11785,8562,1463,5300,37933,8766,4419,4347,8766,139400,2013
51678,21.6,7026,5455,608,431,855,36505,1709,949,760,1709,262700,2013
51680,29.5,76467,48226,21545,2405,16060,38138,28556,15061,13495,28556,145800,2013
51683,32.4,39317,18248,5354,12530,9054,71036,12072,7865,4207,12072,245000,2013
51685,32.3,15125,6244,1983,5064,3331,71227,4435,2825,1610,4435,213300,2013
51690,43.5,13808,6613,6158,571,3408,28116,5995,3220,2775,5995,86800,2013
51700,32.5,181025,82833,71433,14045,43720,51027,69211,35601,33610,69211,200100,2013
51710,29.8,244090,108102,101530,16811,49478,44747,85557,38066,47491,85557,202800,2013
51720,40.1,3998,3614,268,91,902,39416,1706,899,807,1706,88000,2013
51730,39.5,32326,4984,25256,1272,7283,34424,12456,5694,6762,12456,122500,2013
51735,43.6,12117,11312,31,243,3421,81892,4591,3755,836,4591,302400,2013
51740,35.2,95901,38397,50081,3130,23689,46166,36690,20997,15693,36690,175600,2013
51750,22.1,16705,14158,1336,428,2409,30714,5516,2546,2970,5516,144000,2013
51760,32.6,207878,81985,101673,12970,40329,40496,84833,36547,48286,84833,196400,2013
51770,38.2,97355,60064,26563,5406,23116,38145,42494,23271,19223,42494,134700,2013
51775,40.1,24950,21651,1948,655,6226,48733,9908,6599,3309,9908,170300,2013
51790,42.3,23989,19746,2873,565,5939,38501,10495,6054,4441,10495,169400,2013
51800,38.1,84842,43016,35256,2664,22396,66085,30492,22373,8119,30492,242000,2013
51810,34.9,442151,283228,82312,30693,112631,65219,164944,105839,59105,164944,267600,2013
51820,38.7,21099,16672,2576,845,5370,44847,8708,5067,3641,8708,165600,2013
51830,24,14579,10262,2157,1008,2276,48616,4391,1962,2429,4391,311800,2013
51840,35.6,26587,18325,2868,4148,5666,44200,10393,5055,5338,10393,224100,2013
53001,29,18802,7118,13,11291,4557,43926,5738,3781,1957,5738,133600,2013
53003,43.6,21802,20086,111,711,5768,43175,9058,6115,2943,9058,173600,2013
53005,35.5,178992,132252,2536,34044,45471,60485,65675,44721,20954,65675,176700,2013
53007,39.4,73047,51086,245,19250,18707,51354,27220,17753,9467,27220,254500,2013
53009,49.4,71731,60488,660,3841,18778,46033,30814,21516,9298,30814,222200,2013
53011,37,432549,351705,8291,34006,110058,58225,158855,103213,55642,158855,232500,2013
53013,49.2,4027,3579,4,255,1106,42519,1651,1215,436,1651,147900,2013
53015,40.5,102110,87214,489,8108,26726,47596,39602,26236,13366,39602,181500,2013
53017,36.8,38807,26072,39,11272,10459,51908,13976,9918,4058,13976,205100,2013
53019,47,7623,5674,35,270,1988,37571,2951,2125,826,2951,156300,2013
53021,28.7,81835,35264,1332,41820,18039,55177,23445,15698,7747,23445,161600,2013
53023,52.3,2249,2090,0,69,653,51548,970,741,229,970,139500,2013
53025,32,90202,51366,789,34904,21720,45949,30012,18156,11856,30012,154700,2013
53027,42.2,72092,58350,813,6486,17571,42405,27396,18998,8398,27396,157600,2013
53029,43.7,78806,64695,1676,4687,22620,58455,33096,22986,10110,33096,292100,2013
53031,54.3,29882,26593,284,908,7993,46320,13801,10099,3702,13801,284100,2013
53033,37.1,1974567,1266794,118312,178436,473862,71811,802606,466964,335642,802606,377300,2013
53035,39.3,252687,198446,6879,16650,66152,62413,97622,65834,31788,97622,268200,2013
53037,32.7,41291,35316,326,3297,9444,42982,16538,9386,7152,16538,244700,2013
53039,44.4,20537,17089,111,2302,5486,41694,8019,5600,2419,8019,194700,2013
53041,42.2,75419,64566,447,6727,19647,42860,29527,20266,9261,29527,180200,2013
53043,48,10481,9742,25,260,3004,47195,4457,3471,986,4457,155700,2013
53045,44.7,60647,50114,631,4980,15674,48755,23358,18188,5170,23358,210200,2013
53047,42.2,41143,27867,202,7457,10877,40368,15980,10902,5078,15980,160800,2013
53049,50.9,20781,17459,101,1737,5832,39830,9366,6826,2540,9366,162000,2013
53051,48.3,12956,11611,17,416,3686,40567,5484,4118,1366,5484,186400,2013
53053,35.8,805434,562296,53006,75964,202286,59204,300623,184926,115697,300623,240400,2013
53055,53.3,15786,14201,79,890,4806,53376,7753,5541,2212,7753,472900,2013
53057,40.4,117641,89817,653,20115,31066,55925,45293,30600,14693,45293,261400,2013
53059,44.9,11126,9898,45,602,2993,53712,4452,3287,1165,4452,248200,2013
53061,37.3,724627,534153,16971,66323,182790,68381,268722,179550,89172,268722,292500,2013
53063,36.9,473832,409345,8388,22405,118609,49233,187572,119790,67782,187572,184700,2013
53065,45.4,43513,38198,241,1273,12163,41742,17684,13698,3986,17684,173500,2013
53067,38.2,256080,200096,6646,19128,66801,62229,100801,67365,33436,100801,244900,2013
53069,50.3,4006,3679,0,151,1096,41815,1715,1302,413,1715,195600,2013
53071,37,59092,43463,899,11938,13905,46597,21677,13373,8304,21677,195200,2013
53073,36.5,203211,165179,1809,16574,49023,51939,79314,49929,29385,79314,277000,2013
53075,24,45512,37012,923,2230,8238,36257,16624,7681,8943,16624,182300,2013
53077,32.3,244654,114952,1693,111916,58232,43506,79679,49559,30120,79679,156300,2013
54001,41,16655,16036,115,107,4299,37327,6099,4707,1392,6099,87900,2013
54003,38.1,105812,90509,7588,4057,28434,53515,40447,30408,10039,40447,165000,2013
54005,41.6,24517,24071,222,107,6864,42156,9559,7357,2202,9559,77600,2013
54007,43.7,14524,14196,83,74,3845,31848,5780,4446,1334,5780,80400,2013
54009,45.2,23932,23072,452,175,6521,42493,9968,7540,2428,9968,82300,2013
54011,38.7,96604,87593,4329,1145,24174,38374,40144,24646,15498,40144,105400,2013
54013,45.8,7603,7412,20,1,2101,31679,3141,2493,648,3141,75900,2013
54015,42.2,9352,9188,25,36,2434,31613,3435,2841,594,3435,84500,2013
54017,43.2,8213,7914,81,41,1930,34817,2778,2300,478,2778,80700,2013
54019,42.9,45889,42545,2286,430,11508,33771,17250,13234,4016,17250,72000,2013
54021,38,8678,6926,948,407,1615,38442,2590,1996,594,2590,72500,2013
54023,44.7,11869,11520,145,88,3022,41368,4449,3517,932,4449,112900,2013
54025,44.9,35588,33393,891,445,10005,37895,15409,11472,3937,15409,96700,2013
54027,43.4,23746,22892,281,261,4657,27766,10570,5684,4886,10570,123800,2013
54029,45.1,30517,28950,766,326,8542,38522,12890,9726,3164,12890,84700,2013
54031,43.3,13922,13179,238,464,3094,32723,5020,3887,1133,5020,123100,2013
54033,41.6,69078,65534,1142,933,18520,43183,27599,20508,7091,27599,94600,2013
54035,42,29229,28539,215,48,7810,40376,11459,8904,2555,11459,101800,2013
54037,39.2,54131,45798,3452,2668,14034,65304,19889,14943,4946,19889,214400,2013
54039,42.3,192311,169920,7427,1898,50847,46085,82756,58777,23979,82756,101600,2013
54041,44,16411,15950,60,45,4342,36199,6451,4617,1834,6451,91400,2013
54043,41.7,21660,21331,101,21,6112,35487,8416,6625,1791,8416,76700,2013
54045,42.6,36442,34944,828,294,10392,36999,14699,10851,3848,14699,77600,2013
54047,43.8,21651,19225,2196,111,5394,22252,8229,6367,1862,8229,35000,2013
54049,41.4,56666,52984,2045,584,14742,42152,22593,17191,5402,22593,91500,2013
54051,44.2,32840,31924,220,286,9395,40681,14042,10749,3293,14042,86000,2013
54053,42.5,27271,26519,192,132,7295,38411,10609,8435,2174,10609,83900,2013
54055,42.1,62261,56567,3586,520,16640,34842,25641,18503,7138,25641,79400,2013
54057,42.5,28015,26470,906,217,6251,31163,11180,7023,4157,11180,114800,2013
54059,41.5,26460,25512,469,68,7592,35955,10827,8411,2416,10827,69000,2013
54061,29.6,98483,88089,3490,1832,19147,44173,36449,20792,15657,36449,161800,2013
54063,45.8,13512,13106,86,142,4030,41234,5648,4657,991,5648,102200,2013
54065,45.5,17502,16861,198,192,3872,36046,7343,4770,2573,7343,161200,2013
54067,44.1,26168,25568,3,64,7821,40064,10657,8562,2095,10657,75500,2013
54069,43.3,44156,40895,1690,391,10837,41025,18553,13011,5542,18553,98700,2013
54071,48.3,7603,7238,185,92,2091,34175,3274,2532,742,3274,90600,2013
54073,42.8,7602,7349,73,43,1957,41859,2747,2300,447,2747,97300,2013
54075,47.8,8723,8431,73,55,2418,33779,3694,3023,671,3694,104500,2013
54077,42.2,33666,31811,991,434,8831,45413,12697,10172,2525,12697,106300,2013
54079,41.7,56033,53715,590,523,16000,54854,21391,18121,3270,21391,142900,2013
54081,40.8,78993,69106,6463,1059,20899,40758,31364,22939,8425,31364,93900,2013
54083,43.5,29399,28388,411,208,7527,37276,11163,8396,2767,11163,99000,2013
54085,44.7,10303,10107,21,77,2600,35769,4032,3184,848,4032,73400,2013
54087,43,14807,13867,2,119,3978,28513,5975,4524,1451,5975,81900,2013
54089,45.4,13795,12675,531,399,3700,33784,5350,4261,1089,5350,79600,2013
54091,43,16906,16342,218,152,4873,39536,6878,5340,1538,6878,89900,2013
54093,46.9,7061,6917,24,38,2087,37635,3050,2440,610,3050,105000,2013
54095,45.4,9120,8967,19,55,2587,39206,3712,3000,712,3712,78700,2013
54097,41.3,24371,23566,252,162,6130,39381,9011,6955,2056,9011,100500,2013
54099,42.1,42007,41153,46,234,10975,36964,16555,12906,3649,16555,79500,2013
54101,45.1,9073,8897,4,41,2759,27645,3928,3062,866,3928,64100,2013
54103,45.3,16435,16132,12,94,4527,37969,6903,5473,1430,6903,79000,2013
54105,44.7,5796,5643,19,0,1591,34702,2427,2022,405,2427,73100,2013
54107,42.1,86779,83088,909,777,23292,42287,35569,25996,9573,35569,106400,2013
54109,42.4,23479,22945,185,113,6427,34454,9101,7463,1638,9101,57500,2013
55001,50,20741,18845,656,782,5433,44897,8278,7064,1214,8278,135600,2013
55003,41,16068,13424,60,326,4089,38550,6775,4803,1972,6775,107400,2013
55005,43.3,45826,43292,442,946,12730,44054,19168,13894,5274,19168,134900,2013
55007,50,15071,12939,76,185,4499,44944,6964,5707,1257,6964,158600,2013
55009,36.4,250597,208644,5283,18685,64785,53119,98962,65614,33348,98962,158700,2013
55011,44.4,13466,13001,37,252,3808,47384,5777,4408,1369,5777,140900,2013
55013,49.9,15449,14016,87,216,4737,39564,7354,5838,1516,7354,147600,2013
55015,38.6,49288,45522,127,1764,13720,65130,18381,14973,3408,18381,164300,2013
55017,40.4,62676,59138,843,821,16474,50551,24456,17728,6728,24456,147700,2013
55019,37,34630,32679,102,1323,9005,43276,13036,10175,2861,13036,111700,2013
55021,41.7,56647,53280,810,1497,15514,57922,22735,17193,5542,22735,175000,2013
55023,45,16578,15887,342,166,4352,42235,6772,5075,1697,6772,121100,2013
55025,34.5,496762,404991,24512,29856,119426,61721,206982,123138,83844,206982,228800,2013
55027,41,88598,80957,2422,3652,22225,53075,33173,24592,8581,33173,154000,2013
55029,50.2,27826,26462,134,706,8474,50438,13459,10524,2935,13459,192200,2013
55031,40,43994,40632,583,531,11638,45418,18933,12846,6087,18933,130600,2013
55033,33.7,43871,41125,233,671,10499,48893,16222,11041,5181,16222,156200,2013
55035,33.5,99788,91581,767,1980,23450,48090,39754,25229,14525,39754,150000,2013
55037,49.1,4477,4255,0,34,1313,47960,1767,1547,220,1767,131100,2013
55039,40.5,101666,93164,1069,4536,27658,53820,41267,29182,12085,41267,145800,2013
55041,44.7,9255,7553,79,155,2528,39963,3739,2848,891,3739,122400,2013
55043,36.5,51080,49025,595,655,12111,46963,19420,13953,5467,19420,124800,2013
55045,41.8,36901,35113,121,1036,10136,55584,14640,11006,3634,14640,158300,2013
55047,44.8,19042,17884,72,804,5333,46994,8001,6070,1931,8001,140500,2013
55049,41.9,23709,22887,84,357,6606,55659,9610,7426,2184,9610,160500,2013
55051,51.5,5937,5764,18,35,1857,39051,2953,2364,589,2953,108300,2013
55053,42.4,20506,17923,525,574,5260,44149,8112,5984,2128,8112,124000,2013
55055,38.6,83985,76031,526,5654,21623,53454,32137,22785,9352,32137,176900,2013
55057,43.7,26673,24654,475,724,6803,45297,10194,7745,2449,10194,116000,2013
55059,36.8,166874,129617,11388,19992,41941,54930,62560,42209,20351,62560,169600,2013
55061,42.5,20578,19706,100,476,5544,53588,8145,6596,1549,8145,149000,2013
55063,35.4,115420,104917,1734,1823,27839,51339,45949,29889,16060,45949,154700,2013
55065,41.4,16841,16028,49,561,4605,49107,6605,5158,1447,6605,121800,2013
55067,46.4,19838,18902,141,351,5648,42389,8758,6670,2088,8758,108000,2013
55069,45.3,28650,27616,206,357,8351,49021,12513,9646,2867,12513,129100,2013
55071,43.6,81098,74729,408,2637,21982,48881,34067,26047,8020,34067,125200,2013
55073,39.8,134497,120966,776,3145,36120,53363,53079,39287,13792,53079,142300,2013
55075,46.3,41632,40052,114,570,11480,40490,18573,14394,4179,18573,108200,2013
55077,47.7,15308,14540,50,413,4416,46077,6453,5156,1297,6453,142000,2013
55078,33.7,4292,552,4,111,883,33333,1220,869,351,1220,88500,2013
55079,33.8,950527,513202,248065,128643,216535,43193,379637,194837,184800,379637,158400,2013
55081,39,44953,41399,592,1701,11879,49774,17543,11963,5580,17543,135300,2013
55083,44.5,37531,35955,93,565,10933,51615,15701,13048,2653,15701,147700,2013
55085,48.7,35868,34330,196,429,10188,45759,15797,12864,2933,15797,165200,2013
55087,37.6,178013,158829,1936,6617,46896,58318,69572,50289,19283,69572,155700,2013
55089,43.4,86708,80700,1152,2103,24285,75457,34108,26522,7586,34108,250200,2013
55091,44.3,7417,7230,27,85,2025,47701,3085,2389,696,3085,134800,2013
55093,34.9,40870,38960,231,667,10090,59226,15069,11106,3963,15069,191300,2013
55095,43.2,43905,42078,141,688,12625,48538,18266,14284,3982,18266,159100,2013
55097,35.9,70136,64811,350,1935,17536,50996,27975,19200,8775,27975,145600,2013
55099,49.2,14025,13473,42,173,4368,42644,6776,5319,1457,6776,114100,2013
55101,39.3,195045,144382,20731,23028,49280,54090,75087,52214,22873,75087,170100,2013
55103,43.3,17911,17136,78,382,4994,45271,7343,5514,1829,7343,124000,2013
55105,38.6,160345,135265,5677,12349,42623,49435,63309,45013,18296,63309,133000,2013
55107,46.7,14571,14063,88,188,4207,38658,6430,4933,1497,6430,106800,2013
55109,37.1,84912,80336,637,1745,23351,68426,32114,24986,7128,32114,206900,2013
55111,40.1,62353,57475,287,2787,16811,52140,25206,17676,7530,25206,168800,2013
55113,47.8,16542,12941,113,299,5112,39904,7663,5774,1889,7663,162500,2013
55115,43.7,41776,36690,143,964,11762,46559,17245,13037,4208,17245,129900,2013
55117,40.7,115235,99893,1608,6464,30644,52920,46312,33250,13062,46312,152300,2013
55119,42.3,20633,20004,84,334,5720,44869,8761,6735,2026,8761,126100,2013
55121,40.9,29098,26900,110,1732,7925,49143,11745,8739,3006,11745,135200,2013
55123,41.7,30002,29022,112,425,7961,45488,11790,9284,2506,11790,138200,2013
55125,51.4,21401,18449,85,301,6575,40833,10636,8194,2442,10636,186000,2013
55127,38.3,102619,88355,878,10807,26624,54020,39929,27443,12486,39929,194900,2013
55129,48.1,15842,15082,70,230,4707,41924,7348,5861,1487,7348,146000,2013
55131,41.2,132186,124277,1245,3561,37674,66159,52053,40287,11766,52053,222900,2013
55133,42.4,391200,352952,4896,16752,108185,75850,153422,118038,35384,153422,253800,2013
55135,43.9,52300,49918,201,1368,14402,50822,21388,16274,5114,21388,136300,2013
55137,46.7,24483,22173,458,1428,6653,43070,9902,8033,1869,9902,136800,2013
55139,37.7,167860,151766,2752,6001,41058,51010,68140,45194,22946,68140,141300,2013
55141,43.1,74469,69730,318,1756,20620,47685,32037,23873,8164,32037,119300,2013
56001,27,36745,30967,536,3297,7457,42774,15257,7822,7435,15257,201500,2013
56003,41.5,11741,10416,5,1012,3078,52589,4462,3378,1084,4462,131000,2013
56005,32.1,46901,41527,332,3695,12141,79488,17108,12812,4296,17108,201900,2013
56007,39.2,15809,12526,126,2688,4003,55347,6077,4477,1600,6077,143500,2013
56009,39.8,13937,12598,23,940,3935,63918,5746,4381,1365,5746,180900,2013
56011,44.1,7110,6906,4,168,2130,53237,3010,2331,679,3010,172200,2013
56013,38.2,40517,28807,157,2440,10340,50418,15425,11100,4325,15425,181000,2013
56015,42.8,13458,11722,22,1366,3423,43257,5255,3978,1277,5255,139700,2013
56017,48.9,4825,4582,11,125,1319,42019,2238,1575,663,2238,143900,2013
56019,44.6,8595,7993,1,325,2379,57004,3679,2725,954,3679,228800,2013
56021,37,93073,74520,2475,12521,24612,55864,36859,25126,11733,36859,181700,2013
56023,37.4,18100,16868,15,774,4750,64205,6245,5168,1077,6245,190900,2013
56025,36.3,77343,68184,632,5685,20673,57791,31116,21685,9431,31116,178300,2013
56027,45,2495,2288,13,67,600,38438,1045,650,395,1045,147700,2013
56029,43.1,28557,26197,217,1474,7689,53951,11801,8503,3298,11801,212100,2013
56031,46.7,8701,8015,2,622,2264,45512,3642,2850,792,3642,147100,2013
56033,42.1,29376,27079,197,1139,7809,52008,12381,8580,3801,12381,220400,2013
56035,37.9,10178,8745,1,742,2676,77900,3502,2607,895,3502,282800,2013
56037,33.2,44437,35694,186,6887,11783,71525,16682,11928,4754,16682,177300,2013
56039,37,21575,17673,28,3206,4532,68078,7583,4480,3103,7583,660100,2013
56041,34.4,21040,18542,23,1873,5322,58515,7290,5297,1993,7290,181700,2013
56043,42.8,8468,7061,39,1171,2197,47104,3468,2485,983,3468,162600,2013
56045,41.8,7153,6744,15,237,1906,55461,2975,2264,711,2975,136000,2013
72001,36.6,19334,112,0,19222,4619,11528,6074,3773,2301,6074,104600,2013
72003,38.6,41595,1624,33,38945,10279,15665,13246,10348,2898,13246,90300,2013
72005,38.3,59982,1328,16,57452,14376,15847,19565,12904,6661,19565,119700,2013
72007,36,28378,169,2,28206,6820,14902,8887,5837,3050,8887,96400,2013
72009,37.6,25560,67,0,25490,6447,16189,8867,7044,1823,8867,120200,2013
72011,39.4,29086,159,16,28870,7107,16568,9572,7323,2249,9572,110300,2013
72013,39.3,95185,509,7,94607,24742,16977,32590,23611,8979,32590,101700,2013
72015,35.6,19443,31,0,19386,4445,16350,6300,4539,1761,6300,87700,2013
72017,36.1,24884,147,25,24681,6040,14848,8184,6435,1749,8184,104500,2013
72019,33.1,30218,17,15,30127,7115,15127,9020,6124,2896,9020,101800,2013
72021,38.6,204725,1221,272,202494,51980,24374,71564,50051,21513,71564,144500,2013
72023,40.1,50869,224,14,50631,11107,17228,15818,10516,5302,15818,112700,2013
72025,37.7,141600,1039,114,140393,36095,23924,49025,34330,14695,49025,139800,2013
72027,37.9,34806,149,24,34560,9009,19527,11321,8427,2894,11321,96200,2013
72029,35.9,47730,0,55,47675,10827,21588,14527,11232,3295,14527,121400,2013
72031,38.4,173994,1493,219,171482,44756,28674,62396,44345,18051,62396,155100,2013
72033,35.6,27669,112,11,27497,7062,18977,9455,5863,3592,9455,124600,2013
72035,38.2,47700,209,9,47426,11742,21223,16329,11444,4885,16329,111900,2013
72037,38.4,13419,49,13,13348,3161,19520,4512,3500,1012,4512,96700,2013
72039,37.1,18509,44,0,18465,4254,13802,5624,3972,1652,5624,104300,2013
72041,36.6,43238,107,1,43101,10662,24224,13393,10175,3218,13393,115200,2013
72043,35.6,40579,97,12,40452,10101,17645,13418,10806,2612,13418,91200,2013
72045,35.5,20676,55,0,20621,4789,12615,6239,3966,2273,6239,92900,2013
72047,35.4,36828,85,0,36670,8520,16219,10850,7856,2994,10850,112300,2013
72049,38.4,1478,67,9,1394,298,16188,460,333,127,460,118800,2013
72051,37.5,38303,802,75,37350,9293,28306,12124,9742,2382,12124,146100,2013
72053,37.9,36252,90,35,36030,9088,21544,12917,9519,3398,12917,107200,2013
72054,36.2,12645,28,0,12617,3198,16750,4099,3059,1040,4099,108700,2013
72055,37.4,19019,205,0,18814,4155,13031,5636,3990,1646,5636,86900,2013
72057,35.3,44725,50,17,44570,10730,17260,14941,10564,4377,14941,94000,2013
72059,36.6,21218,95,0,21115,5211,15063,6625,5179,1446,6625,85500,2013
72061,40.3,96670,1144,94,95244,24339,35074,34982,26070,8912,34982,204500,2013
72063,36,46084,224,8,45822,10761,27459,14188,11528,2660,14188,163900,2013
72065,37.9,41932,189,0,41535,10817,19199,13708,9801,3907,13708,134500,2013
72067,42.4,17151,222,15,16878,4618,21107,6457,4907,1550,6457,102800,2013
72069,38.7,57823,599,47,57056,13496,20156,18741,14538,4203,18741,113600,2013
72071,38.4,45315,229,8,44968,11319,15495,15384,9707,5677,15384,107500,2013
72073,33.9,16413,30,0,16383,3812,19489,4676,3321,1355,4676,95200,2013
72075,35.1,50365,203,3,50116,12618,17139,16379,12767,3612,16379,104500,2013
72077,35,40346,172,15,40094,9654,18497,12641,9460,3181,12641,116400,2013
72079,39.5,25442,96,0,25346,6079,13975,8155,4897,3258,8155,100500,2013
72081,38.1,30051,111,0,29916,7644,11851,10116,6097,4019,10116,96800,2013
72083,37.3,9699,73,0,9626,2462,15779,3198,2137,1061,3198,83500,2013
72085,35.9,38777,60,16,38688,8809,18632,11889,8675,3214,11889,114500,2013
72087,34.1,29549,1,8,29529,6635,19085,9003,6793,2210,9003,106900,2013
72089,38.4,19918,297,96,19511,4879,18593,6862,4852,2010,6862,109700,2013
72091,38,43497,418,28,43012,11384,18046,15797,11494,4303,15797,113500,2013
72093,37,6552,0,9,6543,1329,15104,1799,1335,464,1799,97700,2013
72095,39.1,12070,12,0,12058,3072,18446,4133,2997,1136,4133,98200,2013
72097,37.6,87161,718,96,86078,20155,15112,30844,18101,12743,30844,96700,2013
72099,35.8,39755,215,0,39429,8875,14717,11631,8672,2959,11631,96400,2013
72101,33.8,32609,0,1,32580,7364,14797,9360,7282,2078,9360,103100,2013
72103,34.7,26867,242,1,26613,6139,17132,8532,6485,2047,8532,100900,2013
72105,35.8,30256,13,0,30153,6594,16685,8245,6061,2184,8245,100400,2013
72107,35.1,23194,77,0,23117,5085,14743,6845,5192,1653,6845,108400,2013
72109,39.4,19017,30,0,18973,4250,14506,6398,4846,1552,6398,93600,2013
72111,34,23783,207,15,23530,5874,14938,7498,5854,1644,7498,86500,2013
72113,37.3,162793,771,137,161734,39380,17211,55766,37261,18505,55766,106700,2013
72115,37.4,25738,62,0,25637,6795,15221,8795,5338,3457,8795,112200,2013
72117,41.3,15094,682,75,13917,3917,15842,5641,4438,1203,5641,121400,2013
72119,37.3,54035,214,56,53764,12914,22947,16845,13152,3693,16845,118000,2013
72121,38.8,24974,372,0,24602,5482,16458,7152,5492,1660,7152,97700,2013
72123,35.4,30807,80,40,30673,7865,13495,10868,8382,2486,10868,85800,2013
72125,40.3,35070,102,3,34951,8085,15696,12019,8569,3450,12019,98300,2013
72127,39.4,387336,5136,1091,379728,90170,22754,148767,81441,67326,148767,166400,2013
72129,37.3,40701,166,1,40433,10179,17743,13237,9284,3953,13237,132300,2013
72131,39.7,41798,359,4,41410,9635,14463,12881,8675,4206,12881,113100,2013
72133,34.3,23231,0,19,23212,5715,18033,7818,5983,1835,7818,96300,2013
72135,34.8,74561,234,32,74295,18340,28255,22108,17948,4160,22108,152400,2013
72137,36.3,88195,406,132,87439,21610,23934,29945,22479,7466,29945,132200,2013
72139,36.8,73970,367,16,73576,17857,31261,24642,17336,7306,24642,162300,2013
72141,38.6,32593,146,36,32361,7813,14852,10247,6707,3540,10247,99900,2013
72143,35.8,39856,641,3,39187,9072,18184,11732,9320,2412,11732,123300,2013
72145,37,58782,1411,17,57354,13419,16453,17384,14433,2951,17384,118300,2013
72147,41.8,9273,290,11,8959,1820,17355,2785,2297,488,2785,118300,2013
72149,34.4,25618,35,1,25480,6269,16754,7823,6010,1813,7823,98100,2013
72151,37.6,37404,63,79,37249,9056,17264,11908,8783,3125,11908,95800,2013
72153,39.2,41194,352,28,40787,8580,15053,11466,8876,2590,11466,93700,2013
01001,37.9,55136,42033,10156,1391,14272,52475,20304,15248,5056,20304,136600,2014
01003,41.8,191205,159047,17833,8630,50624,50183,73058,52203,20855,73058,168800,2014
01005,38.3,27119,12505,12528,1283,6003,35634,9145,6181,2964,9145,89500,2014
01007,40,22653,16936,4791,455,5344,37984,7078,5449,1629,7078,96300,2014
01009,40.2,57645,50820,847,4880,15682,44409,20934,16416,4518,20934,117700,2014
01011,38.5,10693,2372,7640,431,2265,34804,3746,2727,1019,3746,68900,2014
01013,40.5,20523,11006,8975,233,5384,31571,8253,5770,2483,8253,76000,2014
01015,38.8,117186,85871,24186,4017,30601,40919,45348,31077,14271,45348,103300,2014
01017,43.1,34091,19651,13715,158,8818,32835,13901,9331,4570,13901,82400,2014
01019,45.2,26042,23929,1240,375,8543,34983,11726,9069,2657,11726,98500,2014
01021,38.3,43781,35342,4438,3366,12097,41785,16281,12270,4011,16281,98800,2014
01023,44.6,13546,7551,5847,56,3621,34325,5526,4537,989,5526,59100,2014
01025,41.1,25331,13548,11401,110,6341,30951,9791,6868,2923,9791,84700,2014
01027,43.6,13617,10900,1986,424,3834,35286,5572,4087,1485,5572,82200,2014
01029,41.3,14990,13897,430,331,4006,37008,5639,4378,1261,5639,101000,2014
01031,38.2,50726,36434,8576,3236,12973,45558,19086,13233,5853,19086,137000,2014
01033,42.3,54491,43099,8691,1276,15419,39914,22442,15976,6466,22442,99900,2014
01035,43.6,12985,6629,5814,206,3314,24433,5030,3883,1147,5030,65800,2014
01037,44.8,11247,7311,3524,238,2875,32340,4446,3610,836,4446,73100,2014
01039,42.6,37881,31656,4849,564,10283,36256,14979,11329,3650,14979,90600,2014
01041,41,13938,9873,3269,229,3619,37349,5424,3921,1503,5424,68100,2014
01043,40.5,80668,74464,886,3481,22013,39415,31160,23501,7659,31160,107000,2014
01045,36.6,50013,35116,9528,2929,12958,44473,19470,11953,7517,19470,103300,2014
01047,37.9,42743,12251,29738,160,9762,26494,16259,9892,6367,16259,79200,2014
01049,38.8,71074,57599,1179,9922,17854,37977,24743,18592,6151,24743,95300,2014
01051,37.6,80321,59434,16493,2180,20673,54159,28617,21633,6984,28617,143800,2014
01053,39.4,38042,23179,12339,768,9464,31422,13737,9677,4060,13737,88000,2014
01055,40.5,104126,81954,15955,3669,27577,38467,40001,28337,11664,40001,100400,2014
01057,43.4,17019,14559,2081,128,4813,33144,6967,5058,1909,6967,72700,2014
01059,38.5,31663,24970,1391,4882,8438,35450,12247,8364,3883,12247,86300,2014
01061,41.9,26816,22582,2557,947,7819,36268,10898,7972,2926,10898,78100,2014
01063,42.5,8798,1559,7102,39,1984,22170,3282,2344,938,3282,69100,2014
01065,40.6,15393,6128,8974,164,3932,30839,5931,4556,1375,5931,86800,2014
01067,43.1,17270,11767,4777,418,4709,42926,6900,5366,1534,6900,93900,2014
01069,38.7,103079,70059,26765,3251,26351,41077,39464,25516,13948,39464,121600,2014
01071,42.1,53012,47536,1715,1413,14448,36874,20425,15213,5212,20425,93800,2014
01073,37.4,658834,337392,277526,25116,165855,45239,259397,165697,93700,259397,141300,2014
01075,42.6,14268,12270,1659,195,4497,36021,6147,4528,1619,6147,66800,2014
01077,40.9,92780,78934,9179,2174,25304,42703,38691,26986,11705,38691,115300,2014
01079,41.6,33835,25899,3743,663,9553,40356,13312,10811,2501,13312,92400,2014
01081,30.2,147790,101394,33782,5434,34771,43641,56637,34197,22440,56637,150100,2014
01083,38.8,87167,67850,11113,4934,23200,49461,32156,24454,7702,32156,138100,2014
01085,40.4,10918,2754,8024,102,2818,25678,4287,3178,1109,4287,69100,2014
01087,37.8,20505,3255,16627,305,4916,30254,8039,5284,2755,8039,73400,2014
01089,37.6,343229,225888,81479,15984,88295,58203,135409,93421,41988,135409,166500,2014
01091,42.1,20489,9389,10472,425,5553,33714,8477,6060,2417,8477,89600,2014
01093,43.8,30527,28105,1083,706,9022,33819,12602,9503,3099,12602,77700,2014
01095,38.6,94121,78149,1692,11830,24645,39473,34524,24768,9756,34524,114600,2014
01097,36.9,414045,242009,144312,10710,103593,43844,154400,102973,51427,154400,124500,2014
01099,40.9,22509,12333,9392,234,5563,30569,8390,6033,2357,8390,78800,2014
01101,34.9,228850,85400,126780,7956,57018,44830,89143,53528,35615,89143,123100,2014
01103,39.1,119744,92275,14277,9304,31503,45341,45856,32616,13240,45856,121900,2014
01105,36.3,10203,3045,6974,88,2333,25528,3263,2204,1059,3263,61700,2014
01107,42.3,19629,10920,8387,154,5169,29839,7741,5576,2165,7741,85600,2014
01109,31.1,33216,18995,12087,750,7987,32798,12909,7513,5396,12909,101900,2014
01111,42,22724,17095,4515,658,6213,36498,9016,6432,2584,9016,89700,2014
01113,35,56980,28839,23592,2592,13933,36066,21568,12636,8932,21568,108600,2014
01115,39.5,85242,73778,7888,1861,22995,51317,31673,25535,6138,31673,135200,2014
01117,37.5,201168,159233,23009,11892,53369,69723,74790,58945,15845,74790,192200,2014
01119,36.8,13433,3288,9805,63,3039,22865,4962,3481,1481,4962,72500,2014
01121,40.3,81673,52292,26002,1742,22135,35896,31277,22337,8940,31277,93100,2014
01123,42.5,41295,28551,11328,1036,11418,38644,16437,11614,4823,16437,101200,2014
01125,31.6,198670,126998,60158,6319,45044,46448,68103,43975,24128,68103,154500,2014
01127,42.4,66211,59498,3618,1438,18234,36712,25571,18946,6625,25571,81600,2014
01129,40.2,17137,11195,4119,200,4602,44731,6218,5392,826,6218,86200,2014
01131,39.3,11367,3082,8197,68,2547,23406,3843,2832,1011,3843,72500,2014
01133,43.9,24256,22916,127,665,6545,34064,9526,7204,2322,9526,84200,2014
02013,41.3,3296,456,332,441,348,59886,577,324,253,577,122400,2014
02016,38.4,5650,1633,289,596,645,82284,1105,388,717,1105,213600,2014
02020,32.6,298178,182096,16625,24687,70004,78121,105164,62928,42236,105164,286600,2014
02050,26.5,17576,1988,117,281,3328,51930,4441,2818,1623,4441,185100,2014
02060,40.1,995,532,3,56,260,82500,398,216,182,398,186500,2014
02068,39.1,2048,1731,39,49,405,79167,722,521,201,722,196100,2014
02070,29,4956,877,11,130,914,54846,1353,795,558,1353,198000,2014
02090,30.6,99319,72005,4228,6857,23044,70408,35844,20976,14868,35844,215000,2014
02100,43,2557,2056,1,32,664,57551,1144,791,353,1144,188700,2014
02105,47.5,2126,1052,12,38,557,50268,909,564,345,909,219400,2014
02110,37.3,32200,21398,376,1884,7890,84750,12081,7692,4389,12081,318000,2014
02122,40.5,56687,46519,314,1982,14112,63099,21559,15770,5789,21559,210400,2014
02130,38.8,13676,8951,55,636,3211,61712,5305,2985,2320,5305,261600,2014
02150,32.3,13924,7206,113,1128,3492,70529,4560,2724,1836,4560,241200,2014
02164,28.9,1490,312,8,31,365,47143,510,330,180,510,146100,2014
02170,34.7,93843,76444,768,3982,22285,72134,31104,23708,7396,31104,220100,2014
02180,27.9,9792,1621,64,168,2107,47579,2839,1581,1258,2839,132700,2014
02185,34.3,9618,3097,43,318,1509,74609,1977,970,1007,1977,152700,2014
02188,26,7672,894,24,112,1483,63971,1886,1029,857,1886,121900,2014
02195,41.8,3212,2276,74,242,835,61492,1367,911,456,1367,225400,2014
02198,40,6356,2935,19,185,1502,46387,2377,1661,716,2377,162600,2014
02220,38.5,8957,5687,89,503,2160,69635,3513,2025,1488,3513,335800,2014
02230,42.2,996,766,0,31,208,72868,387,220,167,387,323100,2014
02240,35.1,7044,5459,75,306,1466,65481,2156,1466,690,2156,203500,2014
02261,37,9685,6820,29,411,2265,81736,3225,2346,879,3225,193200,2014
02270,22.5,7778,311,21,20,1435,40943,1690,1272,418,1690,119800,2014
02275,54.4,2383,1697,4,23,636,48324,1163,837,326,1163,167100,2014
02282,40.5,635,237,37,27,160,69306,265,125,140,265,156800,2014
02290,35,5651,1228,17,91,1262,37796,2057,1442,615,2057,100500,2014
04001,33,72142,14126,414,4428,12962,32396,19046,14614,4432,19046,81900,2014
04003,39.6,130807,74920,4850,43777,32402,45974,48846,33223,15623,48846,141300,2014
04005,31,135817,74410,1792,18683,30050,48540,46391,27667,18724,46391,217200,2014
04007,48,53242,34203,280,9807,13589,40042,20824,15072,5752,20824,134100,2014
04009,32,37311,19402,739,11672,8010,46965,10975,7942,3033,10975,123700,2014
04011,33.5,8800,4163,125,4161,2488,50818,3446,1589,1857,3446,83200,2014
04012,54.6,20348,12396,49,5037,5914,37009,9707,7485,2222,9707,81800,2014
04013,35.3,3947382,2281134,192604,1181100,935257,53689,1424244,873599,550645,1424244,175600,2014
04015,48.6,202482,159353,1890,31101,51377,38456,80529,54904,25625,80529,124600,2014
04017,35.4,107489,46229,467,11779,24401,36591,34018,24088,9930,34018,106500,2014
04019,37.9,993144,537726,32167,351329,238491,46233,386155,238500,147655,386155,161700,2014
04021,36.6,390160,226838,17388,113046,90877,50248,126128,92021,34107,126128,122500,2014
04023,36.2,47250,7426,112,39134,11725,38802,15514,10095,5419,15514,137800,2014
04025,50.8,213689,173956,1142,29702,57762,44000,91508,64048,27460,91508,181100,2014
04027,33.6,201453,68571,3601,122270,54094,41380,69915,48447,21468,69915,113500,2014
05001,41.6,18861,13289,4733,549,4930,37813,7787,5289,2498,7787,74800,2014
05003,40.7,21437,14573,5587,1074,6025,35136,8518,6389,2129,8518,63800,2014
05005,51.1,41154,39277,115,760,11844,35594,18237,13919,4318,18237,119700,2014
05007,34.9,232611,175546,3051,36821,61934,56325,83191,56451,26740,83191,148500,2014
05009,41.5,37169,35167,58,796,10349,38705,14855,10719,4136,14855,109000,2014
05011,40.3,11316,6484,3209,1551,3258,33745,4720,3318,1402,4720,64400,2014
05013,44.9,5266,3855,1300,45,1456,35000,2062,1650,412,2062,67800,2014
05015,44.7,27626,22743,177,3833,7471,36897,11069,8182,2887,11069,114300,2014
05017,42,11489,4555,6202,594,2998,28086,4495,3058,1437,4495,55200,2014
05019,34.1,22800,15919,5446,974,5369,34109,8467,5378,3089,8467,84300,2014
05021,43.8,15577,14999,14,253,4396,32057,6729,4985,1744,6729,64100,2014
05023,46.8,25793,24581,112,590,6886,40768,10292,7944,2348,10292,121700,2014
05025,41.4,8597,7312,996,73,2438,41586,3270,2574,696,3270,81300,2014
05027,35.8,24400,14455,8784,617,6553,37509,9509,6476,3033,9509,78500,2014
05029,40.1,21175,17376,2502,787,5959,37314,8370,6296,2074,8370,88100,2014
05031,33.4,99835,78721,13585,4545,25754,42085,38081,22447,15634,38081,127400,2014
05033,38.6,61825,53282,841,3987,17771,40712,23490,17718,5772,23490,107600,2014
05035,34.2,50172,22413,25645,1094,12742,37781,18253,10446,7807,18253,101100,2014
05037,40.1,17595,12995,3922,293,4824,37725,6882,4372,2510,6882,81000,2014
05039,43.4,7954,4286,3285,202,2161,32554,3322,2197,1125,3322,59700,2014
05041,39.6,12602,5861,6064,575,3206,28457,5166,2961,2205,5166,56900,2014
05043,37.7,18705,12578,5377,511,4928,32351,7344,4511,2833,7344,87400,2014
05045,31.5,117804,96357,12889,4697,28925,51095,42964,27295,15669,42964,141700,2014
05047,40.3,17960,16719,132,460,4698,39879,6783,5137,1646,6783,91900,2014
05049,47.6,12218,11732,22,132,3657,36244,5312,4069,1243,5312,88000,2014
05051,44.1,96804,80697,7993,4935,25624,39558,39876,27022,12854,39876,130200,2014
05053,39.7,18014,16824,459,439,5061,46074,6798,5234,1564,6798,101600,2014
05055,38.2,42970,40747,362,1052,11520,39500,16610,10790,5820,16610,101700,2014
05057,38.9,22419,12561,6599,2776,5395,32587,8115,5565,2550,8115,74900,2014
05059,40.2,33277,27736,3935,1014,8567,41353,12027,8566,3461,12027,83300,2014
05061,37.3,13685,9106,2968,1409,3572,38050,5085,3309,1776,5085,79000,2014
05063,38.5,36861,32972,913,2183,9905,36186,14405,10084,4321,14405,91300,2014
05065,47.4,13522,12764,151,227,3728,31219,5656,4519,1137,5656,74000,2014
05067,40.9,17746,13839,2943,477,3965,31512,6402,4336,2066,6402,58200,2014
05069,38,74655,30447,41362,1327,17959,36799,28488,18165,10323,28488,81400,2014
05071,38.1,25791,21197,394,3334,6956,32553,10023,7024,2999,10023,86800,2014
05073,43.7,7391,4415,2787,138,1778,31215,2827,2053,774,2827,56800,2014
05075,40.8,17163,16533,137,190,4369,33481,6630,4665,1965,6630,62700,2014
05077,40.1,10151,4174,5744,220,2240,26986,3488,1940,1548,3488,56800,2014
05079,37.2,14113,9211,4142,485,3066,32615,4195,2923,1272,4195,57300,2014
05081,41.1,12852,9476,2630,384,3578,39494,5241,4055,1186,5241,74400,2014
05083,42.6,22129,20319,400,544,5880,36062,8439,6215,2224,8439,80000,2014
05085,35.4,70118,61205,4316,2591,19095,52805,25572,18475,7097,25572,121900,2014
05087,41,15696,14327,18,808,4533,37351,6152,4791,1361,6152,89600,2014
05089,50.9,16534,15728,44,350,4704,33293,6912,5475,1437,6912,95300,2014
05091,37.6,43537,30532,10673,1222,11188,40829,16946,11093,5853,16946,92400,2014
05093,35.2,45385,27234,15560,1703,12010,34424,17188,10068,7120,17188,78000,2014
05095,44.7,7855,4346,3242,154,2068,27571,3374,2133,1241,3374,54100,2014
05097,47.9,9296,8554,58,337,2541,32293,3813,3105,708,3813,76600,2014
05099,41.5,8877,5721,2702,267,2196,31614,3596,2619,977,3596,64300,2014
05101,47.5,8131,7684,4,78,2311,32500,3346,2852,494,3346,72400,2014
05103,42.6,25421,14223,10089,469,6959,32220,10502,7162,3340,10502,67800,2014
05105,42.6,10350,9620,311,275,2777,42030,3926,3310,616,3926,77200,2014
05107,37.6,20847,7304,12898,312,5322,27183,8291,4318,3973,8291,63500,2014
05109,41.1,11187,9818,327,736,3127,32045,4352,3213,1139,4352,74700,2014
05111,39.8,24359,21493,1902,605,6384,33238,9314,5736,3578,9314,71300,2014
05113,43.5,20454,18237,46,1241,5406,33558,7994,6075,1919,7994,85100,2014
05115,35.3,62687,53790,1879,4807,15667,40818,22776,15715,7061,22776,115900,2014
05117,45.2,8475,7248,1048,88,2588,36904,3776,2710,1066,3776,71300,2014
05119,36.2,388752,212221,137287,22845,93304,46410,153323,92448,60875,153323,141600,2014
05121,42.1,17794,16999,126,309,5142,36487,7293,5464,1829,7293,70000,2014
05123,37.2,27642,11525,14225,1180,6130,31336,9351,5356,3995,9351,65600,2014
05125,38.7,111811,98166,6078,4442,30053,55697,41702,32389,9313,41702,139300,2014
05127,40.9,11024,9326,29,812,3014,36754,4125,3109,1016,4125,78600,2014
05129,46.7,8036,7587,26,145,2014,33610,3179,2508,671,3179,85400,2014
05131,36.9,126801,91171,7574,16330,32420,39208,49424,30623,18801,49424,113800,2014
05133,34.5,17250,10300,785,5506,4271,36218,5918,4195,1723,5918,68200,2014
05135,46.8,17117,16170,57,324,4596,30826,7053,5473,1580,7053,73600,2014
05137,48,12531,12178,19,192,3325,29982,5267,4056,1211,5267,91200,2014
05139,39.7,40954,25252,13496,1465,11404,38762,16689,11597,5092,16689,72800,2014
05141,47,17090,16030,102,484,4729,31030,7077,5286,1791,7077,86000,2014
05143,31.2,212238,154358,6998,33740,50396,41983,80457,44619,35838,80457,149400,2014
05145,36,78275,69633,3349,3133,21106,42852,29447,20225,9222,29447,103200,2014
05147,43.6,7094,4928,1937,41,1839,27165,3055,1903,1152,3055,57600,2014
05149,38.8,21934,17190,230,4171,5265,37378,7825,5273,2552,7825,94300,2014
06001,36.9,1559308,519375,179984,352500,362173,73775,551734,291645,260089,551734,509300,2014
06003,43.6,1202,830,11,86,262,61343,377,308,69,377,313800,2014
06005,49.6,37159,29696,781,4724,9131,52964,13939,10546,3393,13939,251800,2014
06007,36.9,221578,164509,2996,32968,51044,43165,85215,50593,34622,85215,220100,2014
06009,50.3,44921,37234,280,4901,12609,54936,18608,14692,3916,18608,242600,2014
06011,34.1,21424,8184,180,12155,5147,50503,6912,4393,2519,6912,174500,2014
06013,38.7,1081232,503515,93141,267859,269678,79799,380183,247153,133030,380183,417400,2014
06015,39.2,28066,17906,991,5231,5852,39302,9527,5678,3849,9527,180100,2014
06017,44.4,181465,143978,1533,22411,47617,68507,67220,49833,17387,67220,356900,2014
06019,31.2,948844,300279,45398,485914,214330,45201,292550,155487,137063,292550,191700,2014
06021,36.7,28019,15244,217,10906,6600,40106,9561,5892,3669,9561,214600,2014
06023,37.4,134876,102908,1581,13940,30273,42153,53130,29121,24009,53130,281300,2014
06025,31.9,177026,22957,4802,144090,36679,41772,46952,26135,20817,46952,145200,2014
06027,45.3,18439,11951,192,3730,4349,45625,7891,5007,2884,7891,235200,2014
06029,31,857730,319419,45563,432370,194671,48574,257737,147334,110403,257737,161800,2014
06031,31.2,151390,52180,9412,78911,31998,47341,41108,21358,19750,41108,170000,2014
06033,45.2,64209,46876,1430,11601,16240,35997,26771,16795,9976,26771,167900,2014
06035,37.3,33356,22024,2852,6040,6296,53351,9821,6248,3573,9821,176500,2014
06037,35.3,9974203,2711665,802132,4800491,2174805,55870,3242391,1503915,1738476,3242391,425100,2014
06039,33.3,152452,56174,4927,84009,33265,45490,42723,25930,16793,42723,179100,2014
06041,45.1,256802,185603,6459,40414,64194,91529,103034,64490,38544,103034,785100,2014
06043,50.2,17946,14790,155,1729,4905,50560,7289,5309,1980,7289,240300,2014
06045,42,87612,58871,631,20332,20144,43290,33693,19135,14558,33693,310300,2014
06047,30.2,261609,79818,8676,147270,59029,43066,76516,40310,36206,76516,152600,2014
06049,47.1,9335,7301,108,1345,2348,38560,3893,2820,1073,3893,157300,2014
06051,37.2,14193,9519,47,3843,2978,61814,5160,2853,2307,5160,324600,2014
06053,33.3,424927,135763,10907,239901,91099,58582,125115,62089,63026,125115,362100,2014
06055,40.3,139253,76531,2853,45937,34468,70925,49631,29997,19634,49631,439000,2014
06057,48.8,98606,84772,344,8751,26312,56949,40838,29617,11221,40838,344800,2014
06059,36.7,3086331,1323581,47072,1050771,721785,75998,1002285,583146,419139,1002285,532300,2014
06061,40.7,361518,270962,4504,47800,94256,73747,134111,94577,39534,134111,345900,2014
06063,50.6,19286,16295,135,1594,5112,48032,8529,6096,2433,8529,231400,2014
06065,34.2,2266899,868743,133798,1055027,510655,56592,690388,453356,237032,690388,236400,2014
06067,35.3,1450277,686482,140377,319934,340777,55615,519460,290450,229010,519460,236500,2014
06069,34.8,56888,21125,483,32657,13639,67874,17121,10610,6511,17121,357200,2014
06071,32.2,2078586,660447,170307,1050173,460308,54100,607604,370032,237572,607604,225400,2014
06073,34.9,3183143,1510851,150600,1039752,723355,63996,1083811,578412,505399,1083811,412800,2014
06075,38.6,829072,343368,45653,126524,159647,78378,348832,127689,221143,348832,765700,2014
06077,33.2,701050,244319,47251,278523,162293,53253,217343,123584,93759,217343,211300,2014
06079,39.5,274184,192262,5372,58889,65084,59454,102350,59381,42969,102350,426200,2014
06081,39.4,739837,304779,18352,187635,175308,91421,258683,153322,105361,258683,736800,2014
06083,33.6,431555,201923,6934,188743,93059,63409,142028,74300,67728,142028,446500,2014
06085,36.6,1841569,627346,44910,492546,440578,93854,614714,350103,264611,614714,664100,2014
06087,36.9,267203,156915,2269,87406,59085,66923,94219,54749,39470,94219,559500,2014
06089,41.9,178520,145485,1692,15908,44541,44556,68961,43687,25274,68961,213700,2014
06091,53.5,3019,2636,4,283,840,43107,1291,978,313,1291,195700,2014
06093,47.3,44261,34749,565,4923,12050,37495,19380,12228,7152,19380,185400,2014
06095,37.2,421624,169041,57919,104865,102042,67341,142521,85815,56706,142521,263600,2014
06097,40.5,491790,320735,6594,125674,117825,63799,186935,111419,75516,186935,414500,2014
06099,33.3,522794,237248,13055,225013,124916,49573,168090,96098,71992,168090,175400,2014
06101,35,95067,46558,1744,27931,23137,51527,31723,18735,12988,31723,189600,2014
06103,40,63284,44728,286,14539,16245,42369,23480,16058,7422,23480,170300,2014
06105,50,13515,11235,110,960,3394,36862,5521,3894,1627,5521,258500,2014
06107,30.1,451108,141322,5997,279022,104044,42863,132706,75974,56732,132706,161000,2014
06109,48.2,54347,44017,998,6048,14709,48493,22181,15372,6809,22181,262600,2014
06111,36.9,835790,397118,13499,344520,197214,77335,267829,172637,95192,267829,444800,2014
06113,31,204162,99540,4605,63249,43978,55508,70953,37180,33773,70953,317700,2014
06115,32.1,73059,41919,2261,19181,17914,45470,24712,14360,10352,24712,170800,2014
08001,32.8,461558,242237,13753,177234,110183,57421,155047,100071,54976,155047,189400,2014
08003,30.8,16111,7969,248,7339,3592,31400,5993,3523,2470,5993,142100,2014
08005,36,596684,373627,58597,110721,151009,62213,228267,142463,85804,228267,235600,2014
08007,48.8,12132,9407,33,2209,3739,48186,5343,3746,1597,5343,264300,2014
08009,48.1,3735,3244,55,357,1087,38625,1637,1177,460,1637,71500,2014
08011,40.9,6000,3181,724,1863,1209,39053,1788,1185,603,1788,69800,2014
08013,35.7,305166,240384,2472,41482,71826,69407,121526,76007,45519,121526,358000,2014
08014,37.4,59027,46425,562,6869,15526,80430,22651,15760,6891,22651,284100,2014
08015,48.9,18121,15553,417,1802,5161,48528,7735,5855,1880,7735,265700,2014
08017,36.3,2153,1776,7,327,511,53900,788,606,182,788,84200,2014
08019,48,9114,8323,130,478,2504,68531,4103,3299,804,4103,273400,2014
08021,38.5,8276,3565,6,4530,2197,37357,3023,2401,622,3023,111000,2014
08023,50.6,3578,1128,0,2320,847,33594,1396,1081,315,1396,101200,2014
08025,39.9,5558,3177,438,1651,770,31534,1173,925,248,1173,73700,2014
08027,57.4,4274,3996,86,134,1337,32261,2125,1694,431,2125,215400,2014
08029,47.1,30378,25008,328,4390,8386,42389,12527,8996,3531,12527,190500,2014
08031,34,633777,334981,59987,197760,130387,51800,271054,134843,136211,271054,257500,2014
08033,46.3,1736,1530,0,119,456,32578,759,615,144,759,117400,2014
08035,37.2,299794,253272,2839,23870,82156,102626,105404,85040,20364,105404,340300,2014
08037,35.1,52233,35099,510,15692,11674,73774,18038,12153,5885,18038,435600,2014
08039,44.5,23545,21256,117,1390,6164,82154,8259,7346,913,8259,327300,2014
08041,33.6,645707,458845,36429,101403,163634,57487,240154,151792,88362,240154,214300,2014
08043,43.3,46879,35995,2682,6006,10670,40569,16600,11944,4656,16600,157400,2014
08045,35.6,56684,39067,275,15964,14539,57214,20330,13294,7036,20330,290600,2014
08047,43.3,5557,4934,20,447,1395,65851,2463,1827,636,2463,260000,2014
08049,42,14478,12773,91,1101,3262,64109,5208,3944,1264,5208,292700,2014
08051,34.2,15503,13676,57,1362,3604,51371,6336,3732,2604,6336,325800,2014
08053,57.5,871,835,0,19,281,55682,418,331,87,418,264800,2014
08055,52.1,6550,4022,41,2292,1707,32932,2864,2104,760,2864,154700,2014
08057,46.5,1389,1122,1,257,389,45606,644,443,201,644,124800,2014
08059,40.4,546162,432475,5399,81148,143112,69698,220814,154706,66108,220814,267200,2014
08061,40.4,1407,1248,11,85,365,39375,559,408,151,559,76400,2014
08063,38.4,8122,6099,279,1548,2061,41495,3053,2028,1025,3053,121600,2014
08065,39,7311,4906,38,2158,1764,46174,3106,1875,1231,3106,168800,2014
08067,38.5,52547,41941,179,6454,12778,58456,21124,14087,7037,21124,333100,2014
08069,35.5,311435,260863,2646,33750,77616,58844,122743,79788,42955,122743,251600,2014
08071,44.6,14789,7882,192,6235,3880,45707,5890,4218,1672,5890,151200,2014
08073,38.7,5462,3928,665,712,1158,43701,1757,1162,595,1757,124300,2014
08075,37.1,22604,18028,287,3589,4932,41749,7825,5290,2535,7825,122300,2014
08077,38.2,147509,121600,996,20161,38386,48610,58966,41098,17868,58966,203200,2014
08079,61.2,704,674,5,19,220,47986,375,320,55,375,280200,2014
08081,36.7,13286,10942,25,1896,3139,50123,4890,3607,1283,4890,177700,2014
08083,43.1,25569,18945,9,3020,6974,43431,10659,7424,3235,10659,184300,2014
08085,43.5,40885,31407,205,8199,11470,44885,16815,11793,5022,16815,194600,2014
08087,36.5,28342,17224,707,9811,7556,46223,10443,6593,3850,10443,135000,2014
08089,39.8,18712,10447,82,7642,4962,32594,7381,4797,2584,7381,93200,2014
08091,52.5,4532,4184,0,270,1272,60701,1969,1433,536,1969,389600,2014
08093,48.4,16174,14669,7,869,4703,60800,7184,6276,908,7184,244300,2014
08095,42.1,4385,3148,1,1097,1137,44390,1656,1128,528,1656,132900,2014
08097,43.3,17303,14993,224,1655,3675,71060,7357,4941,2416,7357,570700,2014
08099,37.4,12359,7608,31,4435,3396,35408,4925,3280,1645,4925,86200,2014
08101,38.8,160757,85833,2755,67523,40041,41974,62829,40786,22043,62829,137600,2014
08103,36.8,6739,5732,32,706,1825,63910,2644,1773,871,2644,199800,2014
08105,40.6,11840,6358,48,5166,3102,38673,4741,3132,1609,4741,126300,2014
08107,39.9,23428,21150,117,1601,5958,61095,9573,6803,2770,9573,378100,2014
08109,45.2,6211,3533,24,2436,1473,33398,2598,1782,816,2598,142200,2014
08111,45.3,653,482,0,142,151,37679,338,208,130,338,230300,2014
08113,40.1,7597,6655,17,706,1770,59490,3330,2060,1270,3330,511800,2014
08115,49.3,2365,1818,10,407,602,43864,932,649,283,932,84500,2014
08117,36.6,28482,23176,199,4136,5936,64521,10386,7008,3378,10386,461100,2014
08119,48.8,23363,20980,211,1379,6870,62559,9611,7835,1776,9611,232300,2014
08121,44.1,4781,4237,49,434,1374,44271,1986,1462,524,1986,111500,2014
08123,33.7,265066,177812,2541,75658,66401,58100,92369,64617,27752,92369,196100,2014
08125,36,10131,7815,56,2167,2164,43279,3833,2484,1349,3833,137200,2014
09001,39.6,934215,605136,96438,167047,231729,83163,333502,228331,105171,333502,422400,2014
09003,40,897374,579222,111463,145270,227653,65499,348204,226557,121647,348204,238600,2014
09005,45.4,187542,169779,2467,9297,50637,72068,75229,58127,17102,75229,259800,2014
09007,43.9,165534,141166,7498,8726,43563,77931,66372,50004,16368,66372,288300,2014
09009,39.6,863148,569982,103377,137844,209278,61646,327086,206556,120530,327086,250400,2014
09011,40.6,274071,211433,14446,25384,69435,66693,106882,71809,35073,106882,247700,2014
09013,38.3,152251,132010,4086,7157,37235,79988,54444,40282,14162,54444,252400,2014
09015,40.2,117918,99632,2268,12070,30027,59218,44487,31377,13110,44487,203200,2014
10001,36.8,167477,107420,39261,10648,41437,55169,59142,41937,17205,59142,200200,2014
10003,37.3,545846,329717,128460,49565,132832,64857,201543,139759,61784,201543,243400,2014
10005,46.5,203737,153081,25326,18385,53572,53505,78361,61164,17197,78361,231400,2014
11001,33.7,633736,224184,308766,62637,113596,69235,267415,111198,156217,267415,454500,2014
12001,30.5,251759,158603,49836,22071,50977,42045,96137,51472,44665,96137,164600,2014
12003,36.3,27057,22246,3844,598,6395,46865,8351,6419,1932,8351,118100,2014
12005,39.7,172988,135595,17508,9069,43717,47274,67388,41372,26016,67388,156500,2014
12007,40,27552,20465,5422,1029,5990,40481,8824,6691,2133,8824,93000,2014
12009,46.3,548891,420237,53964,48070,141708,48483,221582,160380,61202,221582,138500,2014
12011,39.8,1815269,750735,482429,480080,422787,51574,667578,430676,236902,667578,177300,2014
12013,39.1,14657,11334,1947,809,3221,34053,4756,3735,1021,4756,76200,2014
12015,56.9,163151,138848,9201,10287,46038,44265,70948,55801,15147,70948,140900,2014
12017,55,139771,124540,3995,6899,38734,38109,60670,49432,11238,60670,113500,2014
12019,38.7,194868,147565,18244,16524,51125,59103,68016,51230,16786,68016,153700,2014
12021,48,334474,216765,21947,88094,84634,56250,126331,92058,34273,126331,258400,2014
12023,40.4,67662,49892,11948,3523,15064,39194,23714,16985,6729,23714,106600,2014
12027,39.2,34785,19303,4421,10525,7536,36114,10964,7911,3053,10964,83800,2014
12029,45.9,16137,13846,1561,377,3850,35000,6020,4717,1303,6020,79000,2014
12031,35.9,880750,490026,255569,71540,208742,47582,334721,201882,132839,334721,144000,2014
12033,37.2,304099,200135,66171,15581,68224,44883,112395,70147,42248,112395,123000,2014
12035,48.9,98843,74528,10607,9172,25819,47733,35939,28660,7279,35939,163800,2014
12037,41.5,11636,9165,1719,564,2764,37815,4253,3106,1147,4253,128700,2014
12039,40.2,46865,15595,25691,4752,11318,36146,16986,12088,4898,16986,107900,2014
12041,41.3,16948,14827,1029,855,4428,40984,6274,5052,1222,6274,105300,2014
12043,43.1,13190,8041,1613,2817,2446,33609,3846,2844,1002,3846,84100,2014
12045,43,15781,11673,2883,729,3710,40964,5381,3867,1514,5381,119900,2014
12047,40.3,14466,7966,4741,1318,3100,35629,4704,3489,1215,4704,69400,2014
12049,33.4,27549,13131,1883,11835,5775,36094,7534,5402,2132,7534,84200,2014
12051,33.3,38360,13109,4572,19167,8102,36504,11156,7832,3324,11156,72400,2014
12053,48.4,173792,140872,8674,19011,47629,40457,70183,55067,15116,70183,111800,2014
12055,51.9,98261,68388,9013,17678,25416,35911,39882,30660,9222,39882,87700,2014
12057,36.4,1279668,669999,200505,328820,303249,50122,477472,283064,194408,477472,156700,2014
12059,42.1,19741,17332,1355,513,4654,36236,6758,5418,1340,6758,83200,2014
12061,50.2,140918,108116,12345,16338,36275,44645,57342,42565,14777,57342,156300,2014
12063,41.1,49105,32368,12841,2245,10506,36310,15961,11959,4002,15961,86900,2014
12065,44.9,14335,8176,5210,567,3686,42866,5372,4011,1361,5372,127100,2014
12067,35.6,8821,6136,1483,1144,1839,35720,2706,2149,557,2706,106000,2014
12069,46.2,305010,222280,28928,39764,81749,45465,117657,87644,30013,117657,137900,2014
12071,46.4,647554,452551,52929,122812,161552,47908,246061,170487,75574,246061,150000,2014
12073,29.9,280882,163209,85980,16753,61082,46620,110669,58799,51870,110669,180600,2014
12075,46.1,40057,32174,3661,3122,10252,35483,15638,11961,3677,15638,89800,2014
12077,37.1,8302,6128,1396,491,1559,38990,2362,1852,510,2362,73200,2014
12079,41.4,18901,10321,7194,918,4488,33520,6651,5163,1488,6651,77500,2014
12081,46.3,335840,243767,29155,51384,87075,49228,133445,93971,39474,133445,163700,2014
12083,47.8,334771,243893,40888,38444,87761,39339,133137,101048,32089,133137,111500,2014
12085,50.5,149658,119152,8028,18890,38093,51703,60828,46294,14534,60828,191500,2014
12086,38.8,2600861,399395,441994,1696171,568570,43099,833541,458132,375409,833541,194100,2014
12087,46.7,75208,52315,4517,16306,16287,55449,28418,17205,11213,28418,379700,2014
12089,43.8,74918,65429,4908,2695,20460,55256,28068,21768,6300,28068,176200,2014
12091,37.1,188984,142830,16800,14774,48970,55768,73655,47598,26057,73655,181800,2014
12093,39.6,39398,25360,3329,9709,9075,35490,13213,9538,3675,13213,100900,2014
12095,34.2,1200241,531707,236918,337871,272230,47556,423609,237326,186283,423609,161900,2014
12097,35.7,289449,109258,27299,138512,67289,44551,90414,56511,33903,90414,124500,2014
12099,43.9,1359074,793341,234736,271524,327716,52878,529729,371761,157968,529729,194600,2014
12101,44.2,472745,370986,21185,59716,121950,44518,184806,139015,45791,184806,115700,2014
12103,46.9,925030,702358,93861,78298,222414,45574,402536,263545,138991,402536,146500,2014
12105,40.3,617323,390132,90118,115072,152115,43063,220556,153444,67112,220556,107100,2014
12107,43.9,73191,52693,11541,6848,18043,32714,27842,20937,6905,27842,86600,2014
12109,42.6,203402,172046,10777,11629,53386,65575,77443,58509,18934,77443,240400,2014
12111,43.3,283988,170801,53324,48603,72288,42665,107104,78524,28580,107104,120700,2014
12113,39.4,158240,132127,8252,7654,41765,58199,57583,42228,15355,57583,160200,2014
12115,53.5,386944,325136,16998,32402,105186,50304,172720,126928,45792,172720,172800,2014
12117,38.9,432135,280010,46242,78917,98345,57875,147932,102947,44985,147932,175100,2014
12119,64.5,103708,86867,8827,6025,31902,49874,45868,41407,4461,45868,199500,2014
12121,41.4,43404,32801,5640,3848,10955,37879,15583,10946,4637,15583,93800,2014
12123,41.2,22690,16463,4818,872,5112,36907,7464,5696,1768,7464,84000,2014
12125,40,15258,10784,3056,779,2742,41476,3816,2577,1239,3816,87000,2014
12127,46,498981,370295,50656,58558,122024,41714,197092,139861,57231,197092,133100,2014
12129,39.8,31015,24497,4631,1108,7949,53143,10905,8289,2616,10905,129900,2014
12131,43.3,57821,48855,3145,3313,14785,44468,22638,16422,6216,22638,161100,2014
12133,40.6,24660,19162,3622,808,5535,38563,8381,6470,1911,8381,84500,2014
13001,38.3,18421,12801,3451,1730,4613,38461,6878,4527,2351,6878,69500,2014
13003,35.1,8297,4722,1401,2016,1865,30403,2713,1944,769,2713,74000,2014
13005,36.3,11196,8391,1755,854,2712,37698,3953,2756,1197,3953,74200,2014
13007,44.3,3342,1765,1546,18,890,45526,1362,1014,348,1362,76500,2014
13009,34.2,45854,24688,18915,959,9647,31758,16194,8956,7238,16194,104300,2014
13011,39.5,18317,16259,509,1124,5113,42826,6703,5146,1557,6703,130700,2014
13013,34.4,70873,52508,8096,6530,17703,53256,23064,17649,5415,23064,122600,2014
13015,37.2,100771,79885,10573,7849,25806,48306,35293,23612,11681,35293,123900,2014
13017,38.6,17547,9975,6126,1066,4338,30643,6349,4211,2138,6349,80400,2014
13019,38.6,19091,15717,2070,929,4997,31812,7102,5166,1936,7102,80900,2014
13021,35.5,155237,63766,81268,4760,35861,36614,56660,30459,26201,56660,122000,2014
13023,37.3,12912,8931,3662,140,2704,35507,4019,2821,1198,4019,85500,2014
13025,38.7,18463,17137,687,382,4877,36301,6523,5103,1420,6523,66900,2014
13027,41.3,15766,9148,5506,844,4073,31686,6550,4562,1988,6550,91800,2014
13029,35.3,32185,24267,4774,1831,8805,65123,11231,7824,3407,11231,184800,2014
13031,26.1,71940,46210,20127,2579,15340,35642,25803,12990,12813,25803,128200,2014
13033,36.1,23136,10821,11515,659,5554,33299,7970,5749,2221,7970,79700,2014
13035,38.5,23469,15802,6548,681,5673,47385,7781,5783,1998,7781,122300,2014
13037,38.4,6549,2165,3935,340,1131,26309,1787,1170,617,1787,52400,2014
13039,31.6,51193,36222,9526,2925,13984,52799,18560,11382,7178,18560,151800,2014
13043,37.9,11056,6930,2713,1225,2705,30518,3944,2564,1380,3944,83400,2014
13045,33.9,111872,80882,20201,7080,27322,45009,39610,25574,14036,39610,115600,2014
13047,39.1,64955,59716,1684,1662,17480,50180,23813,17695,6118,23813,129300,2014
13049,38.7,13098,8233,3269,1445,2595,41059,3552,2790,762,3552,85000,2014
13051,34.2,275303,137615,108646,15990,62819,46987,103807,58158,45649,103807,171100,2014
13053,23.3,11846,7216,2078,1699,2005,48488,2602,730,1872,2602,83100,2014
13055,40.4,25484,21074,2859,1136,6356,32496,9347,6419,2928,9347,66700,2014
13057,37,221951,178700,12948,21900,58719,67371,77654,60780,16874,77654,186900,2014
13059,26.4,119681,67761,31510,12682,20663,33430,42107,17929,24178,42107,152700,2014
13061,38.4,3110,927,1995,138,714,21300,1170,666,504,1170,63700,2014
13063,32.3,264221,36924,172549,35231,56955,40314,87490,47133,40357,87490,89100,2014
13065,36.5,6777,4513,1805,268,1636,29125,2579,1722,857,2579,66500,2014
13067,35.9,708920,390157,179819,88665,179929,64657,264805,172044,92761,264805,194900,2014
13069,35,42947,25662,11777,4533,9932,34523,14597,9828,4769,14597,79700,2014
13071,35.2,45987,26590,10673,8155,11528,32233,15893,10262,5631,15893,79300,2014
13073,36.5,132362,95250,21054,7508,35035,68516,44764,35260,9504,44764,170100,2014
13075,36.7,17061,11084,4678,1010,4734,34230,6255,4390,1865,6255,83200,2014
13077,37.3,131419,94767,22830,8833,35384,61662,47666,35303,12363,47666,178800,2014
13079,42.7,12536,9222,2845,135,3453,41910,4655,3751,904,4655,86100,2014
13081,38.3,23403,12013,10080,760,6245,36280,8574,5208,3366,8574,89100,2014
13083,39.9,16533,15598,156,330,4620,44992,6175,4890,1285,6175,116800,2014
13085,41.5,22500,20880,99,889,6310,54457,8277,6233,2044,8277,174400,2014
13087,38.3,27508,14145,11402,1488,6974,31090,10473,6632,3841,10473,99800,2014
13089,34.9,707185,209985,376010,65649,154723,50799,264120,147784,116336,264120,163600,2014
13091,39.8,21365,13940,6170,741,5531,34812,8056,5121,2935,8056,70700,2014
13093,41.3,14443,6224,7145,971,3079,28251,4957,3373,1584,4957,63600,2014
13095,34.1,93890,26146,63217,2297,22464,31458,35585,16474,19111,35585,100800,2014
13097,35.6,135037,63484,54850,11740,34480,52997,46708,32113,14595,46708,125500,2014
13099,40.3,10662,5037,5332,201,2830,35000,4096,2718,1378,4096,83900,2014
13101,34.9,4018,2669,62,1141,1080,32667,1434,918,516,1434,71500,2014
13103,35.9,53673,43026,7421,1748,13595,63903,17942,13863,4079,17942,153700,2014
13105,41.6,19694,12603,5980,1020,5448,35170,7786,5280,2506,7786,81800,2014
13107,36.7,22731,13674,7603,1006,5507,33142,8003,5391,2612,8003,69400,2014
13109,35.8,10868,6163,3301,1328,2655,37804,3936,2489,1447,3936,88000,2014
13111,49.6,23632,22611,57,453,6586,35441,9684,7461,2223,9684,159400,2014
13113,43.2,107930,71654,21946,7300,29763,79993,38231,31168,7063,38231,229400,2014
13115,38.1,96146,69799,13942,9460,23342,41046,34794,21468,13326,34794,117500,2014
13117,37.6,189314,148291,5411,18184,48151,87657,59633,50733,8900,59633,260200,2014
13119,40.3,22051,18698,2033,917,5799,35878,8527,5907,2620,8527,109600,2014
13121,34.6,967100,392358,420903,74583,207151,56642,373005,196020,176985,373005,237600,2014
13123,44.4,28441,24689,129,2936,7718,39581,10959,8198,2761,10959,144700,2014
13125,40.5,3086,2718,238,44,815,40089,1155,876,279,1155,63800,2014
13127,40.5,80937,52105,20784,5205,21653,45588,31743,19426,12317,31743,157200,2014
13129,36.6,55666,43946,2427,8135,14078,42414,19320,12870,6450,19320,113100,2014
13131,38.5,25239,14937,7107,2656,6654,31653,9378,5458,3920,9378,107100,2014
13133,47.3,16190,8991,5918,995,4636,41390,6491,4817,1674,6491,164300,2014
13135,34.3,842091,354468,203563,171142,206956,60329,270773,182874,87899,270773,167700,2014
13137,38.9,43342,33968,1644,5693,10413,40689,14613,11033,3580,14613,129800,2014
13139,35.2,185318,116190,13511,49756,45317,51036,61361,41303,20058,61361,162200,2014
13141,43,9043,2145,6612,198,1657,24552,2787,2190,597,2787,66800,2014
13143,39.7,28563,26087,1487,365,7764,41482,10688,7516,3172,10688,105000,2014
13145,43.1,32539,25142,5409,989,9088,69060,11554,9880,1674,11554,201000,2014
13147,43.3,25406,19222,5006,876,6755,36867,10050,7563,2487,10050,114800,2014
13149,40.3,11674,9942,1186,260,2966,41354,4358,3272,1086,4358,86900,2014
13151,36,209069,105646,78662,12788,52852,60269,69717,51500,18217,69717,142300,2014
13153,34.6,145622,86111,42198,9262,36892,55170,52564,34668,17896,52564,132300,2014
13155,38.9,9482,6508,2759,76,2343,36729,3325,2416,909,3325,76900,2014
13157,38,60928,50647,4382,3982,15935,52857,20927,16228,4699,20927,156700,2014
13159,39.3,13647,9881,2846,546,3806,42099,5142,3836,1306,5142,113100,2014
13161,36.2,15028,10919,2370,1630,3834,36707,5383,4061,1322,5383,80600,2014
13163,38.1,16554,6914,9001,536,4135,26796,6100,3849,2251,6100,66800,2014
13165,39.2,8794,5088,3015,511,2279,28910,3411,2351,1060,3411,61900,2014
13167,40.5,9850,6127,3377,79,2282,36466,3253,2434,819,3253,66500,2014
13169,39.1,28783,20835,7246,369,7712,54512,10329,8197,2132,10329,131900,2014
13171,38.7,18128,11742,5570,376,4503,41038,6427,4591,1836,6427,120900,2014
13173,33.3,10356,7065,2539,530,2635,36904,3737,2377,1360,3737,102100,2014
13175,38.3,48028,28575,17381,1172,11995,33487,17614,11256,6358,17614,85700,2014
13177,36.3,28805,21331,5750,664,7768,60667,10060,7316,2744,10060,156400,2014
13179,27.7,64489,27593,25398,7176,17063,43209,22863,11209,11654,22863,124300,2014
13181,47,7800,5094,2497,23,2263,34596,3397,2603,794,3397,99100,2014
13183,31,15967,9445,4101,1923,3740,49317,5078,3375,1703,5078,97900,2014
13185,29.4,112515,61928,40238,5863,25423,37248,39718,20833,18885,39718,133100,2014
13187,35.9,30719,28013,599,1404,7114,42764,11096,7154,3942,11096,169700,2014
13189,38.7,21563,11944,8917,535,6021,37899,8177,5342,2835,8177,106300,2014
13191,47,14172,8650,4812,261,3358,45216,4991,3994,997,4991,120800,2014
13193,39.8,14232,4672,8831,216,2983,29295,4655,3041,1614,4655,69200,2014
13195,39.6,28142,23810,2319,1222,6923,43746,9819,7236,2583,9819,118800,2014
13197,41.9,8751,5127,2727,607,1958,36271,3114,2177,937,3114,103300,2014
13199,42.3,21434,12213,8346,406,5742,36606,8083,5407,2676,8083,88400,2014
13201,41.7,6017,4128,1820,67,1637,33224,2396,1746,650,2396,90700,2014
13205,37.3,23175,10743,11059,1015,5144,31101,8159,5233,2926,8159,80400,2014
13207,41.5,26788,19410,6378,597,7174,47815,9626,7220,2406,9626,150000,2014
13209,38.1,9000,5986,2363,525,2090,34653,3166,2301,865,3166,73400,2014
13211,41.8,17866,12836,4323,515,4816,49746,6408,5061,1347,6408,175600,2014
13213,37,39416,33114,362,5357,10524,34478,14020,9402,4618,14020,86200,2014
13215,33.3,198247,85068,87576,14018,46959,41362,72556,36878,35678,72556,134200,2014
13217,35.4,101503,51878,41463,4798,25457,49208,34516,25031,9485,34516,118500,2014
13219,39.3,33769,28931,1709,1541,9305,75057,11621,9186,2435,11621,235000,2014
13221,41.6,14695,11236,2215,567,4018,46901,5428,4234,1194,5428,125100,2014
13223,34.8,145565,108519,25369,7807,38807,61153,48472,38833,9639,48472,131800,2014
13225,33.9,27337,12309,12555,1926,6567,39085,9677,6293,3384,9677,123300,2014
13227,44.4,29550,27734,397,874,8527,50452,11019,8523,2496,11019,167500,2014
13229,38.8,18860,15862,1641,947,5098,41685,6857,5141,1716,6857,86200,2014
13231,38.5,17821,15377,1934,237,4879,51985,6096,5068,1028,6096,155800,2014
13233,37.2,41250,29778,5408,5170,10874,39121,14778,10176,4602,14778,102000,2014
13235,42.2,11693,7175,3844,558,2943,35430,4148,2622,1526,4148,87800,2014
13237,44.6,21226,13925,5744,1389,6214,44058,8457,6325,2132,8457,140400,2014
13239,44.1,2407,1094,1274,0,659,30313,1001,778,223,1001,63600,2014
13241,47.3,16267,14232,232,1329,4502,34043,6966,5061,1905,6966,160200,2014
13243,39.7,7411,2556,4567,57,2006,26837,2868,1847,1021,2868,73400,2014
13245,33.3,201244,74751,107963,8889,43597,37704,71776,38235,33541,71776,100400,2014
13247,37.2,86256,33381,41266,8516,21524,52341,29284,20441,8843,29284,143900,2014
13249,40.9,5054,3359,1319,325,1392,38537,1967,1263,704,1967,91200,2014
13251,40.4,14281,7825,6018,214,3363,34097,5252,3722,1530,5252,78200,2014
13253,43.9,8804,5515,2969,247,2399,34894,3310,2658,652,3310,76300,2014
13255,38,63946,38556,20973,2659,16474,40243,23013,14270,8743,23013,114600,2014
13257,40.9,25741,21467,3124,708,6608,40103,9260,6917,2343,9260,99500,2014
13259,39.7,5900,1629,3197,978,951,21880,1791,1135,656,1791,46100,2014
13261,34.3,31804,12885,16445,1652,7564,33694,11574,6883,4691,11574,85000,2014
13263,47.4,6594,2599,3813,115,1919,34073,2688,2084,604,2688,76900,2014
13265,45.8,1700,731,900,42,406,24783,682,480,202,682,57800,2014
13267,36.1,25356,14946,7318,2647,5494,35346,8036,5535,2501,8036,90100,2014
13269,41,8505,4966,3345,182,2532,30288,3584,2483,1101,3584,61600,2014
13271,39.4,16493,8306,5921,2229,3649,27760,5428,3223,2205,5428,58200,2014
13273,40.4,9304,3368,5607,204,2229,32602,3227,1919,1308,3227,81600,2014
13275,39.3,44733,25971,16498,1422,11190,35515,17352,10053,7299,17352,124200,2014
13277,34.8,40721,23145,11881,4339,9177,34830,13966,8366,5600,13966,116200,2014
13279,35.8,27272,16779,6928,3082,6872,31291,10579,6558,4021,10579,89400,2014
13281,52.1,10670,10191,81,248,2760,37425,4299,3537,762,4299,162700,2014
13283,40.1,6781,4501,2136,63,1716,40143,2596,1741,855,2596,73200,2014
13285,36.2,68375,40350,23082,2404,17281,41906,24597,14829,9768,24597,118300,2014
13287,38.2,8491,4621,3397,339,2164,29763,3086,1985,1101,3086,74600,2014
13289,45.5,8612,4803,3740,4,2236,31285,3033,2370,663,3033,55400,2014
13291,51.8,21553,20401,155,582,5744,39179,8447,6795,1652,8447,181400,2014
13293,41.8,26681,18156,7560,635,7307,34614,10363,6639,3724,10363,82600,2014
13295,40.5,68445,62731,2973,1214,18437,39688,26123,18792,7331,26123,100100,2014
13297,37.8,85378,66002,13271,3101,23085,53454,29490,21912,7578,29490,153500,2014
13299,38.5,35915,23171,10659,1269,9099,35247,13702,8616,5086,13702,79700,2014
13301,44.4,5626,2098,3385,3,1279,28929,2126,1444,682,2126,67700,2014
13303,39.9,20861,9198,10949,433,5044,34877,7122,5045,2077,7122,82300,2014
13305,37.3,30170,21559,6238,1836,7289,37970,10226,7046,3180,10226,85300,2014
13307,43.9,2744,1329,1415,0,748,31809,1175,912,263,1175,43500,2014
13309,37.6,7932,4514,3258,137,1274,27629,1877,1233,644,1877,61100,2014
13311,43.7,27594,25659,944,733,8101,40547,11507,8200,3307,11507,161700,2014
13313,34.6,103132,62959,3961,33644,25608,40081,34734,22364,12370,34734,120800,2014
13315,39.9,9061,5367,3344,170,1788,32545,2735,1983,752,2735,70000,2014
13317,44,10123,5275,4320,376,2475,30729,4078,2830,1248,4078,92800,2014
13319,40.9,9455,5434,3559,235,2325,37258,3343,2649,694,3343,71800,2014
13321,40,21365,14499,6143,423,5786,38339,8016,6102,1914,8016,69200,2014
15001,40.9,189382,58393,1252,22769,42664,51213,64586,42485,22101,64586,301500,2014
15003,37.2,975690,189172,22506,86894,217422,73581,310141,170342,139799,310141,564400,2014
15005,51.9,73,32,0,4,11,61250,46,2,44,46,NA,2014
15007,41.5,68745,20812,419,7013,15495,62946,22395,14046,8349,22395,483800,2014
15009,40,158814,49998,867,16805,36156,64567,53131,30440,22691,53131,510300,2014
16001,35.5,409239,351385,4165,30412,104286,55805,154408,103945,50463,154408,183300,2014
16003,51.3,3908,3663,0,117,1109,38583,1643,1313,330,1643,142800,2014
16005,32.4,83394,71457,566,6160,20073,43953,30277,20850,9427,30277,143800,2014
16007,39.1,5941,5590,9,237,1731,44974,2437,1983,454,2437,127200,2014
16009,45.2,9149,7752,39,282,2441,38963,3703,2678,1025,3703,135600,2014
16011,32.5,45558,34047,133,8013,11343,48088,14840,10931,3909,14840,136300,2014
16013,42.4,21269,16483,18,4316,6162,62489,9258,6205,3053,9258,373000,2014
16015,50.6,6880,6382,27,247,1850,41194,3038,2442,596,3038,187700,2014
16017,46.6,40899,38454,29,1029,11241,41879,17388,12540,4848,17388,215600,2014
16019,32.3,106703,90084,496,12898,27075,50897,36402,26641,9761,36402,154000,2014
16021,43.5,10903,9983,15,432,2826,39204,4101,2999,1102,4101,173500,2014
16023,43.4,2734,2488,43,105,675,41000,1028,830,198,1028,111400,2014
16025,40.2,1156,933,0,201,292,41250,465,310,155,465,154200,2014
16027,32.5,195353,140302,766,47473,47382,43108,64514,44476,20038,64514,120200,2014
16029,37.3,6857,6441,4,362,1936,54481,2683,2211,472,2683,124800,2014
16031,31.7,23275,16737,48,6004,5550,44847,7744,5393,2351,7744,128200,2014
16033,32.4,823,465,0,354,217,32770,282,175,107,282,100400,2014
16035,50.1,8600,7881,22,297,2334,39750,3560,2798,762,3560,131200,2014
16037,49.4,4284,4092,0,108,1184,39432,1783,1380,403,1783,154500,2014
16039,30.7,26349,19660,579,4186,6886,43516,9682,5905,3777,9682,131200,2014
16041,32.5,12853,11758,17,867,3247,45542,4241,3405,836,4241,159200,2014
16043,34.9,13024,11115,42,1622,3405,44991,4539,3676,863,4539,150100,2014
16045,43.8,16732,14781,4,1349,4429,41969,6400,4656,1744,6400,141900,2014
16047,35.9,15241,10494,3,4339,3889,38447,5433,3744,1689,5433,119000,2014
16049,48.4,16315,15010,11,471,4395,38320,6523,5207,1316,6523,151600,2014
16051,30.8,26620,23257,39,2736,6716,52495,8175,6878,1297,8175,155700,2014
16053,31.7,22580,14663,24,7369,5830,40718,7686,4884,2802,7686,138300,2014
16055,39.4,142783,130660,418,5819,38821,49292,55807,39177,16630,55807,184200,2014
16057,28.5,37989,34276,208,1468,8252,41944,15069,8207,6862,15069,189100,2014
16059,50.6,7828,7353,6,210,2275,34457,3868,2719,1149,3868,174800,2014
16061,48.4,3822,3358,3,145,1043,36159,1657,1215,442,1657,114800,2014
16063,33.7,5246,3565,15,1533,1205,41088,1608,1174,434,1608,112100,2014
16065,23,37754,34051,229,2419,8203,32052,10376,5023,5353,10376,174400,2014
16067,35.3,20191,13008,11,6668,5413,44220,7104,5169,1935,7104,109000,2014
16069,41.2,39655,34875,127,1287,10219,46608,16159,11205,4954,16159,166000,2014
16071,39.7,4241,4013,0,140,1239,43078,1657,1386,271,1657,130600,2014
16073,37.1,11412,7813,9,2959,2773,32589,3888,2543,1345,3888,123200,2014
16075,38.2,22658,18141,57,3590,5919,44326,8218,6197,2021,8218,128200,2014
16077,34.6,7742,5019,8,2366,1981,45010,2543,1698,845,2543,130300,2014
16079,47.1,12629,11710,44,415,3515,38006,5796,3930,1866,5796,117500,2014
16081,34.7,10212,8269,24,1770,2452,52316,3558,2534,1024,3558,220700,2014
16083,34.6,78933,64523,441,11449,20291,44138,28581,19018,9563,28581,150400,2014
16085,48.9,9662,9120,0,405,2121,49722,3240,2487,753,3240,207200,2014
16087,44.3,10068,7950,0,1745,2477,36483,3897,2844,1053,3897,132200,2014
17001,40.4,67113,62186,2474,890,17432,45472,26866,19089,7777,26866,106500,2014
17003,39.8,7821,4668,2805,162,1869,25495,2826,1856,970,2826,52800,2014
17005,40.2,17571,15508,817,579,4229,48120,6230,4721,1509,6230,106500,2014
17007,38.1,54005,40495,1205,10943,13949,60166,18162,14999,3163,18162,150900,2014
17009,37.3,6878,5099,1008,344,1340,45463,2124,1593,531,2124,85200,2014
17011,43.2,34361,30705,220,2805,9348,49921,14111,10603,3508,14111,102000,2014
17013,45.8,5033,4932,5,13,1471,52661,2052,1649,403,2052,111300,2014
17015,47.2,15027,14156,163,474,4258,49629,6531,5074,1457,6531,97000,2014
17017,39.6,13440,10412,449,2432,3452,47443,5205,3753,1452,5205,75700,2014
17019,29.2,204214,142589,25224,11165,42670,46680,79624,43745,35879,79624,149200,2014
17021,41.9,34415,32821,640,511,9033,45727,14089,10432,3657,14089,84100,2014
17023,43.3,16240,15768,58,206,4515,50412,6689,5007,1682,6689,88100,2014
17025,42.7,13675,13203,55,179,3659,43189,5410,4329,1081,5410,76000,2014
17027,40.1,37952,34836,1307,1127,9649,62407,13944,11525,2419,13944,130700,2014
17029,32.4,53655,49011,1885,1216,12090,38174,21017,12929,8088,21017,90400,2014
17031,35.7,5227827,2266635,1248338,1281217,1185299,54828,1937060,1115461,821599,1937060,222200,2014
17033,42.4,19626,17940,612,394,5078,46057,7644,6121,1523,7644,79100,2014
17035,41.2,10950,10657,41,79,2840,43825,4230,3412,818,4230,87100,2014
17037,29.8,104919,82527,6716,11053,22651,53771,37374,22280,15094,37374,169100,2014
17039,42.4,16461,15713,79,361,4430,53129,6746,5298,1448,6746,107000,2014
17041,38.3,19867,18147,92,1335,5286,51701,7534,5755,1779,7534,99100,2014
17043,38.7,926485,640577,41920,127142,239227,79016,337003,248836,88167,337003,279700,2014
17045,43.4,18171,17702,110,194,5435,43075,7912,5853,2059,7912,75700,2014
17047,43.4,6687,6499,38,78,1776,42779,2747,2265,482,2747,64300,2014
17049,39.2,34280,33103,104,626,9163,52374,13386,10605,2781,13386,118400,2014
17051,40.2,22041,20849,655,351,5449,44603,7981,6418,1563,7981,81700,2014
17053,43.1,13906,13251,74,353,3526,48908,5611,4223,1388,5611,91000,2014
17055,41.7,39774,38391,103,553,10366,37333,16243,12103,4140,16243,65300,2014
17057,42.4,36616,33837,895,950,9500,45938,14501,10936,3565,14501,81300,2014
17059,45,5439,5235,21,13,1614,40721,2351,1845,506,2351,63800,2014
17061,42.4,13677,13278,136,135,3847,43178,5689,4359,1330,5689,74600,2014
17063,36.8,50173,44184,685,4360,13176,65197,18408,13799,4609,18408,178800,2014
17065,43,8371,8171,56,118,2299,41801,3499,2741,758,3499,77000,2014
17067,45.8,18808,18245,80,233,5452,45741,7983,6293,1690,7983,84000,2014
17069,46.9,4226,3939,30,89,1098,38170,1731,1432,299,1731,68100,2014
17071,49.1,7074,6847,21,89,2124,48438,3116,2481,635,3116,86300,2014
17073,41.9,50031,45662,764,2554,13600,52518,20237,15681,4556,20237,110100,2014
17075,43.7,29272,26750,363,1753,7948,47184,11804,8925,2879,11804,96000,2014
17077,29.5,60125,45144,8450,2497,11848,32681,23471,12426,11045,23471,100400,2014
17079,43.1,9658,9425,16,110,2714,54133,3796,3275,521,3796,91800,2014
17081,40.9,38716,33503,2946,857,9853,43173,15289,11101,4188,15289,85400,2014
17083,42.1,22751,21984,120,263,6509,54391,8873,7117,1756,8873,121700,2014
17085,48.2,22427,21338,65,659,6401,52065,9555,7476,2079,9555,137200,2014
17087,42.8,12650,11063,1184,221,2977,41414,4380,3566,814,4380,88700,2014
17089,35.5,521874,305106,27475,162048,128588,70514,171316,127614,43702,171316,216000,2014
17091,37.3,112682,82076,16507,10584,28247,51000,41430,28401,13029,41430,143100,2014
17093,33.7,118194,86528,6703,19155,30066,83844,38453,31961,6492,38453,204100,2014
17095,41.5,52447,44181,4384,2706,12621,39800,21438,14329,7109,21438,80800,2014
17097,37.2,703170,451700,46644,143841,179476,77873,241846,181664,60182,241846,247300,2014
17099,41.6,112698,98659,2280,9569,29108,51232,43891,32654,11237,43891,123400,2014
17101,40.5,16726,12037,3460,894,3314,39569,4981,3788,1193,4981,66200,2014
17103,41.8,35248,30886,1624,1910,8921,52004,13468,9993,3475,13468,110700,2014
17105,41,38476,34179,2065,1629,9683,54723,14515,10578,3937,14515,109200,2014
17107,39.6,30047,24140,3371,960,7178,49882,10908,7557,3351,10908,97500,2014
17109,29.9,32388,28607,1605,865,7023,37959,12553,7757,4796,12553,87100,2014
17111,38.9,307888,255364,3563,36623,82682,76345,109221,89100,20121,109221,213400,2014
17113,32.4,172390,139277,13083,7946,39873,61955,64415,42813,21602,64415,158800,2014
17115,40.5,109833,85294,16562,2200,27807,46696,45153,31267,13886,45153,94000,2014
17117,42.1,47229,45612,140,453,13068,50911,19098,14560,4538,19098,96000,2014
17119,39.2,267937,231019,21348,7837,70767,53912,107298,76625,30673,107298,125100,2014
17121,41.5,38922,35818,1449,631,10399,41783,15835,11908,3927,15835,68500,2014
17123,45.8,12319,11734,59,356,3212,53914,4926,4103,823,4926,103200,2014
17125,44.9,14309,13884,93,152,3983,42476,6155,4675,1480,6155,80800,2014
17127,43.3,15148,13545,841,353,3851,43092,6013,4462,1551,6013,83200,2014
17129,42.7,12658,12195,108,152,3540,59989,5119,4123,996,5119,119900,2014
17131,44.3,16204,15623,69,327,4723,51259,6662,5206,1456,6662,93700,2014
17133,41.7,33373,32317,98,496,9626,69592,12557,10292,2265,12557,192400,2014
17135,41.6,29740,26396,2412,486,7463,45158,10923,8427,2496,10923,81100,2014
17137,40.9,35272,31566,2167,770,8933,46524,13961,9654,4307,13961,94600,2014
17139,41.1,14896,14508,40,163,4001,47438,5669,4400,1269,5669,96700,2014
17141,41.1,52782,46554,419,4871,13869,55894,20759,15735,5024,20759,143600,2014
17143,36.8,187197,134242,32703,7910,47511,51454,76019,49503,26516,76019,124700,2014
17145,40.8,22034,19032,1852,646,4996,40532,8048,6055,1993,8048,77100,2014
17147,43,16552,16051,47,174,4764,63002,6623,5481,1142,6623,118700,2014
17149,42.6,16244,15572,174,191,4377,38740,6675,5254,1421,6675,72700,2014
17151,48,4362,4045,147,52,1106,39395,1672,1392,280,1672,107600,2014
17153,43.6,5967,3793,1940,104,1416,33946,2337,1821,516,2337,56200,2014
17155,45.2,5895,5506,4,273,1662,55360,2427,1967,460,2427,123800,2014
17157,41.6,33091,28497,3356,903,8110,48901,12050,9279,2771,12050,93600,2014
17159,42.8,16144,15533,69,221,4174,44514,6576,4855,1721,6576,79300,2014
17161,40.1,146964,109637,13371,17686,37351,48226,60367,42209,18158,60367,113200,2014
17163,37.5,268415,168336,80175,9534,68053,50728,102404,68146,34258,102404,121300,2014
17165,42,24876,22875,982,382,6497,38772,10070,7211,2859,10070,71100,2014
17167,39.7,198808,162332,24583,3996,51204,55565,83102,58041,25061,83102,127500,2014
17169,44.7,7454,7024,159,144,2170,48575,3042,2480,562,3042,78700,2014
17171,43.3,5260,5127,0,80,1412,48500,2074,1591,483,2074,83300,2014
17173,44.2,22216,21715,83,199,6346,47411,8941,7219,1722,8941,86100,2014
17175,45.4,5888,5701,24,63,1615,52956,2403,1966,437,2403,87800,2014
17177,44.2,47053,39770,4296,1502,12346,44631,19311,13799,5512,19311,100300,2014
17179,40.4,135872,128489,1428,2822,37341,57052,54330,41398,12932,54330,133300,2014
17181,43.5,17620,16192,228,884,4534,41849,6815,5186,1629,6815,88400,2014
17183,39.9,80773,64396,10905,3626,20313,42548,31601,22147,9454,31601,75200,2014
17185,43.3,11730,11254,31,163,3285,48679,4806,3631,1175,4806,82400,2014
17187,39.2,17784,15393,457,1577,4454,43683,6817,5049,1768,6817,82000,2014
17189,42.9,14527,14007,146,224,3951,52761,5788,4627,1161,5788,107500,2014
17191,42.8,16627,16112,95,202,4907,44535,7047,5600,1447,7047,76800,2014
17193,44.7,14549,14142,60,174,4246,45347,6300,4767,1533,6300,71700,2014
17195,42.4,57680,49210,749,6606,15490,48343,23328,17582,5746,23328,99200,2014
17197,36.2,682108,451501,73878,109841,171217,76142,223379,182913,40466,223379,212700,2014
17199,40.7,66808,60838,2701,1463,18080,43855,26758,19309,7449,26758,98000,2014
17201,38.9,292026,209087,35748,33578,74813,47523,113553,75525,38028,113553,119400,2014
17203,40.4,38965,37431,315,615,10912,68119,14373,11671,2702,14373,158000,2014
18001,34,34533,32525,225,1477,8608,47964,12164,9522,2642,12164,118400,2014
18003,35.6,360990,272913,41566,24650,90813,49124,139384,96758,42626,139384,112600,2014
18005,38,78628,67224,1513,4917,20815,54488,30516,21300,9216,30516,135900,2014
18007,40.3,8810,8201,65,459,2276,46909,3464,2478,986,3464,84300,2014
18009,42.8,12576,12120,73,164,3640,39370,5236,3986,1250,5236,67600,2014
18011,38.7,59246,54928,761,1449,16532,67416,22248,17008,5240,22248,183900,2014
18013,48,15074,14510,31,212,4158,53107,5926,4792,1134,5926,156300,2014
18015,41.3,20068,18982,63,783,5419,52806,7828,6263,1565,7828,107100,2014
18017,39.5,38730,31835,575,5126,9819,41356,14759,11003,3756,14759,81100,2014
18019,38.4,112212,95075,7675,5590,28564,51182,42774,30630,12144,42774,127800,2014
18021,40.6,26797,25951,88,337,7342,46228,10221,7728,2493,10221,91400,2014
18023,38,32987,27837,251,4644,8297,49669,11853,8512,3341,11853,96600,2014
18025,42.2,10646,10280,29,150,2861,40905,4166,3385,781,4166,88100,2014
18027,35.2,32156,30003,377,1413,8124,47104,11462,8513,2949,11462,103400,2014
18029,41.3,49840,48167,357,556,13379,58000,18648,14699,3949,18648,158700,2014
18031,39.5,26112,24931,282,465,6906,49631,9809,6980,2829,9809,112300,2014
18033,38.3,42321,40386,40,1077,11503,49561,16235,12836,3399,16235,108400,2014
18035,34.8,117441,102944,6272,2313,27710,37900,46239,29323,16916,46239,88300,2014
18037,40.9,42170,38851,147,2664,11306,54186,15926,12417,3509,15926,132900,2014
18039,35.1,199544,152558,10941,29150,50758,46983,70427,49478,20949,70427,122600,2014
18041,41.5,23955,23018,403,234,6239,37833,9336,6518,2818,9336,80900,2014
18043,39.5,75431,67105,3497,2110,19864,53431,29017,20912,8105,29017,152800,2014
18045,42.2,17002,16296,74,402,4756,45660,6912,5209,1703,6912,86400,2014
18047,40.4,22980,22406,46,236,6599,50262,8726,6946,1780,8726,144900,2014
18049,41.2,20638,19130,217,961,5598,42585,8208,6245,1963,8208,93800,2014
18051,40.1,33586,31707,583,493,9009,48176,12987,10200,2787,12987,103500,2014
18053,39.9,69313,59679,4523,2657,17450,39885,26829,18780,8049,26829,80200,2014
18055,42.1,32978,32033,95,374,8898,43470,12879,10171,2708,12879,88700,2014
18057,35.9,289722,247571,9890,10499,78018,84635,105578,83206,22372,105578,218000,2014
18059,39.7,70851,66412,1388,1343,19258,65517,26142,20540,5602,26142,157600,2014
18061,41.3,39216,37731,218,646,10529,53483,14678,12029,2649,14678,123900,2014
18063,37.3,150977,131720,8113,4960,40266,68342,53959,43609,10350,53959,160700,2014
18065,42.2,49227,46430,791,762,12199,40247,18214,13363,4851,18214,92100,2014
18067,41.2,82914,71743,5744,2400,21829,42078,34386,23603,10783,34386,96200,2014
18069,39.9,36959,35393,238,703,9811,47356,14413,11005,3408,14413,97100,2014
18071,39,43127,39110,249,2600,11673,47758,16657,12412,4245,16657,112900,2014
18073,38.7,33443,30828,305,1893,9075,56214,11988,9428,2560,11988,148700,2014
18075,39.6,21279,20329,105,614,5634,40761,8196,6154,2042,8196,80000,2014
18077,41,32447,30364,673,773,8867,45306,12746,9088,3658,12746,112500,2014
18079,38.8,28223,26977,279,623,7233,44758,10585,8033,2552,10585,91100,2014
18081,37.2,143789,131419,2379,4716,38364,60644,52873,38308,14565,52873,142600,2014
18083,39.3,38181,35666,1200,660,9341,42997,14705,9735,4970,14705,83100,2014
18085,38,77790,69396,531,5958,20947,52706,29414,22681,6733,29414,132000,2014
18087,30.9,37759,35780,21,1420,9178,49112,11735,9487,2248,11735,161000,2014
18089,37.8,493140,270560,122333,85807,123165,49617,182919,126039,56880,182919,135900,2014
18091,39.7,111293,89845,11682,6421,28246,47117,42756,30448,12308,42756,124000,2014
18093,41.7,45970,44251,170,655,13160,44553,18561,14564,3997,18561,103000,2014
18095,39.5,130688,112358,9348,4487,33262,43440,51232,35423,15809,51232,91200,2014
18097,34,919336,538599,245439,88171,212599,42378,361648,199813,161835,361648,117400,2014
18099,39,47032,41771,280,4220,11978,47219,17468,13405,4063,17468,124100,2014
18101,42.4,10294,10042,19,39,2721,45113,4199,3426,773,4199,88500,2014
18103,40.3,36394,32746,1789,937,9170,43862,13246,9857,3389,13246,85100,2014
18105,28.1,141101,120198,4071,4446,27530,41857,53778,29092,24686,53778,158700,2014
18107,40.1,38183,35354,405,1728,10069,46286,14574,10399,4175,14574,108200,2014
18109,40.7,69343,66984,200,920,18868,54986,25456,19427,6029,25456,139900,2014
18111,42.9,14140,13096,28,784,3726,49769,5327,4061,1266,5327,109800,2014
18113,37.6,47497,41881,163,4651,12845,49102,17703,13382,4321,17703,111500,2014
18115,44.8,6073,5899,112,28,1597,47208,2445,1842,603,2445,135500,2014
18117,40.6,19756,18978,285,230,5074,38556,7618,5779,1839,7618,88100,2014
18119,43.2,21321,20653,128,233,6042,44684,8539,6688,1851,8539,110400,2014
18121,42,17200,16372,381,224,4259,43214,6128,5031,1097,6128,89000,2014
18123,41.2,19452,18419,585,224,5007,47309,7356,5851,1505,7356,98400,2014
18125,43.2,12733,12643,23,9,3629,43065,5093,4196,897,5093,87900,2014
18127,39,165819,140954,5408,14929,43750,62818,61693,47744,13949,61693,165000,2014
18129,42,25641,24741,287,261,7438,59969,10178,8463,1715,10178,129000,2014
18131,41.6,13130,12494,30,352,3632,42910,5134,3976,1158,5134,92300,2014
18133,38.1,37728,34742,1491,647,9079,49914,12557,9593,2964,12557,120500,2014
18135,41.8,25801,24412,106,808,6923,41537,10514,7769,2745,10514,77300,2014
18137,40.2,28601,27566,137,460,7953,50364,10871,8343,2528,10871,132000,2014
18139,41.4,17147,16563,161,208,4983,46021,6920,4922,1998,6920,102800,2014
18141,36.4,266916,199669,34015,20628,65242,45012,101759,69630,32129,101759,113400,2014
18143,40,23897,23100,126,393,6190,43739,8973,6430,2543,8973,98900,2014
18145,40.3,44428,41290,507,1684,11745,52341,17315,12334,4981,17315,122600,2014
18147,42.7,20893,19971,146,545,5781,53073,7917,6462,1455,7917,112700,2014
18149,41.3,23215,21984,90,793,6425,40357,9009,7228,1781,9009,96400,2014
18151,41.2,34190,30713,235,1059,9345,48750,13409,10414,2995,13409,124300,2014
18153,41,21227,19615,1124,346,5508,45176,7720,5674,2046,7720,78000,2014
18155,39.8,10514,10168,24,164,2909,44447,4065,2945,1120,4065,116200,2014
18157,27.9,178135,140914,7629,13897,38297,44474,66921,35944,30977,66921,132100,2014
18159,43,15688,15042,43,388,4694,53340,6479,5003,1476,6479,107900,2014
18161,41.6,7382,7121,20,32,1971,47083,2949,2227,722,2949,105700,2014
18163,37.6,180877,153323,16454,4264,45106,43067,74365,47178,27187,74365,114700,2014
18165,42.5,15952,15524,37,160,4174,44088,6491,5130,1361,6491,75300,2014
18167,35.9,108264,93366,6943,2635,24804,41175,39769,24730,15039,39769,91200,2014
18169,42.3,32492,30858,176,728,9043,45657,12777,9689,3088,12777,95100,2014
18171,43.8,8421,8195,9,95,2412,56642,3325,2595,730,3325,106200,2014
18173,40.4,60538,56684,895,1007,16832,62747,22675,18901,3774,22675,144400,2014
18175,40.3,28017,27212,107,358,7418,42424,10512,8299,2213,10512,101100,2014
18177,40.7,68360,60698,3109,1814,18257,37932,27891,18734,9157,27891,92200,2014
18179,41.3,27732,26564,70,638,7800,49050,10952,8694,2258,10952,114000,2014
18181,42.2,24485,22145,45,1808,6684,51250,9458,7255,2203,9458,106400,2014
18183,40.6,33307,31989,103,588,9349,54023,13091,10652,2439,13091,129600,2014
19001,46,7543,7338,36,114,2062,47264,3252,2482,770,3252,88900,2014
19003,46.4,3937,3822,32,39,1187,47335,1735,1310,425,1735,86600,2014
19005,44.8,14152,13032,69,769,3941,47886,5899,4572,1327,5899,111100,2014
19007,44.7,12754,12290,39,197,3401,41525,5447,3947,1500,5447,77600,2014
19009,47.7,5935,5796,12,42,1711,47556,2703,2231,472,2703,69800,2014
19011,40.9,25895,25058,162,314,7327,59186,10137,8182,1955,10137,137100,2014
19013,34.6,131947,109903,12018,5214,31033,47002,52438,35296,17142,52438,125700,2014
19015,41.1,26326,25083,270,574,6866,52714,10619,8038,2581,10619,119800,2014
19017,38.6,24481,23531,268,290,6557,61619,9296,7502,1794,9296,146000,2014
19019,38.8,20947,20267,96,278,5777,56393,8298,6561,1737,8298,123600,2014
19021,36.8,20460,13290,492,4925,4961,48010,7635,5358,2277,7635,100300,2014
19023,43.6,14966,14586,54,154,4360,51701,6222,4960,1262,6222,104000,2014
19025,46.7,9980,9491,147,161,2798,44934,4310,3359,951,4310,74600,2014
19027,41.9,20702,19880,293,406,5461,48998,8557,6457,2100,8557,110100,2014
19029,44.7,13694,13151,46,310,3899,43960,6074,4293,1781,6074,88900,2014
19031,41.9,18434,17740,39,314,5253,59672,7639,6056,1583,7639,134200,2014
19033,43.9,43707,40283,457,1784,11602,45012,19864,14237,5627,19864,112400,2014
19035,47.1,11982,11347,27,343,3369,50828,5384,4014,1370,5384,81500,2014
19037,43.5,12329,11876,37,283,3615,46020,5330,4207,1123,5330,99000,2014
19039,39.6,9284,8055,108,1030,2316,42430,3686,2561,1125,3686,86500,2014
19041,42.1,16555,15690,25,486,4602,49438,7269,5372,1897,7269,106400,2014
19043,45.4,17900,17275,124,322,5166,47725,7698,6071,1627,7698,104900,2014
19045,42.2,48663,44765,1384,1351,12826,49849,19977,14801,5176,19977,110100,2014
19047,38.5,17259,12112,209,4563,4435,47437,6371,4824,1547,6371,87300,2014
19049,34.6,72124,63134,779,4486,19128,74876,26819,20444,6375,26819,184400,2014
19051,37.9,8765,8540,14,101,2230,46048,3085,2406,679,3085,98700,2014
19053,37.6,8286,7734,144,213,2086,38275,3085,2066,1019,3085,81700,2014
19055,42.3,17578,17165,35,173,5008,54801,7115,5619,1496,7115,123000,2014
19057,41.7,40265,35737,2377,1102,10868,42146,16881,12277,4604,16881,94300,2014
19059,48.7,16877,16364,23,242,5120,56086,7831,5823,2008,7831,165800,2014
19061,38.9,95166,87930,1449,1970,24590,53410,37720,27400,10320,37720,146500,2014
19063,40.6,10068,8915,103,909,2675,48545,4150,3252,898,4150,82400,2014
19065,43,20693,19675,156,426,5321,45443,8470,6450,2020,8470,85000,2014
19067,43.6,16153,15171,399,346,4624,43169,6923,4954,1969,6923,96700,2014
19069,43,10572,9175,74,1203,3029,48218,4321,3286,1035,4321,86000,2014
19071,46.3,7200,6876,8,184,2043,52221,3003,2284,719,3003,96300,2014
19073,45.1,9232,8826,4,227,2621,47255,3849,2935,914,3849,82600,2014
19075,42.4,12403,12091,26,141,3495,55896,5112,4129,983,5112,127800,2014
19077,45.4,10794,10393,47,222,3142,50238,4559,3645,914,4559,98500,2014
19079,42.3,15363,13996,71,794,4236,47358,6354,4475,1879,6354,90800,2014
19081,44.8,11175,10548,51,397,3124,52057,4629,3822,807,4629,90100,2014
19083,44.3,17406,16230,149,670,4472,50941,6997,5354,1643,6997,89800,2014
19085,43.4,14600,14149,10,200,4033,53506,5959,4569,1390,5959,107700,2014
19087,40.7,20197,17980,476,868,5077,49036,7512,5566,1946,7512,103900,2014
19089,42.3,9529,9233,37,139,2474,47300,3917,3121,796,3917,95500,2014
19091,44.1,9731,9195,14,364,2723,47500,4200,3115,1085,4200,85900,2014
19093,44.9,7085,6839,32,127,2045,45912,3124,2322,802,3124,78800,2014
19095,42.3,16316,15697,107,353,4744,58553,6705,5265,1440,6705,138300,2014
19097,44.5,19656,18913,41,252,5789,47004,8494,6390,2104,8494,110500,2014
19099,42,36715,34947,513,594,9697,52430,14658,10614,4044,14658,116200,2014
19101,42.7,17102,14359,261,461,4083,44688,6886,4741,2145,6886,94600,2014
19103,29.7,136802,111913,6891,7046,29769,54985,54850,32712,22138,54850,191900,2014
19105,43.1,20607,19595,426,307,5680,54264,8235,6347,1888,8235,127300,2014
19107,44.2,10361,10077,9,136,2813,44745,4386,3485,901,4386,76900,2014
19109,46.6,15347,14799,13,261,4251,52345,6628,5368,1260,6628,93700,2014
19111,42.6,35552,32399,1058,1154,9271,43314,14319,10599,3720,14319,85000,2014
19113,36.9,214927,190417,9020,6029,54987,59560,87004,63957,23047,87004,145700,2014
19115,40.5,11305,9086,77,1821,3120,52750,4386,3372,1014,4386,99000,2014
19117,44.8,8785,8580,13,57,2455,43280,3745,2938,807,3745,80700,2014
19119,38.5,11680,11287,3,267,3231,54344,4495,3693,802,4495,109000,2014
19121,40.4,15629,15123,58,217,4149,56661,6103,4628,1475,6103,156600,2014
19123,39.6,22420,21206,312,398,5844,48750,9084,6377,2707,9084,103800,2014
19125,38.8,33308,31673,204,574,9015,55419,12843,9712,3131,12843,135800,2014
19127,38.6,40922,30975,649,7635,10457,52354,15354,11249,4105,15354,104200,2014
19129,41.7,14946,14203,77,383,3950,65160,5348,4438,910,5348,151700,2014
19131,44.2,10744,10484,32,108,2959,47326,4453,3670,783,4453,105300,2014
19133,47,9149,8759,32,141,2512,41238,3972,2872,1100,3972,78900,2014
19135,42.8,8019,7910,16,40,2087,47297,3280,2496,784,3280,96800,2014
19137,45.1,10549,10015,0,338,3120,43566,4590,3174,1416,4590,78100,2014
19139,38.2,42857,34111,607,7122,11440,52899,16301,12121,4180,16301,126700,2014
19141,44,14173,13314,42,575,3949,52458,6018,4479,1539,6018,101100,2014
19143,43.8,6279,5771,25,408,1812,50700,2697,2067,630,2697,80900,2014
19145,43.8,15737,14499,265,447,4104,44786,6379,4696,1683,6379,80700,2014
19147,42.9,9263,8882,88,174,2489,46334,4011,3017,994,4011,84900,2014
19149,42.1,24899,23507,65,859,6989,57583,9899,7967,1932,9899,133500,2014
19151,47.4,7191,6835,85,213,1970,45500,3222,2528,694,3222,62500,2014
19153,34.9,445136,355421,26920,34835,113841,59844,174759,119821,54938,174759,155400,2014
19155,38.7,93153,82987,1016,6407,24527,51939,36615,25658,10957,36615,124500,2014
19157,41.1,18765,17434,186,503,4596,51650,7424,5180,2244,7424,125700,2014
19159,46.4,5082,4908,10,70,1383,44032,2078,1574,504,2078,76800,2014
19161,46.5,10162,9766,70,244,2799,48581,4413,3541,872,4413,81200,2014
19163,37.5,168714,138286,13105,10063,42573,53704,67325,46219,21106,67325,144900,2014
19165,46.5,12034,11578,10,246,3303,49599,5171,3978,1193,5171,106500,2014
19167,33.2,34261,30363,149,3201,8871,59272,11782,9220,2562,11782,137500,2014
19169,26.5,91939,79196,2141,2863,19001,51270,35666,19202,16464,35666,164200,2014
19171,42.5,17568,14654,103,1373,4890,54325,6815,5187,1628,6815,101400,2014
19173,44.4,6225,5706,20,432,1857,44939,2752,1980,772,2752,66200,2014
19175,41.1,12554,11969,166,283,3294,44134,5293,3890,1403,5293,90700,2014
19177,44.1,7487,7277,9,93,2125,45057,2986,2545,441,2986,75000,2014
19179,39.8,35406,30499,554,3406,9462,41519,14608,10645,3963,14608,76900,2014
19181,38.3,47058,44850,283,1040,12906,64956,17584,13733,3851,17584,159300,2014
19183,41.8,21906,20207,166,1177,6059,55198,9056,6644,2412,9056,121900,2014
19185,45.1,6385,6190,14,57,1641,42083,2548,2059,489,2548,66400,2014
19187,39.9,37399,33427,1384,1527,9029,42112,15397,10396,5001,15397,84600,2014
19189,44.1,10645,9964,79,381,3061,49208,4584,3474,1110,4584,94200,2014
19191,40.5,20957,20005,184,421,5363,53735,8141,6190,1951,8141,155300,2014
19193,35.4,102372,78324,2725,14892,25524,46015,38818,26210,12608,38818,98300,2014
19195,44.4,7567,7249,44,181,2220,49977,3194,2547,647,3194,98600,2014
19197,44.4,13007,11491,44,1278,3281,43082,5419,4114,1305,5419,72800,2014
20001,41.3,13212,12075,258,402,3471,38712,5398,3901,1497,5398,61700,2014
20003,42.3,7962,7582,16,58,2134,40567,3314,2465,849,3314,93300,2014
20005,36.5,16737,14851,747,441,3967,44648,6180,4496,1684,6180,85800,2014
20007,45.4,4898,4622,11,144,1408,48462,2146,1582,564,2146,66000,2014
20009,39.8,27566,22815,369,3815,7464,43573,11480,7956,3524,11480,79800,2014
20011,37.8,14913,13620,570,330,3880,39555,5702,4022,1680,5702,80100,2014
20013,42.2,9926,8323,171,352,2676,41126,4157,2835,1322,4157,81600,2014
20015,37.6,65927,59521,1141,2780,17131,57474,24062,18028,6034,24062,130800,2014
20017,45.4,2746,2546,34,104,702,38633,1139,829,310,1139,78200,2014
20019,49.1,3572,3147,19,98,1071,39444,1584,1265,319,1584,50700,2014
20021,41.6,21179,18839,98,458,5808,40920,8132,6207,1925,8132,70600,2014
20023,49.5,2695,2458,0,167,807,39681,1294,998,296,1294,83000,2014
20025,45,2170,1765,17,267,629,43750,958,680,278,958,63500,2014
20027,44.1,8460,8042,73,205,2291,51375,3398,2707,691,3398,93100,2014
20029,41.8,9414,8853,32,301,2395,39509,3972,2901,1071,3972,69700,2014
20031,44.1,8493,8020,47,200,2416,56274,3578,2690,888,3578,100000,2014
20033,45,1911,1779,0,84,507,44417,757,573,184,757,64100,2014
20035,38.2,36201,29445,946,3507,8818,42157,13783,9585,4198,13783,79900,2014
20037,32.7,39277,34653,782,1893,9038,37154,15364,9233,6131,15364,85000,2014
20039,51.8,2915,2794,12,59,803,37396,1442,1133,309,1442,51300,2014
20041,41.7,19641,18064,58,841,5458,50123,7838,5752,2086,7838,107100,2014
20043,38.7,7904,7157,280,197,2156,48659,3138,2338,800,3138,84100,2014
20045,28.7,113703,91632,4220,6240,23705,50732,43834,22678,21156,43834,181300,2014
20047,44.3,3006,2345,31,572,817,47101,1287,981,306,1287,56500,2014
20049,49.7,2734,2525,16,91,852,38182,1276,1011,265,1276,50700,2014
20051,32.2,28878,26249,291,1512,6577,45127,11859,7437,4422,11859,143200,2014
20053,44.9,6443,5614,258,367,1626,45417,2549,1904,645,2549,78200,2014
20055,30.5,37099,16643,759,17655,9211,47994,12670,7947,4723,12670,112000,2014
20057,30.7,34604,14675,765,18058,8235,51374,11086,7132,3954,11086,92200,2014
20059,38.8,25834,23631,326,986,6998,50415,9933,7112,2821,9933,120000,2014
20061,26.4,36458,21649,5968,5028,8872,45660,12782,5702,7080,12782,136900,2014
20063,46.4,2786,2688,29,22,844,48276,1212,964,248,1212,74700,2014
20065,49.4,2602,2329,128,72,727,45192,1158,927,231,1158,66000,2014
20067,33.1,7856,4110,2,3552,2164,54478,2776,2041,735,2776,95100,2014
20069,35.8,6043,5129,0,875,1624,58656,2125,1547,578,2125,99800,2014
20071,48.5,1223,937,10,246,344,51023,471,365,106,471,83000,2014
20073,47.6,6495,6025,12,236,1853,39286,2860,2218,642,2860,57100,2014
20075,35.8,2632,1738,1,852,718,44274,1008,748,260,1008,82900,2014
20077,43.6,5906,5385,10,350,1650,41332,2567,1965,602,2567,66800,2014
20079,38.7,34797,29273,473,3862,9146,49576,13329,9476,3853,13329,112000,2014
20081,34.8,4198,2927,0,1176,1078,55742,1421,1052,369,1421,110400,2014
20083,46.8,1941,1728,0,191,582,53190,814,610,204,814,77600,2014
20085,41.4,13464,11428,94,547,3907,55296,5288,3946,1342,5288,118900,2014
20087,43.5,18932,17882,85,421,5317,56531,7498,6209,1289,7498,126500,2014
20089,52.1,3060,2929,5,69,936,41042,1438,1162,276,1438,53600,2014
20091,36.6,560025,455178,24299,40754,147863,75017,217826,152020,65806,217826,212300,2014
20093,35.8,3950,2648,34,1158,984,54732,1341,954,387,1341,93600,2014
20095,45.4,7820,7398,22,218,2078,50000,3084,2271,813,3084,88000,2014
20097,41,2529,2308,17,132,636,41211,1051,664,387,1051,107700,2014
20099,40.6,21225,18108,714,893,5657,41434,8495,5998,2497,8495,67700,2014
20101,45.8,1652,1506,7,124,457,54292,811,621,190,811,62600,2014
20103,37.2,77687,61897,6354,4936,18789,64909,26398,17684,8714,26398,165500,2014
20105,46.5,3180,3038,20,76,893,43487,1397,1086,311,1397,63400,2014
20107,44.7,9551,9046,66,203,2830,46448,4140,3338,802,4140,90700,2014
20109,43.9,2783,2572,0,113,786,47073,1228,861,367,1228,78100,2014
20111,32.3,33510,24315,632,6818,7951,40427,13069,7790,5279,13069,92500,2014
20113,41.6,29308,27129,276,1094,8152,55437,11726,9010,2716,11726,127600,2014
20115,44.7,12401,11642,143,343,3292,45964,4845,3820,1025,4845,83200,2014
20117,45,10042,9590,35,219,2841,44615,4289,3290,999,4289,83300,2014
20119,39,4444,3706,52,617,1331,51326,1761,1230,531,1761,86400,2014
20121,40.3,32765,30558,411,930,8847,60622,12350,9768,2582,12350,167100,2014
20123,44.2,6324,6097,9,110,1821,46836,2795,1963,832,2795,75800,2014
20125,39.7,34602,27812,1832,1978,9014,40716,13706,9605,4101,13706,72400,2014
20127,47.9,5808,5409,12,237,1660,48072,2437,1898,539,2437,83100,2014
20129,41.5,3159,2364,52,633,845,45638,1199,828,371,1199,87200,2014
20131,41.8,10136,9745,89,148,2787,47141,4161,3219,942,4161,101300,2014
20133,40,16453,14958,147,767,4390,44879,6503,4766,1737,6503,70300,2014
20135,50.7,3104,2770,17,291,956,48021,1403,1139,264,1403,64200,2014
20137,44.1,5628,4996,158,270,1395,45484,2212,1643,569,2212,66700,2014
20139,42.7,16165,15312,28,390,4549,49716,6544,4972,1572,6544,99100,2014
20141,48.5,3811,3676,11,56,1070,38686,1767,1347,420,1767,54300,2014
20143,42.5,6075,5763,8,154,1747,60098,2479,2010,469,2479,91400,2014
20145,43.1,6959,5949,319,498,1462,40791,2525,1785,740,2525,73800,2014
20147,45.5,5560,5272,9,147,1596,44292,2414,1858,556,2414,66100,2014
20149,34.5,22338,20189,317,1089,5721,60479,8109,6288,1821,8109,154800,2014
20151,39,9758,8770,77,605,2674,49519,4071,2786,1285,4071,84300,2014
20153,50.8,2553,2395,12,103,763,43555,1211,835,376,1211,72000,2014
20155,39.7,64223,54948,1762,5458,16747,44673,25335,17292,8043,25335,92500,2014
20157,50.9,4868,4715,0,67,1290,40538,2258,1768,490,2258,47900,2014
20159,38.6,10050,8516,121,1074,2503,46342,3837,2828,1009,3837,77400,2014
20161,24.6,74478,58134,4586,5565,14016,44522,26162,11067,15095,26162,174800,2014
20163,44.9,5174,4949,23,45,1459,43816,2310,1717,593,2310,67500,2014
20165,49.1,3222,3087,29,34,887,40746,1535,1170,365,1535,60400,2014
20167,47,6959,6549,143,151,2038,40369,3317,2426,891,3317,76500,2014
20169,37.7,55793,45290,1570,5772,14435,47745,22497,15029,7468,22497,120400,2014
20171,41.2,4965,4004,0,853,1536,47079,2157,1621,536,2157,109000,2014
20173,34.5,503788,349662,45471,67855,124990,50326,192303,124247,68056,192303,125400,2014
20175,29.2,23319,7979,835,13503,5553,48621,7442,4897,2545,7442,88900,2014
20177,38.6,178600,134049,13530,20123,45501,49695,72069,46485,25584,72069,120100,2014
20179,46.6,2540,2350,8,89,698,48750,1130,881,249,1130,85100,2014
20181,38.2,6078,5172,130,712,1615,38528,2738,1534,1204,2738,71600,2014
20183,50.4,3779,3627,20,35,1090,42174,1690,1332,358,1690,65400,2014
20185,45.2,4363,3683,38,561,1267,44180,1877,1546,331,1877,58500,2014
20187,36.9,2187,1305,21,795,579,42146,833,626,207,833,79200,2014
20189,35.4,5744,3683,22,1915,1523,57614,1939,1509,430,1939,88600,2014
20191,40.5,23763,21553,47,1179,6178,50310,9053,7034,2019,9053,84000,2014
20193,35.6,7947,7317,123,400,1939,48649,3167,2298,869,3167,103700,2014
20195,46.8,2959,2840,10,44,856,50670,1250,928,322,1250,75400,2014
20197,41.8,7034,6610,40,220,1953,55018,2701,2284,417,2701,113300,2014
20199,43.4,1569,1500,2,63,404,48125,614,466,148,614,67700,2014
20201,46.4,5717,5435,35,165,1612,42738,2458,1977,481,2458,58300,2014
20203,41.1,2220,1633,0,556,622,57266,867,646,221,867,75300,2014
20205,43.8,9177,8559,13,240,2552,38811,3836,2828,1008,3836,62700,2014
20207,48.2,3246,3063,19,79,914,36863,1499,1213,286,1499,49400,2014
20209,33.2,159466,68412,39007,42801,37576,39326,58057,34483,23574,58057,91400,2014
21001,39.6,19032,17805,518,342,4871,34490,7124,5293,1831,7124,80100,2014
21003,39.7,20219,19368,375,339,5593,40273,8057,5751,2306,8057,93000,2014
21005,39,21664,20484,521,316,6008,53410,8353,6282,2071,8353,133500,2014
21007,42.5,8274,7745,293,101,2174,42852,3279,2685,594,3279,94600,2014
21009,40.1,42691,38895,1809,1204,11589,38885,16789,11442,5347,16789,101900,2014
21011,40.3,11870,11376,226,164,3017,33091,4361,3325,1036,4361,69700,2014
21013,41.1,28234,26740,734,115,7403,24976,11181,7500,3681,11181,62600,2014
21015,36.1,123030,109614,3631,4678,32595,67286,43903,32561,11342,43903,174200,2014
21017,41,19972,17010,1438,1360,5304,43521,7782,4690,3092,7782,139300,2014
21019,41.8,49242,46111,1286,746,13291,41739,19533,13497,6036,19533,96700,2014
21021,41,29150,25240,2007,864,7441,40853,10981,7128,3853,10981,133000,2014
21023,40.4,8459,8322,1,119,2208,40194,3303,2574,729,3303,93400,2014
21025,40.7,13663,13327,69,67,3647,26094,5434,4150,1284,5434,49300,2014
21027,42.2,20076,19061,508,227,5217,40039,7325,5793,1532,7325,84600,2014
21029,38.9,76093,72670,488,1189,21160,56199,28282,23029,5253,28282,145700,2014
21031,40.9,12797,12238,82,428,3447,34581,5107,3776,1331,5107,89300,2014
21033,42.5,12880,11798,771,171,3604,40135,5320,3799,1521,5320,93700,2014
21035,33.4,37981,34139,1449,942,8715,38589,14854,9677,5177,14854,119500,2014
21037,37,91268,84542,2740,1598,22573,54482,35478,24417,11061,35478,147700,2014
21039,42.5,5031,4781,70,108,1474,39125,2075,1640,435,2075,72500,2014
21041,36.6,10871,9663,187,748,2745,39668,4108,2562,1546,4108,97900,2014
21043,39.7,27439,26577,213,141,7330,37139,10525,8160,2365,10525,76000,2014
21045,42.1,16002,15277,177,426,4213,30051,6186,4920,1266,6186,68900,2014
21047,28.5,74459,50437,14477,5159,18147,38720,25734,12773,12961,25734,106800,2014
21049,41,35633,32282,1865,952,9874,46554,14368,9201,5167,14368,144800,2014
21051,38.5,21446,19889,979,292,5280,22626,7652,5707,1945,7652,58600,2014
21053,41.2,10192,9797,74,263,2562,27285,3878,2918,960,3878,66300,2014
21055,42.2,9254,8963,82,65,2482,33356,3812,2934,878,3812,71800,2014
21057,44.3,6829,6474,229,22,1810,30813,2684,1938,746,2684,62600,2014
21059,39.2,97631,87518,4500,2626,25671,45760,38000,26226,11774,38000,113100,2014
21061,42.5,12137,11651,175,209,3476,42404,4734,3777,957,4734,92700,2014
21063,41.7,7781,7494,240,38,1952,28363,2790,2282,508,2790,64600,2014
21065,42.6,14547,14258,76,6,4029,29905,5706,4091,1615,5706,69400,2014
21067,34,304473,221145,43354,20827,71151,48667,124101,68100,56001,124101,166000,2014
21069,40.6,14505,13970,226,171,3976,33392,5542,4097,1445,5542,78900,2014
21071,40.4,39087,38102,347,261,10725,30190,15438,10878,4560,15438,72000,2014
21073,40.2,49509,40890,5142,1415,12921,46818,21065,13144,7921,21065,138600,2014
21075,42.6,6550,4702,1597,83,1751,32948,2662,1558,1104,2662,59200,2014
21077,38.3,8554,7869,132,176,2021,48917,3024,2126,898,3024,98900,2014
21079,41.4,16880,15917,257,398,4945,44304,6567,5036,1531,6567,124300,2014
21081,36.7,24667,23311,54,602,6296,46382,8301,5883,2418,8301,128200,2014
21083,40.3,37451,32695,1737,2208,9905,39529,14284,10573,3711,14284,89200,2014
21085,39.9,25934,24922,230,318,6860,33788,9839,7156,2683,9839,90400,2014
21087,43.5,11186,10605,331,58,3129,34368,4474,3449,1025,4474,71400,2014
21089,42.7,36656,35363,272,350,10236,44035,14230,10912,3318,14230,93600,2014
21091,41.4,8654,8318,84,114,2552,50311,3367,2646,721,3367,96600,2014
21093,35.3,107565,82544,12757,5887,28084,49602,39955,25078,14877,39955,141200,2014
21095,40.9,28744,27416,642,230,7865,25186,11251,7757,3494,11251,50300,2014
21097,41.7,18643,17555,395,363,4619,35957,7257,4842,2415,7257,110300,2014
21099,40.4,18427,16965,887,287,5136,34771,7135,5262,1873,7135,84900,2014
21101,39.8,46394,40436,3298,974,12413,41006,18875,12398,6477,18875,101500,2014
21103,40.9,15427,14196,504,490,4310,44764,5984,4234,1750,5984,122000,2014
21105,47.2,4790,4194,458,36,1267,42256,1992,1608,384,1992,64400,2014
21107,40.3,46684,41573,2841,809,12443,42404,18533,13351,5182,18533,87200,2014
21109,39.4,13370,13138,3,78,4216,27224,5670,4201,1469,5670,60500,2014
21111,37.9,751485,525268,153321,34389,185802,47692,306511,190583,115928,306511,149900,2014
21113,36.5,49601,45078,1531,1382,13636,50057,18120,11629,6491,18120,158200,2014
21115,40.3,23390,22869,67,129,6643,35026,9134,6914,2220,9134,79800,2014
21117,36.3,161915,144784,7391,4547,40005,54817,61962,41536,20426,61962,143900,2014
21119,40.6,16139,15759,143,117,3943,31624,5776,4592,1184,5776,61300,2014
21121,39,31857,30691,498,317,8228,25523,12524,7967,4557,12524,73600,2014
21123,40.5,14149,13014,482,429,3869,39364,5294,3906,1388,5294,106000,2014
21125,38.1,59535,57166,507,799,16500,35746,23184,16048,7136,23184,91000,2014
21127,39.9,15850,15525,17,52,4264,36225,5940,4604,1336,5940,84400,2014
21129,42.4,7681,7337,101,76,1741,23968,2957,2184,773,2957,64600,2014
21131,41.6,11128,10937,26,105,2930,29156,4212,3169,1043,4212,46500,2014
21133,41.4,23965,23502,140,147,6582,31630,9391,7048,2343,9391,57900,2014
21135,40.2,13848,13595,18,86,3705,27707,5222,4120,1102,5222,62600,2014
21137,39.7,24546,23191,611,373,6918,35949,9693,7185,2508,9693,89100,2014
21139,45.8,9443,9109,24,136,2710,40580,3708,3037,671,3708,79500,2014
21141,40.7,26844,23844,1764,691,7083,36101,10862,7691,3171,10862,90700,2014
21143,48.6,8415,7704,533,70,1913,43715,3263,2671,592,3263,116000,2014
21145,42.4,65545,54923,7064,1462,17475,43650,27409,18438,8971,27409,121500,2014
21147,38.6,18073,16561,998,296,4495,20000,6210,4273,1937,6210,63100,2014
21149,42.1,9510,9184,45,120,2649,40851,3744,2975,769,3744,81400,2014
21151,33.6,85485,77079,3732,1898,20284,42155,31752,18771,12981,31752,144000,2014
21153,40.3,13076,12822,2,119,3471,27947,4928,3689,1239,4928,49700,2014
21155,38.4,19965,17374,1892,493,4895,38478,7385,5473,1912,7385,98700,2014
21157,44.5,31223,30344,85,385,9060,44539,12426,9848,2578,12426,105200,2014
21159,37.9,12750,11814,535,274,3201,28040,4381,3118,1263,4381,78800,2014
21161,40.9,17398,15583,1166,72,4714,39783,6636,4567,2069,6636,102600,2014
21163,36,29203,26070,1187,1084,8148,49379,10557,7575,2982,10557,123500,2014
21165,41.8,6337,6094,34,119,1716,30313,2404,1837,567,2404,80100,2014
21167,42.7,21311,19551,823,507,5966,42658,8770,6394,2376,8770,131500,2014
21169,42.9,10025,9487,102,141,2658,30453,3918,2974,944,3918,82000,2014
21171,42.5,10837,10162,224,309,2974,30378,4436,3218,1218,4436,72000,2014
21173,38.4,26983,25137,810,702,6935,38373,10288,6691,3597,10288,111800,2014
21175,40.1,13522,12677,416,127,3586,29730,4841,3551,1290,4841,75600,2014
21177,41.3,31391,29047,1428,404,8459,38849,11619,9127,2492,11619,78200,2014
21179,37.9,44254,40214,2260,905,12451,45655,16660,12443,4217,16660,125200,2014
21181,41.8,7064,7014,27,23,2026,41996,2861,2103,758,2861,83200,2014
21183,40.1,23956,22628,291,828,6306,39574,8573,6820,1753,8573,80900,2014
21185,39.7,61711,54895,2589,2248,16011,84447,19610,16809,2801,19610,246000,2014
21187,41.5,10740,10252,173,257,2986,40995,4355,3331,1024,4355,99100,2014
21189,42.9,4686,4490,37,35,1130,19146,1740,1323,417,1740,70100,2014
21191,40.9,14642,14240,75,155,3555,46085,5349,4055,1294,5349,103900,2014
21193,41.8,28261,27115,343,64,7792,32302,11005,7902,3103,11005,69200,2014
21195,41,64380,62603,558,487,17754,32571,26312,18797,7515,26312,67300,2014
21197,39.1,12552,12171,25,152,2917,29141,4628,3242,1386,4628,78100,2014
21199,41.9,63505,60075,662,1438,17671,33425,26052,18315,7737,26052,105100,2014
21201,44.3,2239,2220,0,0,590,30479,911,697,214,911,89900,2014
21203,42,16965,16595,24,67,4753,31536,6634,5144,1490,6634,75300,2014
21205,32.5,23485,22229,389,171,5216,40697,8407,5494,2913,8407,105000,2014
21207,42.3,17646,16675,86,612,4628,30773,7223,5340,1883,7223,84800,2014
21209,35.6,49167,42994,2553,2064,13212,62134,18306,13157,5149,18306,160400,2014
21211,38.3,43581,35157,3141,3862,11732,57890,15665,10950,4715,15665,170300,2014
21213,39.1,17551,15036,1679,338,4493,39055,6660,4352,2308,6660,116800,2014
21215,40.3,17419,16519,268,297,5100,65149,6301,5300,1001,6301,174600,2014
21217,39.3,25059,22688,1160,498,6410,35521,9491,6549,2942,9491,96300,2014
21219,37.1,12499,10760,1063,505,3318,41047,4567,3316,1251,4567,86000,2014
21221,44.7,14277,12610,1172,213,4213,45303,6055,4862,1193,6055,117000,2014
21223,40,8816,8487,16,273,2505,47119,3578,2752,826,3578,106200,2014
21225,37,15192,12617,1937,272,3820,38367,5620,4000,1620,5620,80700,2014
21227,32.8,117169,94786,10849,5701,28830,45209,44923,26232,18691,44923,141300,2014
21229,41.2,11871,10462,708,433,3120,39313,4514,3650,864,4514,100500,2014
21231,41.7,20728,19489,420,592,5450,29295,8004,5693,2311,8004,77200,2014
21233,39.8,13454,12032,640,601,3665,40852,5057,3645,1412,5057,72800,2014
21235,37.6,35557,34269,286,345,9332,32255,12931,8821,4110,12931,75300,2014
21237,42,7273,7191,15,14,1816,21198,2826,1961,865,2826,51500,2014
21239,41.6,25151,21701,1234,1669,6633,58639,9716,6767,2949,9716,183300,2014
22001,35.6,62031,48367,10937,1211,15648,37684,22788,15837,6951,22788,88500,2014
22003,38.6,25691,18114,4834,1327,5498,39440,8108,5897,2211,8108,80800,2014
22005,34.7,112308,78806,25012,5529,30190,70207,39447,31613,7834,39447,166300,2014
22007,38.6,23170,15358,6891,530,6251,47961,8726,7054,1672,8726,104800,2014
22009,38.2,41604,27460,12236,676,10422,33781,15107,10573,4534,15107,89600,2014
22011,37.4,36109,28870,4709,1166,9711,46420,13095,10067,3028,13095,97300,2014
22013,42.2,14122,7699,5973,219,3763,32826,5888,4234,1654,5888,60900,2014
22015,34.5,121918,83674,25746,7584,30571,52754,46285,30492,15793,46285,147500,2014
22017,36.4,255529,120068,121306,6732,61691,41251,98427,60685,37742,98427,123100,2014
22019,36.1,194943,134462,48421,5491,51129,44045,74757,52059,22698,74757,119100,2014
22021,40.8,10008,7899,1739,257,2547,36792,3851,2791,1060,3851,66800,2014
22023,40.9,6713,6341,207,140,1966,64129,2577,2319,258,2577,104400,2014
22025,38.7,10273,6760,3232,114,2656,35093,3786,2859,927,3786,65600,2014
22027,41.6,16817,7814,8432,211,3530,34216,5677,4062,1615,5677,74800,2014
22029,37.7,20609,11746,8413,233,5408,29824,7767,4732,3035,7767,78800,2014
22031,39.8,26968,15364,10308,714,7188,41486,10172,7592,2580,10172,91300,2014
22033,32.9,443598,204838,200711,16798,103429,48535,168534,101114,67420,168534,166800,2014
22035,33.5,7602,2031,5310,216,1683,24947,2592,1350,1242,2592,48300,2014
22037,41.3,19964,10534,8976,242,4952,46220,6909,5467,1442,6909,128000,2014
22039,35.6,33778,22920,9528,810,8286,30323,12053,7954,4099,12053,79800,2014
22041,38.6,20645,13657,6754,76,5042,30607,7748,5478,2270,7748,76800,2014
22043,37.4,22363,17156,3475,1009,4803,39729,7204,5492,1712,7204,80400,2014
22045,35.7,73735,44313,23349,2586,18836,45022,26433,18471,7962,26433,99200,2014
22047,38.4,33375,15970,16206,773,7957,45692,11257,8518,2739,11257,105300,2014
22049,39.7,16199,10803,4887,236,4385,36466,6166,4136,2030,6166,77000,2014
22051,38.6,434528,238538,112733,57335,107451,47871,167840,104951,62889,167840,171100,2014
22053,38.3,31492,24607,5420,621,8089,40335,11553,8600,2953,11553,91700,2014
22055,33.9,228084,152624,58216,9449,54463,51406,87602,56477,31125,87602,163800,2014
22057,36.8,97235,75182,12959,4042,25253,50396,35329,27016,8313,35329,131700,2014
22059,38.4,14874,12421,1872,357,4094,41173,5715,4692,1023,5715,70800,2014
22061,27.3,47243,25206,19165,1246,10095,34210,17060,9164,7896,17060,118400,2014
22063,35,132160,117838,7802,4237,34952,57478,46960,37771,9189,46960,151100,2014
22065,34.4,12008,4258,7361,201,2490,24028,4035,2222,1813,4035,62600,2014
22067,38.8,27319,13703,12938,302,6743,28304,10383,6718,3665,10383,77400,2014
22069,33.3,39359,21040,15997,788,9299,33629,14598,8973,5625,14598,100600,2014
22071,35.1,368471,113105,217983,19911,77261,36964,150409,70478,79931,150409,184100,2014
22073,34.6,155285,91506,57496,3145,38207,39111,57732,34631,23101,57732,122400,2014
22075,36.2,23545,15772,4934,1329,6465,54835,8772,6192,2580,8772,159700,2014
22077,42.6,22631,13634,8103,535,5892,46158,8888,6887,2001,8888,115300,2014
22079,37.3,132199,81716,42337,3595,31522,41305,47704,30983,16721,47704,121800,2014
22081,39.9,8937,5177,3506,122,2325,37681,3382,2534,848,3382,81300,2014
22083,37.8,20845,12738,7497,403,5681,38708,7676,5060,2616,7676,81300,2014
22085,41.3,24286,16678,4097,871,6097,36513,9174,7105,2069,9174,78100,2014
22087,32.9,41114,27143,8270,3883,10103,44706,14051,9819,4232,14051,127300,2014
22089,37.1,52616,34603,13755,2860,13698,57785,18421,14856,3565,18421,181000,2014
22091,39.4,10937,4876,5764,14,2917,35262,4155,3434,721,4155,83400,2014
22093,38.8,21782,10423,10906,315,6045,53259,7925,6350,1575,7925,128100,2014
22095,35.8,44570,17295,23900,2261,11372,50716,15444,11854,3590,15444,149200,2014
22097,36.7,83518,46155,34054,1463,20964,33928,30664,21554,9110,30664,88700,2014
22099,36.5,52823,34296,16004,1234,13295,42948,18834,14990,3844,18834,98500,2014
22101,37.9,53784,30587,16775,3145,13972,41956,20183,13897,6286,20183,89700,2014
22103,39.7,239814,191548,27875,12117,64017,61942,87975,68221,19754,87975,197500,2014
22105,34.1,124125,79470,37000,4649,30663,40721,45027,30589,14438,45027,135400,2014
22107,42.6,5008,2099,2807,82,1167,26178,1936,1213,723,1936,55600,2014
22109,35.3,112167,76464,21187,4895,28310,49932,39635,28665,10970,39635,133900,2014
22111,41.2,22623,15365,5749,967,6028,35115,8712,6909,1803,8712,83300,2014
22113,36.3,58784,46477,8223,1652,15415,47344,21623,16322,5301,21623,97600,2014
22115,29.9,52844,37448,7293,4516,13341,46867,18112,9913,8199,18112,93400,2014
22117,39.1,46723,30774,14129,937,11774,31750,17589,12772,4817,17589,79200,2014
22119,40.8,40890,25702,13862,713,10276,35292,15831,11259,4572,15831,82400,2014
22121,35.5,24347,14032,9066,628,6448,49202,9030,6285,2745,9030,149500,2014
22123,40.8,11522,9198,1855,325,2873,31843,4216,2896,1320,4216,67000,2014
22125,41.5,15485,7983,7076,239,2914,53967,3976,2940,1036,3976,166000,2014
22127,39.7,15000,9833,4650,260,3827,32608,5371,3718,1653,5371,68400,2014
23001,40.4,107470,98452,1675,1769,27633,45765,44391,28461,15930,44391,152800,2014
23003,46.1,70653,66943,465,738,19091,37378,30571,21723,8848,30571,92500,2014
23005,41.7,284351,259442,7338,5297,71982,59560,117406,79785,37621,117406,242000,2014
23007,44.4,30569,29429,82,344,7797,41665,11975,9370,2605,11975,130800,2014
23009,47,54581,52192,246,680,14903,45747,24317,17722,6595,24317,197800,2014
23011,43.6,121507,115712,926,1645,32062,46559,51242,35994,15248,51242,151400,2014
23013,47.1,39653,38143,248,396,10673,50515,17038,13293,3745,17038,193300,2014
23015,49.1,34237,33064,89,308,9534,50027,14905,12115,2790,14905,209900,2014
23017,45.3,57517,55195,228,632,14335,40695,22392,17500,4892,22392,136100,2014
23019,40.8,153627,144951,1167,1777,38545,44543,62215,41918,20297,62215,137700,2014
23021,49.2,17271,16568,22,194,5006,37110,7666,5896,1770,7666,107300,2014
23023,45,35102,33355,243,500,9747,55046,15108,11526,3582,15108,190800,2014
23025,44.6,51762,49831,197,477,14007,39792,21567,16875,4692,21567,110500,2014
23027,44.8,38904,37457,141,409,10726,43484,16527,12837,3690,16527,156000,2014
23029,46.5,32397,29411,147,513,8894,38239,14173,10766,3407,14173,104700,2014
23031,43.7,198934,189240,1242,2913,53037,56701,81593,59293,22300,81593,226700,2014
24001,41.5,73976,64982,5866,1150,17457,39794,28490,19769,8721,28490,120800,2014
24003,38.5,550269,391876,84265,36666,139320,89031,201429,149541,51888,201429,333100,2014
24005,39.1,817720,499018,216219,37830,203880,66940,313408,207603,105805,313408,248700,2014
24009,40.3,89793,71303,11754,2808,23602,95425,31041,25209,5832,31041,347300,2014
24011,39.5,32759,25425,4530,1920,8512,55605,11842,8383,3459,11842,203900,2014
24013,41.9,167399,151808,5228,4682,44775,85532,59907,49398,10509,59907,322000,2014
24015,39.7,101803,88027,6808,3852,26271,65124,36453,26693,9760,36453,244600,2014
24017,37.6,150960,70122,62237,7244,38836,91910,52269,40740,11529,52269,287000,2014
24019,43.4,32614,21316,9100,1317,9076,45628,13419,8836,4583,13419,188100,2014
24021,38.9,239253,183121,20327,18809,63252,84480,87259,64897,22362,87259,301300,2014
24023,44.2,29945,29027,249,260,8219,46096,11851,8984,2867,11851,165500,2014
24025,39.9,248029,193737,31893,9609,66770,81016,91037,72008,19029,91037,279300,2014
24027,38.6,299269,170896,52792,18344,79606,110133,107516,78764,28752,107516,426300,2014
24029,46.3,20016,15618,3028,874,4746,58201,7448,5383,2065,7448,244600,2014
24031,38.5,1005087,476726,170308,180397,250726,98704,362608,241626,120982,362608,448700,2014
24033,35.5,884764,128365,556318,140455,202436,73856,305115,189940,115175,305115,258800,2014
24035,43.1,48439,42158,3404,1591,13278,86406,17354,14684,2670,17354,341100,2014
24037,36.1,108472,82351,15239,4648,27915,88190,37947,27535,10412,37947,300200,2014
24039,36.2,26197,13501,10789,938,5056,36716,8498,5492,3006,8498,149700,2014
24041,48.2,37894,29703,4778,2228,10934,58495,16140,11302,4838,16140,324100,2014
24043,40.4,148913,122212,14558,5744,37611,56477,55769,35929,19840,55769,200700,2014
24045,35.3,100376,65805,24107,4896,24368,52301,36479,23019,13460,36479,175500,2014
24047,48.6,51558,41255,7298,1711,13323,58820,20492,15738,4754,20492,242000,2014
24510,34.5,622271,174732,388945,27751,125948,41819,242212,114407,127805,242212,155000,2014
25001,50.8,215167,196810,5215,5267,58136,61597,94371,74245,20126,94371,362800,2014
25003,45.4,130064,116871,3439,4907,32878,49737,55369,37953,17416,55369,204100,2014
25005,40.4,551065,467030,18211,35832,139133,55957,211001,131868,79133,211001,275400,2014
25007,45.7,16915,15931,305,63,3863,65518,5839,4552,1287,5839,641100,2014
25009,40.6,757395,563691,21615,133486,191407,68776,286896,180939,105957,286896,349300,2014
25011,44.9,71300,65447,633,2502,18382,54072,30390,20846,9544,30390,220400,2014
25013,38.7,466447,308203,36177,103159,116644,50036,177736,109322,68414,177736,196600,2014
25015,35.8,160328,136762,4092,8061,34659,61460,58776,38615,20161,58776,261700,2014
25017,38.5,1539832,1162190,69466,108884,373715,83488,583809,364735,219074,583809,404600,2014
25019,39.9,10414,8104,847,753,2388,86529,3978,2554,1424,3978,912600,2014
25021,40.8,682860,538710,40003,25030,170211,86469,258675,178389,80286,258675,393500,2014
25023,41.8,500772,418101,41935,17069,128955,75816,180659,137978,42681,180659,328200,2014
25025,31.9,747928,352091,149442,156323,143588,54169,290631,103236,187395,290631,365200,2014
25027,39.6,806804,642703,32475,80488,201103,65453,300355,195706,104649,300355,255600,2014
26001,56.3,10657,10287,21,140,3214,38019,5007,4437,570,5007,95800,2014
26003,48.3,9516,8099,665,119,2336,39211,3609,3086,523,3609,117200,2014
26005,39.8,112266,100194,1522,7761,30725,52472,41767,34133,7634,41767,137500,2014
26007,46.6,29242,28149,140,352,8349,38353,12860,9960,2900,12860,94900,2014
26009,48.9,23368,22254,62,439,6710,46480,9593,8223,1370,9593,136800,2014
26011,47.7,15564,14831,180,267,4337,38129,6409,5356,1053,6409,87800,2014
26013,43.2,8740,6433,1521,107,1883,40935,3055,2538,517,3055,86500,2014
26015,42.1,59107,56212,276,1435,16204,53730,22700,18600,4100,22700,135900,2014
26017,42.3,107074,97250,1298,5233,28334,45715,43712,34145,9567,43712,93300,2014
26019,47.9,17450,16485,92,350,4845,47620,7388,6250,1138,7388,147400,2014
26021,41.3,155992,117817,23277,7566,40217,44701,60320,43397,16923,60320,130700,2014
26023,40.3,43965,40168,1060,1828,10934,42538,15863,12329,3534,15863,94800,2014
26025,40,135150,107276,14377,6279,34234,43199,52842,36908,15934,52842,97100,2014
26027,43.7,52001,45303,2547,1661,13821,45166,19804,16461,3343,19804,121100,2014
26029,46.4,26038,24595,88,418,7087,46709,10518,8545,1973,10518,149700,2014
26031,48.4,25821,23893,112,287,7543,39486,11250,9195,2055,11250,110800,2014
26033,39,38698,27460,2490,588,8954,40828,14382,10114,4268,14382,101500,2014
26035,46.2,30786,29305,148,535,8614,33264,13208,10585,2623,13208,79300,2014
26037,39.1,76479,69141,1178,3197,19940,60381,28568,22868,5700,28568,155000,2014
26039,48.6,13941,13352,68,221,3914,42666,5781,4738,1043,5781,97000,2014
26041,46.3,36841,34581,117,362,9878,42070,15695,12340,3355,15695,99400,2014
26043,46.2,26097,25062,123,320,7476,44350,11263,9249,2014,11263,86800,2014
26045,40.8,108081,90967,6521,5441,28686,55223,43562,31137,12425,43562,133400,2014
26047,43.9,32922,30173,217,473,9202,51113,13612,10438,3174,13612,165500,2014
26049,39.1,418654,303735,84672,13171,107638,41879,165962,115167,50795,165962,88300,2014
26051,48.7,25599,24751,131,324,7328,37725,10827,9151,1676,10827,99000,2014
26053,48,16042,14501,699,171,4018,34021,6916,5265,1651,6916,66900,2014
26055,41.5,88981,82634,1218,2202,22548,52487,34833,26373,8460,34833,167600,2014
26057,39,42057,36601,2413,2324,10063,41833,14705,10941,3764,14705,87300,2014
26059,41.7,46282,44204,276,917,12012,42183,17632,13717,3915,17632,100600,2014
26061,32.9,36739,34095,292,492,8029,36443,13941,9633,4308,13941,89900,2014
26063,47.7,32525,31181,110,671,9093,41290,13965,11358,2607,13965,92100,2014
26065,31.4,282562,202627,30469,21130,61600,45278,109806,63961,45845,109806,117700,2014
26067,37.3,63976,56645,2357,2941,15832,48100,22140,17367,4773,22140,109100,2014
26069,51.7,25504,24180,164,473,6967,36928,11361,9122,2239,11361,86300,2014
26071,52.9,11615,11108,85,181,3160,35689,5415,4596,819,5415,75800,2014
26073,26,70506,61155,1698,2489,13734,37615,24773,14682,10091,24773,120600,2014
26075,40.2,159927,136532,13267,5103,40140,45452,60485,43916,16569,60485,110500,2014
26077,34,254870,201538,27857,11091,59913,46356,100042,64147,35895,100042,135400,2014
26079,43.9,17204,16380,114,269,4538,39986,7123,5755,1368,7123,95200,2014
26081,34.7,615381,463842,57483,61036,154265,52716,230895,159706,71189,230895,136700,2014
26083,53.2,2197,2151,20,10,622,39180,1021,906,115,1021,101400,2014
26085,51,11431,9780,975,268,2591,28872,4308,3475,833,4308,74100,2014
26087,42.8,88155,81632,1052,3807,24238,53016,32510,27026,5484,32510,131100,2014
26089,51.6,21739,19723,118,834,6340,56521,9136,7805,1331,9136,239100,2014
26091,40.6,99257,86607,2187,7585,25185,48118,37859,29241,8618,37859,113900,2014
26093,41.8,183264,174098,752,3806,51219,73694,68279,57856,10423,68279,183800,2014
26095,45.2,6512,5167,604,84,1483,36398,2345,1737,608,2345,78300,2014
26097,50.3,11080,8314,159,155,3177,38690,5066,3872,1194,5066,119100,2014
26099,40.6,849344,697439,82850,20209,223286,54059,334508,248285,86223,334508,121300,2014
26101,48,24545,22087,667,686,6669,40408,10452,8273,2179,10452,107200,2014
26103,39.3,67535,62610,1105,890,15842,45066,26693,18539,8154,26693,127200,2014
26105,45.5,28705,26462,209,1208,8147,42156,12133,9102,3031,12133,118600,2014
26107,34.8,43226,39703,1157,845,9989,40396,15529,11468,4061,15529,110700,2014
26109,47.2,23838,22383,104,339,6757,41293,10668,8622,2046,10668,94400,2014
26111,40.7,83620,77115,1087,1909,22950,52613,33709,25318,8391,33709,128000,2014
26113,42.6,14986,14255,30,358,4102,40983,5925,4831,1094,5925,99800,2014
26115,41.4,150851,138946,3429,4885,41216,54911,58328,46182,12146,58328,137500,2014
26117,39.9,63046,58159,1295,2010,16214,40739,23219,18411,4808,23219,94800,2014
26119,53.9,9506,9172,19,110,2614,36448,3985,3482,503,3985,94800,2014
26121,39,171328,132044,23023,8688,44041,41842,64889,48481,16408,64889,98600,2014
26123,42.1,48126,43642,636,2747,12805,42640,18157,15081,3076,18157,100400,2014
26125,40.7,1220798,903320,166763,44312,320035,66436,489797,347091,142706,489797,170600,2014
26127,42.3,26325,21823,90,3706,6969,40969,9668,7779,1889,9668,104200,2014
26129,48.6,21373,20460,54,360,6096,35850,9398,7729,1669,9398,88100,2014
26131,54.8,6448,6193,37,65,1880,35365,3201,2789,412,3201,69300,2014
26133,42.4,23327,22252,150,361,6095,38899,8847,6981,1866,8847,89000,2014
26135,50.8,8525,8212,28,98,2419,33240,3743,3165,578,3743,81300,2014
26137,43.8,24126,22997,71,337,6568,47693,9811,7729,2082,9811,119200,2014
26139,34.7,269795,229370,3480,24466,70480,58160,95304,74072,21232,95304,153500,2014
26141,52.5,13128,12670,56,129,3943,40404,6091,5313,778,6091,93400,2014
26143,54.2,24141,23174,65,316,7078,33540,11796,9489,2307,11796,90600,2014
26145,40,197727,138758,36008,15768,49847,43566,77589,56490,21099,77589,94800,2014
26147,42.4,161008,147894,3585,4888,43466,48703,64182,49086,15096,64182,119700,2014
26149,39,60998,53401,1681,4221,15898,44145,22856,17255,5601,22856,105800,2014
26151,43.6,42301,39919,219,1503,10688,41578,16177,13038,3139,16177,94400,2014
26153,49.6,8345,7221,40,72,2211,35955,3495,2872,623,3495,87700,2014
26155,41.3,69553,65848,399,1814,19272,47723,27435,21027,6408,27435,104700,2014
26157,42.9,54795,51476,601,1670,14983,44017,21318,17442,3876,21318,93400,2014
26159,40.9,75569,62022,2807,8065,19552,46536,28178,22018,6160,28178,119200,2014
26161,33.3,351454,250800,41877,14963,78243,60805,136471,82742,53729,136471,199200,2014
26163,37.7,1790078,890991,707129,97635,418894,41421,667553,426418,241135,667553,83200,2014
26165,41.7,32699,31102,136,563,8640,40368,12662,9605,3057,12662,95000,2014
27001,52.6,15964,15101,67,169,4953,42036,7637,6311,1326,7637,165400,2014
27003,37.6,336316,283649,15858,12814,88350,70464,123446,99878,23568,123446,186800,2014
27005,42.6,32971,28755,144,520,9166,51470,13534,10714,2820,13534,173400,2014
27007,33.4,45236,33330,363,828,11118,43990,16793,11758,5035,16793,147200,2014
27009,35,38980,36239,954,713,10158,53006,15466,10776,4690,15466,155500,2014
27011,49.5,5180,5043,14,56,1547,47537,2316,1844,472,2316,93900,2014
27013,30.3,64720,58444,1876,1809,14467,50977,24719,16259,8460,24719,159100,2014
27015,43.2,25513,24192,98,904,6780,49527,10749,8353,2396,10749,123000,2014
27017,40.9,35430,31423,450,551,9062,53429,13542,10590,2952,13542,158400,2014
27019,36.9,94212,84985,1010,3805,25578,86391,33813,27463,6350,33813,264900,2014
27021,48,28499,24108,91,429,8902,45567,12876,10404,2472,12876,172800,2014
27023,43.1,12235,11062,91,663,3320,51523,5050,3662,1388,5050,103900,2014
27025,39.5,53798,50767,612,936,14218,70223,19757,16711,3046,19757,190300,2014
27027,32.1,60249,54177,939,2351,14610,55582,22545,15657,6888,22545,155500,2014
27029,42.1,8735,7523,17,134,2450,45105,3539,2829,710,3539,115000,2014
27031,51.2,5197,4502,50,84,1666,51913,2627,1926,701,2627,243700,2014
27033,43.8,11676,10282,65,799,3256,47350,4855,3782,1073,4855,86500,2014
27035,43.5,62900,60150,479,761,17750,49186,26654,19969,6685,26654,177400,2014
27037,37.3,405521,329291,20340,25636,108210,74995,155220,116845,38375,155220,220500,2014
27039,37.7,20246,18869,107,962,5509,68587,7491,6306,1185,7491,160200,2014
27041,44.1,36413,35231,186,449,10351,52485,15639,11922,3717,15639,189800,2014
27043,46.5,14337,13236,54,856,4158,45601,6311,4870,1441,6311,84500,2014
27045,43,20842,20304,74,223,5698,51576,8424,6648,1776,8424,138700,2014
27047,44.5,31034,27179,297,2837,8220,45569,13077,9935,3142,13077,102700,2014
27049,42.6,46336,43020,557,1402,12601,57229,18743,14264,4479,18743,179900,2014
27051,46.8,5977,5760,6,105,1757,49632,2576,2084,492,2576,96000,2014
27053,36.1,1184091,838600,139307,80333,280638,65033,484868,306288,178580,484868,227400,2014
27055,44.8,18859,18269,44,139,5336,53359,7862,6314,1548,7862,155900,2014
27057,47.5,20518,19205,127,349,5982,46412,8740,7103,1637,8740,171300,2014
27059,38.7,38190,36186,216,650,10123,59588,13958,11363,2595,13958,167500,2014
27061,45.7,45303,41901,178,514,12904,47122,18821,15079,3742,18821,152000,2014
27063,43.8,10260,9612,14,322,2962,50907,4442,3426,1016,4442,100100,2014
27065,43.2,16084,15363,27,253,4272,46872,6256,4929,1327,6256,139000,2014
27067,40.1,42316,35641,1197,4763,11558,52043,16885,12532,4353,16885,162000,2014
27069,48.1,4501,4349,19,84,1192,48893,1917,1557,360,1917,68100,2014
27071,47.2,13138,12322,96,34,3598,41725,6006,4587,1419,6006,100200,2014
27073,49.5,7096,6829,34,111,2088,48426,3094,2505,589,3094,81300,2014
27075,49.5,10791,10408,11,120,3242,46850,5010,4115,895,5010,155100,2014
27077,48.9,3976,3767,35,42,1113,45119,1700,1480,220,1700,117600,2014
27079,40.8,27717,25556,136,1508,7699,60296,11007,8965,2042,11007,181500,2014
27081,46.8,5821,5655,28,94,1613,49122,2469,1999,470,2469,90400,2014
27083,34.8,25724,22370,673,1594,6387,51182,10076,6805,3271,10076,134700,2014
27085,39.6,36172,33496,133,1855,10114,56234,14727,11211,3516,14727,151400,2014
27087,36.4,5486,2650,32,139,1402,39924,2018,1466,552,2018,97800,2014
27089,43.9,9447,8908,32,364,2635,53311,4072,3289,783,4072,90500,2014
27091,45.6,20515,19354,72,766,5631,52579,8780,6698,2082,8780,103900,2014
27093,41.8,23147,22005,70,769,6478,54049,9279,7324,1955,9279,156000,2014
27095,40,25891,23317,162,438,6885,48763,10249,7546,2703,10249,141900,2014
27097,41.2,33054,31864,123,447,9060,48080,13494,10844,2650,13494,152200,2014
27099,39,39312,32525,969,4293,9912,47623,15511,11155,4356,15511,108300,2014
27101,47.4,8586,8124,28,265,2431,53426,3768,3098,670,3768,97000,2014
27103,35,32923,29935,798,1311,8350,59963,12410,9087,3323,12410,168600,2014
27105,36.8,21589,13756,845,5287,5471,50340,7838,5624,2214,7838,107300,2014
27107,45.6,6725,6105,29,302,1785,46758,2776,2223,553,2776,84000,2014
27109,36.6,147431,121524,7477,6501,38177,67089,57799,42723,15076,57799,171200,2014
27111,46.7,57417,53992,615,1643,16417,50914,24163,19117,5046,24163,162000,2014
27113,39.3,14041,12850,214,444,3536,47381,5822,4345,1477,5822,113400,2014
27115,43.2,29347,26427,588,766,7591,44680,11616,9150,2466,11616,141600,2014
27117,42.2,9407,8614,97,408,2611,46800,3998,2954,1044,3998,89500,2014
27119,39.7,31630,28271,344,1809,8154,51025,12642,9055,3587,12642,130500,2014
27121,45.9,10946,10630,55,111,3141,51789,4772,3770,1002,4772,146500,2014
27123,34.6,521265,340704,56314,37850,120014,55460,206156,122256,83900,206156,194000,2014
27125,42.1,4071,3802,33,117,1114,47198,1721,1395,326,1721,89200,2014
27127,43.2,15834,13892,97,390,4144,47999,6463,5091,1372,6463,90400,2014
27129,44.3,15326,13803,108,1114,4196,52000,6378,5026,1352,6378,96500,2014
27131,35.7,64829,54871,2270,5064,15785,60365,22498,16972,5526,22498,187100,2014
27133,41.6,9587,9102,45,220,2634,48403,3933,2970,963,3933,123700,2014
27135,41.2,15545,14533,86,140,4401,52256,6351,4945,1406,6351,108900,2014
27137,40.8,200563,184200,3055,2731,50285,47138,85033,60312,24721,85033,137200,2014
27139,35.3,135129,113076,3823,6204,35379,86510,46214,38775,7439,46214,244700,2014
27141,35,89770,83124,1770,2083,23124,73621,30283,24667,5616,30283,188600,2014
27143,40.9,15096,13601,46,1184,4011,56317,6025,4774,1251,6025,132000,2014
27145,33.6,151728,136308,5363,4458,36988,55455,56750,40533,16217,56750,166300,2014
27147,39.7,36472,32175,853,2508,9704,55764,14339,11011,3328,14339,150600,2014
27149,32.9,9748,8818,54,376,2212,51181,3665,2486,1179,3665,134900,2014
27151,44.5,9602,9008,113,382,2682,49752,4230,3129,1101,4230,93000,2014
27153,42.7,24588,22662,88,1310,6712,45432,9951,8092,1859,9951,129700,2014
27155,48.7,3455,3187,5,59,974,48750,1534,1238,296,1534,69300,2014
27157,43.5,21485,20470,90,613,6201,55994,8929,7385,1544,8929,156200,2014
27159,43.7,13754,13103,140,206,3620,38661,5737,4272,1465,5737,115500,2014
27161,38.8,19127,17155,426,1056,5108,53830,7405,5771,1634,7405,141100,2014
27163,38.7,244103,207059,8880,8870,65784,83182,89898,72540,17358,89898,240200,2014
27165,39.7,11151,8461,21,2428,2956,50638,4499,3299,1200,4499,94400,2014
27167,43.4,6561,6231,24,151,1795,52361,2763,2119,644,2763,111400,2014
27169,33.9,51285,47321,682,1343,11273,48476,19081,13407,5674,19081,154700,2014
27171,35.3,127386,118814,1324,3368,34013,73085,45064,37958,7106,45064,192800,2014
27173,43.1,10233,9317,28,416,2859,52160,4193,3292,901,4193,97600,2014
28001,40.6,32189,12258,18185,1453,7657,28435,12081,7968,4113,12081,86800,2014
28003,40,37279,31160,4200,1090,9830,33790,14651,10310,4341,14651,82100,2014
28005,44.8,12957,7408,5478,45,3019,29580,5073,4262,811,5073,67600,2014
28007,40.4,19303,10655,8077,353,5072,31671,7341,5199,2142,7341,71800,2014
28009,39.6,8573,5157,3140,176,2029,29132,3040,2524,516,3040,74300,2014
28011,34.6,33961,11074,21794,695,8021,29255,12377,6960,5417,12377,84900,2014
28013,40.5,14841,9735,4047,815,3931,29893,5913,4214,1699,5913,62100,2014
28015,43.6,10418,6740,3517,42,2799,34060,3788,3202,586,3788,74600,2014
28017,38,17376,9064,7514,659,4539,31301,6560,4878,1682,6560,65300,2014
28019,42.8,8399,5685,2633,37,2198,30768,3415,2455,960,3415,65100,2014
28021,32.3,9396,1301,7882,92,1914,23917,3163,2421,742,3163,54300,2014
28023,40.7,16509,10501,5875,96,4524,31478,6454,5417,1037,6454,58200,2014
28025,39,20414,8094,11870,246,5823,32844,7765,5455,2310,7765,78800,2014
28027,33.5,25527,5803,19346,86,6171,27735,9350,5028,4322,9350,58100,2014
28029,37.9,29028,13161,14792,806,6954,35199,10004,7637,2367,10004,80700,2014
28031,38,19495,12018,6859,398,4739,32162,6959,5711,1248,6959,72300,2014
28033,35.7,166266,114442,38200,8250,44492,58995,58957,43640,15317,58957,151200,2014
28035,31.2,76159,44037,27739,2557,17281,36538,27661,15442,12219,27661,115300,2014
28037,42.3,7944,5052,2828,10,2570,35995,3347,2657,690,3347,71500,2014
28039,36.3,22960,20242,1824,487,5697,42472,7574,6518,1056,7574,93800,2014
28041,36.4,14308,10188,3620,144,2957,37412,4257,3634,623,4257,84300,2014
28043,40.5,21660,12084,9300,34,5137,33067,7581,5704,1877,7581,88800,2014
28045,41.2,45136,38568,3875,1555,12787,44069,18413,13543,4870,18413,127800,2014
28047,35.4,193642,127572,43703,10332,48330,42285,74369,43926,30443,74369,139600,2014
28049,33.6,246364,66608,172062,3801,58146,38021,88321,52808,35513,88321,107000,2014
28051,33.2,18965,3095,15668,41,4196,21399,6396,4263,2133,6396,47900,2014
28053,35.2,9106,2026,6840,214,1960,24387,3051,1686,1365,3051,63200,2014
28055,38.5,1279,423,855,1,262,29583,427,276,151,427,63500,2014
28057,40,23415,21375,1523,325,6277,36740,8852,6898,1954,8852,81300,2014
28059,37.6,140194,96894,30260,7087,34567,49145,50388,35809,14579,50388,120500,2014
28061,41.8,16687,7663,8781,143,4868,32261,6923,5670,1253,6923,70600,2014
28063,37.4,7634,1048,6558,0,1715,23480,2553,1610,943,2553,62400,2014
28065,42.5,12100,4649,7384,31,3304,27063,4947,3901,1046,4947,77600,2014
28067,36.7,68273,44598,19532,2992,17547,38044,24352,17849,6503,24352,85600,2014
28069,37.8,10310,3589,5978,294,2242,30206,3661,2847,814,3661,65800,2014
28071,27.6,50256,35381,12163,1145,9877,41343,16557,9825,6732,16557,151700,2014
28073,33.7,58038,43647,11695,1336,15463,51724,21578,14468,7110,21578,161300,2014
28075,37.3,80261,43000,33855,1601,19669,37165,29662,19301,10361,29662,87800,2014
28077,40.8,12636,8328,4076,85,3573,37477,4829,3817,1012,4829,84700,2014
28079,34.4,23368,11294,9666,1002,5833,32953,8165,6029,2136,8165,74200,2014
28081,36.3,84588,57184,23141,2076,22571,43240,31733,21951,9782,31733,111300,2014
28083,32.6,31772,7734,22693,761,6983,24475,10891,5516,5375,10891,70000,2014
28085,38.1,34824,23469,10686,370,9631,35502,13091,9712,3379,13091,84200,2014
28087,36,59736,31629,26342,1029,15309,38672,23431,14528,8903,23431,113400,2014
28089,36.7,98622,55001,37704,2825,26212,63156,36699,26192,10507,36699,204100,2014
28091,38.4,26449,17213,8513,357,7291,29010,9903,7509,2394,9903,77500,2014
28093,39.5,36636,17761,17232,1209,9683,39137,13221,10238,2983,13221,88300,2014
28095,40,36383,24447,11206,373,9939,36708,13777,10612,3165,13777,77900,2014
28097,41.7,10634,5594,5003,0,2902,30993,4169,3124,1045,4169,73300,2014
28099,35.4,29596,17621,6310,532,7522,36830,10833,7996,2837,10833,78400,2014
28101,37.8,21671,13562,6605,330,6024,38265,8113,6260,1853,8113,71800,2014
28103,36.6,11240,2996,8079,104,2984,26231,4193,2928,1265,4193,64800,2014
28105,25.3,48639,27964,17989,771,9378,32348,17778,9329,8449,17778,134600,2014
28107,36.4,34507,16620,17232,547,7630,36651,11868,8911,2957,11868,78400,2014
28109,40.6,55293,45276,7360,1657,14649,40997,20615,15714,4901,20615,112400,2014
28111,39.4,12173,9396,2632,6,3119,33097,4387,3684,703,4387,76900,2014
28113,36.9,40209,18188,20908,523,9562,31926,14809,9957,4852,14809,79600,2014
28115,36.4,30374,23636,4435,1853,7448,40991,10223,7754,2469,10223,81300,2014
28117,39,25338,21151,3574,325,6995,33811,9749,7142,2607,9749,76400,2014
28119,38.5,7902,2255,5502,89,1969,24212,3092,2051,1041,3092,53800,2014
28121,36.5,145483,109915,28248,3792,39328,58811,53527,39987,13540,53527,151100,2014
28123,35.7,28312,14376,10626,2995,6917,34555,9767,7208,2559,9767,69000,2014
28125,40.3,4898,1379,3447,48,1135,30688,1798,1075,723,1798,59100,2014
28127,37.9,27425,16971,9580,436,6775,36097,9820,7609,2211,9820,76900,2014
28129,39.7,16344,12199,4034,35,4634,37356,6204,5109,1095,6204,76800,2014
28131,37.1,17941,13852,3331,279,4368,45141,5763,4735,1028,5763,107400,2014
28133,33.7,28314,7112,20609,411,5839,27941,8451,4946,3505,8451,70600,2014
28135,35.1,15124,5484,7204,2098,3019,31860,4519,3425,1094,4519,66700,2014
28137,36.8,28557,18702,8746,681,7197,42902,10017,7219,2798,10017,114900,2014
28139,38.3,22069,17162,3274,1051,6365,35024,8488,6402,2086,8488,77700,2014
28141,42.9,19532,18266,482,520,5711,34499,7618,5814,1804,7618,74500,2014
28143,32.4,10583,2278,7953,139,2615,31406,4031,1766,2265,4031,77600,2014
28145,37.5,27536,21808,3804,1247,7429,35389,10292,7394,2898,10292,84200,2014
28147,38.7,15126,8006,6719,251,3851,34934,5823,4985,838,5823,87500,2014
28149,37.9,48291,23617,22958,963,12141,40941,18367,11913,6454,18367,103300,2014
28151,35.8,50038,13277,35538,611,12409,28936,18383,10099,8284,18383,74000,2014
28153,37.2,20611,12107,8020,276,5526,29254,8031,6564,1467,8031,69400,2014
28155,41.1,10077,7840,1935,121,3026,33769,4085,3060,1025,4085,71400,2014
28157,35.9,9481,2726,6746,9,2092,32044,3295,2596,699,3295,55100,2014
28159,40.3,18882,9642,8893,204,5451,33969,7658,5331,2327,7658,75900,2014
28161,40.7,12433,7367,4768,184,3263,33900,4808,3596,1212,4808,70400,2014
28163,36,28076,10313,15984,1429,5713,27489,8552,5122,3430,8552,65500,2014
29001,28.8,25642,23547,538,615,5218,34976,9608,5774,3834,9608,102700,2014
29003,42,17373,16586,137,352,4689,53986,6710,5196,1514,6710,125300,2014
29005,46.6,5520,5357,30,64,1538,44216,2465,1700,765,2465,79900,2014
29007,39.2,25637,22630,1509,684,6215,43139,9381,6839,2542,9381,91700,2014
29009,43,35681,31332,18,2934,9314,38789,13398,10090,3308,13398,108800,2014
29011,40.8,12286,11509,27,271,3665,38792,5009,3745,1264,5009,87000,2014
29013,41.8,16780,15952,113,326,4434,39744,6784,4886,1898,6784,100200,2014
29015,52.1,18961,18128,51,318,5641,33145,8273,6951,1322,8273,105400,2014
29017,42.9,12394,12027,41,110,3290,38906,4790,3913,877,4790,96800,2014
29019,29.9,168268,135326,14613,5259,38125,49059,66136,37513,28623,66136,165900,2014
29021,36.8,89536,76174,4275,5103,20828,44971,33359,21225,12134,33359,108600,2014
29023,40,42957,38519,2247,708,11155,36160,16773,11089,5684,16773,91700,2014
29025,41.9,9176,8755,68,164,2589,41740,3696,2667,1029,3696,88900,2014
29027,38.3,44483,40290,1719,796,10658,48264,16497,12258,4239,16497,122400,2014
29029,49.4,43873,41655,200,1066,12382,43498,17419,13694,3725,17419,167100,2014
29031,35.9,77031,67202,5657,1634,19081,45849,29672,19175,10497,29672,138000,2014
29033,42.2,9157,8690,81,120,2376,42582,3652,2809,843,3652,80900,2014
29035,40.7,6283,5955,37,119,1498,32656,2456,1761,695,2456,102900,2014
29037,39,100339,89328,3717,4145,27419,61046,37503,28713,8790,37503,156000,2014
29039,43.8,13912,13288,35,173,3667,29872,5893,4267,1626,5893,87800,2014
29041,45.6,7727,7412,166,61,1958,40195,2956,2287,669,2956,71500,2014
29043,37.3,79856,74963,528,2147,22808,52693,29994,22209,7785,29994,141700,2014
29045,43.5,7001,6821,34,33,1811,43497,2859,2161,698,2859,78600,2014
29047,36.5,227984,189492,12036,14269,59465,61184,87352,61993,25359,87352,153600,2014
29049,41,20545,19326,394,369,5976,53361,8067,5909,2158,8067,136700,2014
29051,37.6,76426,62672,8640,1985,19323,53228,29307,19876,9431,29307,146700,2014
29053,38.8,17585,15651,1006,255,4383,44102,6520,4611,1909,6520,125800,2014
29055,41.1,24680,23733,65,396,6395,35829,9427,6969,2458,9427,106200,2014
29057,46.9,7678,7256,43,130,2166,36209,3166,2507,659,3166,78700,2014
29059,42.7,16632,15760,8,288,4819,38314,6348,5032,1316,6348,94600,2014
29061,40.4,8324,8049,59,107,2219,42188,3134,2419,715,3134,102800,2014
29063,40.7,12824,10648,1384,244,2539,44936,3778,2474,1304,3778,114300,2014
29065,43.5,15681,14923,76,190,4204,37658,5889,4212,1677,5889,88900,2014
29067,46.7,13575,13279,0,136,3620,30879,5156,3962,1194,5156,97300,2014
29069,39.7,31778,26052,3291,1887,8273,31777,12727,7940,4787,12727,69900,2014
29071,39.9,101682,97228,1175,1561,28222,48661,39733,29994,9739,39733,147500,2014
29073,45.7,15014,14532,91,180,4125,42574,6333,4821,1512,6333,116300,2014
29075,41.6,6792,6619,47,53,1786,40591,2725,2031,694,2725,83700,2014
29077,35.6,280657,249670,8440,9040,69160,40512,116632,69036,47596,116632,128000,2014
29079,42.1,10279,9816,66,118,2736,37167,4150,2853,1297,4150,75900,2014
29081,42.1,8795,8452,76,163,2390,39342,3574,2617,957,3574,68400,2014
29083,43.8,22134,20921,326,419,6083,39880,9545,6938,2607,9545,93200,2014
29085,53.6,9420,9029,26,116,2801,31897,4134,3436,698,4134,101200,2014
29087,47,4695,4550,30,13,1397,41842,2164,1518,646,2164,80600,2014
29089,39.4,10183,9249,512,137,2496,44081,3779,2880,899,3779,94100,2014
29091,39.8,40469,38438,114,735,10917,33006,16060,10951,5109,16060,99600,2014
29093,43.5,10424,9892,187,150,2830,37259,4158,2949,1209,4158,80700,2014
29095,36.4,678167,426956,159940,57972,161777,46917,271965,163850,108115,271965,125800,2014
29097,35.4,116996,99976,2506,8408,29310,40914,45236,29351,15885,45236,102000,2014
29099,38.4,220558,209644,1871,3748,59714,55563,81504,66678,14826,81504,150200,2014
29101,29.6,53879,46871,2388,1946,13065,49978,19912,12091,7821,19912,142400,2014
29103,44.3,4078,3945,51,17,1175,35597,1742,1302,440,1742,67000,2014
29105,39.3,35544,33469,189,762,9920,38693,13745,9679,4066,13745,99900,2014
29107,40.8,33069,30621,697,802,9144,51195,13072,10032,3040,13072,116900,2014
29109,39.3,38306,34609,45,2577,10250,40496,14616,10406,4210,14616,92500,2014
29111,39.3,10176,9425,269,166,2494,43000,3842,2798,1044,3842,84300,2014
29113,36.3,53458,50090,975,1108,13514,53280,18521,14406,4115,18521,145500,2014
29115,42.7,12494,11953,59,213,3079,37264,4769,3580,1189,4769,73200,2014
29117,42,15034,14119,353,210,3678,44754,5674,4014,1660,5674,98400,2014
29119,37.2,22851,18238,299,2590,5656,38122,8208,5782,2426,8208,84200,2014
29121,42.3,15527,14643,434,174,3888,36878,6231,4638,1593,6231,83800,2014
29123,42.9,12353,11829,74,252,3275,37648,4536,3436,1100,4536,89600,2014
29125,43.8,9098,8782,27,95,2622,41492,3718,2782,936,3718,113200,2014
29127,39.7,28844,26141,1515,434,7517,41732,11287,7577,3710,11287,102500,2014
29129,43.9,3735,3619,15,47,960,38925,1537,1139,398,1537,71300,2014
29131,40.5,24905,23764,113,410,6610,36592,9710,7564,2146,9710,115800,2014
29133,39.2,14276,10369,3417,263,3363,28436,5249,3278,1971,5249,58800,2014
29135,37.8,15719,14138,574,664,3892,47386,5487,4042,1445,5487,110500,2014
29137,44.7,8725,8209,260,91,2320,40342,3559,2679,880,3559,90200,2014
29139,42.9,12054,11442,100,186,3358,40114,4892,3671,1221,4892,102800,2014
29141,46.6,20314,19270,257,381,5267,34179,8021,6248,1773,8021,110300,2014
29143,40.6,18568,14994,2960,260,5035,34224,7283,4443,2840,7283,74600,2014
29145,39.6,58683,51148,570,2775,15853,42939,22197,16419,5778,22197,107000,2014
29147,28.3,23296,21727,610,333,4699,36237,8636,4747,3889,8636,110100,2014
29149,45.5,10975,10405,19,154,2807,29385,4509,3473,1036,4509,77200,2014
29151,39.6,13812,13494,91,95,3648,52479,5113,4203,910,5113,129000,2014
29153,50.1,9612,9225,15,145,3084,31833,4284,3348,936,4284,87800,2014
29155,37.4,18010,12476,4840,392,4346,30840,6914,3836,3078,6914,65500,2014
29157,39.6,19042,18259,82,374,5331,50817,7443,5762,1681,7443,123200,2014
29159,37.5,42213,36371,1075,3312,11069,39624,16250,11164,5086,16250,100100,2014
29161,33.7,45091,40323,1004,1036,10423,41942,16737,10249,6488,16737,111800,2014
29163,40,18573,16482,1060,374,4548,40120,6630,4813,1817,6630,90300,2014
29165,38.2,92149,76686,5605,4973,24609,68638,36842,23749,13093,36842,186300,2014
29167,38.1,31122,29342,287,632,8051,39336,11813,7953,3860,11813,112700,2014
29169,26.9,53343,37820,5728,5316,10122,49604,15528,8149,7379,15528,126000,2014
29171,45.8,4911,4778,27,49,1432,36886,2245,1610,635,2245,85000,2014
29173,44.5,10224,9826,75,118,3009,47837,4034,3275,759,4034,109100,2014
29175,38.3,25207,22588,1428,446,5739,39316,8640,6208,2432,8640,85500,2014
29177,40.7,23166,21881,316,483,6203,51585,8741,6658,2083,8741,117700,2014
29179,46.1,6644,6330,62,124,1740,34432,2672,2102,570,2672,84500,2014
29181,41.8,14056,13445,9,161,3805,31473,5434,4043,1391,5434,74000,2014
29183,37.3,369781,327256,16553,10938,100010,72100,137483,109958,27525,137483,188100,2014
29185,49.1,9609,9128,85,190,2596,31875,4057,3147,910,4057,81400,2014
29186,42.6,18017,17314,87,168,5050,46244,7218,5886,1332,7218,126700,2014
29187,38.9,65813,60830,2965,880,16304,37476,24868,16496,8372,24868,99600,2014
29189,40.2,1000423,681762,232243,26205,261998,59520,402629,284905,117724,402629,173000,2014
29195,37.9,23363,19142,1269,2115,5765,39027,8865,5983,2882,8865,85500,2014
29197,41,4388,4294,31,16,1208,36060,1745,1276,469,1745,84500,2014
29199,39.1,4862,4765,42,44,1265,39450,1885,1411,474,1885,72600,2014
29201,39.8,39137,33004,4357,789,10812,39076,15361,10463,4898,15361,94300,2014
29203,44.3,8360,7897,28,150,2242,33583,3311,2570,741,3311,84200,2014
29205,42.6,6218,6026,82,79,1646,38935,2539,1857,682,2539,72000,2014
29207,42,29864,28684,402,427,7852,39229,12069,8636,3433,12069,87000,2014
29209,50.9,31593,30211,19,591,9325,40136,13101,10426,2675,13101,150500,2014
29211,40.9,6551,5213,64,1190,1687,37198,2617,1805,812,2617,77100,2014
29213,41.6,53086,47911,355,2715,13669,37249,20632,12659,7973,20632,124400,2014
29215,41.8,25796,23650,648,489,6318,35822,9217,6899,2318,9217,100300,2014
29217,40.7,20984,19861,161,385,5547,40508,8101,5607,2494,8101,86600,2014
29219,40.2,32847,30357,630,1011,8969,52512,12337,9790,2547,12337,151800,2014
29221,39.9,25113,23785,488,99,6491,34282,9062,7056,2006,9062,74500,2014
29223,46.6,13430,12902,60,80,3756,33072,5528,4225,1303,5528,70500,2014
29225,37.9,36461,34586,428,659,9447,45798,12681,9398,3283,12681,117000,2014
29227,47.9,2102,2068,0,15,553,42905,892,666,226,892,60600,2014
29229,41.2,18565,17771,86,283,5084,30029,7321,5359,1962,7321,90100,2014
29510,34.4,318727,136440,152808,11659,65229,34800,139594,61727,77867,139594,118600,2014
30001,42.8,9294,8560,4,340,2420,42577,4124,2665,1459,4124,172800,2014
30003,29.7,13079,3906,0,634,2754,42650,3503,2228,1275,3503,88400,2014
30005,34.5,6576,3121,8,140,1504,37065,2234,1423,811,2234,78400,2014
30007,45.6,5697,5363,36,60,1709,48211,2469,1955,514,2469,178800,2014
30009,49,10189,9699,0,231,2743,48979,4305,3322,983,4305,212300,2014
30011,49.7,1205,1193,0,8,330,44453,489,405,84,489,81500,2014
30013,38.1,81953,70970,1085,3090,21214,45091,33685,21665,12020,33685,159900,2014
30015,41.1,5859,4444,0,111,1603,41270,2323,1472,851,2323,115100,2014
30017,41.2,11869,11078,42,312,3023,46125,4919,3399,1520,4919,123700,2014
30019,50.3,1813,1746,0,41,519,48643,882,685,197,882,102100,2014
30021,41.7,9219,8628,55,220,2678,49955,3884,2695,1189,3884,147900,2014
30023,46.3,9243,8433,108,276,2262,41015,3909,2852,1057,3909,124700,2014
30025,39.8,3028,2920,33,22,810,51595,1197,850,347,1197,122800,2014
30027,48.4,11496,10894,13,219,3084,42865,4988,3636,1352,4988,120200,2014
30029,41.9,92373,86406,204,2288,24432,46858,37073,25985,11088,37073,226700,2014
30031,33,93108,86437,308,2742,22562,54298,37495,22987,14508,37495,263200,2014
30033,46.1,1097,1073,0,5,319,51000,450,348,102,450,115000,2014
30035,31,13641,4332,40,319,2685,33493,4121,2416,1705,4121,85800,2014
30037,52.6,738,700,0,8,209,42083,319,242,77,319,86000,2014
30039,53.3,3133,2989,2,55,934,49583,1396,1037,359,1396,209000,2014
30041,34.6,16434,11752,56,480,4114,44368,6125,4144,1981,6125,125600,2014
30043,47.6,11465,10725,48,241,3235,61460,4497,3784,713,4497,239500,2014
30045,50.3,2023,1980,0,20,585,45670,899,665,234,899,117000,2014
30047,41.7,28987,19413,25,1122,7941,38492,11916,8373,3543,11916,218000,2014
30049,41,64772,59565,261,1791,16437,55594,26553,19004,7549,26553,204600,2014
30051,47,2235,2146,6,16,556,46250,829,545,284,829,88200,2014
30053,50.4,19455,18242,26,495,5298,35603,8900,6956,1944,8900,160500,2014
30055,50.8,1758,1684,0,23,509,48194,762,616,146,762,109800,2014
30057,51.4,7723,7315,47,214,2016,44764,3389,2533,856,3389,230800,2014
30059,48.3,2026,1985,0,29,529,38144,795,593,202,795,123400,2014
30061,51.5,4230,4118,35,40,891,33060,1582,1195,387,1582,171300,2014
30063,34.4,111011,100271,455,3205,26735,47029,45961,27203,18758,45961,237300,2014
30065,48.9,4760,4454,46,62,1346,45096,1965,1460,505,1965,135500,2014
30067,46.3,15642,14789,30,383,3766,42506,6539,4895,1644,6539,210100,2014
30069,48.3,489,465,17,7,151,40250,220,165,55,220,76800,2014
30071,47.9,4194,3601,0,76,1229,38426,1794,1345,449,1794,95900,2014
30073,42.2,6211,5065,25,105,1476,40969,2306,1584,722,2306,105800,2014
30075,52,1710,1598,0,30,488,44167,748,520,228,748,99700,2014
30077,45.6,7010,6362,27,154,1537,41326,2399,1691,708,2399,118300,2014
30079,53.7,1282,1224,0,7,344,40580,525,456,69,525,82900,2014
30081,46.8,40640,37931,112,1283,10809,38366,16839,12016,4823,16839,233400,2014
30083,39.3,10686,9813,47,427,2743,61438,4294,2898,1396,4294,160700,2014
30085,30.4,10861,3941,11,108,2034,36825,3142,1875,1267,3142,81500,2014
30087,36.8,9335,5521,29,370,2317,50924,3323,2239,1084,3323,120200,2014
30089,50.9,11373,10266,15,264,3404,31665,5153,3860,1293,5153,172100,2014
30091,47.7,3510,3258,4,56,1030,47348,1625,1194,431,1625,121700,2014
30093,40.8,34462,31574,147,1348,8614,37503,15275,9778,5497,15275,122100,2014
30095,47.3,9214,8703,32,259,2668,58326,3723,2933,790,3723,189200,2014
30097,44.4,3622,3394,7,85,995,51797,1381,1005,376,1381,195800,2014
30099,44.9,6075,5747,4,86,1571,45572,2339,1781,558,2339,135600,2014
30101,41.5,5208,4626,8,165,1327,46917,1990,1205,785,1990,107400,2014
30103,51.3,761,678,0,49,226,40682,340,221,119,340,70600,2014
30105,45.8,7518,6460,11,132,2042,49198,3181,2243,938,3181,110900,2014
30107,49.9,2126,2044,0,20,569,33825,901,605,296,901,81500,2014
30109,49.5,987,966,0,21,280,39097,437,317,120,437,107900,2014
30111,38.1,151965,133145,957,7608,38402,51743,61385,42037,19348,61385,186500,2014
31001,38.1,31396,27604,231,2641,8029,51342,12580,8904,3676,12580,101900,2014
31003,46.7,6531,6262,5,192,1980,45417,2824,2133,691,2824,77800,2014
31005,38.4,476,472,0,0,121,41103,189,114,75,189,85000,2014
31007,49.3,788,725,14,39,234,46875,310,212,98,310,93300,2014
31009,39.4,594,587,0,0,175,48214,250,130,120,250,92000,2014
31011,46.1,5404,5307,5,76,1522,47450,2236,1766,470,2236,86500,2014
31013,40.8,11308,9421,13,1267,3160,49367,4807,3075,1732,4807,93000,2014
31015,51.2,2067,2002,16,12,578,40083,948,753,195,948,54100,2014
31017,47.1,3090,3003,1,30,1028,34645,1509,1012,497,1509,73100,2014
31019,32.5,47388,41819,411,3812,11528,52562,18018,11570,6448,18018,142800,2014
31021,47.9,6690,6297,54,171,1939,46988,2882,2225,657,2882,85300,2014
31023,44.5,8312,7959,67,224,2415,49241,3556,2721,835,3556,101200,2014
31025,41.5,25315,24006,233,701,7004,65560,9754,7849,1905,9754,148300,2014
31027,44.8,8736,8511,12,132,2390,49507,3528,2851,677,3528,96300,2014
31029,43.3,3990,3443,1,486,1169,48450,1698,1318,380,1698,87900,2014
31031,44.4,5749,5138,3,136,1820,46817,2603,1673,930,2603,106900,2014
31033,39.8,10044,9060,26,636,2768,54094,4382,2932,1450,4382,108400,2014
31035,43.8,6425,5765,35,541,1872,50682,2624,2023,601,2624,80100,2014
31037,34.9,10512,5806,159,4459,2617,52086,3670,2728,942,3670,87200,2014
31039,43.8,9081,8122,5,811,2633,49872,3834,2648,1186,3834,90700,2014
31041,44.2,10820,10374,50,247,3250,44336,4746,3481,1265,4746,83700,2014
31043,32.6,20902,11082,886,7631,5451,48508,7248,4696,2552,7248,107700,2014
31045,34.7,9141,7916,63,357,2227,41267,3745,2371,1374,3745,108700,2014
31047,36.3,24205,15038,988,7892,6265,48104,8731,5970,2761,8731,89700,2014
31049,47.3,1951,1761,0,165,519,50764,840,641,199,840,67100,2014
31051,41.8,5900,5123,8,675,1658,49634,2348,1799,549,2348,78800,2014
31053,39.8,36742,31803,147,3924,10051,47991,15162,10096,5066,15162,110100,2014
31055,33.8,531057,378929,59094,61516,127760,53444,206522,127777,78745,206522,143300,2014
31057,47.5,1966,1821,1,124,612,47636,888,576,312,888,70000,2014
31059,47,5767,5490,33,198,1612,52063,2430,1855,575,2430,76700,2014
31061,49.6,3161,3068,8,44,949,45707,1405,1170,235,1405,56100,2014
31063,44.5,2540,2477,0,21,701,48713,1079,814,265,1079,84000,2014
31065,46.8,4908,4674,6,147,1387,40765,2215,1630,585,2215,61400,2014
31067,44.4,21889,20904,28,422,5906,49021,9119,6582,2537,9119,107900,2014
31069,51.3,1939,1844,0,33,582,41410,878,696,182,878,73300,2014
31071,50.5,1954,1917,9,17,525,41776,870,660,210,870,84800,2014
31073,45.1,1997,1942,0,39,534,50063,749,562,187,749,104000,2014
31075,48,649,636,0,13,185,45268,273,187,86,273,47200,2014
31077,46.2,2500,2412,13,50,679,43226,1028,823,205,1028,59300,2014
31079,35.9,60223,42478,1270,15022,14839,49178,22418,14326,8092,22418,118300,2014
31081,42.8,9098,8742,39,229,2618,58382,3564,2844,720,3564,111600,2014
31083,49.7,3462,3295,4,94,959,46859,1518,1193,325,1518,73800,2014
31085,47.4,1145,1081,2,61,354,48750,462,320,142,462,70900,2014
31087,48.9,2884,2767,6,67,805,35938,1351,985,366,1351,56900,2014
31089,45.5,10432,9932,4,366,2914,45782,4424,3280,1144,4424,94500,2014
31091,57.2,688,661,0,20,205,38011,309,250,59,309,72300,2014
31093,43.6,6315,6071,7,137,1723,48750,2605,1980,625,2605,100600,2014
31095,46,7505,7121,1,237,2159,44449,3319,2601,718,3319,68000,2014
31097,43.6,5178,4234,279,493,1190,44057,1927,1405,522,1927,76800,2014
31099,41,6560,6162,6,301,1824,55670,2646,1881,765,2646,100700,2014
31101,48.5,8206,7524,7,498,2370,42326,3769,2610,1159,3769,95000,2014
31103,52.5,741,732,1,0,246,39028,375,285,90,375,74300,2014
31105,46.1,3760,3372,16,264,995,42219,1628,1084,544,1628,75100,2014
31107,47.4,8573,7480,10,196,2430,43709,3721,2750,971,3721,79500,2014
31109,32.8,293726,245460,10848,18340,70894,51916,116533,69281,47252,116533,150000,2014
31111,39.1,36054,32164,280,2811,9562,49250,15032,10086,4946,15032,113100,2014
31113,45,736,707,2,19,205,45179,322,223,99,322,102400,2014
31115,48.3,559,523,0,11,182,55125,244,191,53,244,75400,2014
31117,46,426,418,0,4,152,57763,188,129,59,188,132700,2014
31119,37.1,35103,28849,430,4812,9240,47622,14049,9001,5048,14049,115300,2014
31121,43.1,7790,7284,45,298,2173,49637,3331,2424,907,3331,83900,2014
31123,41.9,4918,4108,13,699,1357,45000,2028,1395,633,2028,80600,2014
31125,46,3667,3569,3,85,1023,46220,1548,1187,361,1548,71000,2014
31127,39.8,7214,6840,93,162,1822,47875,2898,2016,882,2898,90200,2014
31129,49.6,4431,4257,2,102,1381,42404,2054,1525,529,2054,54700,2014
31131,42,15750,14356,28,998,4400,51316,6448,4821,1627,6448,117200,2014
31133,48.3,2754,2680,0,48,798,38462,1292,980,312,1292,56700,2014
31135,44.3,2938,2809,4,103,829,56333,1244,968,276,1244,88300,2014
31137,41.8,9189,8604,9,441,2535,51396,3769,2746,1023,3769,106400,2014
31139,41.8,7201,7006,11,105,2039,52178,2908,2307,601,2908,98500,2014
31141,38.1,32485,26804,97,4988,8460,55391,12666,9111,3555,12666,122700,2014
31143,45.8,5307,5031,3,180,1532,54375,2238,1675,563,2238,97600,2014
31145,42.1,10993,10194,140,512,2944,43627,4661,3373,1288,4661,84000,2014
31147,47.3,8237,7662,3,134,2261,40765,3715,2783,932,3715,67900,2014
31149,50.6,1436,1377,10,4,439,48854,692,551,141,692,63500,2014
31151,36,14317,10652,110,3113,3543,46814,5156,3395,1761,5156,94800,2014
31153,33.5,165955,137714,6587,13038,44893,70121,60844,42508,18336,60844,162100,2014
31155,41.3,20867,20032,112,428,5588,60487,8070,6336,1734,8070,147300,2014
31157,38.6,36844,27420,207,8084,9691,46443,14659,10127,4532,14659,104100,2014
31159,38.5,16939,16214,87,339,4437,59503,6224,4560,1664,6224,142700,2014
31161,46,5342,4446,24,204,1440,40489,2292,1575,717,2292,67600,2014
31163,49.2,3120,3029,34,48,895,46301,1343,1058,285,1343,83900,2014
31165,49.5,1279,1188,0,66,383,40625,557,409,148,557,86600,2014
31167,39.3,6112,5679,29,300,1748,53532,2312,1917,395,2312,101200,2014
31169,48.9,5194,5001,0,41,1563,45213,2331,1824,507,2331,60100,2014
31171,44.5,747,719,0,4,230,52105,324,236,88,324,84300,2014
31173,28.6,6934,2690,23,275,1471,40494,2076,1335,741,2076,68800,2014
31175,46.5,4269,4147,1,61,1317,42708,1901,1382,519,1901,77600,2014
31177,41,20264,19363,127,471,5657,68207,7794,6217,1577,7794,173500,2014
31179,29.6,9488,8656,219,486,2299,53808,3548,2265,1283,3548,107800,2014
31181,47.6,3733,3475,4,153,976,41107,1555,1195,360,1555,67700,2014
31183,48.3,848,835,0,12,230,44107,388,297,91,388,87400,2014
31185,41.2,13797,12745,70,603,3685,50922,5599,3810,1789,5599,112600,2014
32001,39,24347,18294,518,3119,6259,46195,9431,5688,3743,9431,144900,2014
32003,36.1,2003613,931696,206624,596587,462416,52070,715415,379677,335738,715415,163100,2014
32005,48.5,47135,38624,200,5470,13586,58940,19765,14050,5715,19765,267200,2014
32007,33.4,50991,34654,492,12059,12742,72280,17587,12515,5072,17587,183900,2014
32009,47.6,1041,831,0,157,242,31528,467,279,188,467,70900,2014
32011,41.6,1761,1665,9,52,459,68403,769,525,244,769,89300,2014
32013,35.3,17003,11419,75,4272,4056,62632,6092,4441,1651,6092,152900,2014
32015,37.7,5930,4169,8,1379,1463,76558,2075,1650,425,2075,104700,2014
32017,35.8,5282,4403,128,472,1288,40550,1916,1238,678,1916,139500,2014
32019,42.6,51579,39785,483,7891,13470,47143,19728,14185,5543,19728,129300,2014
32021,47.1,4627,2817,80,614,1067,38664,1917,1287,630,1917,84400,2014
32023,50.3,42938,33469,1127,6026,11904,41757,17803,12524,5279,17803,102300,2014
32027,41.3,6741,4534,265,1533,1548,48165,2111,1396,715,2111,119900,2014
32029,54.2,3934,3579,21,163,1148,64835,1823,1694,129,1823,181300,2014
32031,37.5,429985,279817,9268,98671,101752,52910,164461,93950,70511,164461,201100,2014
32033,39.6,10043,7509,387,1434,2075,55337,3373,2466,907,3373,120700,2014
32510,42.3,54634,37927,818,12150,13023,50108,21225,12346,8879,21225,188000,2014
33001,45.5,60252,57369,433,872,16949,60782,25010,18725,6285,25010,220600,2014
33003,49.7,47623,45902,131,587,14114,52393,21279,16937,4342,21279,225400,2014
33005,41.7,76596,72673,589,1195,19403,56139,30659,21599,9060,30659,191200,2014
33007,47.9,32202,30777,345,459,9082,42407,14395,10120,4275,14395,127600,2014
33009,41.5,89360,81945,679,1791,21892,55045,35127,23876,11251,35127,212800,2014
33011,39.9,402776,349690,7588,22706,104236,70906,154236,103198,51038,154236,245900,2014
33013,42.2,146880,137700,1544,2632,37907,65226,57040,41063,15977,57040,227300,2014
33015,43.1,297702,278950,2049,6998,81809,79368,117284,89850,27434,117284,279800,2014
33017,36.9,124387,114548,975,2487,30008,59580,46891,30591,16300,46891,217900,2014
33019,44.8,43291,41392,155,574,11828,56851,17659,13201,4458,17659,170700,2014
34001,40.5,275325,158304,40358,48865,67414,54392,101166,68479,32687,101166,230200,2014
34003,41.4,920456,554930,48700,160193,240414,83686,335671,217432,118239,335671,443500,2014
34005,40.9,450155,312829,70793,31743,115647,79612,164736,127555,37181,164736,247800,2014
34007,38.2,512632,302836,93339,76956,125928,61842,187121,126719,60402,187121,202900,2014
34009,48,96286,83088,4226,6504,26685,57394,41069,30930,10139,41069,307000,2014
34011,36.7,157429,77180,29839,44369,35157,50603,50399,33568,16831,50399,165700,2014
34013,36.7,789616,255623,307806,168373,180154,54499,277745,125432,152313,277745,358100,2014
34015,39.4,289705,231868,28680,15120,75799,76213,104435,83464,20971,104435,219000,2014
34017,34.5,654878,194006,73368,279712,151838,58973,246135,78706,167429,246135,337900,2014
34019,44.5,126746,110636,2999,7213,34329,106519,46951,39343,7608,46951,393500,2014
34021,38.3,369526,195590,72365,58733,88753,74118,131475,85625,45850,131475,280400,2014
34023,37.6,824046,387573,74558,158164,204678,80118,282182,183878,98304,282182,325000,2014
34025,42,629702,479949,42498,63488,162376,85605,233730,174727,59003,233730,386900,2014
34027,41.8,497103,365232,15095,60488,128869,99142,179776,135820,43956,179776,426700,2014
34029,42.8,581413,496484,16851,50206,148949,61839,221720,179925,41795,221720,264100,2014
34031,36.4,505403,221995,56112,194313,118219,59513,162097,87790,74307,162097,343100,2014
34033,41.7,65501,49796,9063,4882,16930,60768,24665,17479,7186,24665,189300,2014
34035,40.7,328704,198187,28478,44972,84439,100903,115941,89848,26093,115941,396500,2014
34037,42.8,146888,129351,2747,10105,40051,87397,54248,45642,8606,54248,277600,2014
34039,38,545236,235384,111077,157092,132464,69396,185688,111028,74660,185688,353300,2014
34041,42.1,107624,90727,4307,8293,28982,70934,41548,30525,11023,41548,261000,2014
35001,36.3,671429,273655,16978,325447,162829,48390,263719,164510,99209,263719,185500,2014
35003,56.8,3651,2764,23,733,851,39342,1440,1256,184,1440,159000,2014
35005,34.8,65850,27902,1073,35258,16435,40541,23506,15372,8134,23506,99100,2014
35006,36.2,27392,5816,210,10206,5716,36279,8354,6245,2109,8354,86700,2014
35007,47.1,13264,6446,53,6392,3303,35189,5369,3629,1740,5369,117300,2014
35009,30.7,50173,25384,2925,19839,12290,40318,18223,10830,7393,18223,129000,2014
35011,47.9,1967,1117,0,769,362,37961,601,497,104,601,84800,2014
35013,32.5,212942,62649,3223,141087,51778,38426,74623,48287,26336,74623,137300,2014
35015,36.7,54834,27741,783,24840,14050,51303,20190,14849,5341,20190,116200,2014
35017,46.4,29303,14057,55,14326,7441,38923,12229,9245,2984,12229,128800,2014
35019,40.9,4594,860,110,3490,789,27957,1269,995,274,1269,81500,2014
35021,56.7,655,411,0,242,129,31500,212,176,36,212,63800,2014
35023,41.2,4734,1994,13,2678,1293,35048,1858,1255,603,1858,75700,2014
35025,31.5,66876,27156,2061,35747,16070,55248,21331,15050,6281,21331,101400,2014
35027,50.2,20162,13017,91,6208,5306,41710,8640,6703,1937,8640,155400,2014
35028,43.1,17974,13424,89,2830,5080,105989,7495,5619,1876,7495,280700,2014
35029,38.8,24947,8454,252,15802,5651,28489,9120,6149,2971,9120,84700,2014
35031,30.7,73082,7407,428,10083,12479,29812,17862,13042,4820,17862,70600,2014
35033,44.1,4722,718,3,3981,823,24425,1525,1191,334,1525,81500,2014
35035,35.6,65415,33794,2350,23230,16209,40614,23907,15475,8432,23907,101400,2014
35037,46,8822,4802,44,3839,1925,29042,3319,2506,813,3319,73000,2014
35039,39.5,40155,5273,158,28676,9240,38635,14245,11109,3136,14245,140900,2014
35041,29.2,20065,10963,467,8013,4722,36567,7198,4259,2939,7198,115800,2014
35043,38.7,135191,62387,2672,49157,34078,57092,47965,38853,9112,47965,175800,2014
35045,33.7,127358,52636,620,24659,29896,48824,40693,29769,10924,40693,144100,2014
35047,41.8,28899,5595,387,22235,6260,28292,11306,8227,3079,11306,117700,2014
35049,43.9,146361,63500,944,74650,35835,52958,61313,42533,18780,61313,272700,2014
35051,55.5,11774,7929,26,3394,2467,28855,4686,3558,1128,4686,91100,2014
35053,36.1,17608,6468,161,8629,3158,33570,5161,3740,1421,5161,112500,2014
35055,46.5,32956,11853,155,18497,7694,35823,13239,9603,3636,13239,211900,2014
35057,43.2,16037,8746,213,6449,3882,34720,5656,4548,1108,5656,107400,2014
35059,40.2,4413,2426,112,1785,975,36176,1602,1016,586,1602,90200,2014
35061,38.2,76480,26947,840,45018,19121,42012,26828,21182,5646,26828,133500,2014
36001,37.9,306124,229001,36544,16336,68646,59940,122945,72312,50633,122945,208600,2014
36003,38.3,48387,45906,643,716,12025,42726,18407,13492,4915,18407,69100,2014
36005,33.1,1413566,148383,421860,767506,317195,34284,480323,91797,388526,480323,366400,2014
36007,39.9,198797,169705,9038,7227,47828,46368,79438,52527,26911,79438,108300,2014
36009,41.3,79397,72600,1116,1467,20176,43503,31798,22808,8990,31798,83000,2014
36011,42.3,79481,72295,3137,2049,19904,51792,30907,22243,8664,30907,109000,2014
36013,41.2,133556,118294,3101,8786,33715,42720,54226,37908,16318,54226,84100,2014
36015,40.9,88681,77064,4927,2459,22181,49685,35390,24160,11230,35390,97800,2014
36017,43.5,49868,47481,328,987,12645,44427,19560,14818,4742,19560,91800,2014
36019,39.6,81829,74113,3273,2164,20660,50985,31976,21830,10146,31976,125200,2014
36021,46.5,62525,54827,2463,2607,16349,58625,25095,18067,7028,25095,222800,2014
36023,36,49231,45720,732,1221,10791,48404,18045,11936,6109,18045,105200,2014
36025,46,47223,43818,837,1611,11936,44183,19370,14372,4998,19370,133600,2014
36027,40.8,297388,218651,27492,32858,72043,72471,106898,74252,32646,106898,282100,2014
36029,40.5,920694,708775,118479,44600,231034,51050,381783,248724,133059,381783,126700,2014
36031,45.6,39072,36142,1089,1101,9901,50322,15571,11451,4120,15571,145800,2014
36033,39.9,51508,42240,2878,1636,12386,47110,19131,13711,5420,19131,98500,2014
36035,42.4,54870,51326,822,1412,14500,45722,22440,15541,6899,22440,107500,2014
36037,42.3,59702,54388,1557,1723,16069,50573,23967,17513,6454,23967,105200,2014
36039,44.9,48618,42044,2791,2510,11661,49864,18102,13605,4497,18102,174200,2014
36041,52.1,4783,4597,20,56,1068,52939,1639,1341,298,1639,163100,2014
36043,42.8,64329,61198,583,1193,17146,45649,26583,18688,7895,26583,95100,2014
36045,31.9,118885,99243,5825,7809,30290,48613,44822,24989,19833,44822,135200,2014
36047,34.3,2570801,917093,812960,506015,584552,46958,925371,273246,652125,925371,557500,2014
36049,41.1,27164,26122,283,424,7583,46990,10726,8131,2595,10726,111900,2014
36051,39.9,64867,59351,1494,2016,15841,52200,24242,17903,6339,24242,119200,2014
36053,40.1,72731,68124,1288,1414,17582,53584,26407,19969,6438,26407,122400,2014
36055,38.5,748076,538244,108352,57682,182388,52501,298915,192943,105972,298915,136600,2014
36057,41,49951,42000,771,5972,12411,44167,19655,13231,6424,19655,101100,2014
36059,41.3,1350601,860218,145909,207996,338607,98401,441912,354515,87397,441912,447700,2014
36061,36.6,1618398,766835,206839,416166,308525,71656,745089,168410,576679,745089,838400,2014
36063,42.3,214973,186633,15355,5171,55365,49091,88252,62584,25668,88252,106700,2014
36065,41.2,233944,196031,13087,11677,56133,48931,90821,60334,30487,90821,111900,2014
36067,38.7,467846,366731,49849,20281,113521,54498,185089,120750,64339,185089,134200,2014
36069,42.9,108975,99273,2240,4237,28683,57318,44198,32297,11901,44198,140100,2014
36071,36.8,374518,251231,34933,70307,89532,70794,124901,86907,37994,124901,268500,2014
36073,41.7,42492,36980,2434,1848,10713,48015,15894,12178,3716,15894,91300,2014
36075,38.9,121659,115240,943,2710,30134,47646,45300,32686,12614,45300,92900,2014
36077,41.2,61778,56916,1081,2052,14962,47884,23798,17601,6197,23798,139000,2014
36079,42.6,99697,81421,1922,12304,26280,96262,34164,28245,5919,34164,362400,2014
36081,37.5,2280602,604615,399864,634930,526083,57210,780069,341857,438212,780069,446800,2014
36083,40,159600,135552,8024,6642,39416,60140,63995,41710,22285,63995,177700,2014
36085,39,471522,298156,45139,83366,122414,74043,165079,113493,51586,165079,439600,2014
36087,36.4,318186,204269,36140,52289,74461,85808,98394,67926,30468,98394,424400,2014
36089,37.8,112015,103494,2299,2309,26465,44454,41579,29367,12212,41579,86200,2014
36091,41.5,222512,204848,3269,6019,58078,70581,89876,64107,25769,89876,230900,2014
36093,39.7,155178,117712,14524,9601,35512,57025,57846,38571,19275,57846,166900,2014
36095,43.4,32153,30137,475,946,8168,51873,12739,9723,3016,12739,146200,2014
36097,44.9,18458,17660,121,288,4914,49225,7759,6056,1703,7759,99700,2014
36099,42.4,35232,31692,1631,1045,8258,48932,13485,9861,3624,13485,95400,2014
36101,41.8,98917,93041,1633,1478,25890,47733,41285,28949,12336,41285,89800,2014
36103,40.3,1500373,1054366,106447,261177,372094,88323,496780,393936,102844,496780,376800,2014
36105,41.8,76892,56797,6002,10985,18190,49388,28954,18857,10097,28954,168800,2014
36107,43.5,50464,48240,383,768,14022,56167,20178,15840,4338,20178,110500,2014
36109,29.8,103179,81157,3982,4706,20181,52836,38340,21501,16839,38340,171000,2014
36111,42.9,181598,146692,9269,16841,43630,58592,69388,48242,21146,69388,226600,2014
36113,45,65388,61952,732,1305,17710,56601,27699,19389,8310,27699,191800,2014
36115,42.7,62910,58519,1692,1519,16682,51494,24165,17757,6408,24165,144100,2014
36117,42.7,92887,84118,2986,3629,25081,51597,36479,28461,8018,36479,110400,2014
36119,40.3,962319,539425,128170,219725,238605,83422,342956,212162,130794,342956,509200,2014
36121,41.2,41679,37506,2286,1281,10482,53012,15691,11759,3932,15691,101800,2014
36123,40.9,25281,24181,223,489,6720,50061,9642,7452,2190,9642,121600,2014
37001,39.1,153713,102201,27485,17799,40955,42592,61046,40306,20740,61046,135800,2014
37003,41.5,37175,32528,2327,1616,9330,41676,13721,10678,3043,13721,120700,2014
37005,47.6,10974,9615,114,1008,3305,35319,4752,3605,1147,4752,145500,2014
37007,40,26309,11987,12792,861,6261,33388,9549,6630,2919,9549,78700,2014
37009,46.4,27173,25242,176,1354,8320,36244,11746,9013,2733,11746,151300,2014
37011,43.1,17739,15005,768,818,4858,38138,7174,5487,1687,7174,144700,2014
37013,44.4,47587,31512,12092,3390,12354,40671,18894,13264,5630,18894,116600,2014
37015,44,20677,7206,12833,318,4940,29388,7662,5607,2055,7662,79300,2014
37017,42,34915,18963,12124,2582,9430,29532,14407,9824,4583,14407,86100,2014
37019,49.2,112907,91603,11973,5555,33716,46955,48331,36390,11941,48331,179800,2014
37021,41,244599,205639,15048,15238,60222,45642,101645,65000,36645,101645,189500,2014
37023,42.4,90164,74205,5638,5018,23243,37735,34597,24789,9808,34597,111700,2014
37025,37.2,184855,129927,29335,17927,47599,53935,65693,47653,18040,65693,167700,2014
37027,42,82140,72489,3913,3924,20641,34853,31354,22358,8996,31354,107000,2014
37029,41.1,10127,8103,1388,247,2807,62194,3609,3075,534,3609,216000,2014
37031,46,67851,58835,3947,2622,18980,47179,29352,20612,8740,29352,193500,2014
37033,44.5,23357,14292,7768,787,6112,38318,8608,6442,2166,8608,97700,2014
37035,40.5,154457,119555,12993,13294,40559,45397,58424,41052,17372,58424,133100,2014
37037,45.5,66050,47041,8302,8456,18289,57140,26474,20785,5689,26474,219000,2014
37039,49.2,27156,24974,460,729,7131,34507,10503,8660,1843,10503,137800,2014
37041,45.3,14703,8925,4820,469,4090,37154,6036,4030,2006,6036,138000,2014
37043,50.4,10616,10162,68,294,2906,36089,4351,3406,945,4351,146400,2014
37045,40.9,97464,71984,20092,2924,25001,39197,37407,25553,11854,37407,104100,2014
37047,40.9,57512,34629,17383,2712,14385,34597,22131,15276,6855,22131,83600,2014
37049,35.8,104574,69793,21855,6986,27672,47295,39930,25294,14636,39930,153500,2014
37051,31,324002,149239,114443,33555,80421,44778,122288,65642,56646,122288,128600,2014
37053,42.2,24212,21282,1504,798,6753,58676,9124,7432,1692,9124,223600,2014
37055,44.3,34530,30386,1013,2317,9869,55520,14852,10259,4593,14852,284400,2014
37057,41,163545,133437,14990,10710,44583,42866,64254,46621,17633,64254,131500,2014
37059,43.4,41411,35189,2768,2592,11367,49591,16117,12951,3166,16117,164100,2014
37061,38.1,59455,31111,15073,12543,15108,34787,22027,14748,7279,22027,86000,2014
37063,34.1,282422,118843,105182,37889,67146,52038,113564,61774,51790,113564,180200,2014
37065,40.1,55779,20762,31655,2191,14192,33892,20987,13146,7841,20987,81700,2014
37067,37.6,358130,208339,92253,43929,89246,46003,141901,89518,52383,141901,150300,2014
37069,40,61723,39177,15798,4868,16564,42763,23395,17387,6008,23395,127200,2014
37071,39.5,208379,156042,31215,12809,53615,42158,79209,53135,26074,79209,124000,2014
37073,42.9,11877,7431,3973,205,3345,49894,4508,3618,890,4508,144500,2014
37075,43.5,8743,7748,25,236,2452,37161,3392,2780,612,3392,122300,2014
37077,41,57955,33999,17877,4250,13942,49655,19983,14920,5063,19983,137800,2014
37079,39.1,21353,10125,7640,3128,4886,39498,7143,4979,2164,7143,86100,2014
37081,36.8,500899,265471,163193,36976,125059,45050,198560,119336,79224,198560,155500,2014
37083,42.1,53803,21138,27637,1310,14262,32834,21554,13480,8074,21554,86400,2014
37085,33.4,121789,77263,24886,13858,30050,44417,41601,27488,14113,41601,133400,2014
37087,46.6,59012,55192,585,2066,17511,41795,26261,19133,7128,26261,157200,2014
37089,46.1,108642,91222,3308,10701,30091,46257,45534,33544,11990,45534,181600,2014
37091,42,24460,8256,14319,794,5841,32201,8700,5543,3157,8700,81300,2014
37093,31.1,50034,20489,16184,6199,12337,43754,16534,11010,5524,16534,143500,2014
37095,44.4,5757,3309,2110,304,1508,44425,2112,1615,497,2112,80500,2014
37097,39.6,162999,125706,19697,11533,43973,51889,60277,43904,16373,60277,168000,2014
37099,36.2,40598,32999,852,2089,9692,36705,15872,10534,5338,15872,173200,2014
37101,37.1,175343,121668,25917,22991,46346,49799,61333,43725,17608,61333,143500,2014
37103,44.7,10184,6296,3147,415,2789,37288,4113,2905,1208,4113,97300,2014
37105,37.3,59096,34619,11382,11258,14805,46309,21239,14270,6969,21239,132900,2014
37107,41.3,59095,30029,23343,4140,15563,35687,23571,14181,9390,23571,92600,2014
37109,41.7,79041,67572,4035,5502,22251,48664,30114,23392,6722,30114,152700,2014
37111,42.8,44982,39826,1693,2470,11642,36271,17142,12027,5115,17142,101300,2014
37113,48.6,33840,30463,166,2213,10064,38491,15504,11370,4134,15504,166800,2014
37115,43.7,20951,19747,314,493,5711,38251,8353,6074,2279,8353,158100,2014
37117,45.1,23947,12475,10361,812,6336,36132,9465,6673,2792,9465,86200,2014
37119,34.3,968500,480033,294076,120368,231837,56472,371921,218221,153700,371921,181800,2014
37121,46.2,15380,14389,123,673,4518,37487,6396,4980,1416,6396,122500,2014
37123,40.5,27626,17603,4840,4048,6922,32715,10625,7391,3234,10625,88600,2014
37125,45.1,90579,70140,11156,5553,24661,50393,36947,27594,9353,36947,199000,2014
37127,40.5,95174,50224,35769,6108,24232,43341,37159,23814,13345,37159,119200,2014
37129,37.7,209586,160866,29987,11208,50752,49582,87176,50174,37002,87176,212300,2014
37131,46.5,21310,8253,12004,371,5594,31468,8564,6098,2466,8564,82800,2014
37133,25.9,182921,124000,27949,20552,44079,46141,61147,32832,28315,61147,154100,2014
37135,33.2,137275,96189,15657,11310,31197,57261,51419,31024,20395,51419,272700,2014
37137,49.4,13062,9711,2476,428,3695,44762,5145,4088,1057,5145,159700,2014
37139,37.4,40233,22084,14947,1757,10210,45664,14608,9243,5365,14608,162800,2014
37141,42,54218,40151,9377,3389,13883,44526,20154,15614,4540,20154,154500,2014
37143,47.2,13507,9649,3325,298,3963,45391,5473,4213,1260,5473,163000,2014
37145,42,39303,26117,10754,1634,10685,43381,15326,10996,4330,15326,113600,2014
37147,31.4,172438,97411,58423,9802,40016,42011,66427,35836,30591,66427,133400,2014
37149,50.5,20352,17965,1052,1140,5759,47534,8764,6635,2129,8764,173600,2014
37151,40.2,142276,114805,7730,15306,38444,41782,54254,40168,14086,54254,119400,2014
37153,39.8,46317,26956,13917,2843,11767,34060,18260,11689,6571,18260,79500,2014
37155,35,134913,36087,32423,10936,32364,30581,45446,29097,16349,45446,67600,2014
37157,43.1,92602,67740,16891,5306,25780,38946,37691,26384,11307,37691,105600,2014
37159,40,138246,101320,22160,10983,35669,41925,52002,35265,16737,52002,128700,2014
37161,42.9,67181,56401,6565,2536,18890,36863,26778,19315,7463,26778,106500,2014
37163,38.9,63842,33645,16419,11141,15798,35731,23413,16337,7076,23413,87700,2014
37165,38.8,36034,16225,13863,919,8599,30834,12931,8315,4616,12931,78700,2014
37167,41.6,60553,49625,6396,2279,16184,42010,23484,17020,6464,23484,128000,2014
37169,44.3,46858,42900,1817,1290,13639,41944,18855,14989,3866,18855,116700,2014
37171,42,73391,62099,2637,7305,20252,35894,29380,21160,8220,29380,114100,2014
37173,40.3,14070,9074,385,227,3597,34632,5357,3973,1384,5357,123100,2014
37175,49.9,32943,29331,1198,989,9295,43959,13735,10642,3093,13735,181300,2014
37177,41.8,4219,2406,1187,406,1032,34056,1455,1087,368,1455,101800,2014
37179,36.9,209387,154755,24290,22419,55905,65893,69464,56274,13190,69464,193500,2014
37181,39.2,44998,18653,22385,3118,10743,34075,16651,10656,5995,16651,99800,2014
37183,35,952513,584852,194646,94166,235627,66579,355647,230730,124917,355647,229200,2014
37185,45.5,20628,7866,10354,759,5142,34953,7866,5558,2308,7866,97400,2014
37187,44.3,12837,5803,6434,547,3370,33115,5126,3493,1633,5126,82600,2014
37189,29.3,51903,47861,549,1790,10533,35491,20224,11609,8615,20224,225600,2014
37191,36.7,124093,68108,38523,13040,32019,41172,47480,28781,18699,47480,108000,2014
37193,43.3,69093,61185,2970,3887,18992,32157,27355,20156,7199,27355,110500,2014
37195,39.5,81499,39800,31281,7983,21218,39332,32026,19225,12801,32026,114700,2014
37197,42.2,38101,32527,1245,3886,10518,38652,15174,11684,3490,15174,120300,2014
37199,46,17662,16454,187,825,5167,39008,7230,5478,1752,7230,142800,2014
38001,50.2,2339,2203,8,31,762,48553,1098,793,305,1098,111900,2014
38003,43.1,11096,10487,71,157,3028,54009,4918,3430,1488,4918,92000,2014
38005,31.4,6764,2869,0,121,1634,38729,2331,1514,817,2331,54500,2014
38007,47.5,855,819,4,1,228,64306,361,265,96,361,122500,2014
38009,46.8,6579,6138,45,107,1848,52593,3000,2270,730,3000,94000,2014
38011,44.2,3192,3015,3,122,836,63750,1330,985,345,1330,128700,2014
38013,38.5,2145,1982,10,105,569,55455,988,655,333,988,98400,2014
38015,36.8,86111,78818,597,1343,22475,64370,35767,25225,10542,35767,182300,2014
38017,31.8,158041,141434,4481,3511,36755,52993,67013,35266,31747,67013,164600,2014
38019,50.9,3922,3785,4,0,1142,61989,1759,1529,230,1759,68000,2014
38021,42.7,5234,4944,71,137,1420,50634,2211,1587,624,2211,83800,2014
38023,52.5,2239,2180,8,0,679,58036,1065,878,187,1065,88200,2014
38025,42.5,3965,3290,7,139,1065,69063,1473,1187,286,1473,118700,2014
38027,48.8,2379,2174,0,83,626,47917,1074,788,286,1074,64300,2014
38029,51.2,3491,3458,0,8,1005,40375,1618,1314,304,1618,72700,2014
38031,46.4,3364,3261,3,59,1064,55089,1576,1178,398,1576,91500,2014
38033,42.4,1812,1764,0,10,443,38542,766,553,213,766,95000,2014
38035,29.3,68144,59295,1679,2338,15341,47050,28045,14472,13573,28045,154000,2014
38037,52.6,2363,2279,8,8,687,43317,1137,880,257,1137,71900,2014
38039,52.7,2348,2318,13,4,700,51528,1068,805,263,1068,73500,2014
38041,46.9,2575,2437,17,36,767,51176,1088,881,207,1088,86600,2014
38043,47.5,2434,2313,0,113,816,56058,1097,885,212,1097,76700,2014
38045,48.9,4127,4043,1,25,1225,54393,1898,1487,411,1898,81800,2014
38047,51,1955,1897,7,28,572,49821,866,724,142,866,66100,2014
38049,44.2,5711,5462,5,125,1616,51161,2576,2071,505,2576,89200,2014
38051,52.1,2788,2685,2,8,833,37750,1336,1103,233,1336,57200,2014
38053,34,8333,6365,18,366,1894,67578,2755,1889,866,2755,170800,2014
38055,48.3,9299,8364,3,168,2770,53778,4078,3145,933,4078,117800,2014
38057,46.3,8532,8044,30,163,2460,66712,3666,3020,646,3666,118800,2014
38059,38.9,28428,26112,179,581,7723,58949,11820,9135,2685,11820,156400,2014
38061,35.2,8743,5642,30,435,2178,66250,3108,2124,984,3108,110500,2014
38063,52.2,3078,2933,37,47,908,50640,1499,1209,290,1499,65300,2014
38065,48.1,1832,1701,3,46,547,62708,783,653,130,783,111100,2014
38067,47.2,7266,6773,10,208,2111,51613,3299,2548,751,3299,73800,2014
38069,46.7,4402,4127,9,60,1204,43125,1943,1425,518,1943,85000,2014
38071,42.3,11522,9926,93,222,2841,47361,5003,3181,1822,5003,93500,2014
38073,44.4,5452,5240,28,81,1453,53472,2307,1618,689,2307,98500,2014
38075,43.1,2546,2476,6,4,707,63480,1079,832,247,1079,110700,2014
38077,38.6,16307,15160,92,362,4288,56396,6616,4856,1760,6616,103700,2014
38079,30.2,14341,2871,40,206,3492,32781,4728,3294,1434,4728,64300,2014
38081,45.7,3863,3683,33,87,1086,56845,1712,1333,379,1712,72100,2014
38083,53.2,1320,1294,9,4,438,50395,620,533,87,620,59100,2014
38085,26.7,4317,588,1,131,811,40152,1098,469,629,1098,60900,2014
38087,50,715,704,2,3,222,65577,318,268,50,318,60800,2014
38089,35.8,27038,24791,294,932,6874,70243,10887,7769,3118,10887,182200,2014
38091,47.9,1982,1951,0,31,567,53438,936,683,253,936,77100,2014
38093,41.1,21056,19806,108,398,5405,50926,9050,6059,2991,9050,102000,2014
38095,48.8,2292,2145,0,19,633,56574,1018,791,227,1018,66800,2014
38097,42.2,8106,7623,58,232,2018,53641,3334,2438,896,3334,97800,2014
38099,45.4,11052,9564,20,1111,3105,49780,4922,3700,1222,4922,73300,2014
38101,31.5,65854,57220,1947,2728,15982,59301,25495,15841,9654,25495,171300,2014
38103,51.2,4210,4127,0,15,1285,44770,1970,1532,438,1970,66800,2014
38105,34.3,27066,23878,302,991,6865,82823,11113,7550,3563,11113,174200,2014
39001,40.7,28342,27453,67,240,7478,34733,10734,7618,3116,10734,88300,2014
39003,38.2,105562,86408,12293,2718,26998,43648,40191,27189,13002,40191,106200,2014
39005,40,53202,51249,397,582,14228,47034,20339,14644,5695,20339,119900,2014
39007,41.6,100346,90681,3301,3625,25374,40304,38933,28158,10775,38933,107300,2014
39009,27,64840,58479,1455,1126,12141,33773,22208,12549,9659,22208,113900,2014
39011,40.5,45867,44371,161,601,12565,52773,18115,13468,4647,18115,131500,2014
39013,43.7,69793,65172,2619,529,18254,43045,28007,21001,7006,28007,89700,2014
39015,40.4,44464,43036,438,322,12160,44899,16587,12912,3675,16587,114700,2014
39017,36.2,371154,309318,27805,15699,93895,56998,134934,94319,40615,134934,156300,2014
39019,43.9,28539,27646,204,295,7927,45660,10922,8571,2351,10922,110900,2014
39021,40.6,39628,37200,798,519,11051,49840,15163,11250,3913,15163,121100,2014
39023,41.1,137303,116592,11642,4019,35844,43011,54969,36306,18663,54969,104200,2014
39025,39.2,199450,188212,2659,3244,53163,60552,74187,55451,18736,74187,152400,2014
39027,39.4,41871,39203,1024,636,11295,45909,16052,10464,5588,16052,118300,2014
39029,42.8,106622,100786,2219,1482,28589,43707,42184,30197,11987,42184,97600,2014
39031,41.3,36768,35425,391,313,10017,41569,14561,10757,3804,14561,95600,2014
39033,42.5,43036,41396,334,567,11782,41377,17625,12339,5286,17625,87100,2014
39035,40.4,1267513,769600,370769,64518,308075,44203,534721,321785,212936,534721,123300,2014
39037,41.2,52537,50794,332,705,14124,43323,20929,15064,5865,20929,110000,2014
39039,39.3,38795,33856,642,3593,10814,48853,15332,11448,3884,15332,107400,2014
39041,37.7,181821,159076,6513,4126,49614,91936,65029,53038,11991,65029,248600,2014
39043,43.8,76416,64487,6159,2829,20542,48204,31998,21885,10113,31998,131900,2014
39045,39.1,148067,130917,8867,2818,39454,60704,54581,39153,15428,54581,163300,2014
39047,40.6,28875,26968,539,531,7646,40576,11532,7071,4461,11532,107800,2014
39049,33.8,1197592,794955,251613,59157,277397,51890,474683,258441,216242,474683,150000,2014
39051,39.7,42541,38270,206,3442,12035,52872,16333,12893,3440,16333,128600,2014
39053,40.3,30763,28902,816,331,8090,37494,11502,8645,2857,11502,93000,2014
39055,43.8,93819,89984,1067,1137,25861,70487,34753,29739,5014,34753,219500,2014
39057,37.6,163313,138327,11913,3983,41992,58775,63549,42690,20859,63549,158300,2014
39059,41.9,39794,37884,762,372,10621,40420,15564,11529,4035,15564,94400,2014
39061,37.1,803272,538689,205189,21969,194588,48927,329062,194184,134878,329062,143000,2014
39063,38.9,75290,68062,1051,3605,20068,50166,30795,21758,9037,30795,124500,2014
39065,35.2,31826,30420,274,450,7664,42670,11438,7957,3481,11438,94700,2014
39067,45.4,15698,14968,324,107,4390,41819,6333,4926,1407,6333,86300,2014
39069,40.8,28074,25566,89,1954,7779,52526,11075,8816,2259,11075,110600,2014
39071,39.7,43266,41492,515,339,11609,39855,16837,12002,4835,16837,98900,2014
39073,42.2,29111,28186,214,229,7970,42792,11426,8523,2903,11426,109500,2014
39075,30.1,43176,42313,208,384,10142,47625,12516,9666,2850,12516,155300,2014
39077,38.3,59186,53898,550,3478,15847,49315,22507,16375,6132,22507,115600,2014
39079,39.6,32952,31719,228,301,8980,37393,13204,9089,4115,13204,90700,2014
39081,44.3,68510,62176,3745,842,18402,40816,28176,20067,8109,28176,86300,2014
39083,38.5,61063,58439,522,817,15448,48953,22642,16005,6637,22642,133300,2014
39085,42.9,229602,206752,8166,8504,61501,56809,94089,70466,23623,94089,148200,2014
39087,40.9,62100,58993,1181,499,15928,42981,23622,17499,6123,23622,97300,2014
39089,39.7,167911,154348,5530,2617,44859,55777,64146,46517,17629,64146,150800,2014
39091,40.1,45564,42946,723,591,12905,48416,18471,13647,4824,18471,117100,2014
39093,40.7,302465,241118,23893,26637,80072,52610,117134,83971,33163,117134,138000,2014
39095,37.6,438167,308206,81211,28129,107529,41751,178121,109711,68410,178121,106300,2014
39097,39.9,43326,38797,2611,669,10331,54331,14676,10383,4293,14676,146200,2014
39099,43.2,235809,181869,35408,11861,60643,41350,97624,67194,30430,97624,96900,2014
39101,40.4,66171,59105,3754,1534,16853,42904,24586,16819,7767,24586,97400,2014
39103,41.1,174091,164390,2278,3066,48135,66296,65950,52180,13770,65950,180100,2014
39105,42.1,23564,22873,248,116,6549,35970,9486,7559,1927,9486,83100,2014
39107,39.8,40789,39287,182,666,11146,52033,15923,12320,3603,15923,127200,2014
39109,41.2,103145,96214,2234,1474,27850,51847,41169,29010,12159,41169,134200,2014
39111,45.3,14590,14251,62,86,4150,41394,6056,4687,1369,6056,88300,2014
39113,39.4,534801,386114,110099,13098,133947,43281,222673,137223,85450,222673,110500,2014
39115,43.5,14977,13884,508,106,4366,38696,6056,4663,1393,6056,88600,2014
39117,41,34991,33758,153,446,9312,51444,12640,10335,2305,12640,132600,2014
39119,40.1,85947,79185,2759,743,22872,40937,34160,23084,11076,34160,106300,2014
39121,49.6,14561,13314,898,151,3379,37126,4916,4030,886,4916,83100,2014
39123,47,41304,38347,332,1905,12091,53599,17366,13870,3496,17366,135800,2014
39125,40.6,19293,17920,112,853,5461,45404,7798,5990,1808,7798,94800,2014
39127,39.5,36000,35028,137,237,9902,41892,13637,10029,3608,13637,89900,2014
39129,38.8,56279,52575,1790,684,14115,55678,19435,14272,5163,19435,147500,2014
39131,40.5,28504,27318,233,229,7355,39989,10944,7679,3265,10944,93100,2014
39133,37.6,161553,146586,6373,2395,39892,53027,61042,42175,18867,61042,149300,2014
39135,41.8,41887,40617,237,281,11547,48147,16151,12361,3790,16151,115900,2014
39137,39.6,34256,31905,97,1950,9610,61036,13006,10787,2219,13006,134300,2014
39139,41.2,122813,106097,10360,1937,30971,42042,48211,33204,15007,48211,102400,2014
39141,40.2,77552,69765,4135,836,19424,43450,28209,20067,8142,28209,109400,2014
39143,41.2,60498,51811,1768,5596,16180,46099,23831,17702,6129,23831,109400,2014
39145,39.4,78520,73568,2172,924,18850,36945,29558,20373,9185,29558,90800,2014
39147,39.1,56100,50951,1315,2599,14747,44947,21539,15464,6075,21539,97200,2014
39149,39.1,49165,46043,1147,716,13504,51266,18616,13661,4955,18616,126000,2014
39151,41.6,375090,327840,26357,6596,99047,46290,149756,103910,45846,149756,121700,2014
39153,40.6,541464,427551,76701,9586,138460,50082,220710,147956,72754,220710,133700,2014
39155,43.4,207596,182337,17000,3128,55763,43226,86565,61734,24831,86565,97700,2014
39157,40.9,92616,88382,925,1992,25342,44656,36366,26231,10135,36366,109800,2014
39159,37.6,53090,48630,1114,742,13727,64758,18291,14064,4227,18291,173400,2014
39161,41.5,28612,27144,283,764,7868,46436,11388,8670,2718,11388,90000,2014
39163,40.5,13319,12943,33,12,3630,37984,5137,3848,1289,5137,79400,2014
39165,38.2,217623,191958,7418,5226,58674,73177,77328,59787,17541,77328,187800,2014
39167,43.5,61473,58736,661,563,16307,43512,24923,18790,6133,24923,108200,2014
39169,38.7,114978,108519,1850,1902,30321,49244,42593,31189,11404,42593,135300,2014
39171,41.5,37493,35024,393,1467,9873,42455,15001,11211,3790,15001,96200,2014
39173,35,128139,114444,3091,6340,30995,52758,49561,33286,16275,49561,145700,2014
39175,41.6,22535,21545,69,555,6201,46904,9327,6656,2671,9327,105600,2014
40001,36.8,22380,9398,72,1287,5912,33325,7942,5591,2351,7942,74700,2014
40003,45.5,5703,4515,131,268,1349,47684,2067,1557,510,2067,64000,2014
40005,40.6,13958,10099,558,463,3741,37519,5208,3961,1247,5208,84700,2014
40007,40.5,5581,4182,55,1193,1519,52386,2089,1584,505,2089,87200,2014
40009,34.7,22941,17739,762,2984,5148,49027,7770,4888,2882,7770,110600,2014
40011,42.1,9832,7408,613,871,2468,44183,3703,2704,999,3703,74400,2014
40013,37,43595,31824,824,2305,10659,38743,16713,10631,6082,16713,87900,2014
40015,37.6,29551,17340,814,3193,7063,40170,10245,7296,2949,10245,76200,2014
40017,35.7,122832,96539,2875,9167,31635,64200,42622,32983,9639,42622,141600,2014
40019,38.4,48288,34657,3254,2922,11709,43280,17475,12223,5252,17475,94600,2014
40021,34.7,47860,23753,529,3096,11182,37230,16873,11088,5785,16873,106300,2014
40023,41.3,15175,9523,1583,508,3774,30282,6067,4225,1842,6067,76100,2014
40025,44.8,2390,1823,12,492,676,45647,993,717,276,993,63300,2014
40027,33,264934,197045,11415,19990,65279,55626,98174,65157,33017,98174,142800,2014
40029,42.1,5877,4205,21,193,1610,38141,2346,1690,656,2346,71900,2014
40031,31.4,125647,72959,20541,15165,29105,46302,44104,24745,19359,44104,114400,2014
40033,41.2,6157,4790,115,404,1714,45877,2420,1837,583,2420,74300,2014
40035,43,14792,9627,473,424,3684,38273,5521,4324,1197,5521,88400,2014
40037,40.4,70607,54859,1668,2471,18753,44003,26232,19845,6387,26232,104800,2014
40039,30.6,28506,20371,836,4398,6922,45056,10302,6185,4117,10302,115100,2014
40041,45.7,41415,27040,131,1342,11328,36198,16520,12738,3782,16520,109400,2014
40043,42,4817,4085,3,270,1238,49087,1840,1335,505,1840,77900,2014
40045,44,4113,3653,8,288,1193,50060,1744,1335,409,1744,77500,2014
40047,36.5,61663,48347,1902,6259,16527,46726,23816,15698,8118,23816,93500,2014
40049,39.6,27421,21304,674,1904,6886,38716,10380,7278,3102,10380,85900,2014
40051,38.7,53161,43963,975,2653,14596,51394,19717,14999,4718,19717,108800,2014
40053,45.1,4523,4089,32,176,1276,48345,1966,1478,488,1966,65100,2014
40055,40,6144,4713,457,641,1383,41020,2211,1473,738,2211,66500,2014
40057,41.2,2883,1780,184,756,817,31285,1175,795,380,1175,46400,2014
40059,38.5,3747,2944,2,713,1032,47703,1493,1171,322,1493,69700,2014
40061,39.9,12839,9309,95,466,3331,35764,4806,3507,1299,4806,79600,2014
40063,39.8,13840,9080,763,595,3144,34439,4696,3636,1060,4696,64100,2014
40065,34,26275,16979,1879,5760,6802,42029,10407,6165,4242,10407,88100,2014
40067,42.5,6377,5064,39,574,1700,34080,2473,1854,619,2473,57900,2014
40069,39.7,11043,7811,165,470,2848,37845,4265,3066,1199,4265,77800,2014
40071,39.1,45781,35026,851,3155,11745,41806,18272,12812,5460,18272,76200,2014
40073,38.5,15202,11974,64,2148,4172,58890,5737,4411,1326,5737,117900,2014
40075,42.9,9379,7136,384,925,2524,37431,3974,2619,1355,3974,59900,2014
40077,39.3,10921,7453,96,334,2874,39563,4101,2778,1323,4101,77800,2014
40079,39.5,50048,36342,1185,3382,12731,35970,18255,13439,4816,18255,79700,2014
40081,40.6,34366,28811,579,948,9519,43746,13342,10255,3087,13342,94200,2014
40083,37.4,43700,34145,4000,2361,11169,54303,15146,11865,3281,15146,138800,2014
40085,39.5,9574,7093,193,1274,2428,44461,3243,2417,826,3243,84900,2014
40087,38.3,35860,28752,321,2626,9827,55741,13014,10445,2569,13014,151200,2014
40089,39,33164,21412,2782,1690,9131,33012,12891,8917,3974,12891,73900,2014
40091,47.2,20334,14017,706,466,5591,36718,8158,6400,1758,8158,83900,2014
40093,42,7639,6610,32,646,2178,50319,3066,2289,777,3066,87100,2014
40095,43.4,15964,10873,234,2425,3966,39028,6003,4729,1274,6003,85300,2014
40097,39.2,41084,27193,178,1234,11027,42076,15802,11709,4093,15802,100500,2014
40099,41.4,13656,10201,223,731,3608,46536,5229,3643,1586,5229,87100,2014
40101,37.8,70519,40641,7711,3894,17825,40133,26574,17928,8646,26574,90200,2014
40103,40.7,11498,9511,188,337,3329,44775,4562,3409,1153,4562,84200,2014
40105,41.9,10555,7129,180,282,2915,40203,4104,3246,858,4104,74600,2014
40107,40.1,12260,7640,950,442,2926,35586,4196,3080,1116,4196,71400,2014
40109,34.2,743145,434225,109805,116951,179729,46584,287998,170763,117235,287998,129800,2014
40111,39.3,39606,25300,3299,1395,9746,38683,15008,10417,4591,15008,77600,2014
40113,42,47937,30893,5383,1486,12844,44748,18433,14313,4120,18433,97300,2014
40115,38.5,32086,21362,253,1584,8243,36616,11988,8558,3430,11988,81600,2014
40117,41.7,16566,13000,171,411,4448,43947,6323,4774,1549,6323,85300,2014
40119,26.9,78723,61654,2718,3302,16432,37637,30182,15293,14889,30182,132700,2014
40121,41.1,45220,32069,1535,1948,12186,41339,18477,13258,5219,18477,89400,2014
40123,35.3,37873,25820,869,1679,9378,42566,14650,9667,4983,14650,102000,2014
40125,37.6,70700,52198,1892,3233,18242,44250,26033,18127,7906,26033,100200,2014
40127,44.8,11315,8298,124,335,3006,32462,4784,3557,1227,4784,75600,2014
40129,42,3743,3209,4,220,897,53194,1307,990,317,1307,86500,2014
40131,38.8,88444,64717,877,3531,25153,57843,33129,26002,7127,33129,142900,2014
40133,39.5,25460,16879,1270,1051,6447,35607,9266,6839,2427,9266,70500,2014
40135,39.6,41720,27023,791,1508,11255,37483,15522,11007,4515,15522,88000,2014
40137,40.1,44900,36660,1020,2970,11903,43519,17850,12543,5307,17850,95100,2014
40139,31.6,21495,10529,375,9569,5257,50172,7166,4486,2680,7166,90700,2014
40141,40.7,7811,4906,588,1872,2103,36592,3029,2225,804,3029,51700,2014
40143,35.3,616128,397073,62031,70434,154855,48926,243509,147510,95999,243509,136100,2014
40145,38.3,74767,54500,2531,3865,20537,56189,27086,21877,5209,27086,139000,2014
40147,40.1,51564,38521,1318,2784,13982,48870,21109,15465,5644,21109,109900,2014
40149,39.2,11622,9844,94,1034,3290,47300,4585,3236,1349,4585,76200,2014
40151,34.2,8958,7566,322,489,1967,52188,3393,2320,1073,3393,88000,2014
40153,36.4,20697,16949,225,2304,4941,54387,7246,5196,2050,7246,108700,2014
41001,48,16049,14780,37,587,4558,40576,7197,4741,2456,7197,152400,2014
41003,32.4,86034,71149,834,5788,18532,49338,33376,19168,14208,33376,268400,2014
41005,41.1,384697,322205,3029,30934,102013,64700,147736,101198,46538,147736,295600,2014
41007,43.8,37236,32267,255,2946,9657,47337,15746,9870,5876,15746,248300,2014
41009,42.5,49325,44287,100,2170,13413,54605,18772,13738,5034,18772,208700,2014
41011,47.9,62678,54022,315,3586,15514,39193,25847,17108,8739,25847,172100,2014
41013,47.6,20798,18522,83,1513,5815,36158,8977,6145,2832,8977,159800,2014
41015,54.1,22341,19631,2,1345,5993,41939,10296,6731,3565,10296,211300,2014
41017,41.4,163141,143653,597,12417,43333,49584,64917,42175,22742,64917,243400,2014
41019,46.7,107156,95471,331,5324,29061,40820,43730,29993,13737,43730,170700,2014
41021,49.8,1926,1752,11,144,542,46490,879,543,336,879,125600,2014
41023,50.8,7325,6782,26,238,2030,37258,3164,2328,836,3164,141100,2014
41025,46.4,7253,6396,45,321,2166,35828,3083,2086,997,3083,104400,2014
41027,39.1,22620,14734,63,6846,5375,56417,8251,5294,2957,8251,309500,2014
41029,42.7,206583,171054,1291,23606,53209,44086,82977,51817,31160,82977,217200,2014
41031,40.1,21830,13297,142,4250,5593,46588,7800,5138,2662,7800,158100,2014
41033,47.7,83021,73113,259,5549,21891,37447,34187,22578,11609,34187,212600,2014
41035,42.3,65985,52869,563,7395,17913,39534,27148,17855,9293,27148,154600,2014
41037,48.1,7854,6778,11,585,2078,34535,3616,2294,1322,3616,141400,2014
41039,39.2,354764,297202,3108,27879,86082,43685,145627,86356,59271,145627,214300,2014
41041,50.1,46138,38535,146,3808,12708,42429,20672,13440,7232,20672,221800,2014
41043,39.4,118270,102446,506,9590,30547,44965,44942,29529,15413,44942,171700,2014
41045,36.6,30740,19216,305,9970,6930,34380,10235,6185,4050,10235,127300,2014
41047,35.6,320448,215738,2932,80204,78526,47360,113883,67850,46033,113883,186300,2014
41049,37.3,11217,7043,34,3722,2742,50443,3714,2593,1121,3714,122200,2014
41051,36.3,757371,542530,40623,83465,167988,52845,308595,165606,142989,308595,270200,2014
41053,37.4,76464,61135,387,9636,19512,51880,28253,18309,9944,28253,212100,2014
41055,49.2,1790,1567,6,97,455,39960,791,512,279,791,139900,2014
41057,48.2,25334,21710,75,2443,6447,43037,10213,7222,2991,10213,226400,2014
41059,35.9,76645,52304,488,19058,18157,47185,26901,16570,10331,26901,141900,2014
41061,40.1,25736,23187,148,1088,6491,43265,10134,6496,3638,10134,159800,2014
41063,51.9,6893,6472,31,172,1857,41522,3018,2122,896,3018,209200,2014
41065,41.8,25387,19424,110,4070,6475,43226,9595,6190,3405,9595,177000,2014
41067,35.9,547451,376160,9425,87650,137564,65272,203901,123661,80240,203901,279100,2014
41069,54.9,1357,1258,0,48,423,34808,666,472,194,666,126800,2014
41071,38,100486,78908,987,15285,24560,53864,34149,22893,11256,34149,218800,2014
42001,42.4,101566,91541,1426,6434,27152,60068,37956,29200,8756,37956,194100,2014
42003,41,1229172,982970,157826,21344,305060,52390,527445,344578,182867,527445,124800,2014
42005,45.2,68343,66626,657,427,19366,45375,28616,21818,6798,28616,93400,2014
42007,44.7,170124,153254,10069,2250,46200,50242,70336,51222,19114,70336,117300,2014
42009,44.6,49332,47991,304,497,14075,44692,20145,16076,4069,20145,120100,2014
42011,39.7,413016,311334,16853,72707,106392,55798,153857,110353,43504,153857,169200,2014
42013,42.6,126708,120714,2025,1350,32863,43871,50948,36708,14240,50948,108500,2014
42015,43.8,62510,60235,318,837,16646,48418,24338,18244,6094,24338,123700,2014
42017,42.6,626205,538121,22525,28853,165939,76824,231959,179188,52771,231959,307600,2014
42019,42.4,185034,176636,2097,2232,50332,59365,74138,56629,17509,74138,173100,2014
42021,44.1,140835,131087,4784,2118,37063,42304,57959,42792,15167,57959,86800,2014
42023,49.5,4939,4820,29,30,1386,41157,2214,1560,654,2214,69600,2014
42025,44.8,64874,60410,751,2422,17551,49913,25764,20358,5406,25764,145200,2014
42027,29.7,156240,136021,5028,4150,32448,50295,57283,34622,22661,57283,193500,2014
42029,39.9,506422,411451,29832,34542,129876,86093,185306,139572,45734,185306,323600,2014
42031,40.1,39437,38082,433,272,9901,42880,15846,11123,4723,15846,108200,2014
42033,43.3,81472,76284,1775,2167,21163,41510,31863,24613,7250,31863,87100,2014
42035,38.4,39611,37822,556,499,9849,44329,14947,10703,4244,14947,113800,2014
42037,39.8,67089,62935,1240,1577,16852,46367,26413,18594,7819,26413,137000,2014
42039,42.1,87801,83701,1498,966,23141,43622,34713,25696,9017,34713,103300,2014
42041,40.7,239420,211391,7708,7395,61739,61417,95835,67978,27857,95835,185900,2014
42043,39.4,269946,186144,46527,20680,68644,54337,109027,70061,38966,109027,159200,2014
42045,38.9,560775,391269,112338,18273,136754,64174,204571,143090,61481,204571,233400,2014
42047,45.9,31584,30877,179,211,8830,46576,13375,10616,2759,13375,90400,2014
42049,38.7,280132,240599,18981,10186,69296,45703,109700,72961,36739,109700,117200,2014
42051,44,135376,125293,5317,1259,34400,38879,53987,38722,15265,53987,87000,2014
42053,41.9,7649,5278,1733,434,1247,36037,2075,1691,384,2075,84800,2014
42055,40.6,151517,135596,5315,7102,40113,53394,58298,42320,15978,58298,174300,2014
42057,42.8,14747,14252,188,148,4214,48452,5981,4694,1287,5981,156300,2014
42059,41.7,38171,35084,1971,496,9530,46485,14383,10519,3864,14383,93300,2014
42061,42.4,45950,42006,2411,790,11673,44163,17231,13133,4098,17231,115900,2014
42063,38.8,88301,82985,2138,1116,21672,45168,34398,24553,9845,34398,107000,2014
42065,43.4,44935,43838,198,320,12272,42295,18583,13824,4759,18583,88700,2014
42067,42.4,24793,23636,208,692,6620,47269,9329,7232,2097,9329,142400,2014
42069,42.3,214023,189540,5530,12021,53406,46056,85335,56727,28608,85335,145900,2014
42071,38.3,526839,442011,17695,48984,136731,57120,194503,134904,59599,194503,187300,2014
42073,44.2,89859,83218,3614,1006,24446,43991,36616,27182,9434,36616,97200,2014
42075,41.1,135184,115439,2234,14110,36302,56173,51793,37002,14791,51793,164500,2014
42077,39.5,354537,246423,17674,71984,89467,55681,133684,89502,44182,133684,193900,2014
42079,42.9,320392,277197,10271,25629,82250,45118,129335,87796,41539,129335,121700,2014
42081,41.3,116676,106510,5384,1897,29845,45877,46008,32189,13819,46008,134600,2014
42083,42.5,43024,40438,994,829,11190,42913,17340,12732,4608,17340,74700,2014
42085,43.6,115739,104925,6589,1368,30529,43715,46128,34156,11972,46128,105100,2014
42087,43.3,46705,45129,329,584,12531,40947,18822,13608,5214,18822,96700,2014
42089,41.3,168342,116388,21282,23410,42252,57748,57661,45835,11826,57661,183100,2014
42091,41,809372,630622,70019,36590,210447,79926,307953,223624,84329,307953,290800,2014
42093,43.8,18475,17205,290,392,4710,53604,7380,5383,1997,7380,157900,2014
42095,41.5,299225,238006,13506,33782,78103,61041,112790,81535,31255,112790,208900,2014
42097,43.6,94294,88245,2174,2605,25215,41560,39170,28015,11155,39170,100500,2014
42099,41.5,45788,44034,280,691,12745,57417,18077,14367,3710,18077,158700,2014
42101,33.6,1546920,560007,646030,201575,308324,37460,580297,306823,273474,580297,143200,2014
42103,45.3,56883,46729,2963,5468,15256,58906,21183,17914,3269,21183,189200,2014
42105,45.5,17451,16929,81,191,4576,41862,6848,5324,1524,6848,100300,2014
42107,43.6,147146,136203,3775,4693,38599,45020,59122,44420,14702,59122,93800,2014
42109,39.4,39922,38164,333,786,10405,48718,14414,10899,3515,14414,139400,2014
42111,44.9,77011,73270,1860,944,20602,44255,29748,23215,6533,29748,97400,2014
42113,51.4,6400,6009,161,78,1571,41786,2476,2062,414,2476,139400,2014
42115,45.9,42708,41310,233,671,11695,49948,17265,13363,3902,17265,145800,2014
42117,42.7,42358,40791,245,526,11429,45863,16802,12619,4183,16802,121300,2014
42119,38.5,44955,38081,3013,2480,10318,48827,15058,10873,4185,15058,154000,2014
42121,45.1,54265,52211,434,542,15156,43291,22412,17109,5303,22412,80800,2014
42123,46,41218,40111,234,354,11097,44391,17029,13141,3888,17029,89300,2014
42125,44,208157,193785,6348,2744,55011,55323,83644,63780,19864,83644,147000,2014
42127,46.2,51967,47510,1691,1992,13210,49285,19362,15313,4049,19362,178600,2014
42129,45.8,362587,342520,8328,3617,100830,51593,151489,115087,36402,151489,137200,2014
42131,42.7,28229,27096,181,476,7375,51021,10895,8511,2384,10895,157800,2014
42133,40.6,438052,374100,21913,26767,118057,58906,168278,126177,42101,168278,170900,2014
44001,43.6,49338,46232,297,1081,12823,69240,19167,13734,5433,19167,330600,2014
44003,43.2,165253,149709,2160,6174,42922,62976,68428,48056,20372,68428,211700,2014
44005,43.7,82772,71817,2650,3984,20903,72702,34833,21791,13042,34833,346500,2014
44007,37,629280,406952,48100,125144,146847,49139,237650,126835,110815,237650,215800,2014
44009,42.8,126609,116212,1859,3449,32541,72784,49491,36413,13078,49491,314900,2014
45001,43.1,25100,17307,7233,139,6668,35409,9752,7624,2128,9752,89000,2014
45003,40.6,162991,109857,40229,8423,43047,45597,63609,46756,16853,63609,126900,2014
45005,38.5,10027,2337,7412,269,2206,25495,3456,2241,1215,3456,55800,2014
45007,40.3,189763,148171,30794,6077,51360,41822,73669,53301,20368,73669,124500,2014
45009,40.2,15649,5571,9759,190,3541,32738,5777,4567,1210,5777,67300,2014
45011,39.1,22287,11493,9920,489,5586,33639,8434,6257,2177,8434,72200,2014
45013,42,168453,112253,31238,19705,44602,57295,65054,45341,19713,65054,272900,2014
45015,35,188835,120911,46160,11388,48030,51844,67423,46838,20585,67423,151100,2014
45017,45.1,15031,7999,6344,482,4271,41727,6135,4807,1328,6135,98400,2014
45019,36.2,365674,229724,105077,19040,85886,52083,145991,88134,57857,145991,236900,2014
45021,38.4,55707,40940,11113,2168,13988,34766,20647,14088,6559,20647,84100,2014
45023,40.8,32708,19309,12143,537,8339,33151,12237,9035,3202,12237,84200,2014
45025,40.4,46333,28497,15197,1748,12248,31692,17837,12475,5362,17837,78000,2014
45027,42.3,34439,16110,16931,968,8509,32243,12768,9170,3598,12768,87700,2014
45029,41.5,38247,21471,14685,1114,9927,32224,14678,10790,3888,14678,85200,2014
45031,40.4,68161,37736,27647,1229,18244,35494,26267,18145,8122,26267,86200,2014
45033,37.4,31529,14798,14470,796,8182,28847,11703,7558,4145,11703,64100,2014
45035,35.7,142772,93151,35738,6687,37315,54452,51450,36013,15437,51450,164400,2014
45037,41.8,26573,14952,9738,1463,6480,44704,9043,6966,2077,9043,110400,2014
45039,43.5,23382,8842,13481,425,6251,36213,9402,6566,2836,9402,95700,2014
45041,37.8,138058,73903,57070,3196,36115,42321,51794,34066,17728,51794,118100,2014
45043,47,60389,37775,19977,1859,16002,41578,23309,17927,5382,23309,155300,2014
45045,37.6,467087,325632,84126,39567,118737,49968,176955,117471,59484,176955,154500,2014
45047,38.6,69708,42410,21305,3930,17529,36045,26760,17524,9236,26760,101100,2014
45049,39.5,20670,8534,11085,779,4991,34494,7463,5721,1742,7463,78800,2014
45051,42.5,283280,218365,38320,17390,74057,42322,115764,80172,35592,115764,157700,2014
45053,36.3,26042,10271,11637,3734,5909,37801,8749,6214,2535,8749,94400,2014
45055,41.2,62342,43107,15426,2499,17145,43203,24061,18673,5388,24061,113500,2014
45057,41,79515,55682,18418,3795,20406,42906,29104,22067,7037,29104,147300,2014
45059,40.7,66390,45526,16824,2813,18012,38300,25312,18022,7290,25312,81000,2014
45061,39.7,18708,6165,11805,371,4404,30939,6471,4830,1641,6471,64500,2014
45063,38.2,270263,206189,38516,15417,71816,54170,105081,77528,27553,105081,139200,2014
45065,51,10003,4843,4923,106,2849,38919,4058,3190,868,4058,105300,2014
45067,39.7,32411,12820,18049,854,8123,29884,11782,7922,3860,11782,75900,2014
45069,39.6,28294,11297,14362,848,6501,28765,9645,6458,3187,9645,58400,2014
45071,40.7,37593,22698,11391,2742,10105,41971,14230,10387,3843,14230,104500,2014
45073,43.8,74656,63878,5586,3484,20978,41197,30319,22684,7635,30319,138700,2014
45075,38.7,91262,30696,56508,1827,22235,33615,33836,23095,10741,33836,86900,2014
45077,35.2,119577,103710,7763,3923,28834,41501,44091,30543,13548,44091,120600,2014
45079,32.7,393707,175637,179336,19412,88161,48674,144647,86537,58110,144647,148000,2014
45081,41.2,19973,11621,5220,2922,4927,38216,7113,5093,2020,7113,88900,2014
45083,38.2,288728,200493,58768,17672,76206,43555,108383,74378,34005,108383,123200,2014
45085,35.6,107782,50350,49903,3814,27507,40662,40024,25825,14199,40024,108300,2014
45087,42.9,28329,18634,8721,309,7933,35221,11739,8474,3265,11739,74300,2014
45089,40.9,33560,10532,21980,724,7696,27485,11788,8681,3107,11788,65600,2014
45091,37.6,235285,169622,43663,11135,62414,53568,87905,62000,25905,87905,158700,2014
46003,42.2,2729,2494,12,148,748,47024,1098,879,219,1098,71200,2014
46005,38.2,17922,14804,112,1578,4583,44258,7460,4871,2589,7460,91600,2014
46007,28.9,3440,945,36,131,776,34697,1088,630,458,1088,52100,2014
46009,42.5,7032,6215,44,288,1653,42795,2499,1988,511,2499,69200,2014
46011,26.2,32647,29835,414,735,7198,48406,12318,7280,5038,12318,152000,2014
46013,38.4,37528,34081,492,736,9685,52469,15794,11095,4699,15794,138100,2014
46015,41.8,5311,4591,0,107,1492,46698,2065,1461,604,2065,94300,2014
46017,25.9,2013,343,11,24,411,31758,543,221,322,543,42900,2014
46019,39.9,10259,9440,6,347,2484,41731,4080,3004,1076,4080,110500,2014
46021,51,1440,1348,0,1,400,39167,676,558,118,676,54600,2014
46023,38.4,9209,5863,2,207,2120,41220,3196,2270,926,3196,75800,2014
46025,44.6,3631,3425,31,81,861,49016,1453,1130,323,1453,74800,2014
46027,25.2,13968,12470,202,339,2453,36627,5185,2697,2488,5185,136000,2014
46029,37.9,27598,25908,46,485,6992,47891,11666,8024,3642,11666,138500,2014
46031,29.8,4122,1260,11,39,908,32892,1212,619,593,1212,55800,2014
46033,52.1,8358,7650,16,225,2423,50903,3680,2990,690,3680,205100,2014
46035,37.8,19730,18302,109,400,5229,50061,8524,5441,3083,8524,124600,2014
46037,48.1,5664,4931,0,61,1594,37901,2564,1870,694,2564,77700,2014
46039,44.5,4340,4171,36,112,1245,52717,1837,1540,297,1837,99500,2014
46041,28.9,5510,1190,20,157,1165,33704,1676,1008,668,1676,56400,2014
46043,48.1,2990,2850,0,25,873,49360,1285,1009,276,1285,71800,2014
46045,47.2,4036,3951,2,11,1040,54229,1589,1279,310,1589,102400,2014
46047,52,6957,5996,71,190,1755,43239,3161,2119,1042,3161,88800,2014
46049,41.5,2371,2261,0,92,571,42781,949,732,217,949,78600,2014
46051,44.8,7281,6926,23,186,2234,51277,3125,2467,658,3125,103800,2014
46053,48.4,4235,3762,0,50,1211,37321,1989,1397,592,1989,59000,2014
46055,48.6,2092,1934,4,12,613,42950,877,710,167,877,72900,2014
46057,36.4,5949,5685,10,175,1541,56134,2087,1606,481,2087,114800,2014
46059,48.7,3344,3298,0,23,931,46951,1464,1063,401,1464,89100,2014
46061,35.3,3392,3157,103,36,733,57857,1026,887,139,1026,106400,2014
46063,40.5,1263,1201,8,6,328,47917,504,361,143,504,76600,2014
46065,39.6,17379,14453,133,426,4284,57614,7140,4591,2549,7140,166700,2014
46067,47,7221,6915,15,132,1954,43688,2932,2266,666,2932,71900,2014
46069,47,1460,1256,0,26,365,53036,541,445,96,541,72300,2014
46071,30.9,3180,1541,5,48,762,45610,1058,631,427,1058,53400,2014
46073,47.5,2051,1953,0,60,604,49236,887,665,222,887,70500,2014
46075,51.1,805,770,10,4,228,38750,437,312,125,437,64600,2014
46077,46.5,5141,4919,22,105,1525,52522,2311,1733,578,2311,86200,2014
46079,41.9,11831,11185,54,240,3046,50378,4722,3394,1328,4722,121800,2014
46081,41.1,24478,22437,60,741,6514,44267,10483,6969,3514,10483,172600,2014
46083,33.5,48326,45597,474,759,13318,75877,17650,13646,4004,17650,191000,2014
46085,35.9,3831,2214,0,17,972,44922,1446,979,467,1446,72400,2014
46087,42.9,5615,5386,21,141,1569,56603,2191,1761,430,2191,101600,2014
46089,50.4,2401,2200,2,52,656,37602,1028,793,235,1028,57500,2014
46091,42.7,4668,3913,2,330,1065,51579,1738,1260,478,1738,96300,2014
46093,35.8,26108,23171,371,982,7409,52967,10244,7277,2967,10244,158100,2014
46095,32.3,2084,834,0,76,500,35478,697,446,251,697,55200,2014
46097,45,2340,2213,11,50,606,48241,1004,792,212,1004,64600,2014
46099,34.7,176014,149692,7275,7938,43675,53391,68906,43862,25044,68906,152900,2014
46101,40.3,6445,5146,47,166,1868,50651,2707,1915,792,2707,113000,2014
46103,37,104574,84545,1254,4728,26201,50564,41155,27392,13763,41155,154900,2014
46105,49.1,3024,2896,2,43,830,38635,1343,950,393,1343,58000,2014
46107,52.1,2312,2194,0,13,657,44931,1048,866,182,1048,64800,2014
46109,38.9,10303,6137,33,193,2464,48441,3602,2471,1131,3602,87300,2014
46111,47.1,2341,2294,0,33,644,49375,1072,791,281,1072,75400,2014
46113,24.9,14005,593,18,148,2398,26383,2929,1596,1333,2929,20000,2014
46115,43.8,6552,6314,0,114,1692,49627,2623,1918,705,2623,68100,2014
46117,39.1,2984,2610,0,56,803,57930,1223,957,266,1223,131300,2014
46119,45.9,1461,1403,0,39,401,61806,611,445,166,611,99400,2014
46121,23.5,9859,973,34,323,2044,30539,2745,1258,1487,2745,45100,2014
46123,45.5,5549,4571,4,39,1575,36978,2595,1692,903,2595,75000,2014
46125,43.9,8339,8001,44,155,2389,51343,3494,2744,750,3494,97300,2014
46127,40.5,14751,13765,120,413,3920,64513,5861,4380,1481,5861,153600,2014
46129,45.1,5498,4485,18,69,1418,42643,2376,1535,841,2376,72800,2014
46135,40.9,22580,20456,430,698,5579,50044,8840,6257,2583,8840,125300,2014
46137,26.1,2837,663,9,95,610,32500,792,394,398,792,65700,2014
47001,43.1,75346,67966,2887,1827,19843,44199,30393,21022,9371,30393,131700,2014
47003,36.5,45660,35725,2704,5234,12243,40989,16608,11528,5080,16608,113200,2014
47005,45.9,16345,15294,581,330,4529,34087,6837,5287,1550,6837,82200,2014
47007,43,13240,12106,576,290,3199,34450,4480,3482,998,4480,105000,2014
47009,42.3,124435,114146,3656,3618,33846,46518,48674,35733,12941,48674,163600,2014
47011,39,101004,88477,4462,5189,26071,41575,37823,25335,12488,37823,141400,2014
47013,42.5,40361,39017,237,501,10726,32616,15902,11263,4639,15902,89200,2014
47015,42,13786,13097,204,231,3739,39438,5405,4081,1324,5405,116600,2014
47017,42.8,28511,24320,2842,644,7353,36168,11096,8339,2757,11096,83100,2014
47019,43.2,57298,54643,702,933,16334,32754,24090,17019,7071,24090,103400,2014
47021,40,39324,36941,614,1005,10680,52138,14520,11716,2804,14520,156500,2014
47023,36.6,17270,14866,1810,408,4231,41028,5943,4309,1634,5943,102000,2014
47025,41.4,31841,30508,289,301,8572,32884,12696,9232,3464,12696,97800,2014
47027,45.8,7802,7440,162,136,2219,29812,3174,2386,788,3174,94800,2014
47029,43.6,35453,33259,496,710,10028,30888,14788,10334,4454,14788,98600,2014
47031,39.5,53151,47625,1139,2063,14598,39656,21131,13963,7168,21131,118000,2014
47033,39.9,14599,11124,1947,1349,3787,37298,5572,3799,1773,5572,86200,2014
47035,49.3,57064,54336,319,1459,16266,38350,23923,18983,4940,23923,139700,2014
47037,34.2,648048,369871,178254,63790,144633,47434,259557,140219,119338,259557,167400,2014
47039,45,11675,10791,335,335,3444,37219,5045,3918,1127,5045,86800,2014
47041,40.9,18968,17070,264,1339,4880,37409,6998,5073,1925,6998,117100,2014
47043,39.3,50115,45233,1975,1559,13406,45056,18469,13291,5178,18469,141400,2014
47045,40.4,38156,30694,5208,1102,10688,41426,15088,9656,5432,15088,99800,2014
47047,43.1,38664,26365,10713,932,10937,55623,14681,11676,3005,14681,177400,2014
47049,43.4,17922,17423,34,214,4963,29784,7326,5692,1634,7326,92100,2014
47051,41.4,41069,36712,1427,1098,11341,42663,16126,12220,3906,16126,106800,2014
47053,39.9,49632,38472,9240,1130,13022,37460,19255,13887,5368,19255,88900,2014
47055,42.5,29064,24735,3070,537,7869,38739,11327,8160,3167,11327,103700,2014
47057,43,22724,21711,157,580,6326,34566,8888,7206,1682,8888,93700,2014
47059,43.4,68596,64200,1442,1806,19348,35860,28489,20336,8153,28489,109800,2014
47061,42.7,13574,11152,37,136,3629,26856,5331,4064,1267,5331,80200,2014
47063,39.6,62863,51921,2288,6835,16792,38600,24401,16655,7746,24401,124400,2014
47065,39.4,344772,247469,68335,16439,88461,47880,135974,87779,48195,135974,157200,2014
47067,44.2,6706,6539,40,2,1806,26528,2819,2127,692,2819,77400,2014
47069,40.3,26560,14653,10999,398,5934,30260,8712,6115,2597,8712,84300,2014
47071,43.9,25969,23953,1157,236,6621,34084,9889,7766,2123,9889,97100,2014
47073,42.8,56741,54224,766,731,16391,37432,23414,17775,5639,23414,109500,2014
47075,39.7,18389,8299,9046,746,4321,33922,6995,4351,2644,6995,93800,2014
47077,40.5,27963,24588,2154,592,7591,38696,10916,8216,2700,10916,97000,2014
47079,44.8,32279,28324,2735,653,8978,38694,13317,9802,3515,13317,91400,2014
47081,40.6,24354,22179,1152,489,6253,38032,8812,6863,1949,8812,96600,2014
47083,41.5,8356,7769,167,166,2220,38637,3311,2437,874,3311,92000,2014
47085,42.1,18322,17185,711,333,4959,41152,7360,5738,1622,7360,106000,2014
47087,45.3,11555,11119,87,193,3264,33500,4552,3560,992,4552,102800,2014
47089,41.8,52166,48268,1393,1770,14201,41426,19979,14648,5331,19979,122700,2014
47091,43.9,18089,17150,518,294,4792,31711,7110,5525,1585,7110,100800,2014
47093,37.3,440732,367063,39802,16252,108952,47543,180558,116472,64086,180558,158400,2014
47095,39.1,7725,5274,2007,279,1429,29214,2150,1225,925,2150,73700,2014
47097,37,27619,16847,9679,611,6715,31185,9833,6076,3757,9833,78600,2014
47099,40,42084,39756,757,746,11347,37371,15932,11829,4103,15932,98300,2014
47101,43,12010,11256,180,244,3292,36114,4768,3718,1050,4768,94800,2014
47103,42.9,33498,29391,1505,973,9261,41328,13702,10085,3617,13702,108100,2014
47105,46,49749,44446,617,3712,14868,50619,19912,15237,4675,19912,177600,2014
47107,42.2,52409,47272,2053,1616,13865,39644,20187,15062,5125,20187,116200,2014
47109,42.1,26138,23630,1566,465,6611,32214,9796,7184,2612,9796,85800,2014
47111,39.6,22582,20980,119,1053,6139,34156,8640,6144,2496,8640,99000,2014
47113,37.3,98364,56355,36254,3419,24193,42069,36253,23504,12749,36253,114600,2014
47115,42.9,28261,26175,450,417,8058,40998,11282,8274,3008,11282,115700,2014
47117,39.8,30977,26780,2170,1472,8288,41822,11724,8644,3080,11724,111000,2014
47119,38.2,82729,66169,9816,4185,21883,46565,32112,22383,9729,32112,138000,2014
47121,43.6,11694,11127,126,144,3265,33061,4677,3627,1050,4677,94000,2014
47123,42.7,45002,41304,1053,1628,12857,37202,17497,12880,4617,17497,113700,2014
47125,30.2,182015,120240,33761,16180,47388,50693,64818,39442,25376,64818,143400,2014
47127,44.3,6348,5959,203,6,1776,43393,2444,2035,409,2444,141700,2014
47129,40.5,21866,20444,809,230,5257,38003,7342,5864,1478,7342,91100,2014
47131,41.8,31378,26442,3329,1080,8911,40327,12496,8555,3941,12496,89100,2014
47133,41.5,22109,21368,137,252,6111,34913,8719,6805,1914,8719,90400,2014
47135,43,7851,7351,198,152,2191,31750,3247,2444,803,3247,83900,2014
47137,48.9,5101,4970,41,10,1766,35510,2252,1801,451,2252,95400,2014
47139,43.1,16715,16044,30,273,4767,39434,6619,5297,1322,6619,110900,2014
47141,36.3,73237,65536,1761,4056,18683,34780,29423,18155,11268,29423,139200,2014
47143,40.7,32272,29551,690,1333,8243,37512,12307,8533,3774,12307,102100,2014
47145,45.8,53413,49875,1418,808,14301,41726,22070,16064,6006,22070,120000,2014
47147,38.4,67024,56532,5023,4028,18091,53748,24435,18698,5737,24435,151900,2014
47149,32.8,275461,205490,36667,19087,68122,55096,98454,65767,32687,98454,157400,2014
47151,38.7,22104,21611,48,150,5533,30206,8294,6241,2053,8294,80000,2014
47153,41.7,14431,12608,25,484,4146,42182,5635,4278,1357,5635,134100,2014
47155,41.8,92561,84300,632,5092,25594,42499,36253,23983,12270,36253,158000,2014
47157,34.8,936130,354076,489400,54305,222233,46213,345475,200407,145068,345475,131700,2014
47159,41,19092,17864,383,466,5204,43988,7387,5522,1865,7387,113800,2014
47161,43.1,13311,12308,257,297,3703,41089,5245,4231,1014,5245,120500,2014
47163,44.1,156850,147436,2780,2538,43834,39577,66279,49071,17208,66279,122700,2014
47165,39.2,166636,143906,11357,6841,45950,56193,61408,44419,16989,61408,174700,2014
47167,37.4,61433,46939,11041,1447,16454,53133,21486,15719,5767,21486,138500,2014
47169,39.5,7859,6732,891,6,2044,37211,2928,2198,730,2928,117800,2014
47171,45.4,18175,17102,143,748,5013,34346,7579,5600,1979,7579,109100,2014
47173,40.7,19139,18514,58,271,5174,36009,7241,5708,1533,7241,99300,2014
47175,46,5578,5366,18,39,1511,34250,2089,1781,308,2089,79300,2014
47177,39.5,39867,34598,624,3275,10395,34592,15440,10809,4631,15440,94000,2014
47179,39.7,124798,112052,4730,3852,33463,42935,52330,34835,17495,52330,146300,2014
47181,41.7,16967,15426,1041,292,4288,31225,6018,4938,1080,6018,77000,2014
47183,36.8,34699,30298,3214,746,8783,35845,13654,8992,4662,13654,92400,2014
47185,41.7,26086,24582,469,497,6908,33933,9827,7452,2375,9827,95800,2014
47187,38.7,193921,166897,8126,8928,53691,91743,68119,55153,12966,68119,336400,2014
47189,39.8,119584,103749,7907,4180,32286,60095,43817,34246,9571,43817,192900,2014
48001,39.1,58084,35169,12246,9582,11693,42511,16610,12053,4557,16610,80300,2014
48003,33.1,16126,7181,292,8359,4077,61250,5412,4161,1251,5412,95500,2014
48005,36.4,87433,54527,13227,17964,22763,42374,30840,20377,10463,30840,86000,2014
48007,49.4,23889,16422,307,6133,6559,42247,9550,6900,2650,9550,133300,2014
48009,43.2,8853,7901,51,704,2548,58274,3336,2730,606,3336,98500,2014
48011,44.1,1947,1645,36,229,511,61250,665,518,147,665,107400,2014
48013,35.6,46343,16434,330,28946,11688,50756,15161,11220,3941,15161,85400,2014
48015,40.7,28724,18481,2578,7144,7742,54603,10786,8157,2629,10786,157800,2014
48017,34.2,7084,2720,119,4208,1787,41982,2400,1554,846,2400,66200,2014
48019,50.1,20642,16535,93,3558,5942,48587,8569,6936,1633,8569,146600,2014
48021,38.6,75708,42220,5801,25648,18607,53382,25314,20000,5314,25314,121500,2014
48023,48.1,3648,3061,60,424,992,33019,1806,1322,484,1806,76600,2014
48025,36.2,32462,10863,2793,18512,6330,41738,8933,5753,3180,8933,72300,2014
48027,30,321591,158774,65423,73126,77093,51027,106743,59726,47017,106743,124500,2014
48029,33.1,1789088,530115,124066,1055568,416246,50867,613290,361408,251882,613290,126100,2014
48031,48,10625,8331,71,2001,2867,51740,4086,3191,895,4086,171900,2014
48033,41.5,676,596,0,64,201,73333,256,171,85,256,83900,2014
48035,46.1,18052,14412,267,2988,4789,44339,6961,5301,1660,6961,86600,2014
48037,37.7,93068,61007,22379,6457,23215,42917,33766,22343,11423,33766,99800,2014
48039,35.4,325477,167352,40873,92992,81531,69092,109817,80586,29231,109817,148800,2014
48041,25,201534,116839,21330,48651,39744,39060,72191,32732,39459,72191,154400,2014
48043,41.9,9270,4933,168,3996,2212,38589,4071,2412,1659,4071,112500,2014
48045,44,1601,1016,58,480,479,36696,635,492,143,635,57100,2014
48047,32.8,7200,574,10,6554,1583,22176,2346,1520,826,2346,49400,2014
48049,39.8,37903,28006,1440,7721,9324,40982,13329,9294,4035,13329,86500,2014
48051,43.4,17236,11503,2036,3337,4425,49533,6243,5076,1167,6243,91400,2014
48053,43.4,43911,32927,1031,9240,11828,50712,16774,12224,4550,16774,153000,2014
48055,35.4,38870,16734,2697,18846,8430,47435,12059,8007,4052,12059,106100,2014
48057,37.8,21569,9612,535,10219,5773,47546,7873,5566,2307,7873,99600,2014
48059,43.4,13519,11851,165,1164,3329,42102,5220,4277,943,5220,74200,2014
48061,31,415103,42678,1582,366892,95442,33390,119695,80361,39334,119695,77400,2014
48063,38.1,12463,7155,2185,2811,3173,38154,4410,3038,1372,4410,87100,2014
48065,41,6108,5327,60,567,1765,63424,2324,2059,265,2324,89000,2014
48067,43.5,30350,23309,5110,1190,7929,36342,11757,8744,3013,11757,76300,2014
48069,33.9,8026,2845,42,4937,1865,40470,2501,1756,745,2501,69600,2014
48071,36.1,36550,25220,2897,7414,9931,72239,12551,10348,2203,12551,145200,2014
48073,37.8,50971,31613,7326,10928,12913,38949,17527,12487,5040,17527,81800,2014
48075,32.1,7066,4509,694,1595,1632,48682,2367,1576,791,2367,66000,2014
48077,45.5,10547,9650,43,523,2930,50025,4163,3487,676,4163,81700,2014
48079,34.3,3031,1199,119,1672,747,41071,1000,795,205,1000,31500,2014
48081,49.7,3260,2553,24,655,1035,40822,1541,1112,429,1541,79800,2014
48083,47.1,8656,6808,199,1466,2605,34692,3505,2382,1123,3505,58400,2014
48085,35.7,836947,514641,72415,125023,219831,84233,296878,199496,97382,296878,211900,2014
48087,36.7,3053,1868,104,982,779,42798,1127,927,200,1127,66200,2014
48089,43.4,20771,12202,2769,5668,5615,45262,7702,6074,1628,7702,109100,2014
48091,42.5,115808,81167,2156,29889,31751,64987,43063,32645,10418,43063,209100,2014
48093,43.6,13755,9849,55,3653,3341,35692,5096,3811,1285,5096,69300,2014
48095,40.9,4091,1792,34,2240,644,52844,821,640,181,821,83300,2014
48097,39.4,38558,29951,984,6319,10565,51222,14615,10187,4428,14615,114800,2014
48099,30.5,76276,46198,11431,13005,16009,49783,20910,12010,8900,20910,97900,2014
48101,50.7,1596,1038,184,361,502,34833,706,527,179,706,39300,2014
48103,34.1,4602,1716,160,2687,1167,52451,1611,1181,430,1611,73800,2014
48105,38.6,3871,1387,6,2453,1069,51594,1418,1008,410,1418,49600,2014
48107,38.4,6025,2509,242,3222,1652,38668,2208,1422,786,2208,53100,2014
48109,39,2325,427,16,1847,565,35302,868,614,254,868,46200,2014
48111,30.8,6957,3729,94,2900,1592,41105,2299,1497,802,2299,70700,2014
48113,32.9,2448943,783974,533634,950159,567715,49925,868717,451904,416813,868717,129200,2014
48115,33.1,13593,5204,841,7384,3035,39746,4363,3109,1254,4363,58800,2014
48117,31.4,19331,5560,180,13352,4589,42995,6210,4138,2072,6210,81600,2014
48119,43.7,5239,4279,422,345,1340,40988,1926,1531,395,1926,73200,2014
48121,33.8,708627,445154,59140,132267,178346,74662,250472,161986,88486,250472,189000,2014
48123,41.9,20397,11555,1889,6788,4706,48082,6921,5409,1512,6921,86300,2014
48125,43.6,2339,1598,123,588,605,38397,928,703,225,928,47400,2014
48127,35.6,10537,1436,49,9052,2481,38140,3635,2594,1041,3635,58400,2014
48129,43.8,3636,3025,205,356,878,40719,1277,982,295,1277,61400,2014
48131,37.6,11644,1190,83,10301,2705,32479,3920,2786,1134,3920,53800,2014
48133,42.4,18403,14884,386,2793,4308,35221,6970,5099,1871,6970,58700,2014
48135,30.9,144932,55549,5889,80169,35680,54903,50214,32894,17320,50214,96800,2014
48137,52.1,2037,1025,15,997,522,41726,799,711,88,799,71100,2014
48139,35.5,154447,99545,13326,37587,40605,61898,51814,37652,14162,51814,140200,2014
48141,31.4,823862,110287,24393,670946,194230,40783,257600,159102,98498,257600,112800,2014
48143,30.5,39291,30056,548,7724,9004,40711,14696,8749,5947,14696,112200,2014
48145,39.5,17524,9131,4364,3811,3528,33587,5496,4012,1484,5496,64400,2014
48147,41.1,33775,27034,2351,3400,8293,44432,11795,8765,3030,11795,92300,2014
48149,47.4,24725,18047,1753,4768,6657,48711,9748,7471,2277,9748,130800,2014
48151,43.6,3882,2641,115,1073,1059,42850,1619,1185,434,1619,61700,2014
48153,38.1,6263,2567,163,3438,1791,40993,2400,1630,770,2400,62200,2014
48155,47.3,1159,969,12,169,265,34375,519,372,147,519,45400,2014
48157,35.3,632946,224691,131378,151616,163817,86407,198316,156145,42171,198316,189500,2014
48159,43.2,10600,8499,473,1389,2975,44000,4228,3223,1005,4228,101800,2014
48161,40.9,19661,13375,3174,2799,5261,44072,7351,5663,1688,7351,78200,2014
48163,31.5,17847,3075,640,13922,3685,35681,4854,3360,1494,4854,63400,2014
48165,28.9,18496,10830,281,7082,4312,54434,5483,4299,1184,5483,89500,2014
48167,37.4,302276,176852,39798,70050,76636,61744,111953,75388,36565,111953,150300,2014
48169,39.6,6337,2516,327,3463,1133,49479,1607,1192,415,1607,71300,2014
48171,50.2,25179,19434,58,5281,7217,52414,10606,7911,2695,10606,218600,2014
48173,41.3,1190,844,0,346,353,81563,470,311,159,470,182500,2014
48175,45.6,7357,4323,344,2597,2175,49702,2978,2517,461,2978,113700,2014
48177,37.9,20054,8760,1396,9745,4545,41263,6397,4541,1856,6397,81400,2014
48179,37.7,22771,15248,945,5812,5516,45179,8403,6208,2195,8403,73200,2014
48181,40.1,121975,94674,7000,14560,32354,47631,46747,31618,15129,46747,105800,2014
48183,35.3,122736,73377,24611,21230,30805,46391,45511,28122,17389,45511,122900,2014
48185,39.2,26812,16061,4064,5938,6244,46652,9001,6789,2212,9001,95800,2014
48187,36.6,139709,74453,8909,50790,36224,62412,47768,37093,10675,47768,158700,2014
48189,32.4,35925,12903,1512,20620,8408,42303,11644,7319,4325,11644,71100,2014
48191,44.5,3270,1895,232,1112,797,33205,1176,810,366,1176,42000,2014
48193,48,8330,7299,65,902,2190,42211,3084,2250,834,3084,95200,2014
48195,37.2,5540,2974,6,2472,1462,46181,1988,1525,463,1988,76800,2014
48197,42.4,4050,2762,370,864,1035,37656,1706,1214,492,1706,42600,2014
48199,38.6,55215,48245,3242,2753,15241,52438,20746,16266,4480,20746,99000,2014
48201,32.6,4269608,1369752,789802,1766483,996530,53822,1462002,813637,648365,1462002,133400,2014
48203,36.9,66971,42874,14837,7885,17042,46969,23544,17476,6068,23544,110900,2014
48205,39.5,6091,4044,485,1518,1345,65132,1817,1175,642,1817,143100,2014
48207,39.9,5875,4071,201,1451,1542,42645,2297,1749,548,2297,47900,2014
48209,30.6,170410,97384,5682,61863,37851,58878,58749,38238,20511,58749,175700,2014
48211,34,4032,2573,5,1370,1081,58281,1410,1034,376,1410,110800,2014
48213,43.2,78836,62980,5048,9035,20568,40299,29820,22507,7313,29820,88100,2014
48215,28.6,806447,60001,3281,733179,181499,34952,221150,150221,70929,221150,78900,2014
48217,42.3,35027,25383,2415,6690,9164,40994,13108,9484,3624,13108,84600,2014
48219,32.6,23205,11427,761,10536,6102,50485,8122,5647,2475,8122,79300,2014
48221,46.8,52347,45051,395,5745,14253,54397,21104,16246,4858,21104,150600,2014
48223,39.2,35478,26544,2449,5583,9964,45158,13243,9487,3756,13243,93300,2014
48225,43.9,23151,14365,5996,2414,5129,32855,7911,5562,2349,7911,74900,2014
48227,37,35702,18660,1830,13996,7341,47994,11192,7641,3551,11192,70400,2014
48229,38.1,3344,671,23,2634,742,23350,1022,843,179,1022,41900,2014
48231,37.8,87256,64590,7378,12438,20957,44898,30697,21233,9464,30697,92000,2014
48233,37.2,21947,15940,535,4682,5533,47191,8390,6446,1944,8390,68200,2014
48235,47,1626,1136,0,437,475,54886,625,477,148,625,104400,2014
48237,40.5,8967,7113,354,1365,2034,45130,2959,2211,748,2959,79000,2014
48239,39.6,14336,8784,993,4343,3607,50856,5216,3912,1304,5216,84700,2014
48241,40.5,35826,26855,5912,2223,8491,39176,12511,9719,2792,12511,87400,2014
48243,54.7,2282,1363,3,852,703,51357,1051,771,280,1051,106900,2014
48245,35.9,252466,109536,84180,45664,59348,42368,92771,59064,33707,92771,96400,2014
48247,37.7,5266,228,109,4892,1277,38013,1773,1333,440,1773,71300,2014
48249,34.2,41348,7958,274,32777,10230,42463,13488,9607,3881,13488,67400,2014
48251,36.4,153854,115758,3652,29353,40881,58221,53255,39739,13516,53255,114100,2014
48253,39.7,20092,11589,2812,5248,3732,42287,5641,4421,1220,5641,65200,2014
48255,37.7,14884,5876,1262,7589,3085,44650,4460,3377,1083,4460,77900,2014
48257,35.6,107119,73654,9918,19544,27508,61459,35177,27221,7956,35177,131500,2014
48259,43.3,36058,27315,216,7717,10001,74320,13119,9554,3565,13119,286400,2014
48261,31.8,528,142,0,385,103,36563,131,40,91,131,166700,2014
48263,45.8,858,731,1,125,224,46842,374,279,95,374,66100,2014
48265,47.8,49914,35484,840,12425,13151,42930,20353,14454,5899,20353,153100,2014
48267,52.8,4522,3417,1,1072,1365,40000,2064,1571,493,2064,84500,2014
48269,48.6,290,226,0,64,82,54583,127,47,80,127,71700,2014
48271,43.6,3598,1336,35,2215,798,32473,1157,958,199,1157,68400,2014
48273,28.1,32142,7181,1282,22826,7379,37725,11059,5817,5242,11059,77100,2014
48275,40.6,3776,2299,252,1211,975,37018,1528,1075,453,1528,42200,2014
48277,40.5,49704,37495,6262,3451,13203,41130,18965,12443,6522,18965,84100,2014
48279,36.2,13875,5775,585,7364,3397,37161,4784,3350,1434,4784,58700,2014
48281,41.1,20020,14840,805,3667,5586,48862,7409,5540,1869,7409,128400,2014
48283,32.4,7075,1004,82,5968,1276,35554,1860,1257,603,1860,69200,2014
48285,45.1,19438,14606,1364,3310,5574,45780,7751,6134,1617,7751,99100,2014
48287,40.1,16617,10724,1920,3789,4244,52452,5967,4498,1469,5967,115900,2014
48289,45.6,16784,12931,1284,2319,4480,48763,6170,5223,947,6170,89600,2014
48291,36.5,76707,52030,8238,14867,18479,47722,25088,19518,5570,25088,84900,2014
48293,38.6,23531,14284,4154,4720,5736,39484,8183,6142,2041,8183,83800,2014
48295,35.2,3418,2361,6,920,795,61151,1173,840,333,1173,87800,2014
48297,42,11738,6770,451,4266,2653,44579,3738,3041,697,3738,87700,2014
48299,55.6,19272,16996,444,1728,5444,45205,8651,6710,1941,8651,160000,2014
48301,43,89,37,0,30,15,65625,33,12,21,33,85000,2014
48303,30.6,286747,161115,19718,94630,66920,45529,106885,61177,45708,106885,109900,2014
48305,38.1,5806,2894,68,2721,1580,41541,2158,1552,606,2158,72200,2014
48307,42.9,8245,5441,108,2527,2019,40908,3055,2398,657,3055,71800,2014
48309,32.9,239717,139307,34193,58550,57392,42544,85893,50428,35465,85893,112100,2014
48311,42.5,646,279,0,367,170,45208,251,204,47,251,64100,2014
48313,34.2,13771,7887,2594,2889,2714,40879,3839,2713,1126,3839,87700,2014
48315,48.5,10335,7359,2339,378,2802,34363,4439,3362,1077,4439,78300,2014
48317,32.6,5096,2593,118,2340,1212,52232,1563,1166,397,1563,90500,2014
48319,50.1,4061,2942,0,981,1154,45536,1678,1378,300,1678,165500,2014
48321,37.4,36611,17058,3634,14432,9079,40410,13143,8972,4171,13143,91300,2014
48323,30,55821,1722,42,53197,13025,32536,16091,11316,4775,16091,85900,2014
48325,37.9,46965,21357,980,23674,11868,56338,15221,12036,3185,15221,115500,2014
48327,44.7,2193,1283,23,817,591,34091,886,650,236,886,58400,2014
48329,32.5,146387,74487,8816,58705,36429,66966,51609,34897,16712,51609,157300,2014
48331,41.3,24388,15686,2026,5960,6147,37183,9279,6242,3037,9279,79600,2014
48333,45.2,4881,4081,15,773,1283,44241,1798,1490,308,1798,100000,2014
48335,34.8,9236,4531,912,3529,1900,45769,2690,1953,737,2690,45800,2014
48337,43.5,19568,17077,41,1981,5480,45897,8090,5962,2128,8090,91800,2014
48339,36.3,487028,339838,20534,105626,124315,68840,168279,122014,46265,168279,169800,2014
48341,31,22172,7993,486,11653,5280,48149,6836,4710,2126,6836,87600,2014
48343,43.5,12805,8456,2945,1087,3683,39387,4967,3590,1377,4967,66000,2014
48345,38.3,1172,951,12,201,289,34853,462,336,126,462,55400,2014
48347,30,65322,39734,11794,11867,15118,39126,23708,13441,10267,23708,108900,2014
48349,37.8,48073,28319,6698,11893,12804,40976,17660,12033,5627,17660,79600,2014
48351,40.7,14323,10612,3064,463,3183,36890,4823,3707,1116,4823,73800,2014
48353,38.2,15082,8895,618,5254,3561,37342,5449,3784,1665,5449,54700,2014
48355,35,348130,110565,12740,214573,86166,49368,125458,72904,52554,125458,111100,2014
48357,31.6,10546,5014,18,5296,2810,51115,3770,2650,1120,3770,77600,2014
48359,33.5,2068,1537,136,251,469,51250,643,487,156,643,87300,2014
48361,38.5,82737,67965,6837,5336,22372,48766,31373,23868,7505,31373,94000,2014
48363,40.9,28028,21512,666,5298,7054,41370,10413,7407,3006,10413,80200,2014
48365,38.1,23880,17535,4074,2075,6284,51794,8979,7153,1826,8979,89300,2014
48367,39.6,119784,101564,2025,13172,32005,64979,42887,33488,9399,42887,157900,2014
48369,32.1,10124,3762,163,6177,2503,46308,3278,2289,989,3278,83800,2014
48371,36.3,15677,4103,820,10592,3112,49421,4546,3090,1456,4546,68600,2014
48373,43.2,45757,32698,5047,6364,12460,39412,17195,13607,3588,17195,78300,2014
48375,33.1,122053,57991,11108,44402,27557,37758,43002,24951,18051,43002,86100,2014
48377,41,7479,1171,19,6072,1833,30983,2646,1787,859,2646,44900,2014
48379,46.8,10988,9497,255,885,3021,46531,4188,3423,765,4188,98500,2014
48381,35.4,124862,94872,3097,22562,33414,60895,48942,33655,15287,48942,144400,2014
48383,37.3,3520,1022,112,2374,952,52692,1200,872,328,1200,70300,2014
48385,53.8,3365,2729,4,623,926,37019,1208,913,295,1208,113500,2014
48387,45.5,12642,9278,2222,879,3331,31344,5144,3758,1386,5144,69100,2014
48389,35,13978,2677,640,10402,2455,44950,3705,2652,1053,3705,40600,2014
48391,43.1,7295,3191,403,3547,1973,44688,2771,2154,617,2771,66500,2014
48393,44.8,924,906,0,10,278,73182,348,305,43,348,104700,2014
48395,41,16546,9686,3504,3135,4219,43371,6002,4265,1737,6002,79800,2014
48397,36.2,83239,60984,4343,13714,22680,86597,27733,22580,5153,27733,187600,2014
48399,41.2,10441,6811,57,3462,2802,38684,3739,2818,921,3739,65400,2014
48401,38.9,54159,35243,9614,8299,12542,46924,17794,13596,4198,17794,96700,2014
48403,50.2,10551,9164,945,387,2513,33951,3965,3485,480,3965,80700,2014
48405,47.9,8777,6054,1994,579,1901,29293,3117,2501,616,3117,69300,2014
48407,43.8,26831,20320,3079,3123,7258,46969,9285,7616,1669,9285,87800,2014
48409,35.7,65509,26889,1144,36191,16976,51760,22621,15416,7205,22621,90600,2014
48411,42.4,5901,3984,147,1689,1298,38065,2098,1600,498,2098,69400,2014
48413,36,3281,1669,4,1596,777,44643,1028,734,294,1028,83500,2014
48415,36.4,17108,9530,700,6495,4206,50829,5894,4333,1561,5894,88800,2014
48417,42.8,3359,2916,46,354,953,50857,1360,1049,311,1360,72300,2014
48419,37.6,25698,16437,4437,4424,6400,36250,9564,6895,2669,9564,68300,2014
48421,37.3,3060,1689,4,1291,759,49219,1007,764,243,1007,77400,2014
48423,36,214735,131865,38078,38701,53927,46669,79089,52107,26982,79089,126400,2014
48425,40.4,8575,6637,144,1643,2415,51190,3265,2311,954,3265,141300,2014
48427,29.2,62040,2103,17,59362,13353,25906,16073,12305,3768,16073,65400,2014
48429,38.7,9485,7045,238,2084,2438,43082,3469,2602,867,3469,76700,2014
48431,35.8,1360,866,3,491,368,50509,475,349,126,475,74400,2014
48433,47.6,1409,1062,65,272,389,42321,588,456,132,588,54200,2014
48435,36.1,3995,1649,8,2315,1114,48986,1458,990,468,1458,79300,2014
48437,36.1,7789,3887,458,3222,1905,37833,2664,1948,716,2664,68200,2014
48439,33.8,1881469,950040,280662,513740,461209,57727,667362,408584,258778,667362,137700,2014
48441,32.2,133560,88124,9705,30550,32750,44695,49482,29506,19976,49482,99100,2014
48443,49.2,809,294,13,490,227,40781,407,262,145,407,54300,2014
48445,35,12681,5463,596,6521,2747,39494,3985,2807,1178,3985,65000,2014
48447,47.6,1584,1384,4,160,452,40833,722,501,221,722,64400,2014
48449,33.4,32540,15609,3135,13210,7872,42856,10532,7373,3159,10532,88900,2014
48451,33.9,113516,64093,4533,41811,27529,45114,42361,26573,15788,42361,102300,2014
48453,32.7,1092810,546993,87332,368010,240052,59620,419496,216365,203131,419496,224600,2014
48455,47.8,14452,11531,1457,1250,3244,35223,5078,4089,989,5078,80600,2014
48457,43.4,21552,17157,2341,1576,5834,41630,8154,6861,1293,8154,77800,2014
48459,40.5,39851,32428,3415,2864,10316,46834,14219,11317,2902,14219,89900,2014
48461,31.9,3339,1652,95,1571,873,50982,1183,858,325,1183,55000,2014
48463,34.5,26763,7577,67,18699,6203,37078,8622,6052,2570,8622,72000,2014
48465,31.9,48999,8423,505,39310,11425,42735,15055,9967,5088,15055,92700,2014
48467,43.3,52605,44640,1320,5115,13278,42579,18903,14749,4154,18903,100800,2014
48469,35.9,88955,41784,5142,39685,22966,50663,32207,21039,11168,32207,116100,2014
48471,35,68882,39731,15566,11968,12175,38903,20681,11909,8772,20681,117600,2014
48473,30.8,44825,19626,10521,13163,10002,50939,13655,9482,4173,13655,134400,2014
48475,35.4,11011,4847,524,5474,2686,45938,3916,2810,1106,3916,68700,2014
48477,41.6,34039,22319,5956,4909,8426,49236,11917,8783,3134,11917,141700,2014
48479,28.1,259471,9316,691,247596,56296,38679,68502,42848,25654,68502,107400,2014
48481,37.3,41219,19203,5836,15900,9828,41992,14492,9770,4722,14492,96900,2014
48483,39.3,5587,3878,72,1460,1614,54382,2281,1687,594,2281,79100,2014
48485,33.9,131802,89018,13443,23084,30808,44854,47818,29774,18044,47818,89200,2014
48487,37.4,13265,8153,1048,3635,3372,41901,5253,3433,1820,5253,67100,2014
48489,32.1,22056,2320,342,19279,4422,27627,5461,4352,1109,5461,51700,2014
48491,35,457218,286351,27525,108082,115045,72118,158283,107802,50481,158283,185700,2014
48493,40.2,44609,26027,651,17210,12473,65760,15598,13088,2510,15598,151600,2014
48495,33.7,7404,2998,182,4148,1898,52938,2659,2101,558,2659,45200,2014
48497,39.1,60413,47513,640,10789,16025,56338,20694,16244,4450,20694,122400,2014
48499,48.1,42431,35664,2036,3875,11247,44376,16076,12971,3105,16076,105900,2014
48501,34.1,8054,2953,55,4898,2048,50167,2594,1964,630,2594,71300,2014
48503,42.3,18374,14639,195,3148,5206,41589,7268,5199,2069,7268,82800,2014
48505,29,14231,925,1,13305,3616,30758,4424,3499,925,4424,54000,2014
48507,30.6,12013,779,35,11192,2567,27253,3556,2559,997,3556,42400,2014
49001,32.9,6514,5589,15,700,1622,50685,2163,1646,517,2163,144200,2014
49003,31.8,50613,44433,143,4411,13160,57336,16223,12595,3628,16223,166200,2014
49005,25.2,115954,97827,711,11829,26829,50367,35505,23170,12335,35505,189300,2014
49007,34.3,21118,17645,123,2698,5295,46366,7834,5479,2355,7834,123000,2014
49009,53.1,714,656,0,20,184,47188,276,219,57,276,202500,2014
49011,29.9,317646,270481,3650,27871,78553,70388,96711,75018,21693,96711,222600,2014
49013,30.2,19378,16694,36,1391,5373,60700,6738,5068,1670,6738,172300,2014
49015,34,10834,9943,76,658,2906,50653,3628,2950,678,3628,125600,2014
49017,39.8,5105,4626,33,270,1248,44914,1815,1425,390,1815,156600,2014
49019,38.9,9348,7804,18,929,2184,44239,3822,2532,1290,3822,220500,2014
49021,27.6,46725,40582,283,3719,10818,42305,15135,9513,5622,15135,165400,2014
49023,30,10349,9640,20,444,2535,56976,3066,2477,589,3066,164000,2014
49025,42.8,7221,6662,43,299,1860,51213,2925,2282,643,2925,168200,2014
49027,34.7,12582,10630,47,1610,3211,51117,4210,3172,1038,4210,130300,2014
49029,32.2,9955,9491,0,262,2556,79304,2941,2547,394,2941,265400,2014
49031,40,1921,1732,4,163,408,33250,557,481,76,557,142800,2014
49033,35,2285,2155,2,75,504,50573,627,515,112,627,163400,2014
49035,31.5,1063670,778880,16113,185778,245484,61446,348110,231755,116355,348110,231200,2014
49037,30.7,14944,6805,26,721,2958,41411,4038,3202,836,4038,137100,2014
49039,29.8,28129,24308,270,2677,6069,48305,7945,5894,2051,7945,165000,2014
49041,33.7,20812,19225,112,984,5355,46327,7112,5499,1613,7112,148300,2014
49043,37.3,37877,32239,175,4369,9767,89886,13425,10254,3171,13425,496800,2014
49045,30.3,59973,50294,498,7052,14779,63077,18400,14073,4327,18400,175300,2014
49047,29.6,34576,28479,94,2659,8374,62363,11048,8311,2737,11048,187400,2014
49049,24.5,540425,452033,2926,59376,119530,60830,145469,97920,47549,145469,222300,2014
49051,32,25550,21547,44,3355,6155,65582,7752,5761,1991,7752,304300,2014
49053,33.8,144844,123721,659,14272,36371,49498,47905,33084,14821,47905,209500,2014
49055,38.5,2742,2540,22,131,734,43393,954,812,142,954,180300,2014
49057,31.5,236307,183240,2576,40731,58619,56216,79860,56951,22909,79860,169200,2014
50001,42.5,36883,34543,302,729,9586,59274,14215,10579,3636,14215,235200,2014
50003,45.8,36739,34952,206,589,10059,49303,15477,10861,4616,15477,210600,2014
50005,42.7,31109,29686,153,398,7802,45089,12398,9106,3292,12398,161800,2014
50007,36.3,158686,143566,3329,3208,37205,64243,63086,40890,22196,63086,269500,2014
50009,48.2,6231,5986,42,72,1738,35567,2752,2220,532,2752,120300,2014
50011,39.7,48226,45575,199,631,13132,57159,18751,14138,4613,18751,203100,2014
50013,46.7,6979,6555,7,103,2076,61338,2981,2390,591,2981,259500,2014
50015,40.4,24843,23637,125,368,5990,50447,10121,7205,2916,10121,216800,2014
50017,44.4,28927,27762,114,333,8088,53114,12135,9777,2358,12135,186400,2014
50019,44.6,27160,26020,173,337,6946,41437,11214,8636,2578,11214,155600,2014
50021,45.2,60864,58525,346,750,16127,48308,25635,17895,7740,25635,176900,2014
50023,42.9,59333,56111,507,1064,15392,58293,24704,18030,6674,24704,207100,2014
50025,45.6,44050,41313,434,892,11376,50526,19223,13381,5842,19223,210700,2014
50027,46.2,56328,53652,339,752,15355,53610,24560,17309,7251,24560,213300,2014
51001,44.9,33165,20234,9475,2909,9346,39389,14289,10053,4236,14289,152500,2014
51003,38.5,101883,78949,9430,5698,24670,67958,38537,25135,13402,38537,317300,2014
51005,46.8,16133,14862,813,215,4374,45183,6714,5337,1377,6714,111600,2014
51007,43.3,12764,9203,3184,115,3522,55870,4761,3886,875,4761,179300,2014
51009,43.1,32237,24405,5994,665,8459,44765,12577,9373,3204,12577,149000,2014
51011,42.5,15137,11609,3023,177,4497,47927,5964,4839,1125,5964,137100,2014
51013,33.8,220173,139255,18071,34014,44558,105120,96264,43157,53107,96264,594800,2014
51015,44,73707,67775,2991,1667,20654,54018,28124,22813,5311,28124,197600,2014
51017,49.8,4644,4178,275,83,1343,46153,2225,1674,551,2225,151200,2014
51019,44.9,75607,66995,5242,1387,21338,56043,30122,24628,5494,30122,196500,2014
51021,44.3,6727,6382,302,27,1775,43508,2591,2078,513,2591,94100,2014
51023,46.1,33105,30959,1192,429,10041,63011,12867,11366,1501,12867,210300,2014
51025,41.6,16961,6880,9547,316,3999,37028,5865,4335,1530,5865,104200,2014
51027,45.3,23683,22681,549,106,6618,29678,9406,7576,1830,9406,68700,2014
51029,42.3,17072,10435,5912,334,4107,38484,5802,4431,1371,5802,128300,2014
51031,42.3,54833,44311,7529,1039,15226,47055,21728,16761,4967,21728,151000,2014
51033,39.1,29057,18528,8413,1096,8044,58417,10728,8737,1991,10728,188000,2014
51035,45.9,29881,28524,247,851,8532,33495,12508,9846,2662,12508,106100,2014
51036,47.9,7154,2922,3460,112,1883,48088,2832,2279,553,2832,154600,2014
51037,44.1,12399,8269,3692,297,3239,34820,4691,3416,1275,4691,97700,2014
51041,38,324337,208242,72159,24629,83117,72514,115005,88056,26949,115005,219800,2014
51043,45.3,14273,12517,734,545,3812,75508,5619,4275,1344,5619,337700,2014
51045,46.1,5206,5037,10,0,1451,46658,2151,1733,418,2151,146100,2014
51047,38.4,47910,34335,6561,4255,12342,65235,16436,12039,4397,16436,243400,2014
51049,43.5,9916,6255,3415,10,2739,41484,4038,3070,968,4038,133100,2014
51051,43.5,15612,15323,118,114,4289,33106,6200,4836,1364,6200,72400,2014
51053,41.4,27993,17583,9131,754,7158,52328,9956,7467,2489,9956,159300,2014
51057,44.3,11166,6193,4170,379,2662,42143,4288,3184,1104,4288,158100,2014
51059,37.4,1117072,594129,100595,178922,278935,112102,391794,267156,124638,391794,486900,2014
51061,41.5,66726,54321,5016,4502,17227,92078,23162,18417,4745,23162,351900,2014
51063,44.7,15452,14519,312,413,4048,47543,6086,4791,1295,6086,153700,2014
51065,41.5,25945,20451,3629,813,7155,64641,9787,8150,1637,9787,214000,2014
51067,44.7,56360,49079,4698,1482,16480,44827,23248,18072,5176,23248,163000,2014
51069,39.6,80377,68765,3588,5594,21681,68719,29184,22682,6502,29184,223300,2014
51071,43,17025,16260,211,237,4992,45919,7253,5482,1771,7253,107700,2014
51073,42.9,36938,31533,3181,1049,10312,60980,14074,11377,2697,14074,225400,2014
51075,46.6,21627,16689,4241,477,6467,82460,8212,7194,1018,8212,324800,2014
51077,47.9,15255,14314,293,434,4270,28892,6686,5079,1607,6686,93200,2014
51079,39.9,18766,15996,1241,863,5082,63739,6965,5353,1612,6965,244400,2014
51081,42,11911,4478,7038,242,2463,38933,3397,2482,915,3397,100400,2014
51083,45,35704,21456,13138,637,9369,35093,14472,10574,3898,14472,106100,2014
51085,41.8,100689,85345,9279,2398,28193,77550,37041,30490,6551,37041,257600,2014
51087,37.8,314878,176113,91846,16303,80049,61438,123821,79065,44756,123821,217300,2014
51089,45.5,52960,37562,11584,2662,15037,34344,22472,16657,5815,22472,94600,2014
51091,58.6,2258,2254,0,0,720,44132,1067,911,156,1067,181100,2014
51093,44.5,35518,25089,8304,812,10251,65910,13519,10679,2840,13519,245400,2014
51095,45.2,69832,53652,9343,3562,19768,76705,27665,20616,7049,27665,320000,2014
51097,45.5,7073,4654,1987,224,2021,47804,2832,2121,711,2832,173300,2014
51099,36.7,24577,18252,4390,971,6223,83071,8315,6114,2201,8315,280900,2014
51101,40.3,16045,12208,3056,129,4689,63560,6147,5051,1096,6147,201400,2014
51103,55.3,11224,7760,3161,157,3167,49456,5283,3984,1299,5283,222200,2014
51105,42.4,25380,23642,837,433,6576,31264,9597,6954,2643,9597,75400,2014
51107,35.1,338916,204542,24124,44028,85993,123966,110047,84662,25385,110047,443100,2014
51109,43.7,33743,25971,5636,824,9288,57126,12811,10397,2414,12811,194500,2014
51111,44.4,12667,7595,4337,494,3165,37881,4634,3429,1205,4634,104200,2014
51113,45.1,13208,11282,1265,141,3624,51641,5093,3982,1111,5093,237200,2014
51115,50.7,8923,7726,888,155,2774,63157,3792,3082,710,3792,263700,2014
51117,46.9,31913,18974,11327,808,8057,37756,12857,9408,3449,12857,123700,2014
51119,51.5,10817,8461,2096,202,2986,54452,4432,3691,741,4432,241600,2014
51121,27,95808,81446,3899,2762,18757,44810,34803,18850,15953,34803,201100,2014
51125,48.1,14892,12186,2032,495,4046,50131,6381,4715,1666,6381,198500,2014
51127,43.3,19187,15317,2490,450,5487,73030,7106,6253,853,7106,247800,2014
51131,48,12254,6638,4506,956,3039,34656,5237,3662,1575,5237,162500,2014
51133,54.7,12320,8643,3616,53,3862,50774,5669,4730,939,5669,241500,2014
51135,41.9,15756,8709,6099,618,3686,35911,5640,3609,2031,5640,128800,2014
51137,42.6,34239,27334,4335,1318,9261,63538,12433,9543,2890,12433,229000,2014
51139,44,23905,22661,376,413,6771,43063,9526,6764,2762,9526,178100,2014
51141,46.9,18365,16542,1209,473,5034,34753,7678,5840,1838,7678,112500,2014
51143,45,62955,46757,13468,1457,18209,42311,26029,20420,5609,26029,107800,2014
51145,42.9,28193,23386,3560,540,7696,75447,9590,8425,1165,9590,259500,2014
51147,30.9,23140,14377,7750,544,4911,37238,7604,5021,2583,7604,155200,2014
51149,37.2,36792,20955,11479,2490,8871,61071,10906,7683,3223,10906,201600,2014
51153,33.7,428772,201372,83229,90746,104407,98514,134737,96757,37980,134737,323400,2014
51155,44.8,34630,31604,2067,472,10171,45635,15125,11036,4089,15125,134300,2014
51157,49.3,7446,6642,284,243,2151,59753,3281,2600,681,3281,383700,2014
51159,44,9072,5590,2490,540,1852,47199,2800,2122,678,2800,156800,2014
51161,43.4,93194,81588,4957,2287,25573,60950,38197,28749,9448,38197,194000,2014
51163,47.7,22367,20881,633,326,6235,48550,9226,6928,2298,9226,184200,2014
51165,40.8,77345,70118,1192,4402,21342,53728,29483,22529,6954,29483,197300,2014
51167,43.6,28444,27585,384,126,7386,34768,11037,8599,2438,11037,94500,2014
51169,45.2,22781,22116,161,274,6538,36579,9363,7361,2002,9363,91700,2014
51171,43.4,42545,38080,866,2768,11987,47936,17246,12381,4865,17246,201200,2014
51173,43.9,31876,30186,649,567,8856,37880,12852,8946,3906,12852,91200,2014
51175,45.3,18364,11023,6652,230,4892,49690,6654,4777,1877,6654,159200,2014
51177,36.6,126200,89775,19561,10236,33285,78505,42280,32204,10076,42280,245600,2014
51179,34.7,134672,89376,22557,13644,34753,98721,42763,32769,9994,42763,300000,2014
51181,46.2,6885,3554,3177,44,1895,51527,2652,2088,564,2652,160200,2014
51183,37.8,11923,4601,6656,393,2022,36972,3261,2124,1137,3261,124500,2014
51185,43.1,44331,41769,1217,354,12369,36248,18306,13447,4859,18306,89600,2014
51187,40.5,38142,33685,1441,1437,10138,60560,14324,10708,3616,14324,210900,2014
51191,44.1,54833,52525,766,766,15408,42458,22842,17600,5242,22842,134000,2014
51193,46.8,17518,11129,5117,1048,4384,48750,6981,5381,1600,6981,188100,2014
51195,39.7,40872,37643,2093,494,10465,37357,15517,10739,4778,15517,86300,2014
51197,43.5,29259,27576,1088,309,7976,40185,11984,8485,3499,11984,119200,2014
51199,39.7,65808,48271,8609,3367,18741,80900,23970,17619,6351,23970,313100,2014
51510,35.8,146422,77220,30971,24112,31353,87319,65916,28146,37770,65916,494400,2014
51520,41.6,17595,15680,1164,123,5004,33616,7764,4292,3472,7764,113200,2014
51530,37.2,6683,5953,213,52,1789,32789,2741,1757,984,2741,120500,2014
51540,29.1,44505,29550,8680,2193,7682,47218,17604,7329,10275,17604,283100,2014
51550,36.6,228168,135861,66788,11089,60216,70176,80388,57644,22744,80388,254900,2014
51570,40.3,17542,13697,2280,820,4554,52529,7025,4542,2483,7025,176300,2014
51580,44.1,5853,4804,804,73,1410,38176,2468,1853,615,2468,66000,2014
51590,42.1,42704,19451,20573,1315,11031,32173,18520,10023,8497,18520,88300,2014
51595,43.2,5682,1762,3715,59,1422,30240,2420,951,1469,2420,114100,2014
51600,39,23507,14144,1077,3823,5580,100584,8480,5944,2536,8480,462800,2014
51610,36.7,13074,9508,724,1239,3135,120500,4966,2933,2033,4966,665400,2014
51620,37.4,8534,3260,4947,50,2412,33133,3580,1559,2021,3580,170900,2014
51630,28.7,26632,16020,5906,2877,5440,49454,9849,3561,6288,9849,317000,2014
51640,43.4,6981,5275,315,1290,1724,30430,2968,1757,1211,2968,108300,2014
51650,35.5,136904,55450,67452,6848,33105,49879,52700,30968,21732,52700,191800,2014
51660,23,50821,35461,3284,8790,8048,38807,15881,5671,10210,15881,200700,2014
51670,36.6,22375,11589,8416,1508,5449,39156,8774,4634,4140,8774,129600,2014
51678,21.6,7114,5849,448,298,857,36840,1727,936,791,1727,248900,2014
51680,29,77626,48821,21705,2512,16199,39391,28424,14795,13629,28424,147900,2014
51683,32.6,40436,18418,5514,13129,9173,71215,12274,7936,4338,12274,257500,2014
51685,32.9,14992,5996,1861,5104,3297,73460,4526,2893,1633,4526,222300,2014
51690,43.4,13745,6528,6262,602,3315,27746,5974,3283,2691,5974,85800,2014
51700,32.7,181362,82511,71224,14546,42998,51000,68987,34930,34057,68987,194600,2014
51710,29.9,244745,107885,101580,17351,50026,44150,86397,37731,48666,86397,196700,2014
51720,39.4,4015,3623,280,80,885,36148,1655,878,777,1655,89900,2014
51730,39.3,32439,5044,24993,1333,7197,33927,12515,5583,6932,12515,114100,2014
51735,43.7,12103,11252,83,257,3507,83460,4627,3763,864,4627,304200,2014
51740,35.1,96007,38175,50211,3335,23674,46239,36764,20528,16236,36764,173700,2014
51750,21.9,16993,14278,1490,474,2451,30284,5333,2518,2815,5333,148400,2014
51760,32.6,211063,83696,102639,13508,40413,41331,85913,36704,49209,85913,195000,2014
51770,38.3,97949,60036,27110,5599,23787,39530,42549,23204,19345,42549,135600,2014
51775,40.5,25120,21683,1970,715,6200,50590,9953,6709,3244,9953,172400,2014
51790,41.9,24132,19796,2796,603,5910,39982,10503,6076,4427,10503,167700,2014
51800,38.3,85477,43103,35419,2834,22600,66822,30798,22044,8754,30798,240200,2014
51810,34.9,445623,283364,82811,32158,114020,67001,165296,105999,59297,165296,263200,2014
51820,38.2,21177,16646,2326,1393,5589,45499,8878,5106,3772,8878,161300,2014
51830,24.8,14401,10028,2092,1002,2213,48057,4365,2023,2342,4365,305000,2014
51840,35.9,27031,18445,2841,4338,6128,44731,10692,5095,5597,10692,219700,2014
53001,28.9,18951,7005,18,11530,4522,44533,5827,3776,2051,5827,139200,2014
53003,44,21955,20173,116,742,5918,42689,9405,6312,3093,9405,170000,2014
53005,35.5,182053,133551,2792,35492,46128,60589,66625,45285,21340,66625,179800,2014
53007,39.2,73664,51165,265,19751,18442,50876,27183,17693,9490,27183,247800,2014
53009,49.7,72024,60531,620,3957,18622,47008,30963,21509,9454,30963,220400,2014
53011,37.2,438272,353906,8341,35620,111328,59551,160492,104112,56380,160492,228400,2014
53013,49.2,4031,3589,3,251,1137,41071,1706,1279,427,1706,147800,2014
53015,40.7,102072,86906,543,8285,26282,46571,39765,26290,13475,39765,175200,2014
53017,37,39183,26123,89,11597,10603,53235,14140,10162,3978,14140,200800,2014
53019,47.3,7657,5684,23,286,2012,37542,3112,2203,909,3112,161500,2014
53021,28.9,84508,36185,1366,43300,18646,56719,24207,16252,7955,24207,163900,2014
53023,50.4,2240,2051,0,116,625,50915,906,681,225,906,140300,2014
53025,32.1,91458,51583,680,35891,21908,46772,30233,18155,12078,30233,160600,2014
53027,42.5,71734,57778,850,6657,17493,43379,27318,18846,8472,27318,158500,2014
53029,43.7,78951,64399,1889,4966,22456,59107,32820,22470,10350,32820,287600,2014
53031,55,29978,26615,268,962,8010,47202,13535,10108,3427,13535,282400,2014
53033,37.2,2008997,1275468,120457,184318,478964,73035,808729,464625,344104,808729,376200,2014
53035,39.3,253614,198211,6708,17336,65550,62473,97993,65511,32482,97993,259000,2014
53037,32.7,41705,35460,379,3452,9461,45406,16753,9601,7152,16753,246000,2014
53039,44.3,20668,17106,133,2394,5447,46368,7959,5461,2498,7959,197500,2014
53041,42.6,75382,64205,496,6932,19773,42917,29450,19966,9484,29450,178200,2014
53043,48.1,10409,9637,25,282,2908,47161,4445,3492,953,4445,142000,2014
53045,45.2,60728,49939,582,5136,15158,49538,23099,18054,5045,23099,204800,2014
53047,42.5,41241,27750,205,7623,10837,39665,16401,11206,5195,16401,162600,2014
53049,51.2,20665,17280,76,1767,5644,39418,9143,6661,2482,9143,158400,2014
53051,48.8,12965,11578,17,440,3726,40070,5532,4130,1402,5532,180100,2014
53053,35.8,812689,563215,53670,78724,200779,59711,301364,184299,117065,301364,233800,2014
53055,53.8,15847,14209,83,905,4734,54331,7611,5477,2134,7611,467000,2014
53057,40.6,118364,89934,692,20544,31037,54917,45309,30395,14914,45309,254900,2014
53059,45,11194,9917,63,618,2864,50986,4433,3217,1216,4433,237500,2014
53061,37.5,735351,537410,17880,68779,184712,69443,271514,180656,90858,271514,287500,2014
53063,37.1,476950,410708,8694,23339,119450,50432,188126,119357,68769,188126,182000,2014
53065,45.7,43541,38076,214,1357,12267,42111,17626,13489,4137,17626,171900,2014
53067,38.4,259330,200863,7075,20150,67388,62286,101530,65854,35676,101530,241300,2014
53069,52.3,4016,3680,0,112,1173,44500,1716,1319,397,1716,187900,2014
53071,36.7,59476,43478,916,12233,13663,47854,21698,13614,8084,21698,193900,2014
53073,36.5,204855,165513,1795,17264,49816,53025,79837,50008,29829,79837,273000,2014
53075,24,46003,37194,940,2359,8370,35578,17174,7728,9446,17174,179700,2014
53077,32.4,246402,113854,1597,114531,57794,43956,79717,49287,30430,79717,157900,2014
54001,40.8,16723,16106,140,113,4272,36351,6179,4676,1503,6179,86600,2014
54003,38.3,107324,91590,7432,4140,28848,55100,40614,30355,10259,40614,162400,2014
54005,41.6,24257,23802,209,112,6947,42740,9602,7235,2367,9602,77400,2014
54007,44,14492,14138,88,80,3763,31984,5652,4260,1392,5652,81800,2014
54009,45.7,23787,22896,386,180,6553,44067,10086,7504,2582,10086,84300,2014
54011,38.5,96826,87630,4439,1209,23677,37716,40220,24380,15840,40220,109600,2014
54013,46.3,7583,7386,7,23,2117,31017,3112,2466,646,3112,69500,2014
54015,42.7,9226,9141,0,13,2490,32933,3486,2953,533,3486,77100,2014
54017,43.4,8282,7963,78,84,1883,40329,2761,2339,422,2761,89000,2014
54019,42.8,45709,42335,2289,449,11903,34914,17566,13659,3907,17566,74700,2014
54021,37.9,8706,6919,981,389,1621,35625,2645,2020,625,2645,74400,2014
54023,44.9,11829,11464,97,88,2919,41600,4256,3278,978,4256,121100,2014
54025,45.2,35639,33404,805,461,9741,40256,15246,11292,3954,15246,100200,2014
54027,43.8,23674,22786,313,272,4595,26828,10628,5471,5157,10628,117600,2014
54029,45.3,30369,28786,766,331,8501,39342,12970,9620,3350,12970,84200,2014
54031,44.1,13955,12841,524,486,3297,36465,5169,3956,1213,5169,123200,2014
54033,42.1,69069,65408,1153,970,18042,43130,27755,20592,7163,27755,93600,2014
54035,42.3,29229,28501,212,8,7760,40733,11242,8674,2568,11242,106100,2014
54037,39.4,54650,46082,3501,2788,14269,66205,20126,15311,4815,20126,204900,2014
54039,42.5,191765,169146,7877,1949,50937,46583,82531,58104,24427,82531,101300,2014
54041,43.8,16412,15918,141,29,4402,38006,6476,4608,1868,6476,94800,2014
54043,41.8,21599,21242,97,29,5625,35623,8128,6274,1854,8128,78300,2014
54045,42.3,36169,34675,793,305,10144,37312,14444,10855,3589,14444,80500,2014
54047,43.7,21281,18911,2002,149,5441,23607,8386,6532,1854,8386,38100,2014
54049,41.3,56698,52916,2013,614,14711,43085,22596,17466,5130,22596,94600,2014
54051,44.1,32716,31749,280,300,9223,41978,13847,10691,3156,13847,88800,2014
54053,42.7,27207,26426,199,143,7476,38297,10729,8686,2043,10729,81000,2014
54055,42.3,62161,56365,3520,563,16592,35678,25590,18645,6945,25590,84100,2014
54057,42.7,27912,26336,824,227,6200,30713,11148,6470,4678,11148,118300,2014
54059,41.4,26229,25244,434,103,7616,34495,10836,8305,2531,10836,68000,2014
54061,29.9,100332,89535,3569,1951,19451,46166,36857,21123,15734,36857,161500,2014
54063,46.1,13524,13094,79,99,4120,38239,5719,4639,1080,5719,103600,2014
54065,45.6,17450,16778,140,205,3836,37406,7358,4864,2494,7358,160700,2014
54067,44,26090,25424,6,17,7599,38755,10686,8497,2189,10686,75400,2014
54069,43.1,43956,40649,1753,428,10899,40342,18582,12680,5902,18582,102500,2014
54071,48.7,7525,7151,214,79,2034,36052,3199,2446,753,3199,89200,2014
54073,43.4,7600,7333,45,72,1983,43831,2822,2377,445,2822,99600,2014
54075,48.2,8710,8393,128,36,2402,34761,3719,3010,709,3719,107400,2014
54077,42.3,33720,31759,1018,424,8871,45806,12610,10032,2578,12610,107800,2014
54079,41.3,56356,53977,672,552,15743,55939,21453,17807,3646,21453,146800,2014
54081,40.9,78827,68844,6496,1090,20994,41152,31164,22788,8376,31164,97700,2014
54083,43.3,29446,28387,410,220,7612,40146,11351,8539,2812,11351,98600,2014
54085,45.1,10221,10017,37,62,2607,39118,4023,3175,848,4023,69400,2014
54087,43.6,14749,14373,4,124,3842,30104,5902,4471,1431,5902,82800,2014
54089,46.4,13699,12555,589,320,3697,35040,5560,4385,1175,5560,82500,2014
54091,42.5,16969,16376,175,158,4723,39933,6801,5265,1536,6801,87900,2014
54093,47.3,6996,6845,11,39,1938,38663,2969,2406,563,2969,104200,2014
54095,45.7,9084,8923,21,55,2539,39974,3750,2996,754,3750,80900,2014
54097,41.3,24487,23630,231,267,6164,39188,8937,6885,2052,8937,100100,2014
54099,42.6,41735,40801,69,245,10877,37491,16757,13012,3745,16757,84200,2014
54101,45.7,9005,8816,4,44,2706,28907,3854,2888,966,3854,65100,2014
54103,45.5,16314,15979,15,100,4477,38066,6734,5274,1460,6734,83000,2014
54105,44.8,5810,5667,50,0,1626,37117,2425,1999,426,2425,74500,2014
54107,42.3,86595,82810,925,809,23059,42471,35900,25973,9927,35900,106100,2014
54109,42.4,23203,22649,164,58,6448,34620,9201,7399,1802,9201,60400,2014
55001,50.5,20604,18696,608,783,5096,45366,7829,6655,1174,7829,133100,2014
55003,41.3,16065,13382,53,352,3991,39172,6741,4721,2020,6741,107400,2014
55005,43.7,45718,43171,548,985,12713,44709,19029,14098,4931,19029,135600,2014
55007,50.3,15064,12908,87,199,4378,45158,6949,5763,1186,6949,158300,2014
55009,36.6,252698,209263,5264,19415,64974,53254,99705,65602,34103,99705,158600,2014
55011,44.7,13374,12896,51,257,3801,48585,5783,4338,1445,5783,142300,2014
55013,50.5,15387,13960,87,222,4655,40722,7288,5880,1408,7288,146900,2014
55015,39,49502,45590,269,1837,13667,66250,18606,15240,3366,18606,165700,2014
55017,40.5,63051,59410,864,872,16530,51428,24643,17754,6889,24643,147300,2014
55019,37.2,34575,32536,114,1363,8978,43515,12882,9954,2928,12882,110800,2014
55021,41.9,56659,53204,843,1553,15229,58703,22571,16857,5714,22571,174500,2014
55023,45.3,16525,16009,233,170,4173,43638,6607,4929,1678,6607,120100,2014
55025,34.6,502984,408186,24970,30662,121353,62303,208749,122762,85987,208749,229000,2014
55027,41.5,88589,80687,2386,3784,21987,53189,32979,24239,8740,32979,152900,2014
55029,50.8,27789,26381,128,727,8299,50078,13154,10241,2913,13154,192900,2014
55031,40.3,43901,40483,509,557,11448,44956,18598,12637,5961,18598,130500,2014
55033,33.9,44045,41195,232,702,10587,49897,16460,11068,5392,16460,154900,2014
55035,33.7,100607,91973,678,2088,23557,48209,40072,24880,15192,40072,149300,2014
55037,49.7,4473,4281,8,40,1322,49703,1844,1581,263,1844,142600,2014
55039,40.9,101709,92943,1147,4665,27713,54529,41290,29325,11965,41290,146200,2014
55041,45.3,9198,7477,95,167,2492,40331,3717,2864,853,3717,122200,2014
55043,36.4,51272,49118,646,671,12162,47266,19472,13789,5683,19472,129500,2014
55045,42,36971,35117,93,1057,10074,54868,14748,10948,3800,14748,157400,2014
55047,45.1,19001,17790,90,823,5315,46502,7898,5937,1961,7898,138400,2014
55049,42.4,23754,22882,79,380,6547,54390,9656,7303,2353,9656,161300,2014
55051,52.1,5927,5737,41,46,1774,41900,2958,2373,585,2958,105600,2014
55053,42.5,20543,17881,443,606,5225,44699,8038,5870,2168,8038,124800,2014
55055,38.8,84201,76084,579,5723,21649,54522,32267,23036,9231,32267,174600,2014
55057,44.1,26607,24552,557,743,6638,45135,10074,7708,2366,10074,116400,2014
55059,37.1,167268,129261,11584,20448,41612,54653,62573,41842,20731,62573,163800,2014
55061,43.3,20545,19650,80,479,5510,53023,8125,6563,1562,8125,145600,2014
55063,35.4,116470,105628,1627,1902,28001,50769,46303,30027,16276,46303,154500,2014
55065,41.2,16847,16001,54,577,4607,50154,6612,5130,1482,6612,122800,2014
55067,46.7,19706,18736,118,367,5444,40994,8742,6466,2276,8742,109900,2014
55069,45.5,28566,27411,217,377,8253,49189,12483,9518,2965,12483,131800,2014
55071,44,80805,74342,426,2679,21786,48629,33917,25714,8203,33917,124900,2014
55073,40.2,134886,121014,890,3259,36120,53779,53392,39247,14145,53392,142900,2014
55075,46.8,41488,39825,110,592,11266,41364,18419,14243,4176,18419,107100,2014
55077,48.2,15224,14418,69,431,4287,46875,6322,5096,1226,6322,139500,2014
55078,32.7,4382,535,15,228,903,37740,1238,914,324,1238,91100,2014
55079,34,953401,510604,248347,131473,217993,43385,381446,193477,187969,381446,154400,2014
55081,39.1,45116,41440,561,1746,11883,49752,17727,11867,5860,17727,135600,2014
55083,45.1,37483,35866,90,588,10831,51695,15441,12875,2566,15441,149900,2014
55085,49.2,35754,34182,217,450,9935,45736,15519,12900,2619,15519,162000,2014
55087,37.6,179139,159333,1879,6866,47386,58421,70144,50202,19942,70144,156200,2014
55089,43.7,86930,80693,1112,2182,24111,75643,34319,26399,7920,34319,247300,2014
55091,44.9,7390,7190,28,91,2031,49321,3027,2431,596,3027,133000,2014
55093,35.3,40859,38883,234,702,10204,61613,15198,11076,4122,15198,187400,2014
55095,43.7,43698,41815,161,706,12438,49679,18225,14135,4090,18225,155500,2014
55097,36,70337,64882,453,2000,17454,50837,27954,19082,8872,27954,147600,2014
55099,49.8,13888,13304,12,190,4252,43581,6654,5234,1420,6654,116800,2014
55101,39.5,195039,143728,20969,23487,49418,55055,75078,52433,22645,75078,167300,2014
55103,43.9,17842,17038,82,400,5022,44785,7489,5539,1950,7489,123900,2014
55105,38.8,160465,134931,5524,12685,42165,49645,63385,44212,19173,63385,131500,2014
55107,47.1,14468,13925,103,206,4191,38728,6306,4895,1411,6306,102600,2014
55109,37.4,85442,80812,609,1821,23761,70313,32199,24921,7278,32199,205700,2014
55111,40.2,62681,57659,316,2880,16697,50982,25400,17481,7919,25400,168200,2014
55113,48.6,16516,12878,119,317,4948,40658,7439,5580,1859,7439,159200,2014
55115,44,41697,36531,147,997,11624,46903,17019,12986,4033,17019,130600,2014
55117,40.7,115168,99461,1643,6612,30625,53029,46433,33057,13376,46433,150800,2014
55119,42.8,20596,19959,79,341,5793,45424,8784,6772,2012,8784,127400,2014
55121,40.7,29274,26944,125,1824,7922,49493,11776,8577,3199,11776,137200,2014
55123,42,30124,29106,118,448,7918,47075,11815,9256,2559,11815,139800,2014
55125,52.1,21368,18346,89,341,6495,40501,10552,8082,2470,10552,193500,2014
55127,38.7,102920,88460,947,11020,26601,53998,39846,27096,12750,39846,191400,2014
55129,48.6,15785,14991,73,241,4573,41749,7259,5669,1590,7259,142200,2014
55131,41.6,132526,124332,1375,3722,37999,67650,52554,41002,11552,52554,217900,2014
55133,42.7,392511,352872,4980,17225,108514,76319,153882,118176,35706,153882,249900,2014
55135,44.1,52212,49719,213,1433,14316,52007,21262,16115,5147,21262,136100,2014
55137,47.4,24409,22032,456,1475,6454,43982,9786,7983,1803,9786,138100,2014
55139,37.6,168413,151770,2884,6193,41260,51949,68484,45154,23330,68484,142100,2014
55141,43.2,74261,69412,364,1842,20429,48241,32115,23993,8122,32115,120000,2014
56001,27,37220,31218,512,3379,7472,42298,15440,7729,7711,15440,205300,2014
56003,41.4,11827,10448,6,1034,2951,52432,4363,3277,1086,4363,137000,2014
56005,32.6,47448,41890,371,3802,12242,78609,17316,12837,4479,17316,206500,2014
56007,39.3,15795,12450,166,2712,4034,56933,6161,4293,1868,6161,140900,2014
56009,39.3,13991,12561,31,991,3712,61820,5721,4218,1503,5721,187200,2014
56011,43.1,7155,6944,4,176,2151,58795,2974,2338,636,2974,188100,2014
56013,38.1,40739,28835,182,2564,10098,51749,15290,10975,4315,15290,183700,2014
56015,42.8,13555,11767,46,1396,3488,45287,5370,4030,1340,5370,147600,2014
56017,49.9,4826,4535,12,144,1340,45385,2218,1620,598,2218,147600,2014
56019,44.7,8599,7941,1,349,2387,56708,3785,2809,976,3785,225400,2014
56021,36.9,94412,75159,2608,12978,24792,58324,37364,25428,11936,37364,186600,2014
56023,37.7,18180,16910,22,783,4916,66530,6584,5423,1161,6584,194700,2014
56025,36.2,78667,68971,820,5994,20512,56769,31790,21582,10208,31790,183100,2014
56027,42.7,2492,2295,6,69,572,39567,1015,637,378,1015,135900,2014
56029,43.6,28735,26196,203,1554,7675,56318,11751,8500,3251,11751,213200,2014
56031,47,8730,7987,2,645,2381,41299,3690,2836,854,3690,147200,2014
56033,42.4,29578,27182,230,1204,7993,56015,12568,8781,3787,12568,219400,2014
56035,37.8,10183,9013,0,788,2729,78578,3540,2587,953,3540,284400,2014
56037,33.3,44595,35709,402,6990,11529,69448,16687,11774,4913,16687,183400,2014
56039,37.6,21956,17859,40,3331,4831,73572,7873,4644,3229,7873,675000,2014
56041,34.4,20989,18463,27,1866,5418,56158,7557,5323,2234,7557,174800,2014
56043,43.6,8444,6976,63,1171,2250,45696,3461,2384,1077,3461,158700,2014
56045,41.7,7135,6609,16,261,1848,53920,2996,2264,732,2996,160600,2014
72001,37.1,19188,35,0,19153,4635,10550,6178,3530,2648,6178,103500,2014
72003,39.1,41176,1571,0,38399,10027,16376,13177,10256,2921,13177,91000,2014
72005,38.8,59068,1058,96,56785,14747,16767,20064,12884,7180,20064,126400,2014
72007,36.6,28083,247,3,27832,6701,15081,8852,6047,2805,8852,102900,2014
72009,38.7,25241,47,7,25184,6319,16962,8692,6949,1743,8692,124800,2014
72011,40.1,28874,207,14,28621,7040,17147,9566,7247,2319,9566,114400,2014
72013,39.9,93969,424,6,93485,24297,16997,32732,23286,9446,32732,101500,2014
72015,36.3,19255,50,0,19205,4419,15863,6251,4565,1686,6251,90200,2014
72017,36.5,24908,127,27,24726,6058,15228,8286,6546,1740,8286,98700,2014
72019,33.8,30045,17,11,29982,7243,15109,9248,6529,2719,9248,107600,2014
72021,38.9,201273,1167,209,199355,52065,24597,71928,50059,21869,71928,143300,2014
72023,40.4,50706,188,0,50518,11255,16880,16465,10199,6266,16465,116800,2014
72025,38.1,140166,991,108,139016,36116,24083,49808,34033,15775,49808,140500,2014
72027,38.4,34438,130,25,34222,9011,19490,11543,8491,3052,11543,98900,2014
72029,36.7,47655,25,55,47575,10885,20494,14592,11287,3305,14592,121700,2014
72031,38.9,171310,1356,150,169119,45363,28660,63708,44570,19138,63708,153700,2014
72033,36.2,27211,102,10,26990,7028,18625,9442,5755,3687,9442,127000,2014
72035,38.9,47252,201,10,46994,11690,21058,16404,11379,5025,16404,115800,2014
72037,38.9,13122,69,3,13039,3195,20339,4556,3517,1039,4556,98000,2014
72039,38.1,18242,74,0,18168,4156,12565,5714,3909,1805,5714,107300,2014
72041,37.1,42878,116,0,42736,10771,23452,13693,10375,3318,13693,117800,2014
72043,36.6,40496,82,6,40408,9993,17938,13568,10703,2865,13568,92100,2014
72045,35.8,20533,16,0,20517,4706,13680,6325,4067,2258,6325,95000,2014
72047,35.8,36463,35,0,36391,8591,17020,10947,8032,2915,10947,109200,2014
72049,37,1585,58,5,1514,323,18167,486,352,134,486,154900,2014
72051,38,38305,774,76,37389,9699,27924,12451,9901,2550,12451,150300,2014
72053,38.4,35539,246,31,35226,8837,20531,12701,9220,3481,12701,106900,2014
72054,36.9,12565,19,0,12546,3425,15992,4245,3166,1079,4245,95000,2014
72055,38.1,18627,97,0,18530,4072,13635,5565,4033,1532,5565,87500,2014
72057,35.9,44261,87,14,44080,10842,16765,15398,10866,4532,15398,97600,2014
72059,37.3,20862,44,0,20810,5082,15483,6564,5010,1554,6564,86100,2014
72061,40.8,95428,1102,102,93991,24028,34450,35109,26267,8842,35109,199000,2014
72063,36.3,46460,184,10,46233,11136,27909,14915,12140,2775,14915,163500,2014
72065,38.4,41830,163,0,41495,10731,19130,13982,10154,3828,13982,135200,2014
72067,43,17023,91,26,16869,4555,21323,6444,4866,1578,6444,106100,2014
72069,39.4,57181,429,42,56612,13721,20251,18717,14392,4325,18717,109000,2014
72071,38.9,44965,264,78,44469,11277,15740,15504,9606,5898,15504,106500,2014
72073,34.5,16183,30,0,16153,3782,16111,4712,3292,1420,4712,93000,2014
72075,35.8,49876,176,18,49642,12683,18758,16479,12924,3555,16479,105500,2014
72077,35.4,40284,152,13,40119,9751,19288,12945,9555,3390,12945,117300,2014
72079,40.8,25117,83,0,25034,6039,13422,8372,4679,3693,8372,98500,2014
72081,38.5,29426,36,8,29332,7606,11929,10159,5748,4411,10159,96800,2014
72083,37.8,9521,94,0,9427,2310,14928,3131,2055,1076,3131,89100,2014
72085,36.5,38759,54,25,38667,9406,19929,12370,8910,3460,12370,115100,2014
72087,34.9,29054,1,0,29042,6685,18456,9115,6767,2348,9115,107100,2014
72089,39.3,19731,340,90,19284,4801,18256,6795,4659,2136,6795,109900,2014
72091,38.5,42900,427,30,42410,11563,18796,16046,11588,4458,16046,116100,2014
72093,38.8,6384,0,7,6377,1350,14149,1883,1326,557,1883,106100,2014
72095,40.3,11904,14,0,11890,2971,17866,4075,2968,1107,4075,99800,2014
72097,38.1,85425,805,52,84388,19356,15402,30526,18039,12487,30526,99300,2014
72099,36.9,39349,200,0,39037,8911,15301,11789,8647,3142,11789,95000,2014
72101,34.3,32484,35,0,32400,7588,16086,9716,7313,2403,9716,97300,2014
72103,35.3,26881,71,2,26769,6238,18295,8788,6826,1962,8788,93400,2014
72105,36.4,30034,32,0,29935,6667,17478,8498,6234,2264,8498,100200,2014
72107,35.9,22927,40,0,22887,5053,14549,6960,5286,1674,6960,105300,2014
72109,40.5,18766,23,0,18731,4271,14343,6431,5007,1424,6431,93700,2014
72111,34.5,23307,196,0,23096,5948,15506,7547,5824,1723,7547,83800,2014
72113,37.9,159660,642,139,158751,39260,16807,56186,36731,19455,56186,106900,2014
72115,38.4,25512,108,23,25331,6887,15277,8966,5302,3664,8966,119500,2014
72117,41.6,14998,704,51,13684,3967,16704,5753,4410,1343,5753,124800,2014
72119,38.1,53628,196,28,53403,12974,22372,16901,13166,3735,16901,117300,2014
72121,39,24692,257,0,24435,5100,15054,7104,5344,1760,7104,98100,2014
72123,35.9,30506,99,29,30270,8025,13871,11013,8882,2131,11013,85500,2014
72125,40.9,34725,144,20,34546,8024,15091,12261,8780,3481,12261,108500,2014
72127,39.9,380149,4787,986,372991,89103,22266,148897,80745,68152,148897,164800,2014
72129,38,40313,92,0,40198,9971,17116,13252,9443,3809,13252,125400,2014
72131,40.4,41204,278,0,40862,9813,14726,13230,8597,4633,13230,111800,2014
72133,35,23114,0,18,23096,5508,16344,7848,5880,1968,7848,89900,2014
72135,35.3,74688,235,40,74381,18476,29183,22424,18400,4024,22424,153500,2014
72137,37,86873,334,122,86239,21122,23642,29387,21959,7428,29387,133400,2014
72139,37.3,73030,304,4,72721,17985,30687,24686,17111,7575,24686,161400,2014
72141,39.2,32086,83,37,31931,7789,15291,10378,6531,3847,10378,101600,2014
72143,36.2,39670,470,1,39115,9150,17944,12221,9122,3099,12221,124800,2014
72145,37.9,57915,1616,74,56216,12965,16625,17282,14273,3009,17282,119400,2014
72147,42,9217,192,0,8997,1842,18179,2755,2362,393,2755,113100,2014
72149,35.1,25196,38,0,25082,6220,17389,7924,6221,1703,7924,97200,2014
72151,38.5,36903,66,85,36739,8715,16627,12073,8698,3375,12073,94900,2014
72153,39.9,40391,236,11,40126,7748,15346,10756,8406,2350,10756,93700,2014
01001,37.7,55221,41848,10236,1440,14213,51281,20396,15077,5319,20396,141300,2015
01003,42.2,195121,162153,18533,8776,50276,50254,74104,52997,21107,74104,169300,2015
01005,38.8,26932,12454,12579,1241,6059,32964,9222,5864,3358,9222,92200,2015
01007,38.9,22604,16840,4838,502,5296,38678,7027,5278,1749,7027,102700,2015
01009,40.7,57710,50700,884,4980,15639,45813,20816,16423,4393,20816,119800,2015
01011,39.3,10678,2372,7550,473,2333,31938,3683,2609,1074,3683,68600,2015
01013,40.5,20354,10856,8924,240,5271,32229,8056,5644,2412,8056,78900,2015
01015,39.1,116648,85184,23703,4075,30581,41703,45154,31179,13975,45154,105900,2015
01017,43,34079,19522,13728,152,8630,34177,13787,9318,4469,13787,80800,2015
01019,45.4,26008,23854,1236,391,8175,36296,11278,8761,2517,11278,105100,2015
01021,38.8,43819,35289,4471,3350,11589,41627,16237,12410,3827,16237,100100,2015
01023,44.9,13395,7487,5753,48,3554,33536,5575,4547,1028,5575,61100,2015
01025,41.1,25070,13376,11346,85,6200,32011,9622,6372,3250,9622,86900,2015
01027,43.8,13537,10821,1948,430,3694,35327,5419,4029,1390,5419,84100,2015
01029,41.3,15002,13877,442,345,4074,38056,5776,4470,1306,5776,108000,2015
01031,38.8,50884,36392,8753,3276,13012,46729,19160,12960,6200,19160,142400,2015
01033,42.2,54444,42957,8478,1321,15087,40576,22204,15833,6371,22204,99400,2015
01035,43.7,12865,6557,5748,210,3434,24900,5168,3992,1176,5168,70100,2015
01037,45.1,11027,7190,3384,237,2798,31212,4450,3530,920,4450,78300,2015
01039,42.6,37886,31577,4912,580,10401,36444,14949,11171,3778,14949,93600,2015
01041,41.3,13938,9825,3277,237,3562,36022,5383,3787,1596,5383,70600,2015
01043,40.5,80965,74635,857,3493,21864,38971,31287,23548,7739,31287,115200,2015
01045,36.8,49866,34829,9678,2980,12611,45028,19018,11792,7226,19018,101700,2015
01047,38.7,42154,12045,29159,130,10242,27306,16413,9658,6755,16413,81500,2015
01049,39.3,71068,57485,1270,9957,17607,38192,25013,18322,6691,25013,98500,2015
01051,37.9,80763,59479,16991,2229,20655,53555,28651,21453,7198,28651,147500,2015
01053,40.3,37935,23023,12660,466,9177,32330,13659,9774,3885,13659,93800,2015
01055,40.8,103766,81479,15947,3740,27595,39220,39899,28472,11427,39899,100400,2015
01057,43.2,16896,14413,2033,126,4947,34680,7037,5212,1825,7037,75200,2015
01059,38.8,31634,24833,1301,4958,8354,35372,11980,8097,3883,11980,85600,2015
01061,42.2,26815,22534,2342,973,7522,36024,10754,8043,2711,10754,77400,2015
01063,42.4,8697,1547,7011,61,1897,20541,3201,2275,926,3201,69600,2015
01065,40.2,15256,6095,8873,170,3898,32714,5927,4466,1461,5927,87400,2015
01067,43,17252,11788,4891,429,4546,41997,6894,5398,1496,6894,96300,2015
01069,39,103534,70069,27121,3338,26082,41571,39197,25359,13838,39197,123300,2015
01071,42.2,52860,47279,1635,1450,14249,37745,20431,15025,5406,20431,98900,2015
01073,37.4,659026,336064,277830,24991,166460,45610,260929,164894,96035,260929,143400,2015
01075,43.7,14133,12154,1565,196,4392,35450,6138,4397,1741,6138,67900,2015
01077,41.1,92737,78773,9156,2229,25104,43125,38612,26757,11855,38612,118600,2015
01079,41.7,33586,25703,3837,697,9684,40003,13537,10845,2692,13537,94800,2015
01081,30.3,150982,102965,34698,5615,35939,44570,57171,33753,23418,57171,154300,2015
01083,39,88805,68756,11385,5137,23293,49570,32213,24570,7643,32213,142100,2015
01085,39.5,10742,2716,7955,36,2833,25876,4282,3154,1128,4282,67800,2015
01087,37.5,20018,3220,16186,313,4677,30738,8009,5203,2806,8009,74700,2015
01089,37.8,346438,227290,82732,16214,89551,57993,137767,93319,44448,137767,167900,2015
01091,42.2,20306,9293,10413,459,5122,32042,8281,5809,2472,8281,90800,2015
01093,44.1,30387,27898,1118,726,9059,32299,12714,9595,3119,12714,81400,2015
01095,38.8,94318,77992,1805,11944,24469,38983,34261,24605,9656,34261,115500,2015
01097,37,414251,240830,144839,10917,103554,43809,154188,102608,51580,154188,122400,2015
01099,41.1,22217,12183,9282,242,5352,27257,8406,5561,2845,8406,81200,2015
01101,35.2,228138,84081,127411,7791,56843,44369,89532,53006,36526,89532,122300,2015
01103,39.5,119786,92013,14543,9358,31614,45751,46235,32710,13525,46235,123500,2015
01105,36.3,10038,3011,6829,93,2292,24537,3450,2364,1086,3450,66300,2015
01107,42.4,19856,10967,8408,325,4891,30330,7644,5486,2158,7644,82000,2015
01109,31.3,33155,18941,12652,289,7861,32825,12786,7411,5375,12786,105500,2015
01111,42.8,22648,17029,4429,668,5978,36924,8915,6353,2562,8915,85800,2015
01113,34.8,58302,29036,24252,2824,14484,37049,22241,13071,9170,22241,111000,2015
01115,39.8,85864,74082,8047,1913,23154,51859,31979,25631,6348,31979,140000,2015
01117,37.9,203530,160416,23890,11902,54072,70187,75534,59588,15946,75534,192800,2015
01119,36.7,13341,3312,9660,53,2744,19501,4815,3269,1546,4815,72900,2015
01121,40.9,81437,51883,25976,1768,21688,35155,31424,22329,9095,31424,93400,2015
01123,42.8,41153,28408,11266,1017,11466,39206,16323,11649,4674,16323,103400,2015
01125,31.9,200458,127351,61240,6446,45971,46565,69128,44160,24968,69128,156500,2015
01127,42.4,65923,59054,3730,1493,17977,35843,25602,18943,6659,25602,82800,2015
01129,40.9,16997,11077,4224,214,4495,42811,6133,5147,986,6133,85700,2015
01131,40.2,11235,3073,8092,66,2430,23750,3843,2645,1198,3843,77300,2015
01133,43.9,24130,22754,122,667,6394,33194,9406,7168,2238,9406,81500,2015
02013,42.4,3304,495,303,398,424,61518,690,369,321,690,126100,2015
02016,36.8,5684,1578,262,623,688,84306,1138,367,771,1138,217500,2015
02020,32.5,299107,180457,16535,25690,69652,78326,105175,63120,42055,105175,290500,2015
02050,26.7,17776,2016,142,325,3361,51012,4488,2898,1590,4488,165700,2015
02060,39.7,970,518,5,69,244,79750,377,204,173,377,187500,2015
02068,35.9,2060,1745,13,54,405,81544,681,513,168,681,190200,2015
02070,29.7,4979,881,17,144,949,54173,1349,813,536,1349,195100,2015
02090,30.4,99705,71649,4131,7356,22810,71068,35582,20677,14905,35582,218100,2015
02100,45.5,2560,2037,1,39,680,58750,1176,812,364,1176,211400,2015
02105,47.8,2128,1049,47,47,553,52419,892,591,301,892,233400,2015
02110,37,32531,21476,402,1985,7985,85746,12114,7711,4403,12114,323500,2015
02122,40.5,57221,46738,353,2124,13746,63684,21485,15566,5919,21485,219100,2015
02130,38.7,13699,8903,58,663,3257,64222,5267,3096,2171,5267,252500,2015
02150,32.4,13973,7186,62,1186,3432,70887,4577,2750,1827,4577,245400,2015
02158,23,7914,353,28,81,1428,38229,1683,1294,389,1683,108000,2015
02164,31.1,1474,310,8,32,335,50781,491,322,169,491,145000,2015
02170,34.6,96178,77677,925,4292,22318,72983,31098,23533,7565,31098,224900,2015
02180,27.8,9854,1630,72,193,2198,48868,2925,1649,1276,2925,123500,2015
02185,33.9,9667,3112,53,350,1488,72576,1962,1050,912,1962,141100,2015
02188,26.1,7732,916,25,142,1517,63648,1903,1060,843,1903,124500,2015
02195,40.4,3221,2209,97,304,802,67935,1284,864,420,1284,218800,2015
02198,39.7,6376,2930,12,205,1431,48523,2268,1625,643,2268,162600,2015
02220,38.9,8943,5606,97,540,2079,70376,3472,2056,1416,3472,338600,2015
02230,43.7,999,752,0,45,200,69318,406,223,183,406,324600,2015
02240,35.8,7029,5389,76,336,1460,62670,2117,1485,632,2117,197300,2015
02261,36.6,9617,6742,0,425,2092,78810,3010,2125,885,3010,200700,2015
02275,50.4,2387,1635,5,34,624,48603,1127,745,382,1127,171400,2015
02282,42.5,643,253,9,17,158,72500,250,136,114,250,166000,2015
02290,35,5644,1228,17,109,1246,38491,1982,1402,580,1982,88800,2015
04001,33.4,72124,13906,434,4547,13236,31757,19272,14755,4517,19272,83300,2015
04003,40,129647,73548,4697,43960,32200,45075,48825,33186,15639,48825,143900,2015
04005,30.8,136701,74746,1874,18916,29887,50234,46619,27868,18751,46619,219300,2015
04007,48.6,53165,33852,339,9869,13802,39751,20909,15209,5700,20909,134200,2015
04009,32,37407,19337,724,11882,7765,45964,10959,7752,3207,10959,123300,2015
04011,33,9023,4262,130,4242,2316,51628,3219,1493,1726,3219,82700,2015
04012,54.8,20335,12179,40,5180,5670,34466,9365,6972,2393,9365,69100,2015
04013,35.6,4018143,2303538,198489,1209034,945115,54229,1442518,875327,567191,1442518,187100,2015
04015,49.2,203362,159067,1995,31809,51465,38488,80832,54220,26612,80832,123200,2015
04017,35.7,107656,45842,499,11905,24289,35921,34129,23882,10247,34129,104400,2015
04019,38,998537,535965,32586,356589,239972,46162,389658,238329,151329,389658,159900,2015
04021,37.6,389772,226031,17194,113394,91302,49477,127599,92151,35448,127599,128700,2015
04023,36.5,47073,7359,112,38965,11568,40140,15359,10137,5222,15359,137000,2015
04025,51.3,215996,175206,1222,30382,58562,44748,92310,64499,27811,92310,188200,2015
04027,33.8,202987,68015,3784,124037,54231,40743,70639,48081,22558,70639,112100,2015
05001,41.4,18731,13172,4730,546,4898,36411,7743,5166,2577,7743,75600,2015
05003,41.4,21229,14412,5517,1078,5855,34263,8327,6290,2037,8327,65700,2015
05005,51.5,41040,39130,135,798,11948,35396,18164,13726,4438,18164,120400,2015
05007,35,238198,178691,3481,38068,63549,56239,85670,57386,28284,85670,150800,2015
05009,41.4,37227,35167,131,836,10364,39251,14961,10651,4310,14961,111700,2015
05011,40.6,11206,6383,3206,1564,3098,33701,4598,3102,1496,4598,68700,2015
05013,44.9,5245,3828,1163,182,1517,36899,2125,1700,425,2125,69000,2015
05015,44.2,27635,22558,115,3950,7241,36897,10977,8297,2680,10977,116200,2015
05017,43.4,11353,4487,6121,604,2988,28913,4513,3053,1460,4513,57300,2015
05019,34,22751,15839,5437,984,5332,35031,8681,5511,3170,8681,87200,2015
05021,43.8,15400,14787,56,268,4299,32552,6611,4858,1753,6611,63900,2015
05023,47.1,25711,24446,133,613,6991,42905,10157,7735,2422,10157,126500,2015
05025,42.4,8510,7231,935,169,2437,43158,3334,2616,718,3334,84700,2015
05027,36,24327,14391,8626,654,6599,36619,9597,6544,3053,9597,79000,2015
05029,40.7,21110,17270,2533,818,5812,37732,8362,6100,2262,8362,91500,2015
05031,33.5,101409,79398,13860,4753,25802,42475,38724,22887,15837,38724,129700,2015
05033,38.8,61748,53037,695,4073,17851,41268,23649,18146,5503,23649,108600,2015
05035,34.6,49765,22077,25243,1120,12564,38004,18348,10499,7849,18348,104600,2015
05037,40.1,17467,12850,3989,302,4805,38103,6918,4426,2492,6918,82400,2015
05039,43.4,7868,4228,3219,219,2097,34084,3248,2144,1104,3248,62000,2015
05041,39.4,12379,5740,5922,575,3358,27197,5272,3030,2242,5272,59300,2015
05043,37.5,18740,12539,5395,540,4942,32819,7314,4443,2871,7314,93600,2015
05045,31.6,119343,97161,13435,4792,28842,51223,43204,27292,15912,43204,146100,2015
05047,40.4,17866,16583,132,486,4763,39285,6784,4818,1966,6784,93100,2015
05049,48,12224,11722,15,141,3750,37066,5300,4016,1284,5300,96700,2015
05051,44.1,96954,80514,8041,5022,25951,38733,40290,27113,13177,40290,130700,2015
05053,39.6,18054,16802,686,221,5094,46171,6859,5305,1554,6859,108300,2015
05055,38.3,43382,41008,398,1122,11439,41286,16682,10787,5895,16682,107700,2015
05057,39.1,22336,12451,6631,2788,5205,32122,7823,5300,2523,7823,74700,2015
05059,40.9,33316,27644,3883,1047,8680,40000,12136,8734,3402,12136,83300,2015
05061,38.6,13555,8958,2955,1433,3549,34229,5049,3299,1750,5049,83900,2015
05063,38.7,36952,32989,740,2213,9846,36265,14238,10167,4071,14238,96000,2015
05065,48.1,13480,12912,162,242,3753,32630,5549,4336,1213,5549,78000,2015
05067,41,17597,13652,3025,494,3886,31261,6339,4310,2029,6339,60600,2015
05069,38.5,73548,29808,40807,1375,17439,36747,28119,17989,10130,28119,82000,2015
05071,38.1,25930,21131,388,3470,6871,34139,10111,7204,2907,10111,89900,2015
05073,45,7270,4339,2777,90,1794,31194,2830,2033,797,2830,61400,2015
05075,41.1,17029,16370,153,203,4363,32379,6696,4713,1983,6696,64500,2015
05077,40.6,9966,4091,5622,225,2220,28393,3605,2051,1554,3605,59500,2015
05079,37.5,14062,9141,4311,494,2861,32580,4040,2817,1223,4040,59600,2015
05081,41.7,12720,9333,2632,397,3434,36205,5251,3860,1391,5251,75500,2015
05083,42.8,22001,20156,407,561,5980,35325,8609,6336,2273,8609,83200,2015
05085,35.5,70691,61524,4300,2722,19375,53631,25909,18237,7672,25909,126900,2015
05087,41.8,15702,14273,3,824,4654,37691,6338,4825,1513,6338,96100,2015
05089,51.3,16458,15597,42,369,4593,34195,6701,5294,1407,6701,102900,2015
05091,37.8,43652,30467,10794,1297,10963,40317,16960,10922,6038,16960,94600,2015
05093,35.6,44864,26759,15487,1720,11672,34612,17141,9870,7271,17141,79600,2015
05095,45.2,7713,4252,3138,163,2022,27647,3364,2083,1281,3364,55000,2015
05097,48.5,9197,8451,57,339,2586,33037,3892,3099,793,3892,82200,2015
05099,41.8,8793,5639,2692,282,2162,30691,3472,2471,1001,3472,66600,2015
05101,47.7,8052,7600,0,85,2226,34536,3310,2788,522,3310,82900,2015
05103,42.7,25044,13950,10043,491,6850,31293,10552,7066,3486,10552,66400,2015
05105,43.1,10300,9547,214,282,2654,42346,3847,3074,773,3847,84200,2015
05107,37.8,20391,7178,12538,321,5115,26844,8135,4170,3965,8135,61200,2015
05109,41.4,11087,9727,348,726,3045,33097,4355,3295,1060,4355,74700,2015
05111,40.2,24210,21279,1992,630,6482,33070,9286,5721,3565,9286,74200,2015
05113,43.1,20364,18070,42,1277,5306,33702,7911,6252,1659,7911,84300,2015
05115,35.2,62830,53712,1839,4919,15440,39810,22645,15305,7340,22645,117100,2015
05117,45.4,8402,7175,1035,93,2626,35833,3826,2700,1126,3826,66400,2015
05119,36.4,390463,211679,138384,23080,92874,46140,154240,92876,61364,154240,142400,2015
05121,42.9,17695,16894,122,317,5010,34044,7335,5362,1973,7335,73700,2015
05123,37.5,27345,11273,14136,1200,5914,32105,9430,5247,4183,9430,60800,2015
05125,38.7,113833,99189,6638,4631,30256,55817,42299,32556,9743,42299,141400,2015
05127,41.3,10870,9174,18,814,3018,37321,4055,3010,1045,4055,76800,2015
05129,47,7965,7492,22,155,2044,33083,3172,2559,613,3172,86300,2015
05131,36.9,127273,90829,7849,16772,32344,38575,49579,30104,19475,49579,114600,2015
05133,34.9,17268,10239,812,5558,4322,36579,6075,4403,1672,6075,68200,2015
05135,47.2,17055,16040,60,334,4426,30691,7108,5512,1596,7108,74800,2015
05137,48.5,12512,11922,5,213,3225,29264,5142,3904,1238,5142,92700,2015
05139,39.7,40633,24984,13323,1466,11327,38678,16536,11724,4812,16536,74600,2015
05141,47.1,17002,15922,90,497,4547,32312,6879,5287,1592,6879,89900,2015
05143,31.2,216432,156896,7020,34732,50871,43524,81722,44668,37054,81722,151900,2015
05145,36.2,78660,69701,3521,3209,20777,42554,29404,20158,9246,29404,108800,2015
05147,43.9,6983,4854,1869,32,1756,28993,2911,1785,1126,2911,60000,2015
05149,39.1,21835,16594,441,4146,5375,37804,7687,5195,2492,7687,94900,2015
06001,37.1,1584983,522707,179400,358168,368905,75619,558907,294644,264263,558907,543100,2015
06003,43.6,1131,725,11,108,225,52917,358,282,76,358,295000,2015
06005,50,36995,29496,822,4784,9402,54171,13925,10577,3348,13925,251000,2015
06007,36.8,222564,164214,3017,33800,50963,43444,85318,50031,35287,85318,221700,2015
06009,50.7,44767,36951,259,4967,12144,53233,18060,14266,3794,18060,243800,2015
06011,34,21396,8017,131,12277,5375,52168,6966,4331,2635,6966,196000,2015
06013,38.8,1096068,503815,94046,273350,273149,80185,384646,248668,135978,384646,439900,2015
06015,38.8,27788,17582,787,5300,5840,40847,9420,5704,3716,9420,183700,2015
06017,44.9,182093,143804,1564,22719,47274,69584,67086,49861,17225,67086,363000,2015
06019,31.4,956749,298219,45409,494077,216106,45233,296305,156474,139831,296305,194600,2015
06021,37.2,28029,15065,241,11094,6502,39349,9497,5855,3642,9497,204400,2015
06023,37.4,135034,102235,1537,14289,30661,42197,53036,29128,23908,53036,279300,2015
06025,32.2,178206,22437,4530,145855,35874,41079,46452,25777,20675,46452,151600,2015
06027,45.7,18373,11906,192,3778,4438,45955,7957,5110,2847,7957,240100,2015
06029,31.1,865736,317048,46058,441496,196097,49026,259700,147125,112575,259700,167400,2015
06031,31.4,150998,51467,8883,79452,31863,46481,41554,21363,20191,41554,169500,2015
06033,45.5,64158,46554,1357,11899,16103,35578,26993,17014,9979,26993,164300,2015
06035,37,32645,21526,2758,5986,6331,51555,9707,6315,3392,9707,172900,2015
06037,35.6,10038388,2703547,801739,4842319,2186485,56196,3263069,1499879,1763190,3263069,441900,2015
06039,33.5,153187,55593,4941,85245,33201,45073,43159,26275,16884,43159,189700,2015
06041,45.4,258349,185975,6181,40875,64413,93257,103670,64729,38941,103670,815100,2015
06043,50.6,17789,14539,192,1803,4962,47681,7345,5224,2121,7345,235900,2015
06045,42.2,87544,58376,538,20693,20243,42980,34017,19679,14338,34017,308400,2015
06047,30.4,263885,78992,8353,150222,59568,42462,77692,40124,37568,77692,161200,2015
06049,47.8,9184,7149,47,1345,2194,37860,3745,2767,978,3745,153100,2015
06051,38.5,14146,9405,59,3862,2740,56944,4906,2919,1987,4906,313000,2015
06053,33.5,428441,135021,10981,243894,90914,58783,125402,61747,63655,125402,369100,2015
06055,40.3,140295,76016,2844,46689,34328,71379,49494,29678,19816,49494,466800,2015
06057,49,98570,84497,462,8902,26119,56521,40993,29683,11310,40993,347000,2015
06059,37.1,3116069,1320050,48196,1064499,727053,76509,1009353,582151,427202,1009353,553600,2015
06061,41,366280,272814,4978,49158,94904,73948,135456,94966,40490,135456,358500,2015
06063,51.3,18966,15993,124,1574,4917,47333,8217,5942,2275,8217,217200,2015
06065,34.5,2298032,867646,136414,1079778,514800,56603,699232,453139,246093,699232,253200,2015
06067,35.5,1465832,686399,140253,326742,343209,55987,522596,289606,232990,522596,248400,2015
06069,35,57557,21092,406,33307,13721,71077,17198,10778,6420,17198,380200,2015
06071,32.5,2094769,652920,169547,1070262,464389,53433,614325,366514,247811,614325,236700,2015
06073,35.1,3223096,1515316,153024,1060995,731328,64309,1094157,579079,515078,1094157,429600,2015
06075,38.5,840763,346732,44879,128619,161887,81294,353287,128698,224589,353287,799600,2015
06077,33.5,708554,243086,47598,284168,163845,53274,219073,124087,94986,219073,223000,2015
06079,39.3,276517,192918,5324,60181,65508,60691,103576,59714,43862,103576,445700,2015
06081,39.5,748731,305166,18471,189389,178371,93623,259711,153422,106289,259711,776300,2015
06083,33.6,435850,201998,7421,192304,93473,63985,142713,74083,68630,142713,465300,2015
06085,36.8,1868149,627328,44980,497074,446734,96310,621463,352836,268627,621463,698600,2015
06087,37,269278,157042,2335,88602,59675,67256,94802,54628,40174,94802,578800,2015
06089,42.2,178942,145248,1752,16384,44950,44620,69375,43331,26044,69375,216600,2015
06091,54.5,3021,2658,3,268,769,42833,1252,981,271,1252,170400,2015
06093,47.8,43895,34244,614,5044,11910,37170,19133,12199,6934,19133,174700,2015
06095,37.3,425753,169259,57650,107592,103174,66828,143612,86079,57533,143612,279100,2015
06097,40.8,495078,320545,6762,127774,118467,64240,187782,111590,76192,187782,436400,2015
06099,33.5,527367,235880,12904,230087,124736,50125,169196,95954,73242,169196,190800,2015
06101,35.4,95247,46108,1841,28261,23432,52017,31917,18864,13053,31917,198700,2015
06103,40.5,63152,44291,291,14813,16350,41001,23704,16008,7696,23704,171500,2015
06105,50.3,13373,11096,151,955,3298,34974,5484,3778,1706,5484,263100,2015
06107,30.3,454033,139581,6021,283533,104130,42031,133570,75685,57885,133570,162700,2015
06109,48.6,54079,43995,970,6139,14546,50306,22133,15129,7004,22133,259300,2015
06111,37.1,840833,395199,13462,349799,198047,77348,268969,172609,96360,268969,458100,2015
06113,30.9,207320,100100,4708,64526,44490,54989,71997,37504,34493,71997,325700,2015
06115,32.1,73437,41676,2377,19611,18202,46892,25139,14593,10546,25139,172100,2015
08001,33,471206,245330,14234,182114,111036,58946,156628,101043,55585,156628,198800,2015
08003,30.1,16269,8020,262,7427,3531,32395,5932,3386,2546,5932,144300,2015
08005,36.1,608310,378452,60356,113506,152068,63265,229601,142695,86906,229601,247600,2015
08007,49.6,12174,9402,77,2251,3673,46646,5334,3827,1507,5334,264200,2015
08009,47.6,3701,3203,41,362,1021,38000,1568,1143,425,1568,73200,2015
08011,41.1,5895,3292,545,1844,1123,36791,1635,1155,480,1635,65700,2015
08013,35.8,310032,243252,2558,42487,72418,70961,122516,76163,46353,122516,368800,2015
08014,37.5,60699,47441,563,7225,16038,81898,23531,16098,7433,23531,295500,2015
08015,49.2,18309,15637,367,1858,5197,51092,7756,5859,1897,7756,274200,2015
08017,37,2002,1691,6,258,456,52554,743,559,184,743,82300,2015
08019,48,9136,8284,120,507,2544,67710,4231,3328,903,4231,283900,2015
08021,38.4,8249,3570,5,4484,2059,36652,2948,2340,608,2948,107100,2015
08023,49,3581,1148,0,2306,848,31321,1457,1107,350,1457,102300,2015
08025,35.5,5551,3394,292,1674,793,31151,1169,941,228,1169,76100,2015
08027,56.4,4303,3940,131,116,1296,35000,1996,1591,405,1996,220400,2015
08029,47.3,30214,24796,290,4448,8083,42452,12058,8595,3463,12058,193000,2015
08031,34.1,649654,344954,60955,201019,133549,53637,275795,136274,139521,275795,271300,2015
08033,39.9,1862,1688,0,110,463,31875,706,544,162,706,119100,2015
08035,37.6,306974,257929,3098,25007,86372,102964,111113,88261,22852,111113,354700,2015
08037,35.6,52576,35237,313,15767,11541,72214,17840,11974,5866,17840,419400,2015
08039,45.1,23855,21455,126,1468,6419,84963,8417,7466,951,8417,337400,2015
08041,33.6,655024,462443,37426,104686,168103,58206,245287,153354,91933,245287,218300,2015
08043,43.5,46809,36525,2388,6080,10640,40423,16342,11584,4758,16342,158500,2015
08045,35.9,57076,39222,244,16044,14848,56590,20622,13331,7291,20622,287500,2015
08047,44.7,5605,4945,29,493,1419,65670,2576,1977,599,2576,252800,2015
08049,42.5,14411,12679,203,889,3453,63628,5250,3818,1432,5250,282000,2015
08051,34.3,15651,13756,69,1404,3426,48071,6287,3729,2558,6287,319200,2015
08053,55.2,874,849,0,11,279,57083,397,302,95,397,276000,2015
08055,53.5,6502,4172,20,2252,1720,31715,3024,2207,817,3024,147600,2015
08057,50.8,1335,1118,1,206,360,46014,616,418,198,616,158000,2015
08059,40.4,552344,435423,5535,83142,144412,70164,222892,155713,67179,222892,279500,2015
08061,41.2,1463,1273,12,105,374,40304,583,442,141,583,83600,2015
08063,38.9,7980,6055,334,1510,2009,40603,3003,2045,958,3003,122300,2015
08065,39,7362,4388,5,2774,1817,45367,3025,1710,1315,3025,168500,2015
08067,38.8,53182,42314,187,6625,12925,60278,21513,14413,7100,21513,332700,2015
08069,35.5,318227,265802,2616,34843,78216,59805,125138,80264,44874,125138,263400,2015
08071,45,14503,7657,249,6146,3794,45067,5826,4008,1818,5826,150600,2015
08073,37.8,5478,3783,611,931,1106,39005,1677,1103,574,1677,118300,2015
08075,37.6,21928,17215,317,3375,5057,42319,7966,5271,2695,7966,124700,2015
08077,38.4,147834,121445,1005,20521,38714,49322,59215,40908,18307,59215,199000,2015
08079,60.9,733,644,6,79,230,48125,368,325,43,368,277100,2015
08081,37.1,13117,10777,64,1873,3152,51387,4986,3486,1500,4986,175800,2015
08083,43.4,25700,18901,23,3122,6578,43553,10417,7331,3086,10417,180400,2015
08085,44.2,40815,31190,214,8243,11415,43999,16768,11746,5022,16768,190900,2015
08087,36.4,28359,17170,710,9913,7658,48450,10421,6747,3674,10421,145500,2015
08089,39.7,18572,10237,59,7647,5053,32311,7454,4753,2701,7454,91900,2015
08091,52.9,4580,4256,0,220,1258,61624,1980,1419,561,1980,388600,2015
08093,49.4,16189,14635,0,916,4502,56969,7319,6027,1292,7319,244800,2015
08095,43.7,4371,3430,5,792,1143,43639,1711,1202,509,1711,132500,2015
08097,43.4,17420,15034,217,1684,3538,71196,7570,4934,2636,7570,620700,2015
08099,37.6,12235,7531,54,4398,3328,40179,4856,3264,1592,4856,87400,2015
08101,38.8,161519,85629,2826,68312,40660,41286,62888,40369,22519,62888,138600,2015
08103,36.4,6712,5676,31,713,1702,61842,2482,1656,826,2482,204800,2015
08105,40.9,11745,6233,53,5187,3110,39672,4617,3078,1539,4617,133700,2015
08107,40.1,23606,21283,97,1612,5708,64963,9431,6519,2912,9431,394600,2015
08109,46.1,6238,3551,23,2427,1510,33393,2598,1813,785,2598,146700,2015
08111,46,606,465,0,117,138,36324,282,182,100,282,223200,2015
08113,40.7,7676,6705,18,729,1696,56047,3310,2001,1309,3310,512800,2015
08115,49.8,2365,1895,29,321,601,44191,951,705,246,951,86800,2015
08117,37.1,28940,23454,334,4266,6009,67983,10143,6728,3415,10143,478800,2015
08119,49.4,23340,20905,251,1414,6840,62372,9581,7728,1853,9581,239000,2015
08121,44.4,4795,4233,28,445,1355,45541,1963,1450,513,1963,113200,2015
08123,33.9,270948,181384,2603,77680,68305,60572,94294,65424,28870,94294,210100,2015
08125,36,10185,7827,41,2201,2283,43105,3865,2433,1432,3865,136400,2015
09001,39.7,939983,602311,97643,171720,232921,84233,334320,228381,105939,334320,416000,2015
09003,40.1,896943,573000,112624,148744,227097,66395,346362,224000,122362,346362,236400,2015
09005,46,186304,167998,2517,9649,49615,72061,74518,57397,17121,74518,254600,2015
09007,44.2,165165,140206,7804,9183,43113,79893,66117,49652,16465,66117,285100,2015
09009,39.8,862224,563977,105051,141282,207295,61640,326028,204886,121142,326028,245200,2015
09011,40.7,273185,209685,14098,26167,69416,66233,106495,70847,35648,106495,244000,2015
09013,38.1,151948,131114,4237,7387,36508,79626,54467,39880,14587,54467,247700,2015
09015,40.4,117470,98828,2232,12376,29674,59392,44276,31184,13092,44276,197500,2015
10001,37,169509,107946,39709,11096,42277,54976,60571,42185,18386,60571,200500,2015
10003,37.5,549643,328838,129600,50568,132978,65476,202268,139675,62593,202268,242400,2015
10005,47,207302,155138,25749,19042,55052,53751,81183,62989,18194,81183,228500,2015
11001,33.7,647484,230489,310678,65803,118737,70848,273390,112750,160640,273390,475800,2015
12001,30.8,254218,159436,49724,22548,52287,43073,96703,51448,45255,96703,164000,2015
12003,36.6,27135,22259,3928,638,6066,47121,8205,6406,1799,8205,114300,2015
12005,39.8,175353,136667,18486,9629,43485,47368,67922,41737,26185,67922,157800,2015
12007,39.6,27223,20263,5407,1030,5768,41606,8770,6477,2293,8770,89200,2015
12009,46.6,553591,421151,54704,50179,141695,48925,222791,159654,63137,222791,142200,2015
12011,40,1843152,744254,495666,496991,425680,51968,670284,425691,244593,670284,185900,2015
12013,40.5,14615,11259,1944,815,3191,34510,4784,3875,909,4784,75500,2015
12015,57.3,165783,140576,9123,10807,46876,44244,71856,56019,15837,71856,145700,2015
12017,55.4,139654,124112,3884,7068,39016,38312,61012,49534,11478,61012,112300,2015
12019,39,197417,148325,18913,17464,51629,58290,69053,51624,17429,69053,153000,2015
12021,48.5,341091,220021,22587,90374,87665,57452,129888,93733,36155,129888,272800,2015
12023,40.4,67806,49743,12031,3649,15142,41926,23708,16917,6791,23708,103500,2015
12027,40.1,34957,19292,4506,10672,7588,35165,11238,7907,3331,11238,80400,2015
12029,46.9,16091,13735,1383,591,3889,36292,6051,4769,1282,6051,73800,2015
12031,36,890673,491717,257936,74775,209958,47690,337900,200029,137871,337900,142300,2015
12033,37.2,306327,200923,65509,16170,68430,45390,113660,69678,43982,113660,120200,2015
12035,49.6,100783,75681,10827,9671,26179,47866,36950,28625,8325,36950,164100,2015
12037,42.1,11628,9142,1593,577,2843,40401,4338,3147,1191,4338,122600,2015
12039,40.2,46424,15596,25299,4663,11354,35567,16964,11990,4974,16964,108400,2015
12041,42,16992,14848,983,864,4185,40623,6187,5006,1181,6187,99900,2015
12043,45.3,13272,8084,1653,2817,2607,34877,3920,2908,1012,3920,84500,2015
12045,43.3,15785,11642,2808,761,3795,41788,5349,3923,1426,5349,142700,2015
12047,40.5,14395,7908,4777,1322,3275,35048,4688,3423,1265,4688,69500,2015
12049,34.8,27468,13014,2107,11801,5743,35457,7618,5300,2318,7618,80700,2015
12051,33.8,38363,13066,4475,19382,8184,36771,11345,7802,3543,11345,72400,2015
12053,48.7,174809,140686,8835,19813,47640,40945,70452,54813,15639,70452,109300,2015
12055,52.1,98328,68044,9216,17963,25837,35093,40397,30667,9730,40397,85200,2015
12057,36.6,1302884,674967,203726,339540,309914,50579,486078,284285,201793,486078,159200,2015
12059,42.1,19635,17145,1353,530,4700,35020,6828,5421,1407,6828,85100,2015
12061,50.7,142866,109224,12751,16821,36247,45798,57825,43168,14657,57825,157800,2015
12063,41,48900,32095,13012,2301,10540,35098,16309,11747,4562,16309,92100,2015
12065,45.3,14198,8223,5089,581,3558,43355,5411,4150,1261,5411,135200,2015
12067,36.4,8801,6111,1558,1058,1741,35864,2493,2001,492,2493,109800,2015
12069,46.4,310561,224450,29462,41936,82497,46403,119251,89192,30059,119251,140100,2015
12071,46.9,663675,461425,54687,127815,165635,48537,252287,174162,78125,252287,157400,2015
12073,30,282940,163155,86917,17151,60921,46745,110834,58008,52826,110834,180900,2015
12075,46.6,39821,31902,3626,3180,10125,35782,15516,11899,3617,15516,88600,2015
12077,37.6,8295,6098,1348,598,1600,39406,2433,1801,632,2433,74000,2015
12079,41.5,18729,10202,7208,921,4275,32164,6614,5186,1428,6614,78500,2015
12081,46.7,343729,248268,30938,53393,88402,49675,134725,94029,40696,134725,169000,2015
12083,48.2,336811,243982,41910,39313,86114,39459,132287,99961,32326,132287,111000,2015
12085,50.7,151586,120303,8181,19491,38625,51593,61952,46795,15157,61952,200200,2015
12086,39,2639042,398700,444590,1731733,572388,43129,842153,452826,389327,842153,203300,2015
12087,46.8,75901,52390,4625,16725,16480,57290,28910,17675,11235,28910,386400,2015
12089,44.2,75880,66176,4854,2819,20405,54116,28306,21575,6731,28306,177100,2015
12091,36.8,192237,144488,16978,15655,49610,55880,74884,47561,27323,74884,186300,2015
12093,39.9,39255,25090,3382,9799,9142,35405,13046,9229,3817,13046,93800,2015
12095,34.4,1229039,534859,244321,352927,279898,47943,434319,238900,195419,434319,163800,2015
12097,35.7,300870,110172,29087,147382,68786,44254,92338,56192,36146,92338,132100,2015
12099,44.1,1378806,794678,241488,280872,332725,53363,534605,369521,165084,534605,204700,2015
12101,44.4,479288,372551,22632,62794,122704,45064,186318,137465,48853,186318,117800,2015
12103,47.1,931477,702808,94385,81072,221986,45819,402653,260848,141805,402653,150200,2015
12105,40.3,626676,391735,91538,120481,153115,43162,221381,152336,69045,221381,107300,2015
12107,44.1,72696,52241,11756,6861,17264,31715,27683,20381,7302,27683,85500,2015
12109,42.7,210495,177340,11001,12435,55003,66194,79242,59811,19431,79242,244400,2015
12111,43.9,288006,172109,54946,49921,71904,43459,107898,78580,29318,107898,125600,2015
12113,39.5,161021,133735,9046,8092,42802,58923,58654,42598,16056,58654,161400,2015
12115,54,392038,328567,17708,33485,106472,51766,175185,127964,47221,175185,181400,2015
12117,39.1,437346,279840,47429,82037,101235,57010,152260,102912,49348,152260,176100,2015
12119,65.3,108501,91246,8782,6237,32883,50350,48039,43312,4727,48039,213900,2015
12121,41.6,43595,32890,5749,3859,10832,36289,15649,10752,4897,15649,92600,2015
12123,41.2,22685,16398,4822,845,5201,36181,7605,5862,1743,7605,83700,2015
12125,40.3,15191,10663,3255,807,2775,39163,3883,2547,1336,3883,87500,2015
12127,46.3,503719,372365,51650,60757,123054,41117,200180,140203,59977,200180,131600,2015
12129,40,31128,24522,4770,1146,7657,50340,10691,7998,2693,10691,122200,2015
12131,43.6,59487,50140,3062,3486,15107,44966,23490,16858,6632,23490,169800,2015
12133,40.9,24629,19052,3720,843,5559,38970,8246,6447,1799,8246,82900,2015
13001,38.6,18417,12825,3479,1723,4736,37135,6812,4752,2060,6812,72300,2015
13003,34.9,8294,4700,1424,2010,1861,30933,2772,1985,787,2772,74400,2015
13005,37.1,11222,8361,1678,879,2698,37162,3951,2723,1228,3951,62800,2015
13007,42.6,3292,1630,1565,64,864,44297,1291,970,321,1291,78500,2015
13009,34.1,45795,24524,18988,972,9198,32460,15978,8687,7291,15978,101700,2015
13011,40.4,18336,16204,485,1158,4974,41472,6553,5066,1487,6553,121600,2015
13013,34.8,72012,53113,8120,6817,17788,52012,23560,17239,6321,23560,119700,2015
13015,37.4,101336,79956,10933,8046,25991,48893,35732,23238,12494,35732,123800,2015
13017,38.6,17477,9871,6237,1081,4260,29994,6413,4101,2312,6413,80900,2015
13019,39,19019,15608,2080,930,4833,31835,6958,5074,1884,6958,84300,2015
13021,35.6,154816,62975,81847,4853,35607,36519,57111,30268,26843,57111,118700,2015
13023,37.3,12746,8856,3334,339,2720,38991,4113,3054,1059,4113,87100,2015
13025,39,18452,17088,570,390,4938,37206,6581,5258,1323,6581,67400,2015
13027,41.4,15637,9033,5423,863,4050,32663,6577,4550,2027,6577,94900,2015
13029,35.1,33151,24757,4917,2038,9156,63327,11441,7819,3622,11441,195600,2015
13031,26.3,72386,46311,20468,2630,15746,36032,26128,12967,13161,26128,129700,2015
13033,36,23007,10788,11405,680,5656,33641,8102,5724,2378,8102,81000,2015
13035,38.4,23445,15736,6555,701,5636,41667,7774,5577,2197,7774,113900,2015
13037,38.2,6489,2138,3954,299,1110,25513,1836,1203,633,1836,56600,2015
13039,31.6,51445,36278,9637,3018,14023,52473,18638,11388,7250,18638,151100,2015
13043,37.1,11031,6897,2687,1239,2755,30185,3909,2370,1539,3909,89000,2015
13045,34,112595,81048,20486,7262,27203,43586,40074,25147,14927,40074,112100,2015
13047,39,65375,59875,1744,1772,17210,50876,23943,17962,5981,23943,129800,2015
13049,40.7,13130,8164,3289,1489,2585,42778,3524,2776,748,3524,82000,2015
13051,34.3,279290,139088,109399,16615,64069,47218,104912,57315,47597,104912,171500,2015
13053,23.3,11914,7172,1764,1781,1992,43378,2599,713,1886,2599,64800,2015
13055,40.3,25241,20857,2708,1170,6303,32913,9364,6209,3155,9364,63900,2015
13057,37.4,225944,181206,13720,22432,59181,68926,79133,61211,17922,79133,190500,2015
13059,26.5,120905,68211,31996,12770,20812,32162,43356,17549,25807,43356,150300,2015
13061,40.3,3104,982,1895,152,689,20438,1183,700,483,1183,69400,2015
13063,32.4,267234,36488,175801,35111,59037,40938,88793,46802,41991,88793,85200,2015
13065,36.1,6791,4494,1794,285,1681,24015,2581,1781,800,2581,58000,2015
13067,36,719133,391063,184546,90536,183266,65873,268616,172334,96282,268616,197400,2015
13069,35.2,43003,25517,12107,4672,9422,33965,14321,9553,4768,14321,83400,2015
13071,35.5,46024,26389,10579,8316,11384,32409,15737,10196,5541,15737,79600,2015
13073,36.6,136204,96778,22057,8131,35724,71021,45488,35613,9875,45488,170800,2015
13075,36.7,17033,11051,4711,1000,4567,35683,6157,4190,1967,6157,86000,2015
13077,37.6,133416,95942,23454,8955,36414,62461,48777,35494,13283,48777,181000,2015
13079,43.5,12539,9214,2876,65,3277,41825,4538,3609,929,4538,85800,2015
13081,38.4,23314,11898,10063,760,6088,31615,8659,5108,3551,8659,98200,2015
13083,40.7,16445,15463,197,350,4631,46434,6150,4789,1361,6150,118300,2015
13085,41.5,22673,21084,126,891,6186,56943,8213,6191,2022,8213,188300,2015
13087,37.4,27378,14089,11373,1508,6952,31284,10614,6303,4311,10614,114400,2015
13089,35.1,716331,212598,379694,64968,156378,51376,267396,147739,119657,267396,163000,2015
13091,40.2,21180,13796,6027,745,5558,34271,8064,5288,2776,8064,67900,2015
13093,41.4,14293,6128,7027,1027,3283,28696,5004,3216,1788,5004,73000,2015
13095,34.2,93310,25627,62966,2374,22047,32084,35455,16202,19253,35455,101400,2015
13097,35.9,136520,62670,56227,12017,34491,53881,47079,31687,15392,47079,121300,2015
13099,40.3,10579,4975,5318,214,2690,31680,3981,2640,1341,3981,81600,2015
13101,35.4,4048,2787,82,1036,1020,32959,1416,932,484,1416,67600,2015
13103,36.1,54630,43667,7361,1896,14141,63100,18432,14107,4325,18432,152600,2015
13105,41.3,19537,12471,5924,1033,5312,35388,7744,5278,2466,7744,82400,2015
13107,36.9,22731,13637,7699,1016,5397,32229,8156,5443,2713,8156,67800,2015
13109,35.3,10814,6125,3262,1286,2771,37865,3982,2532,1450,3982,87900,2015
13111,50.2,23742,22653,64,465,6319,37049,9510,7418,2092,9510,164600,2015
13113,43.3,108655,71294,22424,7563,30104,79066,38535,31316,7219,38535,229500,2015
13115,38,96169,69449,14092,9731,23513,41549,34874,21182,13692,34874,117100,2015
13117,38,196236,151783,5523,18793,50596,88816,62295,52420,9875,62295,267300,2015
13119,40.9,22110,18647,2117,934,5840,33816,8433,5867,2566,8433,102700,2015
13121,34.8,983903,397535,428481,75002,207569,57207,379957,196617,183340,379957,241300,2015
13123,45.1,28673,24735,199,3066,7704,40228,10985,8388,2597,10985,139600,2015
13125,40,3087,2700,214,48,795,40759,1121,829,292,1121,66300,2015
13127,40.5,81743,52402,20924,5395,21755,45918,32311,19709,12602,32311,159200,2015
13129,37,55889,43845,2332,8287,14403,41612,19539,12786,6753,19539,113000,2015
13131,39.1,25243,14919,7122,2654,6506,34187,9270,5360,3910,9270,115100,2015
13133,47.6,16331,9134,5935,1012,4701,42408,6707,4820,1887,6707,169300,2015
13135,34.5,859234,354281,212639,174843,209434,60289,274017,181829,92188,274017,167700,2015
13137,38.8,43527,33959,1661,5884,10697,40907,14864,11128,3736,14864,131500,2015
13139,35.6,187916,117093,13811,50913,45810,51202,61992,41434,20558,61992,159700,2015
13141,43.9,8881,2130,6503,173,1597,24925,2815,2203,612,2815,66700,2015
13143,40.3,28565,25981,1402,377,7827,41910,10733,7559,3174,10733,103500,2015
13145,43.1,32776,25252,5314,1035,8951,63824,11570,9689,1881,11570,201100,2015
13147,43.2,25498,19265,5056,919,6914,37653,9955,7300,2655,9955,116600,2015
13149,40.1,11617,9863,1142,271,2968,41525,4336,3153,1183,4336,88200,2015
13151,36.3,211512,104644,81182,13224,54402,60424,70281,51234,19047,70281,140300,2015
13153,34.8,147570,86268,42975,9563,37863,53270,53771,35105,18666,53771,132400,2015
13155,39,9408,6420,2673,95,2144,34156,3262,2450,812,3262,80000,2015
13157,38.3,61420,50768,4343,4126,16154,53379,21048,16202,4846,21048,155700,2015
13159,39.9,13593,9855,2863,541,3697,42368,5162,3766,1396,5162,111200,2015
13161,36.1,14990,10813,2439,1657,3943,36385,5404,4094,1310,5404,71800,2015
13163,38.4,16374,6852,8886,543,3967,26557,6057,3923,2134,6057,64800,2015
13165,40.7,8922,5029,2981,694,2251,24604,3495,2303,1192,3495,54700,2015
13167,39.6,9794,6092,3384,39,2301,34438,3299,2343,956,3299,67600,2015
13169,39.4,28738,20756,7362,168,7861,51857,10326,8348,1978,10326,129300,2015
13171,38.6,18114,11709,5523,404,4446,40344,6431,4498,1933,6431,124300,2015
13173,33.6,10403,7087,2575,550,2616,37605,3712,2364,1348,3712,100900,2015
13175,38.5,47886,28442,17259,1199,11877,32356,17640,11227,6413,17640,84100,2015
13177,36.7,28946,21277,5740,708,7951,61537,10015,7171,2844,10015,157100,2015
13179,27.6,64427,27348,25346,7514,16666,42201,22943,10887,12056,22943,122400,2015
13181,47.2,7720,5061,2514,55,2152,34243,3425,2582,843,3425,113800,2015
13183,31.2,16588,9823,3846,1944,3714,48863,5017,3211,1806,5017,103300,2015
13185,29.4,113203,61980,40430,6061,24591,36834,39328,20190,19138,39328,135000,2015
13187,36,30921,28122,612,1428,7192,43804,11086,7198,3888,11086,167400,2015
13189,38.2,21582,11835,8983,565,6021,36656,8131,5156,2975,8131,102300,2015
13191,47.6,14007,8582,4871,239,3639,42988,5296,4112,1184,5296,108400,2015
13193,40.5,14045,4771,8316,561,3057,28684,4684,2874,1810,4684,68100,2015
13195,40.2,28232,23698,2525,1272,7084,41912,10195,7364,2831,10195,122700,2015
13197,41.7,8739,5123,2756,633,1922,36242,3055,2205,850,3055,93300,2015
13199,42.1,21297,12077,8156,432,5637,35832,7943,5289,2654,7943,89800,2015
13201,41,5936,4076,1844,6,1638,33983,2376,1562,814,2376,92500,2015
13205,37.6,22982,10666,10857,1001,5264,31915,8140,5372,2768,8140,76700,2015
13207,41.9,26915,19420,6435,605,7161,48744,9581,7257,2324,9581,153300,2015
13209,38,8968,5942,2360,538,2069,34672,3140,2212,928,3140,75200,2015
13211,43.2,17900,12842,4143,524,4899,51820,6418,4985,1433,6418,182900,2015
13213,37.2,39401,32933,354,5493,10476,35539,14236,9624,4612,14236,89800,2015
13215,33.5,200285,85016,88432,14552,46385,42306,72760,36266,36494,72760,134500,2015
13217,35.8,102645,51778,42382,5023,24836,49179,34641,24301,10340,34641,115500,2015
13219,39.7,34400,29323,1811,1605,9524,72182,11880,9453,2427,11880,235700,2015
13221,42.4,14688,11206,2346,578,3985,44226,5542,4168,1374,5542,121200,2015
13223,35.1,147400,109350,25511,8083,39114,60109,49110,38811,10299,49110,133500,2015
13225,34.7,27086,12315,12319,1950,6871,41588,9941,6512,3429,9941,124600,2015
13227,44.7,29740,27803,430,914,8597,54123,11286,8687,2599,11286,175000,2015
13229,39,18934,15864,1481,970,5221,40247,6890,5149,1741,6890,98000,2015
13231,38.9,17812,15354,1989,250,4808,51338,6017,5035,982,6017,155200,2015
13233,37.2,41215,29648,5473,5251,10417,37853,14694,9881,4813,14694,102600,2015
13235,41.3,11590,6851,3891,541,2709,38750,3947,2396,1551,3947,100700,2015
13237,45.6,21247,13871,5650,1411,6213,44299,8462,6205,2257,8462,155100,2015
13239,49.2,2326,1154,1145,0,629,31487,1015,757,258,1015,69200,2015
13241,47.8,16266,14140,295,1318,4387,35211,6789,4989,1800,6789,161500,2015
13243,39.2,7315,2466,4527,90,1871,28377,2794,1703,1091,2794,68400,2015
13245,33.3,201291,73950,108806,9147,43515,37424,71724,38074,33650,71724,101900,2015
13247,37.5,86901,32655,42210,8617,21486,50455,29623,20405,9218,29623,140000,2015
13249,38.4,5074,3601,1215,226,1351,39375,1879,1212,667,1879,91500,2015
13251,40,14206,7809,5966,231,3501,34466,5290,3716,1574,5290,80500,2015
13253,45.1,8769,5489,2937,252,2341,34905,3301,2470,831,3301,75600,2015
13255,38.2,63873,38353,21012,2708,16118,40246,22717,13943,8774,22717,111500,2015
13257,41.2,25620,21273,3120,744,6666,40315,9198,6618,2580,9198,101100,2015
13259,38,5868,1605,2857,1277,991,21118,1731,1077,654,1731,52500,2015
13261,34.6,31429,12642,16214,1651,7433,32758,11403,6651,4752,11403,84700,2015
13263,47.5,6490,2581,3723,126,1781,34078,2665,2142,523,2665,72300,2015
13265,47.9,1721,660,1009,38,410,26306,707,521,186,707,63100,2015
13267,36.2,25302,14850,7307,2705,5517,33980,7880,5451,2429,7880,80600,2015
13269,42.6,8401,4903,3289,191,2415,28143,3405,2392,1013,3405,58000,2015
13271,40.3,16416,8214,5834,2271,3443,26449,5289,3154,2135,5289,56400,2015
13273,41,9213,3331,5573,222,2288,28688,3312,1942,1370,3312,83700,2015
13275,39.4,44824,25917,16261,1496,11520,36641,17385,10420,6965,17385,123100,2015
13277,35.1,40787,23072,12096,4414,9531,37653,14127,8202,5925,14127,112400,2015
13279,34.9,27210,16639,6967,3100,7252,33679,10681,6619,4062,10681,89900,2015
13281,52.4,10800,10271,72,260,2803,37000,4268,3411,857,4268,175100,2015
13283,42.8,6762,4692,1962,79,1685,38596,2627,1830,797,2627,71100,2015
13285,36.1,68867,40240,23591,2485,16971,41489,24645,14265,10380,24645,116300,2015
13287,38,8338,4558,3245,356,2118,31806,3013,2117,896,3013,70900,2015
13289,45.6,8509,4748,3576,5,2107,30468,3022,2339,683,3022,56900,2015
13291,53.3,21725,20495,101,621,5834,40799,8357,6589,1768,8357,184900,2015
13293,41.5,26528,18020,7535,631,6912,35774,10159,6470,3689,10159,85600,2015
13295,40.4,68285,62513,3120,1250,18389,41632,25860,18601,7259,25860,105900,2015
13297,38.5,86201,66141,13638,3269,23843,54453,29667,21705,7962,29667,152900,2015
13299,37.9,35723,23003,10547,1300,9678,34909,13901,8936,4965,13901,78600,2015
13301,44.3,5561,2089,3268,43,1255,29176,2125,1462,663,2125,62300,2015
13303,40,20785,9118,10895,450,5097,37932,7230,5049,2181,7230,80400,2015
13305,37.3,30046,21352,6125,1847,7143,38955,10066,6884,3182,10066,91400,2015
13307,41,2720,1175,1519,26,708,37063,1062,893,169,1062,46000,2015
13309,38.4,7956,4499,3265,173,1367,27620,2012,1269,743,2012,49400,2015
13311,43.9,27791,25742,758,794,8054,40888,11316,8353,2963,11316,155800,2015
13313,34.8,103456,62546,4078,34198,25402,40596,34575,22242,12333,34575,120400,2015
13315,39.4,8972,5267,3371,190,1780,32043,2742,1972,770,2742,64900,2015
13317,44.4,9991,5167,4232,393,2488,32727,4006,2835,1171,4006,95200,2015
13319,41.6,9386,5375,3548,243,2260,38485,3313,2572,741,3313,71500,2015
13321,40.4,21156,14273,6280,443,5496,37974,7924,5844,2080,7924,70800,2015
15001,41.1,191482,58898,1203,23444,43306,52108,65048,43213,21835,65048,301700,2015
15003,36.9,984178,191473,24130,91036,217945,74460,309602,168551,141051,309602,580200,2015
15005,51.9,85,32,0,4,11,66250,54,2,52,54,NA,2015
15007,41.6,69691,20947,452,7350,15665,65101,22405,13799,8606,22405,480600,2015
15009,40,160863,50482,896,17417,36685,66476,53463,30824,22639,53463,509700,2015
16001,35.8,417501,357162,4579,31830,104620,56356,157286,105839,51447,157286,188800,2015
16003,51.3,3880,3629,0,120,1057,39565,1592,1227,365,1592,145000,2015
16005,32.7,83604,71284,564,6442,20064,43779,30394,20313,10081,30394,145300,2015
16007,39.5,5939,5572,28,245,1735,48654,2346,1867,479,2346,138900,2015
16009,45.4,9088,7692,29,291,2347,39863,3668,2647,1021,3668,142800,2015
16011,32.9,45407,33834,133,8034,11249,50155,14698,10890,3808,14698,141400,2015
16013,43,21309,16468,19,4362,5723,60088,8924,5884,3040,8924,374800,2015
16015,52,6885,6365,36,245,1838,44238,2970,2451,519,2970,188200,2015
16017,47.2,41066,38512,35,1102,11301,42171,17193,12499,4694,17193,211300,2015
16019,32.4,107788,90653,480,13316,26910,50762,36686,26254,10432,36686,155600,2015
16021,43.7,10961,10014,26,457,2818,38961,4265,3158,1107,4265,172800,2015
16023,40.9,2653,2323,53,162,667,37891,1009,805,204,1009,105800,2015
16025,42.1,1052,920,0,119,265,42614,435,296,139,435,164500,2015
16027,32.8,198921,142337,787,48640,47514,42888,65807,45221,20586,65807,122200,2015
16029,36.8,6808,6414,7,363,1874,58021,2606,2118,488,2606,126600,2015
16031,31.7,23369,16689,37,6129,5690,45695,7732,5466,2266,7732,131500,2015
16033,32.7,901,524,0,373,209,33672,274,171,103,274,97300,2015
16035,50.2,8560,7829,14,310,2372,38837,3648,2865,783,3648,126200,2015
16037,52,4234,4031,0,113,1212,39457,1767,1388,379,1767,161500,2015
16039,30.8,26175,19391,624,4209,6871,43848,9785,5758,4027,9785,135300,2015
16041,32.4,12914,11789,10,883,3417,48133,4236,3350,886,4236,160900,2015
16043,36.3,12945,11039,46,1598,3511,47988,4477,3685,792,4477,152100,2015
16045,44.7,16731,14789,0,1341,4305,40828,6311,4432,1879,6311,140200,2015
16047,36.3,15233,10419,11,4381,3830,39930,5327,3589,1738,5327,127700,2015
16049,48.9,16312,14965,14,506,4465,38191,6583,5282,1301,6583,153700,2015
16051,31.1,26792,23372,39,2771,6610,51171,8102,6656,1446,8102,156000,2015
16053,32.1,22653,14530,17,7558,5658,41630,7624,4864,2760,7624,135800,2015
16055,39.4,145046,132435,471,6061,38705,49403,56421,39582,16839,56421,185700,2015
16057,28.5,38339,34477,246,1520,8275,42439,15080,8149,6931,15080,191100,2015
16059,51.2,7790,7297,27,226,2176,34329,3721,2645,1076,3721,172700,2015
16061,48.2,3812,3325,3,155,1027,36505,1625,1177,448,1625,115300,2015
16063,33.8,5260,3551,0,1557,1243,43273,1624,1154,470,1624,121000,2015
16065,23.2,37916,34054,250,2515,8114,32233,10305,4908,5397,10305,177700,2015
16067,35.5,20279,12970,18,6775,5481,44853,7148,5299,1849,7148,111000,2015
16069,41.6,39779,34897,146,1371,10318,48160,16096,11262,4834,16096,167900,2015
16071,39,4245,4007,0,149,1115,41338,1582,1259,323,1582,132500,2015
16073,37.5,11364,7790,9,2955,2770,33440,3929,2636,1293,3929,122400,2015
16075,38.5,22700,18062,98,3695,5764,44257,8147,6194,1953,8147,129300,2015
16077,34.2,7731,4941,25,2435,1953,44779,2563,1825,738,2563,125500,2015
16079,47.1,12571,11618,40,419,3475,37665,5712,3900,1812,5712,119600,2015
16081,35.2,10285,8312,24,1792,2392,53474,3605,2588,1017,3605,222900,2015
16083,34.5,80004,64953,400,11914,20654,44048,29017,19207,9810,29017,147900,2015
16085,49.4,9720,9429,1,133,2106,48384,3188,2314,874,3188,221500,2015
16087,44.9,10025,7898,0,1742,2468,34775,3812,2791,1021,3812,127400,2015
17001,40.6,67081,62015,2532,943,17272,45965,26883,19005,7878,26883,110000,2015
17003,39.7,7364,4481,2535,118,1645,27265,2644,1777,867,2644,50200,2015
17005,40.1,17313,15241,962,587,4057,47946,6148,4724,1424,6148,106900,2015
17007,38.2,53851,40227,1119,10974,13783,58248,18129,14711,3418,18129,143700,2015
17009,37.7,6859,5093,1131,286,1325,50739,2140,1587,553,2140,85800,2015
17011,43.4,34115,30358,200,2881,9388,50423,14023,10561,3462,14023,105600,2015
17013,46.9,4999,4891,5,15,1500,53869,2063,1638,425,2063,121400,2015
17015,47.5,14926,14013,168,494,4225,48631,6617,5081,1536,6617,95700,2015
17017,39.2,13254,10204,429,2433,3442,47434,5200,3785,1415,5200,77000,2015
17019,29.3,205766,142486,25591,11403,42424,46495,79912,43897,36015,79912,150200,2015
17021,42,34200,32551,570,525,9032,45334,14013,10447,3566,14013,83800,2015
17023,43.4,16159,15656,47,221,4596,50517,6647,4955,1692,6647,86200,2015
17025,42.8,13582,13089,74,187,3876,44209,5525,4394,1131,5525,77000,2015
17027,40.1,37929,34777,1279,1134,9542,63236,13866,11517,2349,13866,134500,2015
17029,33.3,53037,48426,1807,1209,12296,39588,21063,13070,7993,21063,91800,2015
17031,35.9,5236393,2256002,1239171,1295026,1184857,55251,1942959,1107485,835474,1942959,218700,2015
17033,42.4,19541,17828,692,412,5047,47468,7620,6072,1548,7620,81000,2015
17035,41.6,10943,10623,23,114,2943,46061,4310,3477,833,4310,93400,2015
17037,30.3,104345,81773,6918,11111,22659,54101,37269,21802,15467,37269,165200,2015
17039,42.8,16388,15613,74,370,4481,53959,6840,5359,1481,6840,105300,2015
17041,38.3,19826,18047,96,1371,5245,51810,7618,5721,1897,7618,100500,2015
17043,38.8,930412,638010,42526,129549,239546,79658,338083,248508,89575,338083,278500,2015
17045,43.4,17992,17509,94,200,5428,45691,7716,5720,1996,7716,76700,2015
17047,43.7,6649,6453,32,66,1808,44497,2785,2350,435,2785,69300,2015
17049,38.9,34332,33120,117,638,8952,52224,13330,10544,2786,13330,128200,2015
17051,40.1,22136,20367,923,377,5362,43944,7761,6309,1452,7761,82400,2015
17053,42.7,13835,13144,80,367,3602,49947,5626,4210,1416,5626,93100,2015
17055,42.1,39694,38214,189,581,10215,39512,16257,12017,4240,16257,66300,2015
17057,42.2,36323,33483,1284,979,9427,46083,14375,10818,3557,14375,81500,2015
17059,45.1,5385,5166,21,50,1588,39636,2408,1857,551,2408,65700,2015
17061,42.6,13502,13117,129,142,3601,42565,5458,4158,1300,5458,76000,2015
17063,37.2,50277,44058,717,4505,13475,65887,18492,13864,4628,18492,182400,2015
17065,43.2,8322,8249,42,16,2324,44159,3473,2709,764,3473,84700,2015
17067,46.2,18738,18140,106,245,5404,47699,7862,6231,1631,7862,83400,2015
17069,46.6,4228,4058,33,74,1076,38838,1677,1390,287,1677,68800,2015
17071,49.1,7042,6804,6,99,2103,47672,3094,2435,659,3094,87100,2015
17073,42.2,49883,45466,855,2628,13743,53480,20170,15844,4326,20170,110800,2015
17075,44.1,29053,26420,376,1816,7986,47834,11829,9014,2815,11829,95900,2015
17077,30.1,59534,44539,8420,2471,11998,33871,23390,12236,11154,23390,103000,2015
17079,42.9,9635,9381,33,123,2638,54209,3781,3180,601,3781,94500,2015
17081,40.7,38578,33273,3039,880,9758,43247,15277,11148,4129,15277,87300,2015
17083,42.3,22625,21806,96,275,6424,53271,8830,7175,1655,8830,124300,2015
17085,48.2,22397,21259,60,688,6458,53221,9542,7532,2010,9542,138900,2015
17087,43.2,12829,11067,1129,381,2947,42287,4407,3636,771,4407,93100,2015
17089,35.9,524886,305352,27673,163756,128926,70696,172479,126903,45576,172479,213200,2015
17091,37.3,112221,81441,16746,10803,27599,52110,40880,28306,12574,40880,138700,2015
17093,33.8,120036,86912,7664,19965,30364,84385,38516,31778,6738,38516,200200,2015
17095,42.1,52112,43744,4327,2763,12393,39976,21301,14218,7083,21301,80400,2015
17097,37.6,702898,448118,47253,145475,179321,78026,242426,179785,62641,242426,245300,2015
17099,41.6,112579,97790,2670,9856,28926,50633,44242,32356,11886,44242,123100,2015
17101,40.7,16665,12020,3408,960,3361,40841,5015,3857,1158,5015,66700,2015
17103,42.2,35027,30523,1735,1975,8790,52379,13517,10011,3506,13517,113600,2015
17105,41.3,37689,33631,2030,1624,9671,54254,14464,10578,3886,14464,107200,2015
17107,39.7,29956,23137,3472,1234,7046,50539,10711,7263,3448,10711,98900,2015
17109,30.7,32009,28282,1520,856,6758,40314,12129,7725,4404,12129,89900,2015
17111,39.3,307357,253736,3844,37205,82365,77222,109491,88257,21234,109491,208200,2015
17113,32.7,173114,139183,13441,8101,40488,62211,65346,42905,22441,65346,160500,2015
17115,40.6,109193,84423,15968,2247,27658,47176,44915,30995,13920,44915,94900,2015
17117,42.6,46844,45201,321,469,12923,51206,18982,14724,4258,18982,94300,2015
17119,39.5,267356,229849,21506,7998,70309,53431,107111,75940,31171,107111,126500,2015
17121,41.7,38665,35530,1421,662,10410,42238,15783,11777,4006,15783,68600,2015
17123,45.9,12173,11583,73,375,3235,53423,4993,4155,838,4993,104600,2015
17125,44.7,14126,13674,127,83,3883,41567,6116,4705,1411,6116,81300,2015
17127,43.7,15016,13385,902,379,3765,40977,5987,4365,1622,5987,83900,2015
17129,42.5,12611,12114,113,164,3495,60486,5144,3999,1145,5144,127900,2015
17131,44.3,16107,15493,76,344,4646,54757,6607,5159,1448,6607,98000,2015
17133,42.1,33539,32406,114,515,9661,70859,12699,10428,2271,12699,191200,2015
17135,42.2,29348,25855,2569,483,7780,46966,10985,8551,2434,10985,78300,2015
17137,41,35129,31331,2088,798,8961,45978,13825,9579,4246,13825,98500,2015
17139,41,14927,14506,50,180,4036,49681,5799,4418,1381,5799,100900,2015
17141,41.5,52397,46089,529,4919,13871,54849,20731,15732,4999,20731,140000,2015
17143,36.8,187112,133294,32449,8185,46565,51147,76133,49289,26844,76133,126600,2015
17145,40.8,21810,18821,1903,492,4978,42478,8025,6094,1931,8025,78400,2015
17147,43.3,16495,15968,68,178,4861,66261,6645,5549,1096,6645,123600,2015
17149,42.6,16144,15442,190,197,4318,40588,6677,5172,1505,6677,75300,2015
17151,47.7,4331,4035,155,78,1026,39223,1593,1329,264,1593,102000,2015
17153,43.5,5871,3730,1878,107,1355,31980,2334,1744,590,2334,57600,2015
17155,46,5822,5423,11,279,1667,56358,2453,1965,488,2453,121300,2015
17157,41.7,33069,28318,3394,937,7860,48158,11895,9209,2686,11895,96700,2015
17159,42.4,16127,15485,70,236,4070,44127,6503,4675,1828,6503,83800,2015
17161,40,147161,108746,13496,18061,37358,48817,60391,41981,18410,60391,113800,2015
17163,37.7,267029,166996,79406,9849,67282,49895,102267,67779,34488,102267,120400,2015
17165,42.4,24783,22759,910,391,6637,38258,9955,7115,2840,9955,69400,2015
17167,39.7,199016,161766,24374,4205,50928,56167,82885,57654,25231,82885,130900,2015
17169,44.7,7311,6869,332,32,1991,47723,3000,2446,554,3000,78100,2015
17171,43.5,5198,5055,0,73,1407,47222,2124,1607,517,2124,84300,2015
17173,44.4,22115,21591,118,202,6381,47850,9044,7379,1665,9044,85300,2015
17175,45.9,5859,5666,44,65,1604,50085,2391,1966,425,2391,85100,2015
17177,44.3,46625,39229,4260,1544,12362,45331,19299,13641,5658,19299,98900,2015
17179,40.5,135697,128024,1623,2941,37011,58194,54288,41508,12780,54288,134900,2015
17181,43.6,17551,16099,212,884,4586,42606,6712,5278,1434,6712,93900,2015
17183,40,80368,63786,11073,3715,20188,42977,31531,21751,9780,31531,75800,2015
17185,42.7,11652,11124,109,184,3217,47491,4871,3581,1290,4871,81100,2015
17187,40.2,17701,15177,462,1601,4484,43699,6829,5166,1663,6829,81900,2015
17189,42.6,14457,13907,107,232,3868,53202,5777,4553,1224,5777,106600,2015
17191,42.4,16555,16007,108,97,4812,44993,7043,5650,1393,7043,77800,2015
17193,44.5,14464,14023,58,184,4061,44648,6171,4603,1568,6171,70900,2015
17195,42.7,57525,48915,900,6698,15385,47401,23548,17731,5817,23548,99200,2015
17197,36.6,683995,448959,74943,111709,170695,76101,223640,182276,41364,223640,209800,2015
17199,41,67121,60884,2776,1563,18143,44453,26796,19430,7366,26796,99200,2015
17201,39.2,290439,206488,35926,34122,74809,48225,113912,75502,38410,113912,117700,2015
17203,39.9,39106,37487,213,647,10635,65852,14350,11663,2687,14350,158200,2015
18001,33.8,34642,32584,242,1510,8574,48188,12183,9548,2635,12183,116900,2015
18003,35.6,363453,273309,41223,25365,91978,49092,140536,96765,43771,140536,114600,2015
18005,38.1,79488,67492,1579,4956,20612,55050,30518,21588,8930,30518,136000,2015
18007,40.4,8752,8128,73,458,2239,47046,3429,2426,1003,3429,83800,2015
18009,43.3,12476,11988,72,177,3574,38190,5228,3877,1351,5228,67500,2015
18011,38.8,60511,55938,750,1539,16940,67552,22924,17396,5528,22924,187600,2015
18013,48.3,15011,14425,49,221,4192,54615,6095,4842,1253,6095,162300,2015
18015,41.5,20014,18882,68,798,5386,52005,7793,6275,1518,7793,112100,2015
18017,40.1,38476,31457,529,5220,9773,42290,14555,10975,3580,14555,82400,2015
18019,38.7,113181,95634,7891,5715,28208,51699,42974,30563,12411,42974,129000,2015
18021,40.4,26686,25810,63,342,7469,47602,10345,7782,2563,10345,95000,2015
18023,38.4,32835,27531,237,4756,8146,48478,11643,8434,3209,11643,98100,2015
18025,43.1,10591,10220,11,153,2789,38695,4101,3250,851,4101,86300,2015
18027,35,32411,30145,457,1451,8275,47342,11452,8287,3165,11452,110200,2015
18029,41.7,49679,47886,394,569,13367,58680,18634,14646,3988,18634,159100,2015
18031,39.5,26240,25010,148,478,7046,49799,10074,7076,2998,10074,115100,2015
18033,38.6,42449,40452,52,1107,11228,48341,16247,12496,3751,16247,110100,2015
18035,34.8,117335,102621,6753,2386,27584,38830,45761,29208,16553,45761,87700,2015
18037,41.2,42291,38857,164,2750,11445,53513,16190,12263,3927,16190,137700,2015
18039,35.2,200685,152635,11206,29763,50577,47913,70439,48955,21484,70439,124000,2015
18041,42.2,23773,22819,476,234,6359,39379,9336,6429,2907,9336,81900,2015
18043,39.6,75900,67339,3699,2179,19755,54914,29088,21055,8033,29088,156300,2015
18045,42.3,16888,16169,75,399,4682,46760,6951,5193,1758,6951,87500,2015
18047,41.2,22935,22337,55,239,6787,51748,8848,7071,1777,8848,147600,2015
18049,41.7,20527,18984,204,982,5375,45332,7963,6127,1836,7963,95400,2015
18051,40,33668,31718,553,504,9112,48303,13102,10127,2975,13102,103000,2015
18053,40,68896,59110,4523,2737,17278,40294,26477,18451,8026,26477,82800,2015
18055,42.3,32815,31824,69,399,8721,45397,12798,10119,2679,12798,90500,2015
18057,36.1,296635,252168,10485,11001,80098,86222,108253,84806,23447,108253,222900,2015
18059,39.8,71328,66743,1417,1406,19093,66606,26340,20608,5732,26340,156300,2015
18061,41.7,39230,37685,316,678,10208,52128,14604,11905,2699,14604,129300,2015
18063,37.4,153435,133022,8702,5271,40971,70163,54652,43851,10801,54652,162400,2015
18065,42.2,49146,46221,851,793,12052,41855,18010,13231,4779,18010,91600,2015
18067,41.5,82765,71375,5745,2484,22281,44226,34413,23731,10682,34413,95700,2015
18069,39.8,36863,35238,261,737,9792,46945,14480,10973,3507,14480,99900,2015
18071,38.3,43471,39195,337,2662,11691,47000,16614,12325,4289,16614,112200,2015
18073,38.8,33448,30761,241,1936,8921,55374,11996,9306,2690,11996,148300,2015
18075,39.5,21255,20274,123,627,5464,41021,8117,6075,2042,8117,79400,2015
18077,40.7,32453,30322,629,788,8795,45718,12694,9120,3574,12694,112100,2015
18079,39.4,28113,26837,401,635,7228,44736,10607,8035,2572,10607,95400,2015
18081,37.3,145645,132589,2740,4895,38992,62147,53270,37734,15536,53270,145400,2015
18083,39.2,38062,35471,1125,670,9362,42725,14779,9755,5024,14779,84700,2015
18085,37.9,77983,69391,557,6060,21191,52821,29586,22634,6952,29586,132900,2015
18087,31.1,38084,36030,19,1461,9270,49964,11719,9513,2206,11719,162200,2015
18089,38.1,491596,269262,119856,87085,123259,50135,183314,126228,57086,183314,136100,2015
18091,39.9,111280,89437,12030,6635,28142,46872,43004,30343,12661,43004,123300,2015
18093,41.9,45814,44023,171,680,13009,45875,18494,14245,4249,18494,100500,2015
18095,39.8,130280,111718,10091,4674,33403,44195,51274,35412,15862,51274,90400,2015
18097,34.1,926335,538138,248584,89830,209677,42168,363558,197290,166268,363558,118300,2015
18099,39.5,46962,41585,267,4297,11976,48485,17324,13319,4005,17324,123100,2015
18101,42.5,10262,9993,30,24,2614,44589,4201,3274,927,4201,91800,2015
18103,40.1,36211,32517,1824,962,9103,45184,13164,9606,3558,13164,85500,2015
18105,28.4,142404,120736,4070,4623,27809,42404,54165,29050,25115,54165,160400,2015
18107,40.2,38172,35318,326,1733,9927,48213,14637,10398,4239,14637,110600,2015
18109,40.9,69403,66950,256,959,18758,55432,25609,19554,6055,25609,143700,2015
18111,43,14057,12981,39,794,3739,46895,5401,4062,1339,5401,113400,2015
18113,37.9,47546,41802,228,4733,13101,49331,18101,13592,4509,18101,113000,2015
18115,46,6033,5967,58,0,1615,48780,2389,1880,509,2389,141000,2015
18117,40.9,19725,18904,277,251,5224,39812,7648,5833,1815,7648,89400,2015
18119,43.9,21192,20475,129,146,5987,43948,8553,6812,1741,8553,110200,2015
18121,41.8,17107,16260,348,226,4192,40781,5995,4786,1209,5995,88200,2015
18123,41.4,19414,18336,592,241,5039,47470,7282,5796,1486,7282,100800,2015
18125,43.4,12687,12579,24,29,3536,44399,4994,4096,898,4994,88400,2015
18127,39.2,166570,140793,5272,15371,44331,63926,62103,47809,14294,62103,165500,2015
18129,42.5,25567,24655,339,264,7287,58101,10098,8395,1703,10098,133800,2015
18131,41.3,13047,12381,36,363,3557,43836,5184,3969,1215,5184,93000,2015
18133,37.5,37650,34596,1499,665,9002,51355,12649,9320,3329,12649,122800,2015
18135,42.2,25596,24184,94,814,6846,40810,10529,7758,2771,10529,78200,2015
18137,40.4,28612,27500,136,486,7921,51170,10921,8437,2484,10921,129800,2015
18139,41.3,16991,16391,148,215,4908,45121,6942,4959,1983,6942,100700,2015
18141,36.5,267246,198873,34079,21251,65126,45471,102005,69843,32162,102005,114800,2015
18143,40.3,23783,22938,59,405,6241,44442,8962,6497,2465,8962,98700,2015
18145,41,44441,41258,562,1715,11608,53584,17193,12430,4763,17193,120800,2015
18147,42.7,20856,19905,124,553,5862,55247,7964,6547,1417,7964,116100,2015
18149,41.6,23117,21861,154,803,6179,42208,8789,7123,1666,8789,96900,2015
18151,41.7,34267,32318,87,1108,9375,48472,13485,10457,3028,13485,128800,2015
18153,40.8,21111,19479,951,353,5493,45023,7639,5589,2050,7639,78200,2015
18155,40.1,10500,10142,104,74,2972,44061,4071,2909,1162,4071,119100,2015
18157,27.9,180952,141842,7951,14360,37794,45932,67756,35766,31990,67756,135200,2015
18159,43.8,15573,14902,24,401,4500,51613,6394,4976,1418,6394,111500,2015
18161,42.1,7299,7026,12,53,1902,44277,2963,2132,831,2963,102500,2015
18163,37.8,181305,153326,16391,4415,45063,43046,74217,46954,27263,74217,115500,2015
18165,42.9,15860,15388,50,167,4143,43600,6538,4982,1556,6538,75000,2015
18167,36,108268,93234,6571,2699,24651,40313,40315,24497,15818,40315,91200,2015
18169,42.4,32358,30652,270,759,8852,45649,12901,9561,3340,12901,95100,2015
18171,44.1,8367,8110,47,106,2450,56042,3305,2662,643,3305,107200,2015
18173,40.6,60995,56912,943,1049,17002,62185,22883,18696,4187,22883,148400,2015
18175,40.7,27930,27079,29,382,7333,41289,10542,8088,2454,10542,102900,2015
18177,40.9,67866,60261,3191,1823,17781,38494,27168,18596,8572,27168,92200,2015
18179,41.2,27796,26532,155,684,7669,51101,10831,8791,2040,10831,115200,2015
18181,42,24388,22013,88,1831,6660,52154,9513,7361,2152,9513,105500,2015
18183,41,33330,31963,121,624,9545,54389,13152,10832,2320,13152,130400,2015
19001,45.9,7426,7217,27,114,2050,46526,3229,2484,745,3229,89600,2015
19003,46.8,3892,3775,27,31,1171,48043,1718,1254,464,1718,87800,2015
19005,45.1,14060,12939,99,765,3956,45890,6048,4681,1367,6048,110900,2015
19007,44.7,12669,12184,39,202,3343,41394,5481,3973,1508,5481,78200,2015
19009,47.8,5869,5721,9,49,1714,46979,2659,2191,468,2659,65000,2015
19011,41.4,25803,24974,181,338,7199,60606,10154,8248,1906,10154,140600,2015
19013,34.7,132496,110028,11920,5315,30984,48369,52410,35358,17052,52410,130200,2015
19015,41.3,26401,25081,235,612,6918,52985,10759,8114,2645,10759,119600,2015
19017,38.6,24539,23547,269,312,6451,62163,9365,7563,1802,9365,151600,2015
19019,38.4,20998,20294,79,296,5597,56150,8268,6576,1692,8268,126600,2015
19021,35.9,20507,13107,544,4992,5133,48195,7635,5263,2372,7635,103900,2015
19023,43.5,14966,14552,59,162,4304,52360,6207,4957,1250,6207,107400,2015
19025,46,9914,9419,134,168,2750,44921,4261,3274,987,4261,76100,2015
19027,42.3,20629,19750,314,434,5508,50559,8547,6382,2165,8547,113200,2015
19029,44.7,13590,13030,57,313,3812,43750,6080,4327,1753,6080,89500,2015
19031,42.1,18375,17668,72,317,5163,59047,7620,6084,1536,7620,134700,2015
19033,44.2,43481,39979,533,1839,11830,46122,19519,13867,5652,19519,115200,2015
19035,46.6,11853,11183,54,367,3261,48599,5334,3934,1400,5334,84200,2015
19037,44.1,12244,11778,49,278,3542,47040,5312,4146,1166,5312,103400,2015
19039,39.6,9280,8157,13,1056,2366,43327,3744,2612,1132,3744,91200,2015
19041,42.2,16537,15637,91,503,4544,50389,7146,5323,1823,7146,110500,2015
19043,45.4,17806,17158,166,326,5016,48007,7608,5966,1642,7608,106700,2015
19045,42.1,48365,44351,1324,1399,12893,50498,20067,14780,5287,20067,110100,2015
19047,38,17252,11924,166,4658,4449,48084,6355,4774,1581,6355,90200,2015
19049,34.7,74892,65231,824,4634,19877,76320,27593,21134,6459,27593,190700,2015
19051,38,8742,8507,18,105,2257,48888,3165,2510,655,3165,99900,2015
19053,37.4,8249,7679,139,225,2041,38560,3144,2108,1036,3144,81500,2015
19055,43.1,17507,17058,39,195,5002,58274,6973,5579,1394,6973,123300,2015
19057,42.1,40208,35549,2186,1158,10752,44423,16741,12336,4405,16741,98200,2015
19059,48.7,16967,16404,52,270,5162,57265,7804,5891,1913,7804,167800,2015
19061,38.8,95906,88302,1849,2066,24814,54605,37891,27445,10446,37891,149400,2015
19063,41.5,9917,8776,142,894,2594,47795,4145,3189,956,4145,84100,2015
19065,43.1,20589,19470,223,448,5454,44928,8556,6444,2112,8556,88200,2015
19067,43.6,16050,15029,319,359,4510,44797,6901,4967,1934,6901,98200,2015
19069,42.8,10489,9072,101,1207,2944,48605,4258,3159,1099,4258,85900,2015
19071,46.4,7106,6780,10,180,2028,53324,2954,2240,714,2954,100100,2015
19073,45.1,9174,8751,5,234,2663,46898,3927,2982,945,3927,85300,2015
19075,42.2,12407,12073,51,150,3564,56750,5183,4174,1009,5183,125700,2015
19077,45.9,10740,10319,81,228,3048,51013,4514,3634,880,4514,103700,2015
19079,42.4,15297,13868,102,823,4230,49813,6384,4465,1919,6384,93600,2015
19081,44,11092,10445,72,408,3084,52981,4673,3744,929,4673,91600,2015
19083,44.7,17393,16171,163,685,4393,51019,6973,5267,1706,6973,88700,2015
19085,43.8,14467,14005,8,199,3934,53567,5973,4477,1496,5973,106400,2015
19087,40.7,20080,17852,458,892,5126,49321,7623,5555,2068,7623,103900,2015
19089,42.2,9494,9188,31,141,2430,49869,3867,3077,790,3867,94600,2015
19091,43.7,9674,9140,13,362,2798,47252,4190,3027,1163,4190,89800,2015
19093,45.1,7071,6802,38,137,2072,46993,3101,2332,769,3101,80300,2015
19095,42.4,16344,15689,137,367,4845,59375,6819,5322,1497,6819,138700,2015
19097,44.5,19572,18796,35,262,5698,49028,8433,6324,2109,8433,114300,2015
19099,42.2,36726,34838,542,640,9760,55033,14437,10543,3894,14437,117700,2015
19101,42.5,17318,14249,246,526,4145,42899,6913,4598,2315,6913,101000,2015
19103,29.8,139436,113069,7512,7299,30571,55700,55426,32973,22453,55426,193600,2015
19105,43.2,20560,19496,379,329,5684,55060,8171,6389,1782,8171,129300,2015
19107,44.3,10291,9985,0,147,2785,43838,4347,3375,972,4347,77100,2015
19109,46.1,15280,14688,56,280,4339,51496,6723,5289,1434,6723,92300,2015
19111,42.9,35369,32202,1058,1173,9266,43312,14412,10723,3689,14412,85400,2015
19113,37.1,216640,191139,8916,6256,54653,59322,87318,64274,23044,87318,147400,2015
19115,40.8,11271,8996,87,1817,3045,51144,4311,3354,957,4311,99900,2015
19117,45.4,8731,8505,20,30,2356,43962,3678,2915,763,3678,82400,2015
19119,38.4,11723,11290,7,288,3237,57130,4496,3722,774,4496,111100,2015
19121,40.5,15644,15101,76,226,4215,60060,6225,4660,1565,6225,160200,2015
19123,39.8,22396,21131,301,420,5839,48726,9023,6340,2683,9023,106200,2015
19125,39.2,33248,31604,179,587,8860,54693,12978,9610,3368,12978,137300,2015
19127,38.9,40962,30552,674,7899,10494,53351,15297,11086,4211,15297,104500,2015
19129,41.9,14862,14108,107,394,3991,63979,5399,4319,1080,5399,153100,2015
19131,43.7,10762,10516,15,136,2925,49488,4358,3646,712,4358,108700,2015
19133,47,9088,8682,49,149,2418,40302,4043,2885,1158,4043,79400,2015
19135,43.2,8002,7572,11,69,2146,46304,3326,2482,844,3326,96300,2015
19137,45.1,10465,9904,0,348,3130,42418,4610,3166,1444,4610,78700,2015
19139,38.2,42913,33862,631,7260,11423,53676,16345,12086,4259,16345,126900,2015
19141,44,14092,13185,72,592,3917,55227,6004,4440,1564,6004,102700,2015
19143,44.5,6211,5693,25,405,1734,49448,2670,2091,579,2670,83600,2015
19145,43.5,15660,14398,331,448,3971,43912,6294,4681,1613,6294,82500,2015
19147,42.9,9208,8796,116,185,2527,47113,3977,2958,1019,3977,85300,2015
19149,41.8,24853,23382,126,923,6954,57130,9995,7913,2082,9995,138300,2015
19151,47.3,7127,6731,88,232,1900,45069,3197,2471,726,3197,64700,2015
19153,35,452369,359506,27634,35936,114317,60061,177049,119646,57403,177049,157200,2015
19155,39.2,93213,82913,1169,6573,24448,51976,36683,25441,11242,36683,125800,2015
19157,40.9,18705,17308,200,543,4633,51006,7351,5235,2116,7351,128700,2015
19159,46.3,5061,4882,12,68,1331,47042,2030,1574,456,2030,77600,2015
19161,46.1,10101,9676,58,260,2839,49572,4406,3529,877,4406,81200,2015
19163,37.6,169994,138658,12985,10394,42662,55114,67709,46076,21633,67709,148200,2015
19165,46.6,11992,11479,23,290,3144,50952,5066,4015,1051,5066,108800,2015
19167,33.3,34509,30457,150,3309,8845,61627,11765,9285,2480,11765,140900,2015
19169,25.9,93586,80101,2134,2899,18895,50438,35901,19186,16715,35901,166000,2015
19171,43,17479,14546,89,1401,4845,55203,6790,5230,1560,6790,103000,2015
19173,43.7,6213,5658,13,464,1856,44246,2744,1968,776,2744,70400,2015
19175,40.6,12575,11951,124,310,3254,44351,5337,3799,1538,5337,87200,2015
19177,43.9,7432,7217,23,92,2053,45111,2944,2521,423,2944,76300,2015
19179,39.8,35315,30219,714,3499,9458,42095,14493,10603,3890,14493,80400,2015
19181,38.4,47542,45200,228,1109,13193,64447,18009,13873,4136,18009,159900,2015
19183,41.5,22017,20259,160,1210,5956,56390,8938,6426,2512,8938,122100,2015
19185,44.5,6384,6172,30,63,1662,43358,2596,2110,486,2596,70600,2015
19187,39.7,37295,33145,1500,1571,9114,42408,15155,10257,4898,15155,85900,2015
19189,43.2,10614,9879,98,403,2902,47668,4580,3453,1127,4580,94100,2015
19191,40.6,20884,19897,198,436,5439,54429,8248,6349,1899,8248,157800,2015
19193,35.4,102530,77797,2847,15385,25533,46720,38656,26098,12558,38656,99600,2015
19195,44.8,7563,7219,73,193,2153,48459,3180,2492,688,3180,96400,2015
19197,44.6,12936,11390,49,1289,3390,43698,5495,4140,1355,5495,73400,2015
20001,41.2,13081,11928,223,402,3294,38698,5306,3848,1458,5306,68200,2015
20003,41.7,7896,7498,9,35,2160,40696,3280,2473,807,3280,90400,2015
20005,35.9,16633,14678,681,474,3784,43581,6033,4363,1670,6033,88100,2015
20007,44.9,4770,4438,16,160,1300,51811,1981,1448,533,1981,78100,2015
20009,39.3,27399,22625,353,3837,7381,44013,11306,7624,3682,11306,81200,2015
20011,37.3,14812,13476,513,344,3827,38280,5660,3901,1759,5660,81400,2015
20013,42.5,9880,8285,154,366,2638,43724,4102,2809,1293,4102,84600,2015
20015,37.8,66092,59473,1308,2881,17327,58897,24273,17758,6515,24273,134500,2015
20017,46.2,2722,2517,24,107,659,38707,1110,825,285,1110,76600,2015
20019,49.1,3520,3080,20,58,1039,37993,1557,1228,329,1557,48500,2015
20021,41.4,20952,18608,112,471,5779,41388,7988,6043,1945,7988,72500,2015
20023,49.6,2682,2438,0,174,788,44500,1262,1009,253,1262,82800,2015
20025,44.4,2145,1743,22,260,598,42589,927,650,277,927,62200,2015
20027,42.2,8421,7979,49,214,2411,52066,3377,2749,628,3377,96500,2015
20029,42.3,9339,8743,40,304,2408,39282,3964,2853,1111,3964,69000,2015
20031,44.1,8458,7951,66,206,2433,57433,3569,2707,862,3569,102000,2015
20033,45.7,2010,1903,0,86,531,45288,784,604,180,784,61800,2015
20035,38.2,36079,29202,1008,3612,9131,43860,13688,9245,4443,13688,83200,2015
20037,32.6,39304,34537,818,1981,8729,36534,15065,9203,5862,15065,85900,2015
20039,52.3,2905,2774,12,77,771,40657,1473,1126,347,1473,55900,2015
20041,41.7,19516,17890,99,862,5352,49096,7822,5712,2110,7822,108200,2015
20043,38.8,7859,7093,290,202,2144,47209,3109,2241,868,3109,86900,2015
20045,28.8,114967,92110,4406,6529,23794,50939,43729,22806,20923,43729,179800,2015
20047,45.2,2991,2333,26,586,837,47303,1274,961,313,1274,56400,2015
20049,50.4,2683,2456,21,102,777,36458,1256,987,269,1256,49200,2015
20051,32.2,28993,26233,329,1590,6509,45579,11847,7531,4316,11847,150200,2015
20053,44.2,6410,5562,243,371,1603,47736,2585,1960,625,2585,81400,2015
20055,30.4,37133,16437,779,17804,9186,49227,12600,7830,4770,12600,117000,2015
20057,30.9,34714,14517,803,18319,8262,50777,11205,6859,4346,11205,99500,2015
20059,39,25753,23478,303,1005,6929,51081,9830,7058,2772,9830,122900,2015
20061,26.2,36787,21672,5948,5296,8823,43992,12723,5442,7281,12723,136000,2015
20063,47.4,2735,2600,27,58,836,46364,1190,932,258,1190,76300,2015
20065,49.8,2593,2313,80,76,751,43826,1201,957,244,1201,68600,2015
20067,32.8,7816,4150,1,3579,2047,55432,2707,2102,605,2707,99400,2015
20069,36.1,6065,5139,0,891,1642,61000,2150,1566,584,2150,107900,2015
20071,49.4,1224,901,11,278,353,47750,487,348,139,487,84500,2015
20073,48,6393,5912,10,240,1788,38838,2824,2185,639,2824,57200,2015
20075,38,2586,1672,0,871,718,45114,998,719,279,998,86600,2015
20077,43,5861,5304,5,377,1520,43973,2433,1854,579,2433,66900,2015
20079,38.6,34835,29173,540,3951,9363,51327,13581,9486,4095,13581,115800,2015
20081,36.1,4130,2847,0,1179,1067,56484,1395,1010,385,1395,116000,2015
20083,47.8,1939,1726,0,142,576,54856,811,596,215,811,82900,2015
20085,40.8,13400,11344,90,581,3816,54077,5281,3974,1307,5281,119400,2015
20087,43.5,18898,17809,90,447,5405,57236,7542,6182,1360,7542,127100,2015
20089,52.1,3038,2904,2,71,920,40553,1433,1150,283,1433,53100,2015
20091,36.8,566814,459104,25107,41482,149562,76113,219735,152762,66973,219735,215600,2015
20093,34.8,3952,2615,34,1184,1073,50506,1379,1031,348,1379,94100,2015
20095,45.2,7790,7340,11,237,2055,50844,3006,2205,801,3006,88000,2015
20097,41.7,2536,2294,17,144,682,43963,1066,693,373,1066,121300,2015
20099,40.6,21048,17945,707,901,5769,41439,8413,5833,2580,8413,70200,2015
20101,44.6,1674,1547,6,102,457,56507,805,614,191,805,66200,2015
20103,37.3,78227,62071,6513,5164,19130,63726,26747,17772,8975,26747,167500,2015
20105,46.2,3154,2999,26,79,812,44276,1335,1055,280,1335,66900,2015
20107,43.7,9528,8993,63,211,2837,46964,4182,3257,925,4182,90300,2015
20109,42.2,2793,2548,0,127,751,46875,1243,880,363,1243,79200,2015
20111,32.5,33462,24163,766,6831,8118,40021,13272,7929,5343,13272,93400,2015
20113,42,29252,26964,294,1138,7905,56128,11791,8959,2832,11791,132900,2015
20115,45,12290,11500,100,358,3289,45927,4808,3817,991,4808,81600,2015
20117,45,10005,9532,29,226,2887,45374,4322,3196,1126,4322,86700,2015
20119,39.8,4383,3620,28,633,1283,52250,1694,1203,491,1694,86500,2015
20121,40.4,32688,30429,435,961,8819,60966,12560,9718,2842,12560,167400,2015
20123,44.4,6296,6057,23,118,1714,48217,2687,1950,737,2687,89000,2015
20125,39.4,34184,27469,1734,2038,8642,41083,13435,9339,4096,13435,70600,2015
20127,47.6,5750,5335,7,248,1640,47089,2406,1846,560,2406,85200,2015
20129,41.6,3106,2304,29,638,828,46028,1189,835,354,1189,99400,2015
20131,41.6,10159,9739,89,160,2804,48653,4239,3254,985,4239,109900,2015
20133,40,16423,14894,162,805,4432,43195,6463,4615,1848,6463,69800,2015
20135,49.2,3077,2746,16,283,927,44904,1383,1084,299,1383,67100,2015
20137,44,5590,5019,137,278,1464,47852,2119,1644,475,2119,72900,2015
20139,42.6,16080,15164,24,415,4436,49915,6505,4910,1595,6505,98300,2015
20141,48.5,3782,3638,15,61,1055,40216,1764,1322,442,1764,57400,2015
20143,42.2,6048,5720,16,163,1717,52479,2493,2064,429,2493,92600,2015
20145,43.1,6911,5866,335,524,1449,43250,2552,1773,779,2552,77400,2015
20147,44.7,5501,5207,21,151,1559,44170,2349,1808,541,2349,72700,2015
20149,34.7,22625,20361,279,1164,5864,60216,8192,6395,1797,8192,160700,2015
20151,39.1,9739,8719,70,646,2555,49550,3902,2687,1215,3902,85900,2015
20153,50.9,2545,2371,9,117,726,41579,1212,868,344,1212,75600,2015
20155,39.5,64058,54577,1842,5607,16342,45288,25097,16855,8242,25097,94100,2015
20157,50.9,4806,4649,7,68,1297,40449,2275,1785,490,2275,48900,2015
20159,37.9,10014,8450,170,1088,2593,48460,3881,2911,970,3881,75300,2015
20161,24.7,75022,58247,4744,5844,14170,44437,26467,11050,15417,26467,181200,2015
20163,43.9,5186,4937,12,127,1400,43558,2206,1649,557,2206,67900,2015
20165,48.8,3184,3033,0,94,872,38854,1486,1168,318,1486,62100,2015
20167,47.1,6988,6539,87,171,2077,41102,3239,2428,811,3239,81000,2015
20169,37.7,55735,45070,1745,5873,14187,47801,22390,14704,7686,22390,122200,2015
20171,42,4928,4017,0,815,1379,51850,2196,1583,613,2196,126000,2015
20173,34.6,506529,349955,45738,69308,124645,50657,192961,123624,69337,192961,126500,2015
20175,29.4,23274,7852,819,13575,5423,47134,7480,5060,2420,7480,87100,2015
20177,38.8,178792,133760,13206,20577,44654,50378,71368,45873,25495,71368,122200,2015
20179,45.7,2531,2389,2,93,752,49750,1133,887,246,1133,91400,2015
20181,38.4,6054,5135,87,730,1594,39029,2786,1620,1166,2786,77000,2015
20183,50.7,3740,3581,16,72,1055,43848,1667,1338,329,1667,64000,2015
20185,43.7,4320,3641,42,558,1224,47377,1794,1503,291,1794,65100,2015
20187,35.7,2149,1299,22,762,574,43780,820,640,180,820,73800,2015
20189,34.9,5772,3637,32,1985,1581,55433,2007,1504,503,2007,96400,2015
20191,40.8,23638,21355,205,1230,6143,50141,9091,7057,2034,9091,83900,2015
20193,35.3,7925,7252,143,427,2032,48504,3174,2211,963,3174,105100,2015
20195,49.1,2951,2808,8,64,894,54000,1302,1004,298,1302,86900,2015
20197,42.1,6997,6553,16,225,1864,54688,2668,2293,375,2668,115300,2015
20199,41.8,1595,1545,0,48,393,47279,625,475,150,625,76300,2015
20201,46.3,5686,5372,43,186,1656,45159,2442,1961,481,2442,68800,2015
20203,35.7,2204,1509,0,646,574,57171,781,564,217,781,70600,2015
20205,43.8,9061,8417,14,250,2496,40306,3769,2808,961,3769,60100,2015
20207,47.4,3211,3019,17,84,907,35787,1531,1218,313,1531,48300,2015
20209,33.3,160806,68467,38408,43668,37443,40113,58870,34559,24311,58870,89200,2015
21001,41,18852,17673,516,346,4707,33362,7048,5189,1859,7048,82400,2015
21003,40.3,20355,19451,276,369,5507,41326,7774,5665,2109,7774,95500,2015
21005,39.9,21761,20544,507,326,6015,53974,8446,6501,1945,8446,136800,2015
21007,42.8,8256,7714,279,101,2180,42244,3288,2678,610,3288,101800,2015
21009,40.4,42925,39017,1758,1238,11755,38370,16979,11454,5525,16979,105800,2015
21011,40.4,11978,11466,196,166,2950,33483,4297,3205,1092,4297,73500,2015
21013,41.1,27950,26442,897,130,7049,22443,11088,7341,3747,11088,60400,2015
21015,36.2,124617,110662,3667,4858,33557,66730,44709,32785,11924,44709,175100,2015
21017,41.1,20013,17025,1427,1379,5281,45208,7867,4866,3001,7867,139600,2015
21019,41.9,48917,45759,1313,747,13170,42319,19383,13615,5768,19383,99700,2015
21021,41,29388,25383,2026,899,7107,39704,11045,7235,3810,11045,132500,2015
21023,41,8425,8291,2,121,2147,36327,3303,2517,786,3303,95800,2015
21025,40.7,13591,13229,66,63,3688,25817,5494,4051,1443,5494,47500,2015
21027,42.5,20061,19016,466,240,5212,43479,7297,5784,1513,7297,88000,2015
21029,39.3,76961,73319,361,1255,21024,55975,28267,22946,5321,28267,144700,2015
21031,41.2,12835,12274,87,447,3568,33536,5176,3799,1377,5176,90800,2015
21033,42.6,12826,11718,747,182,3665,42537,5293,3767,1526,5293,96700,2015
21035,33.7,38106,34153,1489,954,8561,37034,14834,9355,5479,14834,119900,2015
21037,37.3,91475,84635,2926,1636,22485,54621,35477,24368,11109,35477,150400,2015
21039,42.3,4984,4718,78,110,1405,38829,2059,1630,429,2059,77200,2015
21041,36.9,10830,9626,259,736,2518,41439,3988,2424,1564,3988,99200,2015
21043,40.1,27326,26433,224,341,7267,36696,10487,8182,2305,10487,77100,2015
21045,42.1,15954,15196,127,437,4420,32341,6384,5088,1296,6384,76500,2015
21047,28.5,74159,50023,14316,5251,18035,39521,25521,12178,13343,25521,108500,2015
21049,41.7,35657,32246,1872,990,9634,47959,14173,9094,5079,14173,142700,2015
21051,39.1,21300,19752,817,374,5377,21549,7707,5713,1994,7707,56300,2015
21053,40.7,10188,9810,58,270,2571,28025,3858,2892,966,3858,65300,2015
21055,43,9222,8922,113,64,2506,35316,3755,2927,828,3755,76000,2015
21057,44.8,6807,6445,202,11,1918,32019,2743,1969,774,2743,63500,2015
21059,39.1,98173,87770,4411,2683,26028,45989,38536,26615,11921,38536,115400,2015
21061,42.5,12105,11603,178,194,3351,41710,4659,3800,859,4659,88800,2015
21063,41.7,7725,7467,189,45,1967,28224,2750,2179,571,2750,66100,2015
21065,42.7,14476,14172,20,9,4004,29770,5750,4011,1739,5750,71400,2015
21067,34.1,308306,223356,44155,21138,72466,49778,125752,68194,57558,125752,168100,2015
21069,40.4,14544,13990,201,177,3982,35469,5636,4258,1378,5636,86700,2015
21071,40.5,38649,37648,311,266,10642,30096,15418,10754,4664,15418,70600,2015
21073,40.7,49778,40906,5160,1452,12780,47964,21033,13241,7792,21033,137500,2015
21075,42.8,6422,4589,1598,94,1595,28359,2568,1543,1025,2568,61000,2015
21077,37.8,8567,7841,96,432,2099,48370,3097,2130,967,3097,107500,2015
21079,41.8,16976,15997,216,394,5080,44243,6594,5054,1540,6594,128500,2015
21081,36.7,24670,23247,78,609,6340,44824,8325,5864,2461,8325,124900,2015
21083,40.3,37502,32700,1866,2228,9881,39530,14390,10686,3704,14390,92900,2015
21085,39.7,26001,24838,300,315,6910,35030,9840,7109,2731,9840,95500,2015
21087,44.2,11149,10547,339,22,3088,34982,4477,3550,927,4477,74200,2015
21089,42.9,36477,35144,281,369,10271,45370,14200,10972,3228,14200,97700,2015
21091,41.6,8669,8320,83,123,2476,50476,3265,2512,753,3265,104200,2015
21093,35.7,107529,82235,12090,5976,27966,50765,40376,25215,15161,40376,143100,2015
21095,41,28400,27046,685,240,7903,25814,11406,7960,3446,11406,52000,2015
21097,41.9,18648,17499,395,394,4650,35681,7120,4791,2329,7120,113000,2015
21099,40.9,18441,16961,868,296,5233,34774,7294,5273,2021,7294,83600,2015
21101,40.1,46396,40372,3304,1014,12505,41036,18742,11863,6879,18742,105500,2015
21103,41.3,15455,14194,539,496,4312,46495,5992,4195,1797,5992,121300,2015
21105,47.7,4720,4135,430,45,1270,41218,1973,1470,503,1973,68400,2015
21107,40.8,46518,41386,2765,837,12659,42346,18622,13324,5298,18622,89500,2015
21109,39.8,13357,13300,6,16,4173,29826,5546,4239,1307,5546,65900,2015
21111,37.9,755809,525430,154852,35322,185758,48695,306915,189914,117001,306915,150400,2015
21113,37.4,50328,45519,1800,1445,13913,50558,18312,11676,6636,18312,160400,2015
21115,40.9,23350,22805,97,114,6376,35570,9035,6766,2269,9035,79200,2015
21117,36.4,163007,145329,7341,4737,40301,54296,62225,40956,21269,62225,145200,2015
21119,40.8,16000,15601,131,123,4122,30411,5984,4643,1341,5984,57900,2015
21121,39.2,31809,30609,364,340,8138,26599,12467,7802,4665,12467,78400,2015
21123,40.6,14149,13009,495,425,3744,38578,5328,3895,1433,5328,110100,2015
21125,38.5,59751,57331,516,841,16195,36020,23164,16096,7068,23164,94400,2015
21127,40.3,15821,15468,24,106,4400,35935,6033,4706,1327,6033,81400,2015
21129,41.9,7119,6867,67,54,1653,22698,2859,2182,677,2859,67700,2015
21131,42,10997,10840,75,49,2873,25872,4150,3199,951,4150,45500,2015
21133,41.6,23671,23175,45,165,6694,30333,9592,7112,2480,9592,56300,2015
21135,40.8,13790,13521,36,92,3876,28630,5373,4115,1258,5373,67100,2015
21137,40.3,24498,23130,657,384,7154,37139,9770,7189,2581,9770,93600,2015
21139,45.9,9394,9043,16,140,2769,42171,3826,3031,795,3826,86900,2015
21141,40.5,26851,23792,1722,728,7217,38570,10870,7359,3511,10870,94600,2015
21143,49,8402,7663,517,61,1959,46931,3230,2644,586,3230,141000,2015
21145,42.5,65408,54765,7039,1492,17027,44067,27514,18511,9003,27514,124400,2015
21147,38.8,18001,16181,1006,402,4544,19328,6277,4354,1923,6277,62300,2015
21149,41.8,9500,9166,42,126,2709,40770,3759,3027,732,3759,91700,2015
21151,33.9,85838,77335,3816,1933,20290,42390,32064,18991,13073,32064,144800,2015
21153,41,12979,12914,11,45,3481,28500,4996,3628,1368,4996,53100,2015
21155,38.8,19717,17203,1685,501,4906,38826,7395,5504,1891,7395,98200,2015
21157,44.9,31181,30252,130,395,8925,45212,12602,9813,2789,12602,111600,2015
21159,38.1,12631,11766,597,191,3105,25795,4320,3086,1234,4320,68200,2015
21161,41.1,17296,15490,1177,65,4758,38824,6736,4510,2226,6736,101100,2015
21163,36.7,29098,25879,1081,1132,8007,49884,10574,7563,3011,10574,126100,2015
21165,41.6,6343,6095,26,144,1729,31503,2427,1878,549,2427,78100,2015
21167,42.6,21342,19547,804,519,6177,42083,8824,6296,2528,8824,133600,2015
21169,43.4,9985,9380,110,150,2691,32294,3936,3039,897,3936,82600,2015
21171,42.7,10765,10078,276,320,2958,31045,4443,3232,1211,4443,70600,2015
21173,38.8,27167,25303,797,687,6852,39275,10248,6616,3632,10248,114000,2015
21175,40.7,13428,12569,434,140,3545,29707,4808,3578,1230,4808,75500,2015
21177,41.5,31309,28924,1642,154,8335,38961,11539,9173,2366,11539,77800,2015
21179,37.9,44564,40407,2322,925,12610,49298,16817,12796,4021,16817,133600,2015
21181,41.8,7075,6820,104,50,1930,36097,2824,2015,809,2824,83900,2015
21183,40.2,24065,22658,328,890,6466,40189,8813,6863,1950,8813,83700,2015
21185,39.6,63037,55821,2613,2405,16005,85452,19706,16912,2794,19706,247500,2015
21187,41.7,10711,10201,170,264,2876,41934,4123,3114,1009,4123,98000,2015
21189,43,4616,4411,50,24,1192,20985,1773,1338,435,1773,69800,2015
21191,41.5,14514,14095,83,159,3760,48353,5356,4150,1206,5356,104800,2015
21193,41.4,28041,26879,402,170,7809,32667,11080,7981,3099,11080,71200,2015
21195,41.1,63434,61664,558,493,17898,33183,26124,19063,7061,26124,70400,2015
21197,38.4,12447,12051,51,159,3057,29736,4767,3326,1441,4767,76600,2015
21199,42,63635,60113,589,1443,17282,34790,25593,17669,7924,25593,106800,2015
21201,46.7,2208,2188,0,0,617,31741,930,735,195,930,104000,2015
21203,41.8,16942,16545,33,103,4648,31555,6621,5016,1605,6621,73900,2015
21205,32.2,23608,22265,402,273,5171,36860,8542,5302,3240,8542,115300,2015
21207,42.9,17669,16652,49,625,4495,30720,7050,5177,1873,7050,88000,2015
21209,35.8,50178,43834,2596,2136,13574,63027,18421,13019,5402,18421,164600,2015
21211,38.7,44290,35714,3164,3909,11823,60324,15888,10979,4909,15888,175700,2015
21213,39.6,17704,15113,1830,352,4576,39679,6793,4271,2522,6793,116800,2015
21215,40.5,17577,16631,235,320,5175,63000,6418,5320,1098,6418,176900,2015
21217,39.2,24993,22597,1002,514,6360,33340,9715,6357,3358,9715,93700,2015
21219,36.9,12524,10692,1053,504,3284,40497,4567,3287,1280,4567,87300,2015
21221,45.1,14250,12578,1253,235,4186,44083,6014,4946,1068,6014,114100,2015
21223,41.1,8783,8470,0,263,2432,47409,3548,2686,862,3548,112000,2015
21225,37.1,15138,12561,1959,273,3722,40120,5562,4015,1547,5562,84100,2015
21227,32.8,118950,95831,11128,5842,29513,44911,45387,26135,19252,45387,141500,2015
21229,41.5,11910,10511,704,440,3170,40976,4495,3529,966,4495,98100,2015
21231,42,20655,19389,434,604,5200,28573,7917,5592,2325,7917,80300,2015
21233,39.7,13357,11915,593,608,3630,38917,5129,3626,1503,5129,74600,2015
21235,37.1,35794,34385,324,371,9572,31014,13110,8733,4377,13110,77900,2015
21237,41.8,7261,7140,26,35,1804,20504,2918,1934,984,2918,52700,2015
21239,41.9,25317,21839,1186,1665,6790,58750,9802,6762,3040,9802,181300,2015
22001,35.7,62163,48303,10829,1285,15229,37649,22599,15958,6641,22599,91000,2015
22003,38.5,25653,18092,5101,1011,5201,40948,8027,5983,2044,8027,81100,2015
22005,34.8,114738,80048,25031,5732,30401,70551,40110,32259,7851,40110,168600,2015
22007,39.3,23057,15273,6885,544,6108,49167,8660,6950,1710,8660,107300,2015
22009,38.2,41389,27230,12323,705,10029,33739,14943,10443,4500,14943,89500,2015
22011,37.5,36259,28870,4732,1263,9662,45969,13152,10050,3102,13152,104100,2015
22013,42.3,13977,7636,5854,223,3748,32876,5814,4114,1700,5814,69600,2015
22015,34.7,123403,84261,26120,7840,31263,52892,47125,30678,16447,47125,154100,2015
22017,36.6,254742,118726,121521,6881,61376,41234,97991,60059,37932,97991,128100,2015
22019,36.1,195887,134615,48319,5736,50663,45312,75325,51678,23647,75325,124600,2015
22021,39.9,9990,7875,1743,266,2496,33294,3838,2870,968,3838,64400,2015
22023,42.6,6706,6186,206,282,2008,64231,2608,2369,239,2608,97400,2015
22025,38.5,10247,6743,3292,112,2649,34904,3748,2793,955,3748,71100,2015
22027,42.2,16639,7688,8324,228,3792,32072,5852,4082,1770,5852,73700,2015
22029,38.3,20449,11664,8406,239,5242,29654,7896,4711,3185,7896,77400,2015
22031,39.8,26965,15430,10158,727,6942,41468,10244,7566,2678,10244,98400,2015
22033,33.2,444690,204045,201634,17142,103091,49285,169120,100963,68157,169120,170500,2015
22035,33.3,7501,2108,5229,99,1679,21099,2678,1278,1400,2678,49300,2015
22037,41.8,19855,10489,8885,255,4985,45520,6937,5660,1277,6937,127100,2015
22039,35.8,33768,22801,9366,958,8107,30009,11954,7895,4059,11954,83900,2015
22041,37.9,20550,13536,6724,78,4893,30275,7469,5258,2211,7469,79300,2015
22043,37.6,22362,17082,3146,1395,4796,39914,7197,5323,1874,7197,83200,2015
22045,35.8,73938,44168,23221,2761,18918,45261,26345,18573,7772,26345,99600,2015
22047,38.4,33229,15899,15952,790,7647,45117,11191,8354,2837,11191,112700,2015
22049,39.6,16109,10714,4860,247,4302,38029,6038,4110,1928,6038,77200,2015
22051,38.7,435092,236758,112504,58988,106320,47947,168104,103991,64113,168104,172700,2015
22053,38.4,31434,24574,5376,658,7979,39063,11652,8622,3030,11652,91900,2015
22055,34,231811,154441,59075,9996,55584,51869,88995,57277,31718,88995,166700,2015
22057,36.6,97474,75082,12989,4153,25155,51030,35592,26975,8617,35592,133200,2015
22059,38.6,14899,12403,1671,581,3988,37310,5551,4347,1204,5551,70300,2015
22061,27.4,47349,25227,19131,1277,10110,33467,17169,9232,7937,17169,126100,2015
22063,35.3,133949,118839,8204,4452,35015,58251,47608,38124,9484,47608,152600,2015
22065,34.6,11873,4171,7358,208,2537,23854,4060,2146,1914,4060,61700,2015
22067,39.3,27012,13461,12774,322,6578,28003,10447,6852,3595,10447,80600,2015
22069,33.8,39330,21003,15921,815,8889,31345,14456,8391,6065,14456,101900,2015
22071,35.4,376738,116141,222313,20601,76586,36792,153140,70843,82297,153140,192400,2015
22073,34.7,155769,91475,57939,3209,37615,37754,57690,34429,23261,57690,123300,2015
22075,36.5,23599,15692,4884,1418,6321,50314,8614,5941,2673,8614,155300,2015
22077,42.6,22498,13550,8077,540,5815,43825,8726,6713,2013,8726,115800,2015
22079,37.4,132225,81538,42202,3704,31802,40734,47674,30052,17622,47674,125800,2015
22081,39.8,8838,5110,3446,130,2219,38000,3434,2569,865,3434,83000,2015
22083,38,20777,12676,7492,422,5494,36421,7619,5055,2564,7619,82500,2015
22085,41.5,24248,16597,4039,905,6193,38828,9171,7049,2122,9171,79900,2015
22087,33,42858,27818,9091,4133,10186,42753,14545,9810,4735,14545,130000,2015
22089,37.2,52639,34590,13759,2971,13541,59990,18383,14886,3497,18383,184300,2015
22091,39.2,10818,4805,5699,16,2785,35437,4131,3516,615,4131,78400,2015
22093,38.8,21650,10364,10835,333,5881,51107,7964,6289,1675,7964,129200,2015
22095,36,44161,16788,23942,2333,11392,50921,15332,11682,3650,15332,150000,2015
22097,36.6,83613,46104,34148,1549,20562,32625,30683,21374,9309,30683,90800,2015
22099,36.7,53126,34383,15718,1311,13651,42794,19055,14952,4103,19055,101700,2015
22101,37.7,53441,30219,16599,3291,13568,40781,20320,13607,6713,20320,92900,2015
22103,39.8,242960,193148,28314,12583,65326,62137,89036,68611,20425,89036,197100,2015
22105,34.4,125486,80213,37144,4785,30976,41302,45483,30751,14732,45483,137500,2015
22107,43,4893,2041,2746,82,1100,22940,1915,1166,749,1915,54200,2015
22109,35.2,112742,76512,20770,5230,28014,47826,40086,28736,11350,40086,137000,2015
22111,41.7,22533,15354,5821,974,5841,34992,8517,6826,1691,8517,88000,2015
22113,36.7,59110,46553,8328,1772,15024,45374,21796,16398,5398,21796,98100,2015
22115,30,52476,36979,7293,4713,12912,46312,17842,9547,8295,17842,98000,2015
22117,39.2,46556,30680,14027,954,11781,30705,17604,12740,4864,17604,79600,2015
22119,40.9,40617,25436,13784,725,9983,33681,15765,11176,4589,15765,81800,2015
22121,35.4,24669,14181,9296,678,6515,53703,9179,6471,2708,9179,162500,2015
22123,39.7,11454,9120,1910,332,2942,31926,4296,2961,1335,4296,66800,2015
22125,40.4,15415,7972,7041,232,2900,56685,3911,2974,937,3911,188200,2015
22127,41.3,14855,9703,4838,88,3925,31087,5513,3651,1862,5513,73100,2015
23001,40.6,107393,98220,1413,1827,27791,47537,44636,28372,16264,44636,151100,2015
23003,46.6,70005,66253,505,767,19247,36923,30355,21450,8905,30355,94800,2015
23005,41.9,286119,260732,7297,5450,72020,60051,117135,79075,38060,117135,243800,2015
23007,44.9,30402,29221,134,379,7629,42811,11841,9456,2385,11841,129600,2015
23009,47.4,54658,52147,263,715,14686,47030,24371,17788,6583,24371,198300,2015
23011,44,121112,115191,934,1684,32199,46917,51443,36158,15285,51443,150600,2015
23013,47.2,39723,38106,258,462,10652,50693,16999,12995,4004,16999,197000,2015
23015,49.8,34156,32924,39,323,9418,50462,14876,11822,3054,14876,204100,2015
23017,45.7,57421,55035,227,652,14209,40630,21767,17225,4542,21767,135500,2015
23019,41.3,153437,144593,1250,1841,38306,44271,61973,41889,20084,61973,137400,2015
23021,49.8,17156,16426,57,211,4814,37495,7529,5618,1911,7529,109700,2015
23023,45.2,35092,33277,249,525,9743,53298,15405,11625,3780,15405,189300,2015
23025,44.9,51577,49580,168,506,14063,40066,21800,16701,5099,21800,107300,2015
23027,45,38976,37443,171,447,10795,44082,16888,13094,3794,16888,157800,2015
23029,46.8,32191,29128,169,553,8813,38083,14139,10638,3501,14139,106900,2015
23031,44.1,199682,189532,1339,3105,53194,57919,82127,60089,22038,82127,229600,2015
24001,41.5,73549,64455,5778,1184,17232,40551,28324,19481,8843,28324,120800,2015
24003,38.4,555280,392444,86074,38114,141164,89860,203336,150384,52952,203336,334100,2015
24005,39.1,822959,495942,219731,39642,203679,67095,312900,207389,105511,312900,246600,2015
24009,40.6,90114,71415,11334,2982,23245,95828,31155,25432,5723,31155,341800,2015
24011,40.1,32661,25218,4449,1985,8423,52465,11920,8402,3518,11920,193300,2015
24013,42.2,167444,151303,5296,4864,44768,85385,60004,49208,10796,60004,321300,2015
24015,40.1,101960,87838,6743,3984,26327,66396,36728,27019,9709,36728,242900,2015
24017,37.7,152754,69387,63812,7651,38911,90607,53171,41321,11850,53171,284500,2015
24019,43.8,32534,21082,9027,1413,8876,47093,13265,8698,4567,13265,187700,2015
24021,39.1,241373,183419,21085,19549,63500,83700,88494,65427,23067,88494,300100,2015
24023,44.5,29813,28844,180,279,8269,45432,11863,8848,3015,11863,165300,2015
24025,40.1,248966,193288,32164,9959,66987,80465,91727,72081,19646,91727,278500,2015
24027,38.8,304115,170615,54027,19032,80937,110238,108555,79666,28889,108555,429100,2015
24029,46.2,19923,15620,3009,858,4787,58147,7624,5478,2146,7624,247200,2015
24031,38.5,1017859,474107,174395,186225,253531,99435,365235,241654,123581,365235,454700,2015
24033,35.8,892816,127687,558578,144996,201936,74260,305610,189462,116148,305610,254700,2015
24035,43.5,48600,42200,3584,1639,13207,85963,17522,14682,2840,17522,339900,2015
24037,36.3,109614,82878,15428,4939,27741,86987,38243,27650,10593,38243,297200,2015
24039,37,25980,13429,10743,925,4994,35154,8385,5430,2955,8385,149600,2015
24041,49,37799,29553,4440,2256,10965,58228,16231,11131,5100,16231,319500,2015
24043,40.4,149270,121625,14450,6020,37775,56228,56067,35980,20087,56067,200100,2015
24045,35.5,101182,65752,24259,4993,24746,52278,36989,23060,13929,36989,172400,2015
24047,49.1,51519,41198,7184,1690,13414,56773,20773,15634,5139,20773,243100,2015
24510,34.6,622454,174785,387565,28492,124878,42241,242268,114145,128123,242268,152400,2015
25001,51.3,214766,195568,5355,5551,58063,63251,94417,74410,20007,94417,363500,2015
25003,45.8,129288,116006,3427,5080,33021,49956,55240,37899,17341,55240,204700,2015
25005,40.6,552763,465443,18386,37322,138877,56842,212029,131608,80421,212029,273100,2015
25007,45.9,17048,15706,537,133,3989,64222,6007,4802,1205,6007,660800,2015
25009,40.6,763849,562176,22419,138848,192381,69068,287912,181293,106619,287912,353100,2015
25011,45.1,71144,65185,772,2576,17985,55221,30202,20834,9368,30202,220800,2015
25013,38.6,468041,305962,36357,106386,115651,50461,176900,109087,67813,176900,196400,2015
25015,35.9,160759,136536,4174,8272,34224,61368,58631,38603,20028,58631,265400,2015
25017,38.5,1556116,1162938,71251,113745,376456,85118,585642,365501,220141,585642,414600,2015
25019,39.5,10556,8090,984,1074,2295,84057,3923,2568,1355,3923,902500,2015
25021,40.9,687721,537263,41513,26416,170875,88262,259545,178492,81053,259545,399500,2015
25023,42.1,503681,417802,43277,17786,129176,75459,181425,137942,43483,181425,328600,2015
25025,32.2,758919,352694,151997,161935,147054,55044,296672,105671,191001,296672,377100,2015
25027,39.8,810935,640956,33877,82804,200870,65313,301176,194957,106219,301176,252600,2015
26001,56.6,10550,10162,29,143,3205,38033,5001,4454,547,5001,97500,2015
26003,48.7,9476,8039,733,123,2190,39300,3470,2977,493,3470,116400,2015
26005,40,112837,100510,1582,7861,30745,54264,41893,33872,8021,41893,140400,2015
26007,47.1,29068,27934,144,363,8203,38829,12722,9693,3029,12722,93300,2015
26009,49.5,23267,22144,73,450,6778,46845,9689,8096,1593,9689,140700,2015
26011,48.4,15424,14676,73,281,4287,38307,6447,5352,1095,6447,87500,2015
26013,43.6,8690,6372,1591,113,1812,39803,2974,2498,476,2974,88100,2015
26015,42.6,59147,56123,284,1499,16226,55064,22836,18714,4122,22836,134700,2015
26017,42.6,106698,96695,1342,5295,27869,45583,43565,33866,9699,43565,92800,2015
26019,48.4,17437,16447,58,366,4727,47388,7225,6166,1059,7225,150000,2015
26021,41.4,155565,117151,23146,7760,40269,44993,61167,43365,17802,61167,132600,2015
26023,40.6,43706,39884,1002,1861,10977,44373,16022,12234,3788,16022,95200,2015
26025,40.1,134790,106614,14450,6339,33625,42520,52850,36640,16210,52850,96000,2015
26027,44.1,51952,45131,2432,1724,14002,46570,20101,16605,3496,20101,122800,2015
26029,46.7,26134,24656,82,431,7132,46554,10794,8689,2105,10794,153000,2015
26031,49.1,25690,23727,169,324,7561,40219,11223,9131,2092,11223,112400,2015
26033,39,38586,27288,2497,626,8808,41993,13997,9833,4164,13997,106300,2015
26035,46.4,30710,29216,112,567,8574,33015,13255,10679,2576,13255,79800,2015
26037,39.7,76905,69423,1199,3314,20009,60909,28857,23109,5748,28857,154400,2015
26039,49.3,13895,13264,64,233,3907,41743,5954,4803,1151,5954,96800,2015
26041,46.4,36712,34397,89,383,9926,42031,15685,12321,3364,15685,101900,2015
26043,46.4,26012,24941,127,336,7195,43779,11059,8977,2082,11059,86300,2015
26045,41,108341,90840,6804,5551,28396,54993,43632,31079,12553,43632,134500,2015
26047,44.3,33018,30212,219,506,9218,51018,13948,10534,3414,13948,163100,2015
26049,39.6,415874,301485,84325,13308,106647,42327,165268,114823,50445,165268,88500,2015
26051,48.9,25501,24620,92,331,7316,38021,10960,9134,1826,10960,98100,2015
26053,48.3,15824,14264,713,183,3864,35686,6741,5247,1494,6741,68800,2015
26055,41.7,89907,83398,1183,2324,22670,52950,35082,26750,8332,35082,167900,2015
26057,38.9,41878,36382,2338,2335,9919,41912,14716,10852,3864,14716,88900,2015
26059,42,46178,44048,272,939,12083,41961,17810,13759,4051,17810,98700,2015
26061,32.8,36660,33941,261,526,8044,37776,13765,9373,4392,13765,93800,2015
26063,48,32290,30908,128,685,9036,42161,13805,11253,2552,13805,92900,2015
26065,31.5,283491,202018,30518,21352,60967,45679,110418,63828,46590,110418,117400,2015
26067,37.9,64064,56612,1956,2982,15543,49124,22092,17337,4755,22092,110000,2015
26069,52,25401,24022,154,505,7009,37317,11343,9091,2252,11343,85400,2015
26071,53.3,11507,10982,48,194,3030,33663,5392,4515,877,5392,74400,2015
26073,26.3,70669,61038,1807,2589,13793,39377,24661,14838,9823,24661,122500,2015
26075,40.5,159759,136056,13412,5228,39930,46326,60591,43555,17036,60591,111500,2015
26077,34,256752,202052,27220,11603,60438,47476,100341,64302,36039,100341,137100,2015
26079,44.4,17230,16359,118,287,4582,40534,7185,5791,1394,7185,98300,2015
26081,34.8,622590,467375,58165,62524,154417,53063,232961,160040,72921,232961,139300,2015
26083,54.5,2198,2150,13,20,635,37813,1040,922,118,1040,102000,2015
26085,51.5,11426,9770,902,280,2656,30439,4365,3606,759,4365,79500,2015
26087,43.3,88235,81480,1113,3917,24287,52996,32682,27156,5526,32682,132300,2015
26089,52.4,21772,19710,120,863,6346,56189,9234,7836,1398,9234,241900,2015
26091,40.9,98902,86348,2225,7512,25134,48043,37964,29180,8784,37964,114900,2015
26093,42.1,184591,175020,855,3990,51548,75204,68980,58358,10622,68980,192500,2015
26095,44.3,6477,5128,538,168,1519,37088,2377,1795,582,2377,74200,2015
26097,50.9,11044,8258,188,160,3225,38434,5209,3839,1370,5209,121300,2015
26099,40.8,854689,695737,87282,20793,222951,54582,336379,246518,89861,336379,126000,2015
26101,48.2,24536,22006,712,695,6406,41395,10142,8192,1950,10142,107100,2015
26103,39.1,67582,62531,1091,941,15710,45409,26457,18161,8296,26457,131400,2015
26105,45.7,28711,26398,257,1240,8070,42024,12248,9192,3056,12248,119900,2015
26107,35.7,43301,39691,1178,878,9644,41889,15478,11532,3946,15478,110500,2015
26109,47.5,23717,22213,63,373,6558,40373,10679,8390,2289,10679,93400,2015
26111,40.9,83624,76855,1145,2004,23066,54059,33617,25337,8280,33617,131200,2015
26113,43,14988,14222,59,372,4064,41098,5866,4810,1056,5866,103200,2015
26115,41.7,150436,138288,3478,4989,41233,55653,58566,46537,12029,58566,137200,2015
26117,40,63004,58045,1286,2067,16261,41584,23284,18408,4876,23284,94100,2015
26119,54.6,9401,9051,34,114,2613,36250,4070,3481,589,4070,91200,2015
26121,39.1,171483,131944,23391,8888,43676,42829,64490,48321,16169,64490,99000,2015
26123,42.4,48029,43526,650,2760,12929,43693,18339,15249,3090,18339,101500,2015
26125,40.8,1229503,904261,169203,45569,322233,67465,493489,347701,145788,493489,178900,2015
26127,42.3,26229,21674,314,3737,7087,41617,9822,7913,1909,9822,104200,2015
26129,49,21222,20256,66,387,6135,36063,9434,7689,1745,9434,86900,2015
26131,55.6,6298,6032,20,67,1740,34459,3084,2709,375,3084,68900,2015
26133,42.5,23234,22132,181,365,5947,38999,8757,6902,1855,8757,90300,2015
26135,51.3,8444,8109,37,106,2317,33021,3686,3117,569,3686,80600,2015
26137,44.2,24141,22925,85,366,6776,48917,9956,7877,2079,9956,121700,2015
26139,34.7,273136,231373,3801,25204,70982,58989,96283,74233,22050,96283,155400,2015
26141,53.2,13037,12564,60,138,3915,41213,5999,5237,762,5999,92900,2015
26143,54.4,24068,23011,48,332,7031,35133,11543,9503,2040,11543,91400,2015
26145,40.3,196479,137535,35577,15862,49689,43042,77925,56270,21655,77925,92900,2015
26147,42.8,160429,147039,3512,4978,43308,49730,64143,48783,15360,64143,120800,2015
26149,39.2,61022,53230,1683,4390,16114,44449,23270,17458,5812,23270,105900,2015
26151,44.2,42014,39586,208,1525,10667,41100,16280,13009,3271,16280,94800,2015
26153,50,8288,7150,41,75,2130,34118,3419,2739,680,3419,89000,2015
26155,41.5,69113,65296,317,1884,19199,48233,27409,20857,6552,27409,105100,2015
26157,43.3,54420,51058,593,1726,14979,43768,21304,17347,3957,21304,93700,2015
26159,41.3,75351,61697,2626,8195,19340,46008,28367,21955,6412,28367,118700,2015
26161,33.4,354092,251417,42294,15474,79373,61003,138067,82525,55542,138067,208200,2015
26163,37.8,1778969,886399,698192,98692,416796,41210,667275,420277,246998,667275,83000,2015
26165,41.7,32751,31101,183,581,8616,41534,12673,9719,2954,12673,91800,2015
27001,53.1,15839,14950,55,178,4904,42252,7609,6270,1339,7609,166400,2015
27003,37.9,338764,283909,16432,13252,89478,70873,124477,99522,24955,124477,187600,2015
27005,42.4,33138,28778,166,582,9176,52038,13562,10733,2829,13562,175000,2015
27007,33.3,45434,33342,347,869,10885,44757,16739,11561,5178,16739,148800,2015
27009,35.4,39221,36353,912,745,10113,52178,15632,10983,4649,15632,156100,2015
27011,49.2,5134,4987,10,57,1517,47794,2282,1803,479,2282,94900,2015
27013,30.1,65125,58430,1977,1920,14354,50061,24847,16052,8795,24847,161500,2015
27015,43.5,25391,23997,113,951,6791,52598,10679,8302,2377,10679,125500,2015
27017,41,35443,31387,423,579,8881,53227,13398,10540,2858,13398,156900,2015
27019,36.9,95715,86114,1099,3908,25966,86323,34421,27654,6767,34421,267000,2015
27021,48.3,28519,24010,90,465,8961,46531,12856,10384,2472,12856,172000,2015
27023,43,12154,10941,97,690,3315,50858,5036,3542,1494,5036,100600,2015
27025,40.2,53834,50697,618,979,14270,71001,19808,16828,2980,19808,192300,2015
27027,32.4,60879,54616,1175,2467,14686,57965,22674,15916,6758,22674,159500,2015
27029,42.5,8752,7507,22,138,2348,43421,3486,2735,751,3486,116200,2015
27031,51.3,5194,4491,47,89,1697,52299,2652,1955,697,2652,242400,2015
27033,42.8,11632,10196,65,818,3068,46750,4779,3759,1020,4779,87200,2015
27035,43.5,63048,60194,401,820,17613,49435,26365,19847,6518,26365,178400,2015
27037,37.5,408456,329985,20801,26324,108777,75567,156466,116951,39515,156466,220400,2015
27039,37.9,20290,18877,109,983,5583,68116,7556,6261,1295,7556,158700,2015
27041,44.1,36620,35366,202,489,10267,54531,15559,11872,3687,15559,188400,2015
27043,46.7,14230,13102,49,868,4164,47540,6374,4897,1477,6374,85600,2015
27045,43,20843,20286,83,235,5701,51665,8531,6682,1849,8531,140100,2015
27047,44.6,30897,26950,344,2870,8270,47105,12993,9925,3068,12993,104800,2015
27049,43,46377,42994,516,1448,12569,57062,18793,14246,4547,18793,179200,2015
27051,46.3,5961,5736,0,105,1689,50174,2530,2031,499,2530,101500,2015
27053,36.1,1197776,843413,143509,81719,283946,65834,490196,307395,182801,490196,229200,2015
27055,45,18812,18187,55,152,5360,53809,7886,6365,1521,7886,159000,2015
27057,48,20574,19243,110,363,6063,47486,8787,7149,1638,8787,174300,2015
27059,39.5,38296,36195,212,675,9867,59865,14059,11368,2691,14059,164900,2015
27061,45.9,45354,41852,213,555,12878,47761,18965,15076,3889,18965,155500,2015
27063,43.4,10211,9546,20,330,2857,50574,4354,3330,1024,4354,104100,2015
27065,43.9,16003,15256,69,261,4228,47384,6191,4974,1217,6191,137300,2015
27067,39.9,42444,35506,1202,4909,11473,52632,16701,12125,4576,16701,160800,2015
27069,48.1,4480,4319,26,87,1195,52326,1912,1545,367,1912,72600,2015
27071,47.4,13054,12227,114,10,3611,42919,5844,4572,1272,5844,101400,2015
27073,49.8,7023,6742,44,120,2021,49903,3078,2481,597,3078,83000,2015
27075,50.2,10750,10348,12,134,3276,48417,5087,4062,1025,5087,157700,2015
27077,50.3,3949,3723,23,39,995,42263,1623,1387,236,1623,117000,2015
27079,41.3,27707,25460,140,1542,7596,60632,10839,8833,2006,10839,176500,2015
27081,46.5,5808,5630,22,101,1591,49575,2497,1980,517,2497,92500,2015
27083,35.1,25699,22245,729,1607,6290,51600,9958,6746,3212,9958,133700,2015
27085,39.9,36046,33312,135,1900,9938,56128,14819,11299,3520,14819,148300,2015
27087,36.3,5496,2628,30,161,1372,41118,2001,1468,533,2001,97300,2015
27089,43.8,9453,8888,25,381,2612,54092,4027,3252,775,4027,93500,2015
27091,45.4,20350,19138,66,798,5640,51391,8831,6513,2318,8831,105400,2015
27093,42,23129,21956,72,789,6294,55042,9174,7350,1824,9174,157200,2015
27095,40.3,25809,23207,141,469,6747,49094,10046,7405,2641,10046,140900,2015
27097,41.2,32962,31729,179,467,9111,50049,13352,10636,2716,13352,153300,2015
27099,39,39227,32317,1186,4281,10054,49427,15425,11095,4330,15425,111700,2015
27101,47.6,8529,8039,30,276,2360,51983,3737,3038,699,3737,98600,2015
27103,35.7,33086,29971,798,1343,8471,58640,12629,9214,3415,12629,170400,2015
27105,36.6,21687,13565,853,5494,5517,50625,7842,5656,2186,7842,106900,2015
27107,45.4,6692,6051,34,309,1773,50377,2728,2201,527,2728,83200,2015
27109,36.7,148736,121949,7583,6820,38499,68023,57899,42696,15203,57899,173000,2015
27111,46.7,57511,53897,670,1712,16191,52365,24042,18873,5169,24042,164900,2015
27113,39.1,14110,12879,221,467,3561,47127,5920,4378,1542,5920,115200,2015
27115,43.7,29218,26259,594,778,7318,44549,11361,8875,2486,11361,141200,2015
27117,42.3,9354,8526,117,438,2566,46990,3980,2960,1020,3980,92300,2015
27119,38.9,31547,28069,353,1840,8048,53326,12723,9213,3510,12723,136700,2015
27121,46.5,10948,10608,60,120,3196,52785,4809,3853,956,4809,150900,2015
27123,34.6,527411,340799,57303,38505,120497,56104,206857,122117,84740,206857,193700,2015
27125,42.3,4061,3782,24,123,1071,50332,1661,1369,292,1661,97800,2015
27127,43.2,15723,13789,107,417,4016,47211,6307,4952,1355,6307,92600,2015
27129,44.5,15171,13579,115,1144,4101,52149,6341,5044,1297,6341,95700,2015
27131,36.4,64886,54743,2473,5065,15434,59598,22532,16655,5877,22532,185200,2015
27133,41.1,9563,9062,51,233,2614,51496,3929,2957,972,3929,128300,2015
27135,41.2,15615,14544,102,152,4362,53199,6318,4967,1351,6318,113200,2015
27137,40.9,200506,183824,3060,2851,49768,48331,84545,60095,24450,84545,139900,2015
27139,35.5,137322,114388,3893,6428,35708,87794,46805,38909,7896,46805,247600,2015
27141,35.3,90401,83580,1740,2139,23397,74170,30574,24721,5853,30574,190600,2015
27143,41.4,15021,13480,59,1228,4122,56990,6014,4732,1282,6014,131300,2015
27145,34,152595,136453,5691,4643,37261,56336,57265,40063,17202,57265,166400,2015
27147,39.8,36523,32087,905,2600,9640,57858,14271,10896,3375,14271,150500,2015
27149,32.7,9771,8829,67,401,2187,52302,3668,2465,1203,3668,131500,2015
27151,44.5,9525,8900,146,393,2708,49035,4231,3105,1126,4231,92400,2015
27153,43,24466,22494,66,1335,6564,46414,9839,8032,1807,9839,131400,2015
27155,48.4,3429,3138,16,67,992,49186,1524,1230,294,1524,70900,2015
27157,43.8,21381,20343,20,615,6191,56510,8953,7285,1668,8953,159500,2015
27159,43.3,13759,13071,130,223,3592,41906,5673,4362,1311,5673,114300,2015
27161,39,19076,17079,500,1080,4971,53564,7325,5669,1656,7325,141800,2015
27163,38.9,246670,208208,9408,9235,66383,83706,90932,72864,18068,90932,243600,2015
27165,39.6,11054,8335,66,2446,2903,50604,4450,3308,1142,4450,93400,2015
27167,43.7,6526,6181,21,152,1744,51476,2776,2096,680,2776,114800,2015
27169,33.9,51213,47095,732,1384,11306,50547,19068,13325,5743,19068,153900,2015
27171,35.6,128691,119786,1296,3435,34600,73557,45265,37478,7787,45265,193100,2015
27173,43,10092,9165,46,414,2859,53041,4196,3308,888,4196,96800,2015
28001,40.7,31979,12122,17672,1887,7524,28869,11854,7731,4123,11854,85600,2015
28003,39.9,37319,31064,4239,1138,10037,36163,14806,10175,4631,14806,84800,2015
28005,45.3,12840,7349,5416,49,2933,30704,4985,4201,784,4985,71600,2015
28007,40.8,19175,10555,8019,353,5181,32886,7451,5378,2073,7451,73600,2015
28009,39.8,8470,5102,3078,185,2049,33141,2964,2589,375,2964,72800,2015
28011,34.7,33803,11004,21648,713,7789,27585,12382,6920,5462,12382,85100,2015
28013,40.5,14789,9670,3974,830,3972,31098,5922,4286,1636,5922,61300,2015
28015,44.6,10338,6669,3470,43,2777,37289,3694,3110,584,3694,80800,2015
28017,37.7,17391,8986,7541,704,4480,30926,6484,4772,1712,6484,63400,2015
28019,42.8,8354,5647,2595,47,2091,30692,3303,2374,929,3303,70300,2015
28021,32.7,9330,1271,7854,101,2023,23259,3192,2230,962,3192,53800,2015
28023,41.3,16362,10404,5731,128,4445,35993,6486,5334,1152,6486,65300,2015
28025,38.8,20279,8023,11799,241,5642,31669,7795,5433,2362,7795,80900,2015
28027,33.5,25254,5697,19138,76,6248,28851,9360,4884,4476,9360,61900,2015
28029,38.1,28921,13070,14683,808,6934,35130,9840,7610,2230,9840,84500,2015
28031,37.6,19471,11937,6876,414,4714,31631,6969,5607,1362,6969,71800,2015
28033,36,168586,114659,40061,8401,44207,58278,60010,44036,15974,60010,152700,2015
28035,31.9,76267,43901,27867,2528,17569,36416,27983,15335,12648,27983,110600,2015
28037,43.2,7857,4965,2816,43,2453,38170,3291,2487,804,3291,73200,2015
28039,36.4,23104,20313,1832,521,5527,44258,7471,6384,1087,7471,101300,2015
28041,36.9,14129,10082,3630,138,2792,40176,4180,3385,795,4180,86200,2015
28043,40.4,21591,11981,9402,25,4844,31779,7429,5456,1973,7429,92600,2015
28045,41.8,45627,38836,4115,1637,12819,43355,18591,13270,5321,18591,133000,2015
28047,35.4,196268,128194,45102,10643,49743,41722,75882,43380,32502,75882,137700,2015
28049,33.6,245874,65432,172408,3854,57708,37324,88762,52712,36050,88762,107100,2015
28051,33.5,18772,3058,15498,62,4364,20732,6420,4072,2348,6420,51500,2015
28053,35.3,8984,1977,6743,233,1846,23216,3057,1656,1401,3057,60500,2015
28055,44.3,1291,443,841,7,280,23491,436,246,190,436,57000,2015
28057,39.3,23451,21333,1531,342,6146,35004,8835,6877,1958,8835,83700,2015
28059,37.8,140676,96569,30229,7540,34023,48406,50242,35474,14768,50242,121200,2015
28061,41.6,16588,7600,8785,99,5027,31578,6873,5634,1239,6873,69900,2015
28063,34.8,7586,1049,6520,8,1645,20743,2545,1548,997,2545,60500,2015
28065,43.1,11941,4586,7312,17,3145,26279,5019,3835,1184,5019,82300,2015
28067,36.6,68276,44516,19711,2901,17308,37143,24561,18021,6540,24561,87500,2015
28069,38.3,10211,3530,6011,246,2231,30056,3665,2797,868,3665,66000,2015
28071,28.5,51169,36042,12258,1188,10343,44643,17334,10351,6983,17334,159200,2015
28073,34,58885,44008,11826,1387,15802,52035,21865,14549,7316,21865,168100,2015
28075,37.5,79832,42631,33866,1656,19498,38132,29701,19372,10329,29701,87600,2015
28077,40.7,12586,8278,4058,79,3454,35634,4780,3739,1041,4780,86800,2015
28079,34.8,23153,11125,9576,984,5962,33452,8314,6102,2212,8314,76000,2015
28081,36.5,85036,57106,23652,2126,22360,42784,32311,22066,10245,32311,117000,2015
28083,32.9,31516,7580,22716,778,6888,24233,10824,5570,5254,10824,70000,2015
28085,37.7,34765,23356,10706,382,9532,36473,12993,9699,3294,12993,85300,2015
28087,36.3,59699,31443,26157,1108,15596,40239,23270,14310,8960,23270,115700,2015
28089,37,100202,55996,38296,2830,26767,64376,37107,26682,10425,37107,206200,2015
28091,39.1,26109,16961,8415,367,7062,30668,9814,7488,2326,9814,78400,2015
28093,39.6,36385,17538,17319,1212,9347,37419,13106,10266,2840,13106,84800,2015
28095,40.6,36175,24302,11021,386,9662,36783,13936,10408,3528,13936,79100,2015
28097,41.7,10464,5490,4713,113,3003,30146,4261,3245,1016,4261,75200,2015
28099,35.8,29553,17522,6607,186,7538,35645,10738,7709,3029,10738,77800,2015
28101,37.7,21663,13498,6576,350,5938,37045,8011,6181,1830,8011,76600,2015
28103,36.8,11143,2956,8016,154,2784,26677,4067,2926,1141,4067,61300,2015
28105,25,49048,28141,18123,780,9317,32485,17483,9220,8263,17483,142100,2015
28107,36.5,34373,16445,17178,546,7869,36555,12133,9003,3130,12133,77900,2015
28109,40.7,55196,45159,7483,1674,14489,40976,20606,15710,4896,20606,114100,2015
28111,40.1,12187,9407,2598,37,3076,34045,4392,3766,626,4392,78000,2015
28113,36.7,40075,18013,20957,547,9592,31677,14769,9795,4974,14769,83300,2015
28115,37,30517,23609,4622,1853,7507,40645,10542,8088,2454,10542,81500,2015
28117,39.2,25380,21154,3596,329,6971,32945,9728,7125,2603,9728,78100,2015
28119,38.5,7761,2200,5452,73,1956,24583,3053,1998,1055,3053,54100,2015
28121,36.9,146761,110432,28815,3818,39246,58801,53800,39926,13874,53800,153300,2015
28123,36,28293,14299,10487,3046,6933,32935,9827,7196,2631,9827,68000,2015
28125,38.5,4805,1329,3426,31,1118,30525,1769,1068,701,1769,62000,2015
28127,37.7,27401,16885,9782,481,6755,35375,9619,7546,2073,9619,78800,2015
28129,40.1,16257,12141,4012,47,4525,32951,6085,4908,1177,6085,79700,2015
28131,36.8,17978,13852,3446,301,4489,45025,5764,4579,1185,5764,111800,2015
28133,34.1,27911,6986,20298,418,5920,27384,8508,4904,3604,8508,70000,2015
28135,36,14959,5408,6708,2492,2897,29731,4386,3283,1103,4386,58100,2015
28137,36.7,28415,18498,8747,701,7223,42880,10004,7389,2615,10004,110200,2015
28139,38.4,22054,17115,3455,1058,6228,35609,8349,6414,1935,8349,77800,2015
28141,42.8,19539,18256,508,522,5725,35143,7652,5861,1791,7652,76600,2015
28143,32.2,10477,2209,7914,139,2647,31211,3989,1641,2348,3989,80000,2015
28145,38,27811,21925,3940,1257,7386,35865,10345,7340,3005,10345,83200,2015
28147,39.4,14978,7922,6667,264,3700,31384,5761,4917,844,5761,93200,2015
28149,37.9,48020,23309,22929,1005,12385,41121,18415,11940,6475,18415,100800,2015
28151,36.2,49499,13088,35171,660,12068,29144,18193,10010,8183,18193,73900,2015
28153,36.7,20564,12030,8015,293,5453,32557,7630,6487,1143,7630,74300,2015
28155,41.1,9999,7776,1964,128,2912,34448,4044,3058,986,4044,78500,2015
28157,36.8,9345,2690,6603,8,2088,29931,3209,2527,682,3209,59600,2015
28159,40.5,18697,9501,8867,208,5326,33202,7664,5294,2370,7664,78600,2015
28161,41.5,12381,7282,4797,202,3517,36502,5101,3819,1282,5101,74600,2015
28163,35.8,27911,10187,16020,1341,5751,28961,8602,5268,3334,8602,68500,2015
29001,27.9,25560,23380,528,613,5146,37516,9635,5636,3999,9635,108000,2015
29003,42.3,17328,16498,144,371,4878,55613,6808,5333,1475,6808,127200,2015
29005,47.1,5440,5266,16,69,1459,43933,2501,1711,790,2501,82300,2015
29007,39.2,25783,22545,1692,718,5863,41310,9273,6522,2751,9273,91900,2015
29009,43.3,35726,31160,60,3031,9370,39033,13246,9971,3275,13246,113000,2015
29011,41.1,12166,11345,33,289,3626,37467,4988,3655,1333,4988,93500,2015
29013,41.9,16643,15788,85,349,4418,41060,6690,4848,1842,6690,103700,2015
29015,52.5,18854,17999,82,333,5393,33042,8149,6647,1502,8149,111200,2015
29017,43.1,12356,11973,30,115,3359,39707,4753,3868,885,4753,97700,2015
29019,30.1,170770,136672,14330,5442,38235,49899,66980,37482,29498,66980,169400,2015
29021,36.8,89561,75705,4546,5309,20874,46315,33176,21091,12085,33176,109700,2015
29023,40,42951,38421,2388,742,11219,35738,16730,10898,5832,16730,93300,2015
29025,42.3,9083,8640,69,175,2538,43691,3715,2775,940,3715,97000,2015
29027,37.8,44566,40287,1638,851,10525,47744,16150,11898,4252,16150,124200,2015
29029,49.8,43927,41601,223,1098,11927,44816,16748,13178,3570,16748,169700,2015
29031,36,77606,67464,5905,1723,18991,46050,29795,19167,10628,29795,142300,2015
29033,42.4,9096,8627,111,120,2431,42415,3624,2718,906,3624,76400,2015
29035,40.9,6284,5949,4,120,1420,33034,2453,1750,703,2453,89200,2015
29037,39.2,100781,89501,3663,4238,27800,61584,37945,28671,9274,37945,159600,2015
29039,44.8,13892,13230,10,192,3757,31532,5904,4117,1787,5904,88900,2015
29041,45.5,7650,7322,166,62,1937,40642,2947,2272,675,2947,75400,2015
29043,37.8,80904,75811,474,2245,22720,53270,29889,21835,8054,29889,143100,2015
29045,43.7,6919,6739,18,21,1877,43883,2833,2165,668,2833,84000,2015
29047,36.6,230361,190625,12224,14704,59130,62099,87676,61320,26356,87676,154900,2015
29049,41,20498,19245,359,389,5907,54773,8076,5960,2116,8076,135500,2015
29051,38,76533,62592,8820,2044,19060,53088,29448,19921,9527,29448,149200,2015
29053,38.6,17593,15606,1070,266,4342,44549,6488,4624,1864,6488,124000,2015
29055,41.2,24660,23660,54,425,6236,36743,9309,6766,2543,9309,111600,2015
29057,47.1,7618,7186,37,136,2153,37035,3195,2512,683,3195,79900,2015
29059,43,16564,15677,13,302,4666,38062,6252,4752,1500,6252,94600,2015
29061,40.5,8277,7988,74,110,2122,41642,3047,2365,682,3047,102500,2015
29063,40.1,12782,10541,1243,492,2469,41406,3756,2354,1402,3756,110700,2015
29065,43.4,15612,14864,62,211,4051,36831,5920,4208,1712,5920,88700,2015
29067,47.3,13516,13214,8,144,3666,30508,5277,3943,1334,5277,101200,2015
29069,39.8,31562,25777,3081,1928,7960,31077,12623,7964,4659,12623,67500,2015
29071,40.2,101828,97152,1053,1623,28098,48480,39915,29390,10525,39915,149400,2015
29073,45.6,14948,14427,66,194,4177,42826,6246,4662,1584,6246,120000,2015
29075,41.4,6785,6591,72,61,1825,41912,2748,2015,733,2748,83400,2015
29077,35.6,283206,251136,8758,9474,69698,41227,117732,68906,48826,117732,129400,2015
29079,41,10256,9762,64,94,2625,37656,4057,2847,1210,4057,79800,2015
29081,42.4,8722,8363,73,170,2395,39301,3574,2623,951,3574,74300,2015
29083,44.1,22034,20764,379,443,6082,42181,9518,7124,2394,9518,91100,2015
29085,53.5,9335,8922,16,130,2739,32122,4105,3332,773,4105,94800,2015
29087,47.4,4615,4464,16,12,1426,42500,2130,1516,614,2130,86200,2015
29089,38.8,10182,9243,523,139,2501,44820,3729,2769,960,3729,97900,2015
29091,40.6,40326,38265,125,764,10934,32784,16263,10902,5361,16263,102800,2015
29093,43.1,10322,9762,269,85,2723,36239,4046,2824,1222,4046,82600,2015
29095,36.5,680905,427402,160258,58974,162706,46869,274485,162755,111730,274485,125500,2015
29097,35.5,117184,99722,2475,8698,29681,41811,45519,29156,16363,45519,106300,2015
29099,38.6,221577,210158,2128,3871,59813,55348,81990,66417,15573,81990,149900,2015
29101,29.7,54155,46860,2384,2061,13088,49792,19971,12062,7909,19971,141400,2015
29103,43.6,4035,3893,23,46,1157,38289,1689,1318,371,1689,71300,2015
29105,39.8,35514,33387,185,782,9574,39712,13545,9491,4054,13545,103400,2015
29107,41,32916,30428,661,837,9122,50723,13188,9982,3206,13188,117400,2015
29109,39.6,38244,34459,47,2627,10118,40597,14483,10315,4168,14483,98100,2015
29111,39.3,10172,9407,305,165,2501,43909,3846,2834,1012,3846,83800,2015
29113,36.5,53850,50374,1007,1160,13730,53718,18498,14312,4186,18498,144500,2015
29115,42.8,12401,11843,57,222,3200,37997,4828,3602,1226,4828,75900,2015
29117,42,15042,14052,390,232,3864,43350,5708,3991,1717,5708,102500,2015
29119,37,22763,18053,343,2583,5865,38368,8318,5847,2471,8318,88400,2015
29121,42.9,15460,14554,409,187,3863,36976,6243,4638,1605,6243,88000,2015
29123,42.3,12401,11816,220,61,3266,35097,4650,3510,1140,4650,89200,2015
29125,44.2,9057,8713,38,50,2438,39700,3686,2697,989,3686,118000,2015
29127,39.7,28840,26106,1453,445,7336,40814,11213,7273,3940,11213,103700,2015
29129,44.1,3718,3595,27,37,955,40768,1503,1141,362,1503,77500,2015
29131,40.8,24956,23763,110,433,6429,38094,9452,7334,2118,9452,120800,2015
29133,39.3,14208,10275,3423,273,3407,28347,5185,3102,2083,5185,67700,2015
29135,38,15801,14153,616,716,3881,47725,5533,4021,1512,5533,116500,2015
29137,44.8,8680,8149,231,98,2307,43138,3513,2610,903,3513,90800,2015
29139,43.7,11939,11326,163,187,3279,39830,4874,3527,1347,4874,105900,2015
29141,46.5,20225,19151,251,393,4934,33525,7812,5961,1851,7812,109300,2015
29143,40.5,18411,14819,2957,287,4955,33630,7247,4443,2804,7247,73100,2015
29145,39.7,58777,51105,562,2864,15798,43290,22096,15888,6208,22096,111700,2015
29147,28.3,23186,21570,631,342,4881,35854,8659,4665,3994,8659,114500,2015
29149,45.8,10979,10371,26,160,2746,29851,4367,3290,1077,4367,79400,2015
29151,39.8,13758,13431,114,99,3629,52693,5143,4222,921,5143,131900,2015
29153,50.7,9537,9146,16,152,2947,31399,4233,3265,968,4233,86600,2015
29155,37.6,17837,12331,4778,406,4385,29238,6975,3743,3232,6975,65200,2015
29157,39.7,19100,18256,151,401,5366,51499,7395,5816,1579,7395,123400,2015
29159,37.5,42215,36235,1165,3402,10892,39928,16131,10971,5160,16131,101400,2015
29161,34.4,45029,40136,1040,1059,10462,41618,16672,10180,6492,16672,114500,2015
29163,39.5,18517,16413,1143,391,4368,41750,6567,4748,1819,6567,95000,2015
29165,38.3,93394,77327,5766,5195,25024,68254,37556,24272,13284,37556,190300,2015
29167,37.5,31107,29247,304,653,8077,41130,11752,7866,3886,11752,114600,2015
29169,26.8,53443,37522,5978,5514,10189,47931,15435,7508,7927,15435,129800,2015
29171,46.4,4895,4751,20,57,1401,36346,2196,1629,567,2196,82800,2015
29173,45.1,10243,9826,147,118,3015,47345,4021,3231,790,4021,112100,2015
29175,38.4,25135,22486,1232,459,5567,37832,8450,6130,2320,8450,85500,2015
29177,41.5,23031,21691,311,513,6161,52526,8646,6616,2030,8646,120200,2015
29179,46.6,6578,6257,94,86,1753,35648,2661,2081,580,2661,85600,2015
29181,41.6,13990,13345,27,168,3747,32444,5423,4078,1345,5423,80800,2015
29183,37.4,374805,330455,16619,11439,100729,72415,138958,110058,28900,138958,188200,2015
29185,49.7,9520,9025,115,196,2589,32046,4015,3044,971,4015,79600,2015
29186,42.5,17990,17205,130,177,5047,47014,7137,5759,1378,7137,131000,2015
29187,38.9,66010,60906,3143,922,16091,39741,24936,16545,8391,24936,103500,2015
29189,40.2,1001327,678612,232960,26783,261710,59755,401839,282099,119740,401839,173400,2015
29195,38.2,23334,18993,1150,2156,5788,40101,8844,5993,2851,8844,89700,2015
29197,41.3,4395,4288,14,37,1195,37500,1722,1274,448,1722,86000,2015
29199,39.1,4873,4763,44,55,1203,39772,1851,1374,477,1851,75100,2015
29201,39.7,39061,32838,4406,826,10520,39162,15247,10384,4863,15247,94300,2015
29203,44.5,8317,7846,23,148,2180,32404,3277,2546,731,3277,89400,2015
29205,42.4,6179,5970,100,83,1587,39087,2499,1779,720,2499,72600,2015
29207,42,29837,28591,446,464,7725,38203,12045,8505,3540,12045,90500,2015
29209,51.3,31375,29941,32,612,9115,40510,12836,10148,2688,12836,153100,2015
29211,40.9,6512,5140,57,1190,1606,40197,2512,1803,709,2512,78800,2015
29213,41.5,53555,48159,442,2811,14083,38357,21300,12763,8537,21300,121700,2015
29215,41.6,25735,23503,452,522,6029,35088,9134,6822,2312,9134,99300,2015
29217,40.6,20878,19710,189,402,5468,40693,8040,5412,2628,8040,90800,2015
29219,40.2,33043,30466,738,1039,8793,51133,11951,9451,2500,11951,152800,2015
29221,40.1,25048,23680,491,75,6327,35305,8982,7146,1836,8982,79700,2015
29223,46.7,13397,12839,78,178,3651,33750,5453,4221,1232,5453,70000,2015
29225,38.1,36690,34759,475,682,9678,44451,12885,9517,3368,12885,118700,2015
29227,47.8,2082,2003,0,29,590,45952,900,672,228,900,57800,2015
29229,41.7,18449,17606,144,315,4922,29778,7351,5094,2257,7351,88200,2015
29510,34.6,317850,136935,151041,11875,64755,35599,139555,61266,78289,139555,120400,2015
30001,42.6,9291,8527,12,345,2315,41512,4080,2605,1475,4080,168800,2015
30003,29.8,13141,3874,12,686,2869,41622,3576,2194,1382,3576,88500,2015
30005,34.5,6598,3119,16,156,1505,36744,2238,1396,842,2238,82500,2015
30007,45.8,5692,5354,35,89,1705,50115,2427,1891,536,2427,184600,2015
30009,49.1,10268,9745,1,247,2752,49767,4480,3412,1068,4480,217500,2015
30011,50.8,1227,1202,0,8,352,45000,504,428,76,504,87500,2015
30013,38,82090,70820,990,3241,21168,45205,33784,21469,12315,33784,162100,2015
30015,41.1,5855,4451,4,122,1556,38521,2288,1381,907,2288,123800,2015
30017,41.2,11945,11117,42,329,3106,48750,4827,3334,1493,4827,137300,2015
30019,50.3,1758,1698,0,44,490,49239,866,669,197,866,112600,2015
30021,41.1,9365,8720,79,249,2660,52738,3974,2755,1219,3974,156500,2015
30023,46.8,9211,8390,95,278,2187,39399,3851,2747,1104,3851,130100,2015
30025,39,3057,2923,40,30,836,53266,1221,863,358,1221,143000,2015
30027,47,11468,10833,23,94,3213,40881,4879,3439,1440,4879,121700,2015
30029,42.1,93333,87120,287,2380,24339,47851,37106,26318,10788,37106,231500,2015
30031,33.2,95323,88303,380,2909,22688,55553,38292,23556,14736,38292,271500,2015
30033,46.5,1047,1017,0,6,304,39732,437,326,111,437,150000,2015
30035,31.3,13672,4371,46,348,2739,29640,4222,2467,1755,4222,91300,2015
30037,53.1,756,716,0,16,226,40938,320,238,82,320,95000,2015
30039,53.7,3168,3071,2,60,946,48512,1421,1063,358,1421,216300,2015
30041,34.3,16523,11765,3,518,4086,44633,6092,4160,1932,6092,128800,2015
30043,47.7,11502,10739,17,247,3172,60842,4473,3756,717,4473,242300,2015
30045,51.4,1997,1943,0,27,614,44602,913,693,220,913,122000,2015
30047,41.6,29157,19320,72,1179,7880,38732,11978,8325,3653,11978,220200,2015
30049,40.9,65357,59990,316,1892,16718,56197,26753,18558,8195,26753,208600,2015
30051,44.8,2369,2278,0,19,555,47768,864,570,294,864,103800,2015
30053,50.8,19337,18084,10,511,5119,35275,8645,6789,1856,8645,164400,2015
30055,51.2,1728,1636,0,26,502,40750,737,603,134,737,112400,2015
30057,52.1,7767,7326,48,232,1991,46250,3369,2514,855,3369,237800,2015
30059,49.6,1898,1842,0,27,495,41641,757,552,205,757,139500,2015
30061,51.6,4238,4124,3,66,881,36031,1563,1134,429,1563,169600,2015
30063,34.8,111966,100853,511,3368,26664,46164,46624,27228,19396,46624,239700,2015
30065,48.5,4790,4431,9,158,1267,39517,1951,1434,517,1951,133800,2015
30067,46.6,15708,14791,86,418,3898,43932,6793,5014,1779,6793,216900,2015
30069,48.9,443,437,0,6,127,43750,192,143,49,192,78600,2015
30071,47.9,4167,3568,0,88,1204,36071,1808,1308,500,1808,121800,2015
30073,41.9,6206,5047,21,114,1469,42264,2296,1586,710,2296,111900,2015
30075,52,1703,1600,0,35,472,46346,756,526,230,756,107800,2015
30077,45.4,6975,6313,33,174,1423,40000,2380,1644,736,2380,119500,2015
30079,51.9,1372,1318,0,11,361,42383,547,502,45,547,80900,2015
30081,47.6,40823,38050,123,1320,10535,39480,16649,11576,5073,16649,239000,2015
30083,38,11132,10140,41,492,2882,65084,4421,2834,1587,4421,179700,2015
30085,30.4,11072,4063,9,127,1918,32974,3063,1795,1268,3063,102700,2015
30087,36.9,9352,5489,19,391,2230,51159,3295,2257,1038,3295,127900,2015
30089,51.5,11346,10217,17,287,3260,32257,5038,3720,1318,5038,180800,2015
30091,47.1,3630,3352,2,64,1049,50664,1639,1242,397,1639,143700,2015
30093,40.6,34549,31571,163,1387,8371,37749,15144,9789,5355,15144,128100,2015
30095,46.7,9288,8739,17,281,2668,58259,3742,3001,741,3742,202000,2015
30097,46.1,3633,3425,7,66,988,50588,1410,1024,386,1410,191800,2015
30099,44.8,6074,5734,5,90,1528,46360,2314,1713,601,2314,143800,2015
30101,41.7,5150,4549,8,159,1351,44804,1972,1191,781,1972,122600,2015
30103,49,812,724,0,56,243,41103,353,225,128,353,86100,2015
30105,45.5,7577,6483,12,153,2188,49141,3295,2248,1047,3295,122000,2015
30107,46.5,2115,2005,0,45,531,32723,885,593,292,885,83300,2015
30109,51.2,986,973,0,13,288,38553,448,315,133,448,106100,2015
30111,38,153692,134295,899,7938,38586,52802,61442,41950,19492,61442,192500,2015
31001,37.8,31442,27567,256,2703,7749,50635,12670,8804,3866,12670,104300,2015
31003,46.5,6486,6214,8,186,1996,45609,2821,2133,688,2821,78100,2015
31005,39.9,448,443,0,0,109,39375,180,106,74,180,100000,2015
31007,50.4,820,767,10,31,258,48897,339,228,111,339,122100,2015
31009,40.4,551,544,0,0,163,48875,231,123,108,231,72500,2015
31011,45.6,5373,5256,7,91,1539,50306,2227,1753,474,2227,97700,2015
31013,40.8,11310,9370,13,1314,3191,51691,4805,3182,1623,4805,92000,2015
31015,50.8,2039,1974,17,10,560,40224,935,753,182,935,51700,2015
31017,47.6,3078,2987,1,16,963,36078,1511,1047,464,1511,70500,2015
31019,32.5,47958,42132,515,3989,11556,53624,18352,11617,6735,18352,151300,2015
31021,47.4,6647,6236,65,183,1877,47429,2801,2226,575,2801,88700,2015
31023,44.7,8256,7885,53,230,2469,51027,3577,2796,781,3577,100200,2015
31025,41.5,25360,23997,242,728,7000,65619,9756,7880,1876,9756,155900,2015
31027,44.8,8675,8434,7,142,2449,52250,3575,2917,658,3575,101400,2015
31029,44.9,3897,3407,1,428,1162,52422,1701,1326,375,1701,91200,2015
31031,43.9,5770,5155,2,144,1774,48750,2639,1740,899,2639,114200,2015
31033,39.9,10077,9091,18,643,2685,53814,4393,3022,1371,4393,113700,2015
31035,43.2,6382,5707,29,551,1810,51470,2617,2031,586,2617,81100,2015
31037,34.2,10522,5704,167,4532,2546,51367,3634,2689,945,3634,88300,2015
31039,43.6,9078,8084,3,834,2502,50013,3699,2601,1098,3699,102500,2015
31041,43.8,10802,10326,87,264,3205,46468,4745,3453,1292,4745,86700,2015
31043,33.7,20798,10879,847,7725,5485,49786,7290,4760,2530,7290,111400,2015
31045,33.7,9136,7879,44,380,2238,41038,3611,2383,1228,3611,104600,2015
31047,36.2,24069,14878,1050,7866,6156,48329,8755,5928,2827,8755,88800,2015
31049,47.1,1946,1728,0,170,508,50962,822,617,205,822,69400,2015
31051,41.9,5866,5078,23,686,1568,51223,2305,1751,554,2305,80900,2015
31053,39.4,36725,31637,150,4019,10057,49068,15110,10059,5051,15110,114000,2015
31055,34,537655,381511,59847,63480,129038,54659,208541,128781,79760,208541,145900,2015
31057,46.2,2015,1790,2,200,601,42500,900,586,314,900,71900,2015
31059,47.5,5697,5405,43,203,1563,52316,2464,1868,596,2464,75700,2015
31061,49.9,3105,3000,4,51,952,45905,1409,1178,231,1409,59900,2015
31063,44.4,2573,2518,0,10,722,49634,1084,804,280,1084,87400,2015
31065,46.8,4887,4635,6,159,1370,39934,2276,1604,672,2276,62300,2015
31067,44.6,21818,20783,83,443,5964,50010,9240,6570,2670,9240,108300,2015
31069,52.3,1823,1762,3,14,543,45845,845,700,145,845,75000,2015
31071,51.4,1933,1880,12,24,537,43179,903,685,218,903,89100,2015
31073,46.7,1976,1914,0,49,570,54375,789,565,224,789,108500,2015
31075,48.5,769,728,0,41,192,44750,299,209,90,299,50800,2015
31077,46,2476,2386,17,50,654,42904,995,806,189,995,59600,2015
31079,35.8,60792,42430,1277,15519,14832,49252,22433,13919,8514,22433,122500,2015
31081,42.9,9100,8700,49,260,2646,59311,3649,2919,730,3649,111600,2015
31083,49.5,3458,3271,7,105,986,46766,1555,1224,331,1555,78200,2015
31085,48,1084,1005,2,76,354,44500,482,324,158,482,73500,2015
31087,48.2,2879,2781,4,77,793,39231,1342,973,369,1342,59100,2015
31089,45.5,10398,9867,9,377,2972,46728,4520,3271,1249,4520,95600,2015
31091,57.9,681,644,6,27,204,37317,312,238,74,312,70000,2015
31093,43.3,6347,6093,7,144,1666,50030,2560,2007,553,2560,109200,2015
31095,45.5,7433,7018,1,257,2085,43008,3359,2552,807,3359,71000,2015
31097,42.3,5167,4199,348,513,1238,45429,1886,1389,497,1886,76800,2015
31099,40.8,6549,6124,10,334,1819,51934,2767,1883,884,2767,109900,2015
31101,49.1,8146,7433,42,514,2439,41781,3905,2599,1306,3905,99700,2015
31103,52.8,711,698,1,0,229,38625,343,243,100,343,74400,2015
31105,45.7,3720,3326,11,293,1005,40242,1574,1020,554,1574,80100,2015
31107,47.6,8556,7423,5,212,2379,45411,3716,2731,985,3716,81200,2015
31109,32.9,298080,247609,11304,19030,70549,51830,117667,69852,47815,117667,152900,2015
31111,40.1,35896,31904,287,2862,9541,50194,15010,9973,5037,15010,114200,2015
31113,44.8,851,823,2,16,238,48281,365,252,113,365,114300,2015
31115,51.8,548,518,0,0,195,55417,258,199,59,258,96300,2015
31117,46.9,433,422,0,4,137,54306,197,128,69,197,133300,2015
31119,37.5,35111,28698,356,4897,9145,50218,14007,9093,4914,14007,118300,2015
31121,43.8,7776,7248,38,311,2309,51012,3325,2434,891,3325,85600,2015
31123,41.3,4874,4046,39,713,1350,45910,1981,1371,610,1981,80600,2015
31125,45.9,3639,3542,2,91,1010,42500,1548,1172,376,1548,78400,2015
31127,39.1,7168,6782,73,168,1806,49656,2877,2044,833,2877,102200,2015
31129,49.2,4391,4212,2,102,1293,40488,2068,1530,538,2068,54500,2015
31131,41.8,15842,14333,18,1096,4252,50275,6447,4725,1722,6447,115800,2015
31133,49.1,2726,2652,0,49,746,41161,1261,980,281,1261,63800,2015
31135,44.1,2924,2796,4,107,819,55893,1243,960,283,1243,97700,2015
31137,42,9216,8589,14,467,2482,50404,3728,2684,1044,3728,110000,2015
31139,41.3,7184,6980,10,108,2029,54482,2940,2255,685,2940,98500,2015
31141,38,32642,26668,90,5204,8460,56318,12707,9251,3456,12707,125200,2015
31143,45.4,5271,4973,13,200,1489,57312,2179,1684,495,2179,103400,2015
31145,41.8,10946,10120,156,530,2916,42931,4651,3394,1257,4651,86100,2015
31147,47,8201,7601,3,145,2229,42750,3761,2813,948,3761,72000,2015
31149,52,1401,1336,10,7,417,48456,690,518,172,690,70800,2015
31151,36.6,14360,10498,114,3228,3457,51738,5104,3263,1841,5104,95700,2015
31153,33.7,169192,139820,6661,13757,45948,70543,61983,43241,18742,61983,163800,2015
31155,41.4,20913,20025,135,449,5629,60854,8055,6303,1752,8055,150600,2015
31157,38.8,36684,27120,257,8216,9622,45992,14755,10103,4652,14755,107700,2015
31159,38.2,16998,16240,58,374,4489,59662,6348,4514,1834,6348,147800,2015
31161,46.1,5294,4391,23,221,1482,41985,2259,1602,657,2259,70200,2015
31163,49.5,3107,3002,38,53,884,46366,1377,1072,305,1377,86600,2015
31165,48.1,1249,1148,0,47,387,41215,549,423,126,549,89600,2015
31167,38.8,6081,5626,34,305,1722,53416,2323,1959,364,2323,103400,2015
31169,48.9,5182,4974,3,58,1528,45741,2341,1855,486,2341,64700,2015
31171,44,675,644,0,4,209,51000,300,217,83,300,84300,2015
31173,28.6,6946,2677,7,302,1479,41266,2084,1288,796,2084,68600,2015
31175,46,4254,4119,3,64,1252,44612,1897,1357,540,1897,84700,2015
31177,41.2,20257,19306,137,496,5891,65370,8034,6361,1673,8034,175800,2015
31179,30.1,9425,8534,315,504,2325,54159,3500,2155,1345,3500,116100,2015
31181,47.5,3697,3413,2,160,953,40256,1552,1213,339,1552,77600,2015
31183,47.8,847,845,0,0,236,46394,389,287,102,389,88100,2015
31185,41.3,13825,12714,129,626,3794,51802,5604,3850,1754,5604,117600,2015
32001,38.9,24252,18087,516,3182,6269,47415,9475,5818,3657,9475,151000,2015
32003,36.4,2035572,932420,211753,611405,465442,51575,724446,380425,344021,724446,170400,2015
32005,49.4,47259,38605,258,5607,13772,58535,19779,13735,6044,19779,272000,2015
32007,33.5,51562,34833,586,12351,12745,71799,17696,12438,5258,17696,184600,2015
32009,46.5,1141,902,0,182,270,39271,483,289,194,483,79800,2015
32011,43.9,1669,1588,1,44,462,60250,767,545,222,767,93100,2015
32013,35.3,17067,11329,77,4353,4069,65212,6149,4515,1634,6149,159900,2015
32015,37.2,5946,3875,8,1613,1513,78190,2114,1664,450,2114,109500,2015
32017,37.4,5194,4372,152,371,1341,44866,1883,1277,606,1883,128900,2015
32019,43.2,51657,39607,431,8079,13356,47255,19524,13702,5822,19524,131700,2015
32021,48.7,4566,2843,59,565,1090,38923,1990,1272,718,1990,83800,2015
32023,50.8,42625,33146,1079,6045,11407,41712,17427,12287,5140,17427,105900,2015
32027,41.3,6722,4489,319,1550,1490,45230,2083,1320,763,2083,105200,2015
32029,54.7,3929,3564,17,147,1096,64832,1767,1546,221,1767,177000,2015
32031,37.6,435019,280739,9623,101261,102630,52870,166345,94470,71875,166345,213100,2015
32033,39.4,9974,7393,398,1456,1990,57122,3187,2386,801,3187,124900,2015
32510,42.6,54482,37485,505,12342,13012,47668,21594,12104,9490,21594,186000,2015
33001,46.1,60399,57437,328,945,16652,62159,24597,18434,6163,24597,219600,2015
33003,50.3,47513,45701,169,643,14030,53306,21206,16861,4345,21206,222300,2015
33005,42,76430,72378,547,1239,19380,57782,30638,21732,8906,30638,188800,2015
33007,48.1,31870,30101,545,477,8955,42312,14198,9943,4255,14198,123500,2015
33009,41.9,89341,81750,665,1897,21689,55762,35035,23902,11133,35035,211500,2015
33011,40.1,403972,349288,8289,23646,104048,71244,155208,103496,51712,155208,245700,2015
33013,42.6,147262,137870,1682,2722,37926,65983,56705,40881,15824,56705,225200,2015
33015,43.5,299006,279490,1998,7369,82788,81198,118095,90387,27708,118095,282500,2015
33017,37.2,125273,115079,1106,2603,30515,60711,47149,30600,16549,47149,216500,2015
33019,45.1,43135,41275,156,600,11395,56032,17420,12939,4481,17420,171000,2015
34001,40.6,275376,157071,39439,49845,68395,54461,101818,68194,33624,101818,225600,2015
34003,41.5,926330,549828,49117,166161,241746,85806,335550,217504,118046,335550,441100,2015
34005,41,450556,310668,70387,32991,114777,78621,164659,125905,38754,164659,245000,2015
34007,38.3,511998,299665,92793,78615,125478,62185,186101,125702,60399,186101,196800,2015
34009,48.3,95805,82334,4441,6733,25946,57637,40412,30683,9729,40412,299700,2015
34011,36.9,157035,76172,29168,44982,35059,49984,50368,33402,16966,50368,162400,2015
34013,36.9,791609,252835,306745,171649,181249,53976,278085,123847,154238,278085,356600,2015
34015,39.6,290298,231202,28383,15737,75337,76727,104268,82968,21300,104268,214500,2015
34017,34.7,662619,194795,73431,283504,154599,59741,249584,78089,171495,249584,335300,2015
34019,45,126250,109710,3030,7399,34130,105444,46899,39142,7757,46899,390900,2015
34021,38.4,370212,193628,72449,60119,88299,72804,130546,84045,46501,130546,276500,2015
34023,37.7,830300,382747,76447,162449,205038,79593,282058,181312,100746,282058,323300,2015
34025,42.3,629185,477374,42416,64639,162126,85242,233105,173378,59727,233105,385100,2015
34027,42,498192,363210,15057,61934,129519,100214,180093,135442,44651,180093,423400,2015
34029,42.8,583450,496778,16901,51293,149817,61994,222494,178850,43644,222494,262700,2015
34031,36.5,507574,219635,55814,198350,117576,59739,161318,86688,74630,161318,336100,2015
34033,41.8,65120,49283,8955,5012,16680,61831,24347,17638,6709,24347,187800,2015
34035,40.8,330604,196255,28993,46148,84966,100667,115998,88277,27721,115998,399000,2015
34037,43.4,145930,127994,2840,10330,39343,86565,53941,44938,9003,53941,270600,2015
34039,38.1,548744,232402,111478,161529,132591,69594,186175,109992,76183,186175,345500,2015
34041,42.6,107226,89844,4327,8589,28860,70471,41667,30111,11556,41667,255300,2015
35001,36.5,673943,272139,17183,328327,161704,47725,263270,163821,99449,263270,185500,2015
35003,57.1,3583,2862,24,629,855,42973,1387,1285,102,1387,166000,2015
35005,34.8,65811,27381,1074,35657,16455,40630,23422,15611,7811,23422,99700,2015
35006,36.2,27382,5732,242,10267,5832,34565,8533,6328,2205,8533,88200,2015
35007,47.6,12997,6230,41,6321,3303,32380,5546,3871,1675,5546,117700,2015
35009,30.7,50497,25277,2873,20152,12373,41084,18162,10601,7561,18162,125600,2015
35011,47.3,2020,1014,0,911,294,32500,520,415,105,520,67000,2015
35013,32.4,213963,62200,3374,142295,51781,38853,74762,48445,26317,74762,138100,2015
35015,36.5,55641,27885,737,25558,14511,56618,20638,15057,5581,20638,124800,2015
35017,46.5,29119,13847,150,14321,7472,38311,12032,9005,3027,12032,132800,2015
35019,41.6,4526,805,71,3498,748,30772,1192,863,329,1192,82200,2015
35021,56.9,565,345,0,218,117,33393,189,157,32,189,65500,2015
35023,41.8,4643,1953,12,2632,1177,34444,1828,1243,585,1828,78200,2015
35025,31.8,68149,26881,2167,37152,16224,57533,21449,14898,6551,21449,108600,2015
35027,50.4,19931,12753,112,6212,5108,40708,8479,6696,1783,8479,161900,2015
35028,43.5,17939,13264,87,2905,5154,101934,7615,5649,1966,7615,274200,2015
35029,39,24789,8183,255,15898,5456,27476,9044,6097,2947,9044,81900,2015
35031,30.8,73998,7320,572,10303,12826,28772,18449,13490,4959,18449,68300,2015
35033,42.6,4660,815,4,3838,883,23822,1654,1324,330,1654,84300,2015
35035,35.6,65318,33387,2315,23607,15586,39775,23668,15218,8450,23668,101800,2015
35037,45.7,8698,4479,192,3831,1895,29113,3347,2380,967,3347,76300,2015
35039,40.1,39949,5238,159,28544,8462,36098,13730,10661,3069,13730,155900,2015
35041,29.4,19908,10781,434,7982,4592,35546,7139,4170,2969,7139,118500,2015
35043,39.1,136638,62189,2631,50357,33541,58982,47931,38853,9078,47931,177400,2015
35045,34.2,125133,51317,604,24504,29352,48671,40643,29820,10823,40643,145400,2015
35047,42.5,28668,5449,383,22060,5749,29237,10788,7783,3005,10788,121200,2015
35049,44.4,147108,63487,950,75131,36482,54315,61179,42266,18913,61179,275200,2015
35051,55.6,11615,7772,53,3380,2908,29356,5044,3644,1400,5044,98800,2015
35053,36.8,17494,6838,129,8598,2858,34037,4947,3597,1350,4947,117800,2015
35055,46.8,32943,11842,148,18508,7897,36582,13224,9534,3690,13224,216200,2015
35057,43.3,15853,8548,201,6444,3449,32083,5370,4475,895,5370,106400,2015
35059,40.3,4339,2348,116,1771,933,36070,1559,1009,550,1559,87400,2015
35061,38.5,76297,26487,788,45161,19054,41703,26863,21410,5453,26863,131900,2015
36001,37.9,307463,228043,36363,16987,67890,59887,123451,72000,51451,123451,208400,2015
36003,38.3,48070,45548,635,734,11838,42776,18285,13373,4912,18285,70300,2015
36005,33.2,1428357,146928,422677,780260,319265,34299,484902,91993,392909,484902,363400,2015
36007,39.9,198093,168178,9555,7459,46966,46261,79132,51992,27140,79132,109900,2015
36009,41.4,78962,71985,1193,1525,20025,42601,31635,22560,9075,31635,84600,2015
36011,42.5,79173,71808,3227,2145,19797,52082,30972,22028,8944,30972,113600,2015
36013,41.7,132646,117041,3054,9043,33580,42993,53546,37284,16262,53546,84500,2015
36015,40.9,88267,76471,5060,2532,21951,50320,35167,24286,10881,35167,100400,2015
36017,43.8,49549,47078,418,1024,12634,45668,19641,14785,4856,19641,91700,2015
36019,39.4,81685,73799,3306,2220,20242,49930,31898,21713,10185,31898,124200,2015
36021,46.6,62195,54393,2528,2664,16245,59105,25235,18141,7094,25235,222100,2015
36023,36.1,49043,45553,723,1226,10794,49514,17935,11788,6147,17935,108200,2015
36025,46.4,46901,43421,825,1660,11731,43720,19262,14000,5262,19262,132400,2015
36027,41.2,296928,216593,27975,33528,72024,71904,106771,73727,33044,106771,275600,2015
36029,40.4,921584,705888,119682,45767,229957,51247,382846,248889,133957,382846,130000,2015
36031,45.9,38912,35886,1110,1156,9947,52758,15268,11275,3993,15268,145100,2015
36033,39.8,51280,41999,2756,1675,12202,47923,19148,13927,5221,19148,101600,2015
36035,42.8,54606,50960,855,1483,14261,46969,22281,15684,6597,22281,108200,2015
36037,42.7,59458,54029,1513,1764,15999,50880,23938,17467,6471,23938,107000,2015
36039,45.2,48312,41658,2786,2563,11541,50278,17634,13261,4373,17634,177700,2015
36041,51.9,4760,4512,24,63,865,48243,1376,1177,199,1376,162600,2015
36043,42.9,64034,60852,592,1247,16909,46229,26130,18556,7574,26130,96100,2015
36045,31.8,118947,98419,6123,8266,30116,49505,44306,24610,19696,44306,141000,2015
36047,34.4,2595259,926945,809358,509243,585894,48201,931786,272717,659069,931786,570200,2015
36049,41.4,27124,26014,247,451,7380,49819,10539,8066,2473,10539,117300,2015
36051,40.1,64801,59100,1447,2157,15650,51734,24226,17624,6602,24226,121200,2015
36053,40.8,72427,67735,1243,1455,17315,54145,26288,19755,6533,26288,124900,2015
36055,38.5,749356,536323,108883,59540,182181,52553,299764,192326,107438,299764,138600,2015
36057,41,49779,41619,725,6111,12324,43764,19539,13109,6430,19539,101600,2015
36059,41.3,1354612,851645,147403,213372,337910,99465,440640,353777,86863,440640,446400,2015
36061,36.6,1629507,767701,207572,420413,310166,72871,750419,172079,578340,750419,848700,2015
36063,42.6,214150,185219,15563,5412,54832,49449,87807,62294,25513,87807,108000,2015
36065,41.2,233558,194569,13196,12024,56216,48246,90844,59675,31169,90844,114000,2015
36067,38.8,468304,364572,49806,21088,112623,55092,184641,120529,64112,184641,135900,2015
36069,43.1,109192,99152,2518,4445,28929,57416,44252,32228,12024,44252,145700,2015
36071,36.8,375384,249415,34951,71699,88788,70848,125270,86184,39086,125270,262500,2015
36073,42.2,42204,36643,2468,1892,10701,46359,16016,12112,3904,16016,91300,2015
36075,39.2,121183,114552,938,2817,30362,47860,45300,32675,12625,45300,94800,2015
36077,41.6,61399,56436,1107,2106,14958,48588,23636,17352,6284,23636,142800,2015
36079,42.8,99488,80787,2152,12618,25937,96148,34090,27946,6144,34090,354900,2015
36081,37.7,2301139,601381,400155,643045,527200,57720,780644,340561,440083,780644,450300,2015
36083,39.8,159900,135285,9148,6913,39493,60709,63447,41240,22207,63447,179100,2015
36085,39.3,472481,296800,45323,84336,122752,73197,165784,114000,51784,165784,439500,2015
36087,36.3,320688,204596,36726,53756,74774,84855,98806,68107,30699,98806,419100,2015
36089,37.8,112011,103238,2342,2415,26288,44705,41449,29600,11849,41449,87600,2015
36091,41.8,223774,205137,3239,6302,59029,71496,89921,64423,25498,89921,232900,2015
36093,39.9,154796,116261,14354,9854,34437,58114,56760,37747,19013,56760,165800,2015
36095,43.3,31913,29868,428,958,8017,51195,12409,9512,2897,12409,147000,2015
36097,45.5,18410,17566,158,318,4818,47680,7686,5933,1753,7686,108500,2015
36099,42.3,35144,31511,1486,1087,8397,49292,13561,9806,3755,13561,97000,2015
36101,42,98665,92654,1519,1517,26139,47280,41058,28756,12302,41058,91000,2015
36103,40.6,1501373,1045354,107319,267396,367526,88663,493849,392390,101459,493849,375100,2015
36105,42.2,76330,56088,5919,11160,17832,50710,28404,18611,9793,28404,165900,2015
36107,43.6,50199,47970,361,797,13812,57514,19872,15585,4287,19872,112600,2015
36109,30.2,103855,81151,3777,4818,20250,52624,38460,21356,17104,38460,176500,2015
36111,43.1,181300,145799,9565,17292,43342,58918,69474,47908,21566,69474,222800,2015
36113,45.2,65180,61638,783,1374,17002,56798,26788,18890,7898,26788,189700,2015
36115,42.9,62700,58182,1753,1572,16459,51143,24237,17531,6706,24237,142700,2015
36117,43.1,92416,83544,3027,3724,24718,50798,36476,28288,8188,36476,112900,2015
36119,40.3,967315,535731,129418,225366,237666,83958,341866,210195,131671,341866,506900,2015
36121,41.1,41446,37232,2219,1313,10484,52564,15787,11865,3922,15787,102000,2015
36123,41.5,25187,24063,237,511,6580,49510,9725,7454,2271,9725,124200,2015
37001,39.2,155258,102350,28265,18432,40938,41814,61545,40273,21272,61545,138100,2015
37003,42.1,37158,32528,2070,1629,9143,39365,13581,10257,3324,13581,124600,2015
37005,47.2,10911,9521,237,1017,3447,36968,4770,3642,1128,4770,146600,2015
37007,39.7,26135,11863,12746,890,6257,33228,9511,6275,3236,9511,76900,2015
37009,46.6,27114,25136,186,1373,8338,36267,11786,8886,2900,11786,151500,2015
37011,43.7,17695,15456,734,831,4646,37777,6801,5307,1494,6801,137100,2015
37013,44.9,47561,31403,12218,3506,11940,40391,18516,13104,5412,18516,115100,2015
37015,44.8,20518,7140,12701,343,4679,30027,7408,5447,1961,7408,78400,2015
37017,42.6,34720,18868,12055,2623,9375,30096,14401,9690,4711,14401,85000,2015
37019,50,115926,94135,12264,5620,34217,46859,49193,37423,11770,49193,182500,2015
37021,41.1,247336,207380,15307,15720,59974,45167,101860,64626,37234,101860,192400,2015
37023,42.9,89548,73673,5263,5174,22824,39360,34180,24366,9814,34180,113100,2015
37025,37.4,188375,131169,30393,18419,48975,54720,67161,47681,19480,67161,167100,2015
37027,42.8,81758,72024,4002,3984,20400,35763,31566,22321,9245,31566,108100,2015
37029,41.1,10161,8171,1399,260,2913,58780,3795,3197,598,3795,209800,2015
37031,46.4,68228,58957,4092,2771,19222,48457,29565,21029,8536,29565,196800,2015
37033,44.9,23174,14196,7577,796,6112,37869,8676,6758,1918,8676,98400,2015
37035,40.8,154610,119091,13032,13537,40404,44376,58641,40729,17912,58641,132700,2015
37037,46.3,67431,48137,8094,8514,18626,56642,26923,20793,6130,26923,223500,2015
37039,50,27092,24829,438,767,7107,34662,10592,8571,2021,10592,142600,2015
37041,44.5,14656,8822,4993,485,4049,38759,5967,3983,1984,5967,135900,2015
37043,50.5,10656,10232,56,316,3088,37076,4540,3474,1066,4540,147900,2015
37045,41.4,97178,71546,20064,2997,24924,39453,37453,25546,11907,37453,104400,2015
37047,41.5,57230,34457,17198,2734,14028,34949,22006,15422,6584,22006,83900,2015
37049,35.9,104450,69552,22042,7243,27519,47985,40131,25127,15004,40131,154500,2015
37051,31.1,324603,147733,114578,34738,80343,44171,122643,64493,58150,122643,129300,2015
37053,42.6,24492,21461,1467,845,6964,60600,9300,7536,1764,9300,229900,2015
37055,45,34863,30615,779,2382,9789,54496,14969,10189,4780,14969,283400,2015
37057,41.5,163867,133272,15147,10860,44782,43363,64299,46221,18078,64299,132200,2015
37059,43.8,41447,35166,2725,2634,11358,51527,15813,12546,3267,15813,169300,2015
37061,38.8,59453,31023,14735,12627,15049,35035,21946,14911,7035,21946,87900,2015
37063,34.4,288817,121493,107085,38768,67955,52503,115975,62241,53734,115975,183800,2015
37065,39.9,55280,20468,31167,2238,14198,32659,21026,12586,8440,21026,82200,2015
37067,37.7,361684,209493,92844,44745,90219,45471,143207,88917,54290,143207,151100,2015
37069,40.2,62296,39545,15861,4913,16479,42685,23506,17523,5983,23506,129500,2015
37071,39.8,209807,156240,31666,13153,53543,42429,79166,52638,26528,79166,125100,2015
37073,43.2,11724,7334,3940,218,3241,49258,4402,3504,898,4402,144300,2015
37075,44.6,8700,7659,47,128,2338,34805,3267,2683,584,3267,120700,2015
37077,41.4,58109,34045,17810,4318,14118,50225,20223,14666,5557,20223,142600,2015
37079,39,21328,10130,7589,3142,4755,35777,7222,5026,2196,7222,87700,2015
37081,36.9,506763,265781,166233,38207,126562,45651,199540,118976,80564,199540,156100,2015
37083,42.1,53407,20929,27734,1379,13977,32245,21468,13524,7944,21468,86600,2015
37085,33.6,124320,78090,25330,14541,30799,46353,42672,28139,14533,42672,135400,2015
37087,46.8,59170,55244,521,2109,17130,42257,26111,19030,7081,26111,161300,2015
37089,46.3,109719,91730,3229,10814,30305,46448,46079,33454,12625,46079,182300,2015
37091,41.7,24368,8215,14106,781,5656,33008,8651,5668,2983,8651,83000,2015
37093,31.4,51075,21011,16655,6302,12514,41542,16990,11234,5756,16990,141500,2015
37095,43,5693,3334,2007,304,1361,42897,2050,1593,457,2050,90600,2015
37097,39.9,165066,126743,19984,11836,43897,52306,60893,44390,16503,60893,166300,2015
37099,36.8,40812,33052,911,2159,9817,38015,15956,10786,5170,15956,171900,2015
37101,37.4,178396,123424,26332,23489,45767,50512,61950,43871,18079,61950,145500,2015
37103,45.2,10166,6305,3214,424,2829,34005,4136,2920,1216,4136,93900,2015
37105,37.5,59418,34689,11326,11434,14685,45608,21206,14145,7061,21206,136900,2015
37107,42.1,58782,29696,23197,4186,15350,34717,23335,14083,9252,23335,92500,2015
37109,42,79578,67925,4008,5599,22264,49215,30088,23191,6897,30088,153200,2015
37111,43.1,44961,39530,1730,2531,11965,35965,17323,12165,5158,17323,98400,2015
37113,49,33919,30431,375,2253,10059,39133,15536,11258,4278,15536,165600,2015
37115,44,21027,19780,392,496,5741,37904,8450,6198,2252,8450,159900,2015
37117,46,23729,12321,10330,840,6107,35080,9269,6329,2940,9269,85500,2015
37119,34.5,990288,486387,301573,123971,235877,56854,379786,218311,161475,379786,184800,2015
37121,46.7,15330,14294,133,699,4295,37391,6344,4862,1482,6344,141100,2015
37123,41.1,27601,17549,5094,4121,6760,32500,10588,7443,3145,10588,90900,2015
37125,45.1,91743,70935,11325,5710,24529,50998,37143,27714,9429,37143,199100,2015
37127,41,94722,49439,36019,6138,23890,42713,36711,23632,13079,36711,118600,2015
37129,37.8,213091,163527,30410,11461,51829,50088,88403,50638,37765,88403,214300,2015
37131,47.1,21011,8101,11916,391,5739,30429,8630,5950,2680,8630,82500,2015
37133,26.1,183753,123644,27226,21348,44838,46335,62185,33428,28757,62185,154000,2015
37135,33.3,138644,96748,15968,11506,31322,59290,51880,31331,20549,51880,272600,2015
37137,49.8,12982,9625,2429,439,3661,43444,5237,3975,1262,5237,150800,2015
37139,37.4,40018,21973,14745,1799,10238,45378,14448,9030,5418,14448,158800,2015
37141,42.1,55166,40959,9440,3461,13595,44828,20130,15490,4640,20130,153400,2015
37143,47.8,13498,9659,3276,308,3840,44329,5500,4278,1222,5500,165800,2015
37145,42.4,39262,26061,10694,1654,10378,42105,15383,11038,4345,15383,115500,2015
37147,31.5,173798,97424,58868,10042,40239,41119,67502,35626,31876,67502,135300,2015
37149,50.9,20327,17916,1034,1151,5804,46528,8701,6512,2189,8701,190700,2015
37151,40.5,142370,114376,8151,15547,38074,41947,54507,39612,14895,54507,120700,2015
37153,39.9,46046,26670,14561,2857,11928,32687,18461,11579,6882,18461,78600,2015
37155,35.2,134871,35850,32411,11028,32212,30608,45773,28886,16887,45773,70200,2015
37157,43.6,92300,67351,16770,5411,25111,38126,37583,25841,11742,37583,106700,2015
37159,40.3,138361,101262,22260,11100,35293,43069,51612,34764,16848,51612,128300,2015
37161,43.3,66865,56071,6686,2592,18334,35630,26426,18870,7556,26426,106600,2015
37163,39.2,63873,33478,16320,11436,15698,35490,23280,16478,6802,23280,87600,2015
37165,39.1,35932,16105,13772,960,8905,30958,12996,8196,4800,12996,79100,2015
37167,41.8,60586,49468,6270,2336,16472,40910,23667,16815,6852,23667,128200,2015
37169,44.7,46661,42672,1915,1311,13349,40696,18968,14696,4272,18968,117400,2015
37171,42.7,73170,61843,2624,7349,19798,36164,29267,21094,8173,29267,115500,2015
37173,40.7,14163,9065,216,342,3516,33931,5379,3888,1491,5379,126700,2015
37175,50.1,32928,29357,1246,1020,9278,45114,13667,10476,3191,13667,192000,2015
37177,44.4,4152,2333,1262,403,1004,32361,1451,1072,379,1451,98800,2015
37179,37.2,213422,156829,24897,23010,56308,65903,70711,56496,14215,70711,197400,2015
37181,40,44829,18454,22115,3167,10463,33316,16589,10411,6178,16589,97900,2015
37183,35.3,976019,595920,198930,97043,243940,67309,364669,234084,130585,364669,234000,2015
37185,46.1,20468,7821,10243,772,4888,34254,7817,5483,2334,7817,96400,2015
37187,45.1,12668,5707,6195,590,3358,34538,5216,3581,1635,5216,82700,2015
37189,29.5,52240,48089,570,1810,10616,37656,19996,11570,8426,19996,231700,2015
37191,36.7,124355,67900,38459,13362,31600,40390,47530,28479,19051,47530,110400,2015
37193,43.7,68946,60898,3082,3977,18925,33232,27422,20385,7037,27422,114800,2015
37195,39.9,81581,39416,31173,8103,21179,39847,32003,19213,12790,32003,116300,2015
37197,42.9,37971,32283,1284,3979,10585,37796,15369,11688,3681,15369,124400,2015
37199,46.2,17604,16371,207,830,5264,37484,7416,5596,1820,7416,140500,2015
38001,47.6,2341,2162,26,26,741,52118,1067,786,281,1067,126100,2015
38003,42.8,11097,10403,104,174,3074,53141,5056,3473,1583,5056,97600,2015
38005,31,6794,2861,0,151,1620,41296,2280,1463,817,2280,63600,2015
38007,45,969,885,8,42,280,70469,407,301,106,407,145300,2015
38009,46,6634,6158,59,119,1867,56349,3035,2257,778,3035,116800,2015
38011,43.6,3221,3013,4,142,886,66845,1377,1019,358,1377,135000,2015
38013,36.5,2208,2054,1,117,573,60096,980,659,321,980,110100,2015
38015,36.8,88223,80347,755,1542,23107,65254,37061,25896,11165,37061,199200,2015
38017,31.9,162500,144298,4980,3805,38056,53289,68776,35858,32918,68776,172100,2015
38019,50.8,3890,3742,3,0,1139,66806,1746,1498,248,1746,86700,2015
38021,43.2,5195,4884,77,151,1378,53750,2132,1533,599,2132,92000,2015
38023,51.7,2314,2210,11,4,678,56042,1081,858,223,1081,100400,2015
38025,41.7,4195,3484,4,116,1087,69732,1557,1261,296,1557,146400,2015
38027,48.3,2370,2146,0,79,614,48583,1060,785,275,1060,68500,2015
38029,51.2,3463,3352,0,4,975,44051,1599,1289,310,1599,79900,2015
38031,46.9,3366,3248,4,39,1012,55769,1484,1097,387,1484,96300,2015
38033,41,1822,1741,0,36,448,40179,803,542,261,803,107000,2015
38035,29.4,68979,59526,1706,2524,15910,48676,28521,14244,14277,28521,160600,2015
38037,53.6,2362,2292,8,20,690,44559,1136,925,211,1136,75100,2015
38039,51.8,2329,2249,29,9,697,48355,1035,765,270,1035,83600,2015
38041,48.4,2621,2468,19,49,787,52169,1091,906,185,1091,95700,2015
38043,47,2430,2302,0,122,791,54559,1084,877,207,1084,87600,2015
38045,48.5,4113,4025,5,33,1199,54821,1840,1444,396,1840,85200,2015
38047,51.8,1945,1878,6,28,555,51458,878,733,145,878,71000,2015
38049,43.3,5817,5542,10,140,1626,57386,2608,2135,473,2608,107700,2015
38051,53.4,2759,2644,9,25,833,42277,1289,1059,230,1289,62800,2015
38053,32.2,9615,7372,77,268,2203,72794,3214,1966,1248,3214,198400,2015
38055,47.1,9451,8466,4,206,2838,55686,4234,3227,1007,4234,130500,2015
38057,45.6,8633,8104,4,192,2507,72704,3673,3049,624,3673,136600,2015
38059,38.9,28985,26489,187,665,7973,62418,12308,9308,3000,12308,165500,2015
38061,34.8,9253,5964,11,534,2120,68188,3206,2234,972,3206,132300,2015
38063,52.8,3048,2883,42,59,889,51085,1522,1178,344,1522,73200,2015
38065,48.5,1819,1668,6,53,571,60278,792,642,150,792,120300,2015
38067,47.2,7206,6686,17,230,2067,53504,3285,2567,718,3285,76900,2015
38069,46.9,4395,4206,23,47,1214,42563,2018,1478,540,2018,97900,2015
38071,42.5,11566,9883,11,259,2836,50841,5016,3179,1837,5016,102400,2015
38073,44.5,5453,5221,32,87,1467,56500,2352,1596,756,2352,103600,2015
38075,39.9,2562,2456,4,63,662,65125,1020,796,224,1020,118000,2015
38077,38.9,16317,15110,76,400,4171,55390,6621,4722,1899,6621,102000,2015
38079,30.3,14498,2891,76,66,3437,33277,4774,3234,1540,4774,69000,2015
38081,45.3,3874,3663,42,102,1093,57125,1728,1305,423,1728,77900,2015
38083,52,1337,1313,0,4,443,48102,653,532,121,653,69600,2015
38085,27,4380,610,2,156,837,38068,1098,453,645,1098,66200,2015
38087,50.4,673,655,4,2,207,55000,322,276,46,322,101100,2015
38089,35,28628,25858,319,1246,7191,72099,11379,7819,3560,11379,206200,2015
38091,50.2,1979,1947,0,32,565,55833,948,734,214,948,74900,2015
38093,40.6,21076,19737,110,424,5284,52359,9061,6042,3019,9061,111200,2015
38095,48.5,2294,2037,0,36,661,56625,1003,781,222,1003,70400,2015
38097,41.4,8077,7561,47,245,1978,54960,3278,2400,878,3278,105600,2015
38099,45.4,11005,9433,26,1170,3148,49411,4929,3663,1266,4929,75400,2015
38101,31.1,67736,58202,2069,3151,15993,61393,26131,16030,10101,26131,189500,2015
38103,51,4204,4110,0,29,1253,48098,2008,1576,432,2008,73700,2015
38105,32.6,29619,25719,532,1346,7633,88013,12082,7735,4347,12082,201400,2015
39001,41,28229,27299,108,247,7441,35560,10858,7495,3363,10858,87900,2015
39003,38.1,105196,85876,12646,2813,26203,44103,39986,26883,13103,39986,105400,2015
39005,39.9,53189,51160,443,607,13980,48003,20427,14680,5747,20427,120800,2015
39007,41.8,99777,89961,3343,3755,25206,40544,38890,27701,11189,38890,106000,2015
39009,28,64974,58513,1482,1180,12464,33872,22486,12662,9824,22486,117700,2015
39011,41,45873,44274,207,632,12463,54274,18193,13493,4700,18193,133300,2015
39013,43.9,69560,64816,2656,576,18038,43833,27935,20719,7216,27935,91700,2015
39015,40.8,44247,42766,436,348,12053,45568,16672,12614,4058,16672,113800,2015
39017,36.4,372538,309123,28417,15982,93384,57540,134720,93510,41210,134720,157200,2015
39019,44.5,28361,27415,237,317,7816,47075,10972,8593,2379,10972,112200,2015
39021,41.2,39393,36906,736,570,10826,50974,15237,11195,4042,15237,123200,2015
39023,41,136827,115933,11565,4113,35980,43625,54809,36310,18499,54809,103600,2015
39025,39.5,200285,188777,2793,3371,53236,60805,74812,55099,19713,74812,155500,2015
39027,39.3,41892,39188,1030,672,11097,46787,16073,10354,5719,16073,120000,2015
39029,43.2,105987,100099,2307,1527,28616,44497,42087,29930,12157,42087,101100,2015
39031,41.5,36724,35337,390,330,9961,41701,14335,10672,3663,14335,96500,2015
39033,42.6,42725,41026,292,594,11722,40795,17798,12208,5590,17798,86700,2015
39035,40.4,1263189,762825,370327,66416,305683,44190,534719,317310,217409,534719,121800,2015
39037,41.8,52356,50549,332,728,14154,44632,20865,15053,5812,20865,109900,2015
39039,39.7,38669,33645,650,3657,10561,50663,15279,11451,3828,15279,108900,2015
39041,37.8,185433,161561,6611,4325,50267,91955,65648,53523,12125,65648,256800,2015
39043,44,76141,64016,6314,2944,20161,48011,31767,21798,9969,31767,131400,2015
39045,39,149112,131258,9532,2936,39967,60567,55032,38803,16229,55032,163100,2015
39047,41.1,28769,26849,554,526,7669,40503,11589,6963,4626,11589,107400,2015
39049,33.8,1215761,800021,256550,60943,279594,52341,480946,258868,222078,480946,150600,2015
39051,39.8,42485,38159,218,3474,11943,55120,16229,12746,3483,16229,129500,2015
39053,41,30565,28654,759,363,8202,37319,11590,8880,2710,11590,94900,2015
39055,44.2,93874,89972,1232,1193,26125,72430,34774,29605,5169,34774,218800,2015
39057,37.7,164192,138632,11713,4232,42229,60113,64182,43163,21019,64182,159400,2015
39059,42.2,39626,37675,614,393,10305,40930,15558,11363,4195,15558,95600,2015
39061,37,804194,537298,205489,22613,194047,49013,331638,193184,138454,331638,142000,2015
39063,39.2,75428,68018,998,3728,20133,50895,31083,21951,9132,31083,127100,2015
39065,35.4,31736,30295,296,473,7686,42703,11540,8185,3355,11540,94000,2015
39067,45.9,15633,14884,328,127,4422,43173,6271,4994,1277,6271,85400,2015
39069,41.2,28015,25425,155,2000,7698,53835,10958,8818,2140,10958,111000,2015
39071,40.1,43170,41360,523,352,11239,39858,16696,11785,4911,16696,103500,2015
39073,42.6,28914,27962,237,244,7841,42170,11387,8465,2922,11387,110600,2015
39075,30.4,43436,42552,86,398,10177,51996,12685,9661,3024,12685,161100,2015
39077,38.8,58937,53564,650,3538,15754,48745,22527,15929,6598,22527,116100,2015
39079,39.5,32854,31593,202,306,8592,39460,12981,8791,4190,12981,91200,2015
39081,44.3,68053,61707,3806,859,18208,41942,27958,19796,8162,27958,86200,2015
39083,38.7,61004,58294,548,844,15269,48533,22759,16124,6635,22759,132500,2015
39085,43.2,229437,205905,8272,8805,61685,58029,94815,70102,24713,94815,147900,2015
39087,41.2,61827,58725,1332,516,15963,42874,23548,17472,6076,23548,98900,2015
39089,39.7,168693,154496,5516,2750,45206,56549,64230,46298,17932,64230,152200,2015
39091,40.7,45484,42793,880,612,12733,49783,18640,13725,4915,18640,119400,2015
39093,41,303152,240822,23547,27411,79771,52457,117298,83591,33707,117298,137400,2015
39095,37.7,436261,305764,80734,28558,106520,41777,177619,108258,69361,177619,104200,2015
39097,40.2,43456,38798,2532,701,10519,57406,14906,10482,4424,14906,149200,2015
39099,43.3,234550,180423,35019,12132,60900,41375,97790,66710,31080,97790,97400,2015
39101,40.4,65943,58743,3785,1575,16761,42966,24478,16618,7860,24478,96400,2015
39103,41.4,174831,165023,2449,3198,47945,66952,66002,52373,13629,66002,179500,2015
39105,42.3,23473,22767,261,121,6420,37813,9322,7317,2005,9322,84900,2015
39107,40.1,40863,39304,178,682,11099,53099,15919,12190,3729,15919,130200,2015
39109,41.4,103517,96412,2235,1525,27826,51569,41135,28906,12229,41135,136800,2015
39111,45.6,14547,14200,71,67,4204,41528,6056,4687,1369,6056,92200,2015
39113,39.4,533763,384338,109373,13466,133872,43829,222687,135689,86998,222687,109900,2015
39115,43.9,14913,13810,527,112,4378,37067,6120,4715,1405,6120,88300,2015
39117,41.2,34996,33692,142,466,9392,51993,12700,10298,2402,12700,132800,2015
39119,40.3,86016,79165,2823,783,22897,41130,34261,22899,11362,34261,108600,2015
39121,50.2,14508,13391,812,130,3362,41708,4886,4074,812,4886,87100,2015
39123,47.3,41162,38118,377,1956,12034,53914,17334,13775,3559,17334,138800,2015
39125,41,19165,17755,164,859,5303,45550,7699,6010,1689,7699,91900,2015
39127,40,36025,35007,97,252,10065,42017,13780,10093,3687,13780,91800,2015
39129,39.1,56515,52699,1802,724,14161,57439,19460,14363,5097,19460,147700,2015
39131,40.8,28396,27177,198,242,7254,40283,10940,7463,3477,10940,95000,2015
39133,37.6,161897,146480,6274,2517,40002,52552,61055,41928,19127,61055,150900,2015
39135,41.9,41682,40383,259,285,11412,47818,16124,12375,3749,16124,112700,2015
39137,39.7,34184,31794,111,1966,9523,60524,13049,10766,2283,13049,138900,2015
39139,41.3,122312,105448,9094,2031,30471,41877,48103,33004,15099,48103,102500,2015
39141,40.6,77334,69503,4004,876,19608,43345,28269,20275,7994,28269,110300,2015
39143,41.3,60187,51358,1875,5664,15850,47209,23626,17523,6103,23626,110100,2015
39145,39.5,78017,72985,2014,962,18677,35903,29700,20345,9355,29700,90200,2015
39147,39,55929,50680,1322,2660,14426,45444,21538,15358,6180,21538,96900,2015
39149,38.9,49067,45843,1225,752,13382,54550,18537,13138,5399,18537,130000,2015
39151,41.8,374979,327096,26587,6806,98810,47137,150385,103621,46764,150385,122900,2015
39153,40.7,541847,425784,76981,9938,138178,50765,220902,146424,74478,220902,133500,2015
39155,43.6,206373,180839,16835,3268,55428,43073,86828,61531,25297,86828,97000,2015
39157,41,92697,88284,783,2131,25250,45310,36713,25820,10893,36713,111100,2015
39159,38.1,53470,48739,1233,778,13816,67382,18431,14277,4154,18431,171200,2015
39161,41.5,28576,27056,257,790,7851,48060,11355,8594,2761,11355,95800,2015
39163,41,13234,12836,57,22,3462,40680,4992,3848,1144,4992,81000,2015
39165,38.7,219916,193119,7356,5379,58919,74379,78359,60511,17848,78359,190900,2015
39167,43.6,61351,58501,677,615,16380,43509,25064,18837,6227,25064,110700,2015
39169,38.8,115371,108671,1890,1984,30420,50383,42910,31355,11555,42910,135700,2015
39171,41.6,37386,34877,405,1506,9818,42492,15150,11305,3845,15150,95800,2015
39173,34.8,128885,114708,3308,6585,30997,53577,50091,33440,16651,50091,146300,2015
39175,42,22467,21755,43,566,6236,47555,9327,6734,2593,9327,106200,2015
40001,37,22236,9292,66,1351,5910,33404,7968,5605,2363,7968,76600,2015
40003,44.7,5755,4432,110,287,1359,50156,2072,1575,497,2072,64600,2015
40005,40.7,13906,10046,541,476,3750,36661,5258,3846,1412,5258,85400,2015
40007,41.5,5530,4201,31,1198,1465,52090,2017,1594,423,2017,89300,2015
40009,34.7,23300,17864,794,3155,5170,48601,7535,4815,2720,7535,122400,2015
40011,41.1,9810,7350,546,891,2317,41972,3580,2688,892,3580,77900,2015
40013,37.1,44003,31960,833,2391,10635,38847,16632,10749,5883,16632,90100,2015
40015,37,29495,17170,787,3314,6953,40674,10202,7156,3046,10202,78400,2015
40017,35.7,126193,98375,2875,9824,31844,64505,43063,33128,9935,43063,144600,2015
40019,38.6,48442,34580,3353,3098,11743,44531,17867,12493,5374,17867,97000,2015
40021,34.8,48097,23788,596,3157,10683,38694,16324,10912,5412,16324,108100,2015
40023,41.8,15120,9427,1729,539,3727,30617,5924,4201,1723,5924,80900,2015
40025,44.6,2341,1773,5,490,664,46680,1017,741,276,1017,59500,2015
40027,33.2,268614,198125,12044,20850,65681,56452,99276,65881,33395,99276,146100,2015
40029,42.3,5812,4126,20,210,1607,38243,2288,1658,630,2288,80100,2015
40031,31.8,125531,72232,20488,15550,28272,46241,43240,23887,19353,43240,115800,2015
40033,41.5,6112,4721,120,428,1745,46361,2429,1838,591,2429,79900,2015
40035,42.3,14744,9539,457,460,3660,38876,5418,4091,1327,5418,90600,2015
40037,40.6,70761,54780,1643,2592,18632,45016,26204,19657,6547,26204,105000,2015
40039,30.7,28978,20478,897,4681,7130,46125,10364,6189,4175,10364,119000,2015
40041,45.8,41409,26904,123,1394,11272,37942,16561,12525,4036,16561,109000,2015
40043,41.5,4863,4094,9,301,1281,50904,1851,1350,501,1851,84200,2015
40045,44.3,4121,3642,1,292,1127,50855,1710,1318,392,1710,81800,2015
40047,36.2,62192,48133,1903,6665,16911,48238,23937,15938,7999,23937,96900,2015
40049,39.5,27455,21159,641,2030,6946,40524,10531,7310,3221,10531,88000,2015
40051,38.5,53612,44095,1111,2818,14319,52279,19589,14860,4729,19589,111200,2015
40053,44.2,4517,4060,17,184,1328,50250,1968,1486,482,1968,73200,2015
40055,41.3,6117,4670,436,652,1349,40125,2186,1443,743,2186,61600,2015
40057,41.1,2866,1743,188,760,821,31250,1174,813,361,1174,51300,2015
40059,39,3766,2918,3,750,980,48359,1444,1160,284,1444,74100,2015
40061,40,12850,9264,98,502,3377,35252,4903,3590,1313,4903,80100,2015
40063,40.2,13785,8987,802,629,2985,35563,4454,3352,1102,4454,67600,2015
40065,34.1,26056,16724,1920,5829,6690,41560,10220,5999,4221,10220,90300,2015
40067,42.4,6333,5000,44,589,1635,33449,2471,1770,701,2471,56600,2015
40069,40.6,11022,7795,202,493,2718,38776,4164,3026,1138,4164,78200,2015
40071,38.8,45587,34665,854,3281,11553,42134,18115,12488,5627,18115,78800,2015
40073,38.6,15302,11969,81,2226,4185,60034,5741,4384,1357,5741,122100,2015
40075,43,9302,7025,356,966,2544,39909,3939,2736,1203,3939,60300,2015
40077,39.3,10774,7303,152,349,2930,39205,4135,2833,1302,4135,80500,2015
40079,39.7,49899,36083,1197,3373,12601,36490,18164,13322,4842,18164,81600,2015
40081,40.7,34504,28798,603,1017,9405,45149,13231,10220,3011,13231,99800,2015
40083,38.5,44493,34647,4027,2464,11083,55299,15091,11934,3157,15091,142900,2015
40085,39.1,9663,7077,178,1344,2377,44549,3202,2445,757,3202,89000,2015
40087,38.3,36512,29158,335,2735,9998,56088,13244,10623,2621,13244,152600,2015
40089,39.1,33143,21205,2720,1763,9103,32324,12908,8902,4006,12908,73700,2015
40091,47.4,20280,13920,711,488,5767,36011,8373,6554,1819,8373,90100,2015
40093,41.6,7700,6611,28,689,2181,51571,3051,2273,778,3051,89300,2015
40095,43.1,16014,10797,236,2516,3993,40475,5965,4563,1402,5965,85700,2015
40097,39.3,41007,27017,164,1296,11229,42071,15740,11531,4209,15740,104000,2015
40099,41.3,13733,10187,184,760,3508,47077,5343,3582,1761,5343,88500,2015
40101,37.8,70224,40284,7710,4005,17653,39984,26349,17650,8699,26349,91500,2015
40103,40.7,11506,9486,165,355,3465,48285,4670,3513,1157,4670,87500,2015
40105,41.4,10555,7111,203,299,2842,39875,4046,3149,897,4046,76300,2015
40107,39.6,12248,7596,946,477,2826,36216,4048,3000,1048,4048,76400,2015
40109,34.2,754480,437189,110135,121246,181431,47437,291390,171014,120376,291390,133400,2015
40111,39.2,39446,25075,3202,1453,9714,38843,15022,10416,4606,15022,78800,2015
40113,41.9,48054,30896,5472,1534,12576,45443,18271,14203,4068,18271,100000,2015
40115,38.5,32085,21262,277,1639,8200,36347,12061,8433,3628,12061,82600,2015
40117,41.4,16499,12849,183,452,4548,45765,6278,4781,1497,6278,85100,2015
40119,27.2,79423,61804,2841,3463,16568,37667,30164,15152,15012,30164,135600,2015
40121,40.7,44961,31659,1498,2028,12008,42576,18087,13099,4988,18087,94500,2015
40123,35.3,38055,25731,869,1775,9347,43261,14591,9355,5236,14591,107800,2015
40125,37.6,71136,52293,1990,3367,18041,44688,25996,17892,8104,25996,102700,2015
40127,44.8,11226,8205,133,359,2978,32445,4749,3530,1219,4749,72600,2015
40129,40.6,3780,3210,4,246,852,50739,1340,974,366,1340,86100,2015
40131,38.8,89190,65064,934,3680,25268,58139,33358,26320,7038,33358,144600,2015
40133,39.7,25481,16757,1272,1127,6323,36068,9202,6671,2531,9202,69200,2015
40135,39.9,41464,26709,779,1552,11130,35736,15552,11116,4436,15552,89600,2015
40137,40.1,44806,36451,853,3063,12020,43781,17868,12567,5301,17868,98400,2015
40139,31.5,21588,10304,471,9759,5098,50242,7173,4454,2719,7173,92700,2015
40141,40.5,7715,4796,587,1885,2137,37759,3057,2234,823,3057,56600,2015
40143,35.3,623335,398866,62014,72657,156574,49759,246080,146793,99287,246080,138500,2015
40145,38.4,75391,54776,2659,4067,20722,55715,27452,21888,5564,27452,141700,2015
40147,40.5,51760,38431,1330,2864,14168,50023,21001,15193,5808,21001,111300,2015
40149,38.8,11649,9823,6,1069,3300,49632,4640,3339,1301,4640,77600,2015
40151,33.9,9033,7675,290,529,2035,55315,3426,2371,1055,3426,88200,2015
40153,36.1,20986,17081,132,2412,5042,55300,7367,5243,2124,7367,115400,2015
41001,48.2,16052,14735,41,603,4453,41098,7160,4730,2430,7160,146600,2015
41003,32.7,86495,71146,736,5975,18837,49802,33840,19470,14370,33840,269700,2015
41005,41.3,389438,324872,3162,31871,102929,65965,149522,102040,47482,149522,301000,2015
41007,43.9,37382,32291,277,3014,9607,46408,15726,9546,6180,15726,246500,2015
41009,42.9,49389,44188,235,2249,12787,53179,18785,13788,4997,18785,206100,2015
41011,48.1,62775,53860,380,3735,15668,38605,25888,16831,9057,25888,170500,2015
41013,48.1,20956,18602,58,1545,5900,37106,9079,6233,2846,9079,166900,2015
41015,54.6,22338,19545,73,1404,6035,40884,10454,6841,3613,10454,218200,2015
41017,41.9,166622,146449,734,12831,44349,51223,66337,42919,23418,66337,253400,2015
41019,46.9,107194,95193,340,5553,29108,41312,43798,29523,14275,43798,169700,2015
41021,48.2,1883,1697,18,147,521,44293,833,506,327,833,117900,2015
41023,51.1,7276,6712,24,254,1953,38046,3149,2276,873,3149,143000,2015
41025,46.2,7229,6346,47,334,2128,37580,3038,2096,942,3038,102000,2015
41027,39.4,22749,14749,112,6948,5259,55827,8189,5313,2876,8189,321300,2015
41029,42.8,208363,171619,1324,24496,53375,44028,83487,51746,31741,83487,218100,2015
41031,39.9,22061,13369,199,4323,5384,46366,7692,5136,2556,7692,149100,2015
41033,47.9,83409,73198,283,5731,22089,37665,34527,22919,11608,34527,215900,2015
41035,42.5,65972,52552,529,7641,17777,40336,27188,17626,9562,27188,151500,2015
41037,48.3,7842,6711,29,603,1955,32369,3526,2114,1412,3526,129100,2015
41039,39.3,357060,297692,3395,28768,86645,44103,146235,85785,60450,146235,215300,2015
41041,50.4,46347,38590,155,3912,12489,42101,20566,13125,7441,20566,219100,2015
41043,39.5,118971,102802,521,9856,30709,45644,45100,28988,16112,45100,170300,2015
41045,36.1,30551,19009,290,9987,6845,35418,10286,6145,4141,10286,127000,2015
41047,35.8,323259,216600,3128,81907,78914,48432,113996,68134,45862,113996,186700,2015
41049,37.4,11204,6941,49,3811,2755,50918,3772,2635,1137,3772,121800,2015
41051,36.5,768418,547919,40815,85202,169156,54102,310669,167110,143559,310669,278300,2015
41053,37.4,77264,61558,525,9910,19363,52821,28458,18292,10166,28458,209200,2015
41055,49.8,1795,1525,10,128,471,38362,804,495,309,804,140500,2015
41057,48,25430,21691,59,2539,6404,42581,10094,7311,2783,10094,222900,2015
41059,36,76738,52015,530,19377,18288,48101,26794,16791,10003,26794,144000,2015
41061,40,25745,23104,151,1130,6432,43822,10130,6467,3663,10130,163200,2015
41063,52.2,6857,6415,21,183,1925,40581,3082,2078,1004,3082,204500,2015
41065,41,25492,19387,107,4215,6506,43422,9704,6263,3441,9704,174800,2015
41067,36.1,556210,379525,9778,89846,139850,66754,206426,124690,81736,206426,285100,2015
41069,56.5,1348,1291,0,19,407,33487,671,472,199,671,113800,2015
41071,38.2,101119,79112,970,15599,24518,53423,34425,23203,11222,34425,220800,2015
42001,42.8,101767,91434,1510,6613,27376,60356,38193,29536,8657,38193,193100,2015
42003,40.9,1231145,980112,158380,22537,305488,53040,529534,343306,186228,529534,129600,2015
42005,45.6,67979,66206,636,445,19141,44942,28524,21411,7113,28524,96000,2015
42007,44.8,169785,152737,10121,2340,46003,50581,70079,51134,18945,70079,120100,2015
42009,45,49086,47663,245,516,13911,45930,20000,15930,4070,20000,122700,2015
42011,39.7,413965,309200,17025,75409,105998,55936,153312,110223,43089,153312,168200,2015
42013,42.8,126448,120251,1999,1404,32758,43981,51034,36617,14417,51034,110600,2015
42015,44.1,62228,59889,328,883,16651,48987,24358,18168,6190,24358,135900,2015
42017,43,626583,535979,23174,29708,166529,77568,233066,178113,54953,233066,308800,2015
42019,42.7,185689,176986,1992,2354,50775,60934,74476,57196,17280,74476,178100,2015
42021,44.4,139381,129671,4531,2149,36531,42107,57465,42440,15025,57465,87100,2015
42023,49.9,4869,4737,30,34,1320,39897,2170,1525,645,2170,70600,2015
42025,45,64634,59990,872,2526,17277,49973,25751,20158,5593,25751,144700,2015
42027,30.3,157823,136652,5484,4317,32532,52186,57183,34606,22577,57183,197200,2015
42029,40.1,509797,412444,29506,35579,130680,85976,186057,139807,46250,186057,325800,2015
42031,40.3,39454,38058,429,282,9906,42536,15830,10963,4867,15830,107100,2015
42033,43.9,81343,75983,1822,2250,21184,42257,31817,24555,7262,31817,87300,2015
42035,38.1,39614,37786,547,528,9911,45078,14796,10549,4247,14796,117400,2015
42037,40.1,66912,62661,1216,1644,16765,45374,26178,18440,7738,26178,140600,2015
42039,42.4,87343,83136,1545,1017,23333,44579,34575,25422,9153,34575,104800,2015
42041,40.8,241427,212171,8027,7844,62224,61820,95950,67813,28137,95950,188400,2015
42043,39.6,271094,185458,46997,21597,69264,53754,109623,69586,40037,109623,159200,2015
42045,38.9,561683,388429,113923,19073,136633,65123,203817,142548,61269,203817,232700,2015
42047,46.4,31370,30619,144,223,8556,46671,13244,10344,2900,13244,90700,2015
42049,38.8,279858,239185,18730,10572,69932,45971,109934,72273,37661,109934,118200,2015
42051,44.2,134851,124606,5457,1350,34500,39636,53997,38729,15268,53997,88900,2015
42053,43.3,7581,4862,2027,487,1167,35533,1974,1632,342,1974,84400,2015
42055,40.9,152285,135822,5470,7400,40598,53916,58570,42014,16556,58570,173400,2015
42057,43.2,14694,14182,188,157,4161,48311,5960,4714,1246,5960,153200,2015
42059,41.9,37938,34601,1808,857,9616,46661,14394,10518,3876,14394,97400,2015
42061,42.5,45906,41877,2342,816,11758,44396,17225,13118,4107,17225,119000,2015
42063,38.9,87895,82505,2050,1150,21318,45195,34061,24112,9949,34061,107000,2015
42065,43.6,44756,43615,231,341,12293,42903,18479,13802,4677,18479,90300,2015
42067,43,24829,23640,188,725,6414,47398,9393,7078,2315,9393,141700,2015
42069,42.3,213459,187898,5770,12664,52407,46271,85034,56646,28388,85034,144800,2015
42071,38.4,530216,442338,18448,50765,137133,57721,195330,134548,60782,195330,189200,2015
42073,44.4,89162,82297,3339,1047,24228,44571,36435,26929,9506,36435,97300,2015
42075,41.1,135776,115056,2324,14951,35976,55499,52267,36836,15431,52267,163800,2015
42077,39.5,356756,244451,18254,75169,89871,56117,133960,89178,44782,133960,191700,2015
42079,42.9,320095,274232,10395,27638,81766,45897,128692,87053,41639,128692,122700,2015
42081,41.4,116656,106063,5517,2031,29537,47313,45906,32187,13719,45906,138500,2015
42083,42.4,42884,40239,968,861,11034,43965,17400,12832,4568,17400,76200,2015
42085,43.8,115320,104346,6497,1481,30174,44156,45546,33564,11982,45546,107900,2015
42087,43.5,46675,45025,330,609,12542,41288,18714,13178,5536,18714,97800,2015
42089,41.8,167881,114983,21343,23909,41743,57365,57297,44899,12398,57297,174500,2015
42091,41.1,812970,629397,70479,37577,210938,80675,308626,223952,84674,308626,292300,2015
42093,42.9,18508,17125,296,444,4657,54648,7380,5346,2034,7380,163400,2015
42095,41.8,299616,236265,13450,35040,78401,60972,112927,81074,31853,112927,206100,2015
42097,43.8,94006,87685,2372,2732,24849,42406,39375,28038,11337,39375,104300,2015
42099,42.1,45677,43849,376,733,12769,57177,18085,14254,3831,18085,159900,2015
42101,33.7,1555072,557211,645130,207721,309568,38253,581050,305884,275166,581050,145300,2015
42103,46,56632,46303,3129,5582,15207,60180,21079,17720,3359,21079,183200,2015
42105,45.8,17377,16837,92,193,4353,40654,6669,5140,1529,6669,101200,2015
42107,43.8,146360,135013,3826,5002,38066,45535,58554,43867,14687,58554,93000,2015
42109,39.3,40046,38228,381,822,10496,49917,14442,10776,3666,14442,144700,2015
42111,45.3,76617,72758,1965,993,20543,44587,29619,23288,6331,29619,98800,2015
42113,51.8,6381,5968,151,112,1659,44189,2669,2222,447,2669,145800,2015
42115,46.4,42369,40911,228,702,11858,50477,17487,13421,4066,17487,150700,2015
42117,43,42284,40665,291,551,11200,46494,16611,12346,4265,16611,124700,2015
42119,38.6,44958,38055,2934,2526,10118,49803,14916,10670,4246,14916,160200,2015
42121,45.4,53906,51809,423,562,15068,43644,22129,16883,5246,22129,81200,2015
42123,46.2,40962,39800,186,383,11024,44020,17113,13113,4000,17113,89700,2015
42125,44.2,208226,193432,5996,2935,55321,56450,83739,63463,20276,83739,152400,2015
42127,46.5,51642,47068,1655,2074,13254,49919,19306,15481,3825,19306,179000,2015
42129,46.1,361251,340727,8340,3769,100715,52247,151173,115868,35305,151173,138500,2015
42131,43.1,28147,26954,199,499,7357,51004,10894,8485,2409,10894,159500,2015
42133,40.7,439660,373619,22942,28334,116539,58269,167416,124269,43147,167416,168400,2015
44001,43.9,49176,45959,578,1164,12745,72458,19290,13682,5608,19290,330100,2015
44003,43.5,164958,148775,2183,6549,43057,64383,68616,48218,20398,68616,208500,2015
44005,43.9,82663,71438,2615,4261,20991,69526,34848,21571,13277,34848,349200,2015
44007,37.1,630459,403279,49082,128218,148061,49743,238284,127215,111069,238284,211200,2015
44009,43.3,126405,115794,1836,3596,32686,72807,49564,36223,13341,49564,311600,2015
45001,43.3,24997,17229,6986,301,6527,34799,9573,7571,2002,9573,88300,2015
45003,40.9,163908,110091,40325,8614,43128,45759,63706,47057,16649,63706,128800,2015
45005,38.7,9838,2286,7258,277,2030,25327,3346,2139,1207,3346,56300,2015
45007,40.5,191215,148792,30984,6397,51232,42143,74023,53216,20807,74023,128100,2015
45009,40.3,15432,5477,9615,193,3609,31314,5921,4480,1441,5921,63900,2015
45011,39.8,22098,11366,9892,512,5649,34336,8344,6086,2258,8344,74100,2015
45013,42.8,171420,114710,31600,19657,44911,57048,65975,46204,19771,65975,274700,2015
45015,35.3,193613,123907,47090,11724,49157,52506,69030,48237,20793,69030,153500,2015
45017,45.3,14958,7978,6330,484,4069,43531,6028,4672,1356,6028,100100,2015
45019,36.5,372904,235661,106155,19052,87214,53437,148018,89750,58268,148018,243200,2015
45021,38.8,55863,40918,11240,2231,13630,35389,20523,13941,6582,20523,86500,2015
45023,41.2,32556,19197,12373,562,8078,31914,12385,8954,3431,12385,86700,2015
45025,41,46192,28331,15287,1829,12641,32083,18022,12600,5422,18022,77600,2015
45027,42.8,34178,16098,16636,976,8810,33162,13161,9629,3532,13161,88500,2015
45029,41.7,38004,21362,14497,1125,9859,32804,14774,10844,3930,14774,86000,2015
45031,40.8,67922,37556,27588,1282,18057,35409,26417,17885,8532,26417,86800,2015
45033,37.8,31435,14715,14370,798,8040,28938,11514,7569,3945,11514,63500,2015
45035,35.8,145715,94831,36673,6980,37154,54901,51856,36012,15844,51856,168000,2015
45037,42.1,26466,14896,9672,1495,6461,46637,9096,6900,2196,9096,114900,2015
45039,44.1,23108,8753,13256,434,6123,36004,8990,6537,2453,8990,97700,2015
45041,38.2,138330,73636,57362,3286,35610,42080,51847,34346,17501,51847,122200,2015
45043,47.5,60572,37991,19696,1875,16404,42835,23566,18106,5460,23566,159600,2015
45045,37.7,474903,330124,85657,40776,120620,50540,179862,118621,61241,179862,156200,2015
45047,38.9,69771,42193,21326,3995,17541,37060,26709,17437,9272,26709,104900,2015
45049,39.7,20473,8446,11015,790,4958,31410,7530,5658,1872,7530,76400,2015
45051,43,290730,223819,39099,17639,76523,43299,118738,81966,36772,118738,159700,2015
45053,36.5,26549,10710,11626,3713,6235,37141,9095,6431,2664,9095,99300,2015
45055,41.3,62722,43207,15491,2542,16970,43622,24194,19055,5139,24194,117600,2015
45057,41.6,81263,56912,18512,3973,20320,44016,29395,22589,6806,29395,150200,2015
45059,40.9,66389,45381,16803,2866,18079,38515,25160,18002,7158,25160,83900,2015
45061,40.1,18461,6028,11634,393,4202,30954,6385,4720,1665,6385,69800,2015
45063,38.5,273843,208072,39461,15579,72498,53857,106637,78476,28161,106637,140500,2015
45065,51.9,9895,4809,4768,115,2782,38712,4003,3076,927,4003,109400,2015
45067,39.5,32167,12676,17920,866,8017,29874,11958,8326,3632,11958,75000,2015
45069,39.4,27993,11137,14186,872,6706,30767,9950,6532,3418,9950,60200,2015
45071,40.9,37690,22675,11306,2747,9820,40127,14287,10462,3825,14287,100800,2015
45073,44.3,74949,63932,5561,3616,21142,41237,30556,22644,7912,30556,147000,2015
45075,38.7,90575,30444,55836,1846,21199,34218,33410,23085,10325,33410,87600,2015
45077,35.4,120124,103895,7974,3995,29032,41459,44646,30915,13731,44646,123000,2015
45079,32.7,397899,176322,180888,19766,88296,49131,145069,85975,59094,145069,149700,2015
45081,41.2,20000,11646,5201,2965,4984,38827,7059,5071,1988,7059,92700,2015
45083,38.2,291240,201442,59733,18252,76454,43907,109892,75378,34514,109892,123800,2015
45085,35.8,107777,50128,49801,4010,27769,41332,40571,26485,14086,40571,107100,2015
45087,43.5,28125,18436,8802,329,7820,34033,11666,8421,3245,11666,72600,2015
45089,41,33238,10427,21762,738,7886,28297,11885,8738,3147,11885,68300,2015
45091,37.9,240076,172474,45212,11625,64399,54117,90322,64200,26122,90322,160100,2015
46003,41.8,2729,2457,11,166,754,48750,1157,907,250,1157,69400,2015
46005,39,18168,14745,45,1622,4738,46267,7565,4933,2632,7565,96500,2015
46007,29.4,3438,1042,33,140,762,42171,1050,628,422,1050,56300,2015
46009,42.9,7013,6174,70,280,1603,45254,2480,1943,537,2480,69900,2015
46011,26.4,33046,30143,414,775,7174,50082,12325,7339,4986,12325,156000,2015
46013,38.1,38060,34218,573,857,9966,53100,15996,10968,5028,15996,143100,2015
46015,40.8,5330,4574,0,22,1485,49531,2067,1508,559,2067,102900,2015
46017,25.9,2038,377,4,21,435,31163,546,240,306,546,57900,2015
46019,39.9,10292,9444,7,358,2548,41920,4079,3046,1033,4079,118600,2015
46021,49.6,1548,1469,0,3,420,45170,683,550,133,683,59800,2015
46023,37.3,9239,5845,4,232,2076,43109,3171,2223,948,3171,82700,2015
46025,44,3625,3400,28,92,881,49600,1488,1133,355,1488,76100,2015
46027,25.2,14011,12445,208,356,2592,36608,5335,2748,2587,5335,135000,2015
46029,38,27750,25946,115,517,7298,48912,11934,8084,3850,11934,145500,2015
46031,29.8,4149,1284,12,24,942,31676,1229,634,595,1229,53800,2015
46033,52.8,8394,7646,23,244,2558,52218,3759,3057,702,3759,208900,2015
46035,38.4,19787,18286,95,435,5280,49991,8580,5398,3182,8580,133600,2015
46037,48,5618,4889,0,109,1591,39216,2533,1845,688,2533,81100,2015
46039,44.6,4341,4167,30,131,1244,53152,1900,1575,325,1900,112000,2015
46041,29.1,5579,1212,2,51,1102,37206,1640,959,681,1640,60100,2015
46043,48,2973,2828,0,26,875,52500,1296,1018,278,1296,73000,2015
46045,46.1,4018,3885,5,51,1091,56000,1586,1297,289,1586,111200,2015
46047,52.4,6906,5924,78,229,1829,45997,3087,2193,894,3087,102800,2015
46049,46.9,2359,2219,0,95,557,43679,951,732,219,951,78600,2015
46051,44.8,7227,6852,26,202,2225,51272,3209,2523,686,3209,107900,2015
46053,47.5,4226,3735,0,34,1183,37540,1970,1356,614,1970,61200,2015
46055,48.3,2083,1853,8,0,602,41518,855,671,184,855,76800,2015
46057,36.1,5982,5698,7,187,1621,58602,2178,1740,438,2178,112100,2015
46059,48.8,3375,3288,0,47,933,47163,1510,1063,447,1510,96100,2015
46061,35.5,3386,3141,118,33,796,60741,1056,880,176,1056,110100,2015
46063,37.6,1328,1256,9,15,342,52396,507,369,138,507,87200,2015
46065,39.4,17466,14386,132,468,4219,59177,7117,4698,2419,7117,167800,2015
46067,45.6,7226,6897,14,136,1957,45075,2942,2213,729,2942,72000,2015
46069,47.4,1413,1238,0,10,357,51776,545,446,99,545,76400,2015
46071,30.5,3237,1458,5,75,710,45074,1032,635,397,1032,57800,2015
46073,47.5,2031,1953,0,51,599,53125,863,653,210,863,81600,2015
46075,51.6,781,736,16,2,214,35972,426,292,134,426,58300,2015
46077,46,5107,4871,31,108,1450,53828,2283,1757,526,2283,88800,2015
46079,41.9,12086,11375,72,263,3108,54535,4764,3500,1264,4764,139800,2015
46081,41.5,24645,22507,110,764,6476,45548,10528,7038,3490,10528,180100,2015
46083,33.8,49874,46879,516,846,13370,76094,18037,14138,3899,18037,193600,2015
46085,35.5,3837,2214,0,13,947,43030,1394,1009,385,1394,70300,2015
46087,42.8,5613,5357,21,155,1544,56954,2253,1756,497,2253,109500,2015
46089,52.1,2263,2070,5,47,614,36375,1009,751,258,1009,57800,2015
46091,42.6,4701,3919,29,227,1121,51788,1765,1274,491,1765,97400,2015
46093,36.2,26381,23306,442,1046,7565,52473,10593,7632,2961,10593,162700,2015
46095,32,2086,821,0,94,488,30938,675,436,239,675,49100,2015
46097,43.5,2306,2183,22,45,636,44938,1006,774,232,1006,67000,2015
46099,34.8,178942,151253,7422,8300,44325,53525,70140,44644,25496,70140,155400,2015
46101,40.7,6439,5092,48,190,1844,52446,2681,1917,764,2681,122900,2015
46102,25.1,14153,673,68,148,2360,26369,2933,1545,1388,2933,20400,2015
46103,37.1,106085,85568,1242,4934,26542,50890,41670,27909,13761,41670,159800,2015
46105,49.9,2981,2850,3,48,835,39773,1306,937,369,1306,65100,2015
46107,52.5,2307,2139,0,20,643,46081,1056,856,200,1056,75400,2015
46109,39.2,10318,6082,43,240,2427,48614,3652,2573,1079,3652,90900,2015
46111,46.8,2339,2274,0,44,692,50541,1072,796,276,1072,75800,2015
46115,43.8,6570,6247,14,130,1677,48217,2631,1934,697,2631,74200,2015
46117,40.1,2962,2640,0,43,863,56829,1268,1026,242,1268,124100,2015
46119,44.6,1469,1434,0,9,400,60417,622,431,191,622,94600,2015
46121,23.9,9942,996,33,365,1973,31128,2737,1229,1508,2737,43700,2015
46123,46.4,5504,4516,5,33,1492,37153,2579,1697,882,2579,71200,2015
46125,44,8302,7953,46,162,2382,53378,3520,2730,790,3520,99700,2015
46127,40.8,14842,13802,47,445,3897,64471,5939,4432,1507,5939,159700,2015
46129,44.9,5495,4468,11,257,1402,43221,2389,1568,821,2389,76600,2015
46135,40.8,22636,20428,462,738,5708,48176,8899,6002,2897,8899,128700,2015
46137,27.5,2833,672,8,104,654,35119,810,431,379,810,65700,2015
47001,43.2,75430,67885,2840,1884,19621,42880,30612,20901,9711,30612,131200,2015
47003,36.6,45986,35916,3053,5318,12185,41984,16721,11401,5320,16721,115700,2015
47005,46.1,16261,15175,563,339,4318,33240,6786,5176,1610,6786,86400,2015
47007,42.9,13686,12372,573,305,3295,37013,4534,3483,1051,4534,115400,2015
47009,42.6,125188,114671,3616,3717,34016,48286,49033,36197,12836,49033,166500,2015
47011,39.4,102062,88921,4649,5482,26469,42114,38466,25108,13358,38466,146200,2015
47013,43,40176,38847,205,506,10924,32028,15995,11185,4810,15995,89400,2015
47015,41.9,13787,13055,221,251,3729,41533,5388,4060,1328,5388,124200,2015
47017,42.6,28353,24144,2934,652,7402,35508,11168,8284,2884,11168,83500,2015
47019,43.6,56941,54280,729,935,16025,33213,23894,16892,7002,23894,108500,2015
47021,39.8,39422,36956,637,1029,10561,51857,14499,11513,2986,14499,159100,2015
47023,37.2,17324,14888,1821,417,4287,40167,6074,4499,1575,6074,108300,2015
47025,41.8,31748,30341,334,318,8658,34899,12705,9142,3563,12705,101500,2015
47027,46.9,7780,7408,128,142,2306,28804,3242,2477,765,3242,94000,2015
47029,44.3,35321,33088,547,723,9838,31187,14710,10115,4595,14710,99500,2015
47031,39.7,53448,47782,1004,2103,14548,41590,21170,14290,6880,21170,113100,2015
47033,39.7,14600,11057,1912,1387,3654,35464,5453,3752,1701,5453,92000,2015
47035,49.7,57455,54547,341,1556,16712,38576,24177,19014,5163,24177,139500,2015
47037,34.2,658506,374311,180490,65133,146749,48368,264211,143045,121166,264211,169600,2015
47039,45.3,11686,10742,325,348,3394,37263,4978,3836,1142,4978,90500,2015
47041,41,19038,17083,233,1370,4859,38319,6920,4925,1995,6920,121800,2015
47043,39.9,50472,45453,1972,1592,13264,44680,18556,13388,5168,18556,140300,2015
47045,40.3,38054,30552,5078,1149,10499,42468,14931,9603,5328,14931,98800,2015
47047,43.7,38814,26453,10697,961,10969,54890,14846,11869,2977,14846,181700,2015
47049,44.2,17931,17401,29,225,5028,30259,7304,5644,1660,7304,95300,2015
47051,41.5,41138,36709,1282,1147,11313,42773,16302,12054,4248,16302,110700,2015
47053,40.4,49572,38409,9156,1191,13248,38457,19449,14046,5403,19449,89200,2015
47055,42.9,28949,24557,2905,562,7812,41093,11297,8210,3087,11297,108100,2015
47057,43.6,22736,21680,175,597,6360,35391,8952,7250,1702,8952,96400,2015
47059,43.7,68576,64067,1416,1846,18704,35196,28061,20059,8002,28061,109700,2015
47061,42.6,13524,11055,32,64,3567,27373,5221,4052,1169,5221,80400,2015
47063,39.9,62999,51892,2321,6948,16993,37617,24470,16135,8335,24470,124200,2015
47065,39.3,348121,249305,68414,17138,88629,48248,136319,87922,48397,136319,158600,2015
47067,44.2,6642,6466,30,4,1816,26898,2754,2104,650,2754,80400,2015
47069,39.8,26253,14455,10981,406,6079,31801,8737,6254,2483,8737,83000,2015
47071,44.8,25900,23887,816,510,6687,35290,9871,7666,2205,9871,96900,2015
47073,43.4,56595,54017,791,750,15931,36927,23167,17280,5887,23167,108600,2015
47075,39.9,18248,8242,8944,759,4357,34182,7008,4352,2656,7008,99100,2015
47077,40.7,28013,24583,2126,620,7476,38745,10809,7726,3083,10809,92700,2015
47079,44.9,32269,28258,2771,691,9077,38234,13471,9987,3484,13471,94300,2015
47081,40.7,24283,22041,1172,501,6119,36334,8769,6793,1976,8769,93800,2015
47083,43.2,8290,7674,223,172,2249,39401,3247,2351,896,3247,94200,2015
47085,42.2,18240,17044,589,372,4859,41949,7124,5613,1511,7124,106400,2015
47087,45.8,11496,11041,82,204,3147,31534,4531,3549,982,4531,101400,2015
47089,42.3,52490,48509,1322,1802,14068,42417,19679,14439,5240,19679,128800,2015
47091,44.5,18017,16664,711,307,4715,30763,7009,5432,1577,7009,110500,2015
47093,37.3,444348,369088,39819,16857,110486,48701,180729,115584,65145,180729,160700,2015
47095,40.3,7687,5201,2029,292,1431,30086,2092,1262,830,2092,71600,2015
47097,37.1,27427,16680,9610,621,6779,30281,9800,5907,3893,9800,81100,2015
47099,39.9,42226,39777,803,784,11379,37814,16104,12059,4045,16104,98600,2015
47101,43.5,11944,11165,191,250,3257,36621,4712,3733,979,4712,89600,2015
47103,42.9,33550,29364,1733,1017,9119,40389,13644,9949,3695,13644,109100,2015
47105,46.5,50229,44666,634,3861,14876,51107,20009,15358,4651,20009,178000,2015
47107,42.7,52506,47246,2126,1729,13445,38535,19978,14744,5234,19978,113200,2015
47109,42.6,26103,23552,1620,481,6666,32557,9872,7478,2394,9872,85000,2015
47111,39.6,22761,21054,66,1103,6086,33509,8856,6230,2626,8856,100700,2015
47113,37.6,98184,55970,36327,3469,24682,42544,36766,23739,13027,36766,117300,2015
47115,43.1,28306,26129,422,437,8405,41348,11525,8366,3159,11525,119100,2015
47117,39.4,31159,26795,2186,1520,8503,42661,11968,8715,3253,11968,112300,2015
47119,38.6,84089,67178,9830,4353,22430,47692,32465,22262,10203,32465,140800,2015
47121,44.3,11716,11113,187,163,3256,34424,4620,3669,951,4620,99500,2015
47123,43,45293,41442,968,1744,12646,35291,17193,12980,4213,17193,113600,2015
47125,30.3,185980,121791,34737,17214,47856,50344,66234,39171,27063,66234,145900,2015
47127,45.5,6351,5969,245,24,1757,49427,2454,2088,366,2454,152500,2015
47129,40.8,21794,20354,940,246,5371,39049,7370,5965,1405,7370,92900,2015
47131,42.1,31129,26141,3226,1123,8912,40281,12665,8642,4023,12665,87800,2015
47133,42.2,22100,21311,179,276,6397,35287,8893,6908,1985,8893,101300,2015
47135,43.7,7864,7323,220,166,2109,31425,3226,2527,699,3226,79900,2015
47137,49.4,5097,4961,38,18,1769,36773,2223,1841,382,2223,106700,2015
47139,44,16687,15941,48,283,4735,38925,6745,5269,1476,6745,109100,2015
47141,36.1,73810,65883,1748,4199,18987,35343,29721,18513,11208,29721,144600,2015
47143,40.5,32394,29566,796,1422,8365,36146,12545,8564,3981,12545,106400,2015
47145,46.1,53162,49564,1404,847,14251,40854,21887,15888,5999,21887,120000,2015
47147,38.6,67426,56759,5002,4134,18269,53151,24641,18665,5976,24641,155800,2015
47149,32.9,282558,209062,37745,20089,70143,56219,100661,66692,33969,100661,160700,2015
47151,38.6,22043,21520,49,161,5620,30246,8309,6064,2245,8309,84700,2015
47153,41.9,14592,12620,31,498,4073,45408,5615,4160,1455,5615,135700,2015
47155,42.2,93617,85222,618,5041,25861,42258,36717,24420,12297,36717,159000,2015
47157,34.9,937750,351310,492349,55338,220451,46224,347224,199014,148210,347224,130800,2015
47159,41.6,19136,17883,432,479,5248,43914,7478,5698,1780,7478,114000,2015
47161,43.2,13286,12230,207,317,3590,42023,5131,4078,1053,5131,123100,2015
47163,44.3,156752,147096,2978,2600,43951,40346,66421,48856,17565,66421,124900,2015
47165,39.4,169623,145753,11666,7137,46063,57382,62425,45012,17413,62425,178000,2015
47167,37,61674,46986,11124,1536,16364,53669,21575,15563,6012,21575,139600,2015
47169,40.2,7884,6744,943,28,2033,41029,2926,2189,737,2926,129400,2015
47171,45.7,18069,16989,138,768,4822,33210,7428,5521,1907,7428,106200,2015
47173,41,19096,18458,107,272,5249,37351,7302,5720,1582,7302,106800,2015
47175,45.8,5596,5367,31,64,1527,40439,2106,1810,296,2106,90700,2015
47177,39.7,40015,34599,502,3361,10427,35376,15661,10804,4857,15661,97700,2015
47179,39.8,125317,112210,4878,3968,33217,42817,52638,34833,17805,52638,145800,2015
47181,42.2,16897,15319,1043,306,4286,30701,5967,4876,1091,5967,82300,2015
47183,36.9,34415,29970,3124,769,8847,37037,13678,9271,4407,13678,94100,2015
47185,42.5,26252,24675,454,535,6762,34901,9731,7660,2071,9731,97900,2015
47187,38.9,199456,171187,8696,9320,55279,96565,69478,56296,13182,69478,348600,2015
47189,40.1,122445,105803,8201,4437,32892,61070,44528,34643,9885,44528,200300,2015
48001,38.9,57915,34836,12239,9749,11909,41327,16737,11791,4946,16737,83000,2015
48003,31.3,16775,7223,212,8925,4258,70423,5476,4090,1386,5476,111600,2015
48005,36.4,87748,54335,13061,18353,22705,44223,30583,20178,10405,30583,87100,2015
48007,49,24292,16581,367,6343,6451,41690,9682,7040,2642,9682,144000,2015
48009,44.1,8779,7797,56,708,2486,60275,3350,2789,561,3350,107500,2015
48011,45.1,1943,1641,12,230,534,59737,714,543,171,714,106600,2015
48013,35.5,47050,16460,369,29541,11719,52192,15363,11409,3954,15363,91500,2015
48015,40.6,28886,18457,2517,7327,7906,53687,11038,8156,2882,11038,157000,2015
48017,34.9,7126,2673,132,4280,1803,37397,2392,1659,733,2392,58300,2015
48019,51.5,20796,16536,294,3644,5541,49863,8292,6925,1367,8292,146100,2015
48021,38.7,76948,42548,5944,26531,18355,54821,25454,19874,5580,25454,129500,2015
48023,48.5,3628,3134,69,322,977,36373,1723,1380,343,1723,81400,2015
48025,35.3,32659,10822,2793,18726,6177,42302,8762,5417,3345,8762,72900,2015
48027,30.2,326041,159050,66361,75761,79124,50550,109844,60615,49229,109844,127500,2015
48029,33.1,1825502,535001,129022,1079710,419295,51150,618831,361851,256980,618831,129400,2015
48031,48.6,10723,8355,6,2034,3043,55504,4164,3138,1026,4164,175000,2015
48033,38.7,705,620,0,62,198,73750,262,177,85,262,83500,2015
48035,46,17971,14265,245,3029,4947,44674,6999,5418,1581,6999,88800,2015
48037,37.7,93155,60723,22250,6616,23339,42670,33423,22053,11370,33423,101800,2015
48039,35.5,331741,167960,42342,96011,82536,69749,112510,80749,31761,112510,152900,2015
48041,25.2,205271,118233,21434,50029,40474,39808,73858,33078,40780,73858,160000,2015
48043,42.1,9235,4884,123,4003,2139,38395,4025,2327,1698,4025,112700,2015
48045,42.5,1670,1008,63,544,489,38603,675,500,175,675,60000,2015
48047,31.7,7221,369,6,6705,1496,22741,2080,1430,650,2080,52100,2015
48049,41,37833,27799,1575,7831,9208,41962,13295,9399,3896,13295,90400,2015
48051,42.6,17293,11443,2119,3408,4619,51821,6401,5135,1266,6401,93100,2015
48053,44.1,44144,32974,1037,9412,12166,49732,16940,12356,4584,16940,158900,2015
48055,35.6,39347,16724,2734,19320,8831,47233,12451,8204,4247,12451,115300,2015
48057,38.1,21666,9546,606,10349,5590,51078,7994,5663,2331,7994,102800,2015
48059,43.5,13532,11798,230,1230,3268,40981,5273,4313,960,5273,74000,2015
48061,31.2,417947,42131,1698,370071,95991,33266,121097,80885,40212,121097,79300,2015
48063,37.8,12516,7156,2145,2875,3270,37851,4431,3017,1414,4431,78100,2015
48065,40.7,6068,5264,65,580,1692,66023,2293,2046,247,2293,93700,2015
48067,43.3,30328,23238,5219,1246,7946,37352,11691,8980,2711,11691,81000,2015
48069,34.6,7948,2768,45,4932,1911,39459,2501,1751,750,2501,70600,2015
48071,36.2,37251,25470,2947,7772,9875,70544,13018,10529,2489,13018,151200,2015
48073,37.6,51167,31518,7358,11204,12935,39595,17729,12712,5017,17729,84500,2015
48075,34.6,7059,4542,678,1447,1573,36633,2391,1531,860,2391,73300,2015
48077,45.7,10479,9530,55,564,2897,48297,4146,3461,685,4146,83600,2015
48079,34.9,2993,1148,110,1683,725,39113,1030,813,217,1030,32300,2015
48081,49.3,3238,2504,25,676,1027,42467,1601,1125,476,1601,79000,2015
48083,47.1,8536,6666,202,1475,2453,35156,3405,2325,1080,3405,60000,2015
48085,35.9,862215,523843,76446,129437,226540,84735,305827,203314,102513,305827,223400,2015
48087,37,3058,1898,106,960,803,39743,1109,863,246,1109,64200,2015
48089,43.6,20757,12068,2831,5780,5530,46618,7657,6206,1451,7657,109800,2015
48091,42.4,119632,82977,2245,31432,32671,65833,43951,33372,10579,43951,214400,2015
48093,43.6,13623,9694,57,3659,3545,37470,5119,3904,1215,5119,72100,2015
48095,40.8,4086,1749,21,2265,604,48368,813,638,175,813,86000,2015
48097,39.6,38761,29869,932,6565,10420,52406,14598,10151,4447,14598,122700,2015
48099,30.6,76128,45785,10922,13286,16422,49340,21829,12483,9346,21829,102700,2015
48101,50.1,1510,904,158,424,432,34955,635,453,182,635,42900,2015
48103,33.5,4730,1687,165,2838,1121,58333,1542,1165,377,1542,75900,2015
48105,40.5,3699,1358,10,2286,1056,53678,1433,1056,377,1433,79000,2015
48107,38.2,6007,2481,220,3235,1591,37434,2189,1483,706,2189,53900,2015
48109,39.2,2296,440,9,1799,540,35000,788,564,224,788,60700,2015
48111,30.7,7014,3699,84,2970,1573,41345,2256,1373,883,2256,72800,2015
48113,33.1,2485003,782992,541844,969793,576726,50270,881279,451480,429799,881279,132700,2015
48115,33.4,13542,5116,761,7408,2937,41095,4232,3046,1186,4232,62100,2015
48117,31.5,19245,5353,159,13440,4522,43373,6194,4214,1980,6194,86700,2015
48119,43.5,5223,4243,426,357,1442,42432,1928,1496,432,1928,73600,2015
48121,34.2,731851,454545,63524,137951,182667,75050,257275,165668,91607,257275,197600,2015
48123,42.2,20540,11571,1961,6911,5036,49736,7061,5376,1685,7061,98200,2015
48125,43.1,2281,1525,139,602,560,39700,878,657,221,878,49600,2015
48127,34.6,10682,1465,34,9160,2229,36825,3568,2465,1103,3568,58200,2015
48129,42.9,3588,2959,203,362,846,36681,1311,999,312,1311,59900,2015
48131,37.3,11577,1159,99,10250,2763,33939,3937,2754,1183,3937,52800,2015
48133,42.9,18328,14707,517,2712,4043,34888,6810,4922,1888,6810,60100,2015
48135,30.7,149557,55290,5986,84533,36204,57150,50868,33733,17135,50868,103200,2015
48137,49.5,1906,930,3,972,488,41813,747,674,73,747,70900,2015
48139,35.7,157058,100289,13841,38824,41290,62465,52653,37889,14764,52653,145400,2015
48141,31.6,831095,110881,25422,675674,194964,41637,259612,159647,99965,259612,113900,2015
48143,30.3,40039,30523,571,7975,8886,41416,14572,8718,5854,14572,121700,2015
48145,39.8,17410,9021,4267,3850,3369,36079,5418,3970,1448,5418,64900,2015
48147,41.3,33748,26898,2293,3474,8498,44071,11974,8916,3058,11974,94600,2015
48149,47.6,24849,18043,1782,4877,6569,47808,9558,7437,2121,9558,138100,2015
48151,41.9,3858,2487,125,1197,1030,41406,1667,1183,484,1667,64900,2015
48153,37.3,6178,2469,163,3446,1771,41026,2413,1628,785,2413,65300,2015
48155,49.1,1197,1012,35,139,261,36477,507,398,109,507,55900,2015
48157,35.5,658331,231705,134742,158162,170472,89152,206188,162261,43927,206188,200200,2015
48159,43.5,10599,8462,527,1415,3044,41537,4259,3095,1164,4259,103200,2015
48161,41.4,19586,13272,3065,2829,5326,44301,7406,5605,1801,7406,81400,2015
48163,31.5,18168,3084,706,14184,3720,36404,4794,3373,1421,4794,68400,2015
48165,28.9,18916,10893,338,7412,4368,57635,5615,4320,1295,5615,92600,2015
48167,37.5,308163,179352,40043,72332,77609,62313,113866,76189,37677,113866,155000,2015
48169,39.4,6410,2501,290,3590,1166,48508,1532,1027,505,1532,80600,2015
48171,50.6,25398,19487,68,5426,7178,54859,10577,8095,2482,10577,238300,2015
48173,38.8,1180,778,0,402,337,67303,431,287,144,431,190200,2015
48175,45.8,7410,4338,395,2632,2115,51226,2881,2441,440,2881,116300,2015
48177,38.1,20172,8723,1325,9901,4631,42983,6477,4538,1939,6477,89200,2015
48179,37,22983,15144,1005,6068,5529,43288,8250,6067,2183,8250,74800,2015
48181,40.2,122780,94631,7239,15071,32294,47952,47215,31593,15622,47215,107000,2015
48183,35.4,123178,72986,24464,21824,30560,47639,45618,27568,18050,45618,124600,2015
48185,40.7,26961,16060,4298,6105,6189,46195,9005,6986,2019,9005,105400,2015
48187,36.6,143460,75400,9574,52644,36990,62420,48940,37581,11359,48940,163300,2015
48189,32.5,35504,12564,1632,20563,8491,43375,11513,7024,4489,11513,73400,2015
48191,44.7,3203,1847,228,1092,820,30950,1155,785,370,1155,36500,2015
48193,48.6,8266,7138,84,924,2203,42432,3166,2302,864,3166,96600,2015
48195,36.4,5559,2986,7,2515,1517,44219,1972,1487,485,1972,81300,2015
48197,42.3,3992,2788,350,813,990,37174,1634,1189,445,1634,45600,2015
48199,38.9,55375,48272,3216,2872,15086,52614,20799,16554,4245,20799,101000,2015
48201,32.8,4356362,1379900,804534,1810720,1024967,54457,1499528,823646,675882,1499528,137800,2015
48203,37.5,66417,42640,14373,8050,17231,45974,23546,17505,6041,23546,112700,2015
48205,39.3,6121,3895,516,1564,1307,63004,1769,1156,613,1769,147300,2015
48207,43.4,5853,4016,191,1474,1501,39850,2285,1751,534,2285,48200,2015
48209,30.9,177562,100577,5959,65150,39447,58583,61360,39185,22175,61360,180900,2015
48211,34.4,4115,2635,43,1358,1152,62813,1466,1065,401,1466,123400,2015
48213,43.4,79016,62804,5160,9218,20855,41607,29780,22128,7652,29780,91500,2015
48215,28.8,819217,59657,3521,745749,183335,34782,224021,152552,71469,224021,79200,2015
48217,42.4,34923,25155,2437,6794,8911,41382,12902,9318,3584,12902,85000,2015
48219,32.8,23322,11293,779,10709,6012,50665,8089,5504,2585,8089,81600,2015
48221,46.9,53171,45494,428,6040,14328,56100,20932,16070,4862,20932,153000,2015
48223,39.2,35645,26531,2409,5695,9879,44396,13273,9431,3842,13273,92800,2015
48225,44.5,22949,14212,5854,2431,5111,32698,8046,5530,2516,8046,76500,2015
48227,36.9,36105,18604,1883,14394,7528,49575,11206,7538,3668,11206,73800,2015
48229,39.6,3330,643,36,2612,728,26384,968,799,169,968,42600,2015
48231,38,88052,64732,7385,12886,21018,45197,30832,21524,9308,30832,94400,2015
48233,37.3,21858,15704,565,4801,5495,49353,8297,6370,1927,8297,73500,2015
48235,44.9,1644,1179,0,412,489,58500,658,507,151,658,104700,2015
48237,40.5,8946,7036,437,1410,2220,50324,3031,2351,680,3031,76700,2015
48239,39,14486,8791,1017,4468,3575,54926,5109,3822,1287,5109,87600,2015
48241,40.6,35768,26640,5822,2312,8280,40820,12310,9439,2871,12310,86500,2015
48243,53.1,2232,1318,7,859,639,50165,1023,772,251,1023,93300,2015
48245,35.9,252872,108386,84269,46984,59419,43540,93495,58939,34556,93495,97900,2015
48247,36.7,5239,345,65,4817,1272,35521,1688,1319,369,1688,68500,2015
48249,34.6,41461,7867,218,32949,10370,42986,13829,9448,4381,13829,70100,2015
48251,36.7,155450,115978,3926,30351,41093,58135,53685,39484,14201,53685,119200,2015
48253,39.2,19978,11101,3022,5313,3729,43897,5489,4180,1309,5489,69000,2015
48255,35.5,14879,5829,1317,7659,2931,45502,4309,3243,1066,4309,87200,2015
48257,35.8,109289,74442,10215,20552,27447,60391,35418,27414,8004,35418,134700,2015
48259,43.6,37361,28070,261,8161,10109,73240,13552,9835,3717,13552,281200,2015
48261,29.4,565,190,0,374,110,36438,145,47,98,145,NA,2015
48263,49.1,821,669,2,147,215,47024,372,259,113,372,72300,2015
48265,47.9,50149,35410,795,12699,13130,43810,20316,14150,6166,20316,158200,2015
48267,52.8,4486,3357,1,1090,1309,40125,1990,1477,513,1990,85400,2015
48269,46.2,267,201,0,66,77,63250,113,34,79,113,73000,2015
48271,44.9,3577,1335,21,2221,730,38281,1079,855,224,1079,72200,2015
48273,28,32029,7029,1264,22846,6981,38247,10906,5769,5137,10906,80800,2015
48275,40.9,3796,2275,256,1255,954,40493,1437,1044,393,1437,42900,2015
48277,40.3,49566,37247,6151,3561,13281,40748,19026,12420,6606,19026,85900,2015
48279,36.1,13742,5640,609,7356,3448,39851,4865,3395,1470,4865,62000,2015
48281,40.8,20219,14841,766,3791,5503,49630,7505,5459,2046,7505,133300,2015
48283,31.7,7191,1102,66,5986,1331,37292,1971,1387,584,1971,70100,2015
48285,44.9,19549,14590,1331,3428,5571,48677,7701,6005,1696,7701,119300,2015
48287,39.9,16664,10679,1911,3847,4266,53902,5996,4469,1527,5996,115800,2015
48289,44.9,16819,12918,1263,2347,4371,49802,6142,5042,1100,6142,102800,2015
48291,36.4,77486,52077,8219,15521,18487,48729,25319,19081,6238,25319,87900,2015
48293,39.3,23454,14137,4122,4795,5571,37554,8084,6019,2065,8084,83500,2015
48295,34.4,3483,2318,10,1036,868,63125,1198,855,343,1198,93000,2015
48297,42,11873,6762,381,4386,2508,50400,3699,2993,706,3699,86900,2015
48299,56.3,19323,16939,432,1792,5592,48259,8654,6752,1902,8654,160600,2015
48301,55.3,117,48,0,41,18,NA,45,22,23,45,92500,2015
48303,30.6,290782,161779,19559,97317,66941,46075,107540,61164,46376,107540,112600,2015
48305,37.4,5764,2843,71,2726,1608,39526,2188,1581,607,2188,69900,2015
48307,44.2,8273,5432,136,2550,2149,40561,3145,2468,677,3145,67500,2015
48309,32.9,241505,139244,34242,59946,57860,42687,86769,50850,35919,86769,114700,2015
48311,42.2,778,392,0,374,216,46250,278,218,60,278,69300,2015
48313,35.1,13838,7823,2573,3001,2827,39390,4121,2760,1361,4121,103100,2015
48315,49.1,10248,7272,2349,397,2791,34175,4463,3386,1077,4463,85500,2015
48317,31.9,5252,2689,122,2393,1171,55682,1630,1231,399,1630,99400,2015
48319,50.5,4066,2918,1,999,1085,37654,1714,1348,366,1714,154800,2015
48321,37.2,36598,16895,3614,14587,9238,40797,13382,9070,4312,13382,93700,2015
48323,29.9,56548,1779,49,53820,12966,33747,16030,11224,4806,16030,88700,2015
48325,38.5,47392,21361,1024,24066,11495,57338,14975,12147,2828,14975,125100,2015
48327,45.7,2182,1284,26,802,628,34464,951,677,274,951,56200,2015
48329,32.1,151290,75140,8761,62419,36702,68806,52870,35449,17421,52870,166700,2015
48331,41.4,24344,15515,2029,6086,6037,38929,9346,6151,3195,9346,80600,2015
48333,45.5,4875,4061,12,788,1316,43920,1848,1507,341,1848,120100,2015
48335,35.5,9169,4465,972,3548,1920,49870,2753,1934,819,2753,48500,2015
48337,43.6,19478,16926,28,2006,5314,46172,8024,5894,2130,8024,96000,2015
48339,36.4,502586,347262,17205,111408,128184,68838,173238,124410,48828,173238,176900,2015
48341,31.1,22281,7805,565,11729,5476,49802,6893,4650,2243,6893,93000,2015
48343,43.3,12700,8353,2916,1114,3654,39453,4954,3573,1381,4954,69300,2015
48345,44.3,1071,888,13,161,270,31683,445,320,125,445,53100,2015
48347,30.2,65531,39602,11776,12092,15013,39538,23888,13310,10578,23888,110400,2015
48349,38.2,48118,28099,6418,12133,12503,41505,17477,11624,5853,17477,81300,2015
48351,41.6,14231,10503,2971,481,3038,38144,4825,3694,1131,4825,74900,2015
48353,37.9,15061,8766,627,5347,3599,37102,5599,3767,1832,5599,57200,2015
48355,34.9,352060,110139,12942,218399,87112,50337,126900,72680,54220,126900,113200,2015
48357,31.7,10642,4958,17,5421,2770,51517,3696,2695,1001,3696,84200,2015
48359,32.4,2071,1496,126,299,464,50893,640,487,153,640,87100,2015
48361,38.1,83217,68053,6845,5564,22434,49763,32054,24507,7547,32054,97800,2015
48363,41.2,27921,21245,684,5405,7041,39516,10562,7195,3367,10562,82800,2015
48365,38,23900,17494,4054,2129,6187,50119,8923,6922,2001,8923,91800,2015
48367,39.6,121418,102634,2071,13634,32561,67288,42781,33261,9520,42781,161800,2015
48369,32.5,10004,3668,167,6141,2489,45326,3224,2200,1024,3224,86400,2015
48371,35.8,15807,4226,662,10703,2881,50305,4339,3044,1295,4339,68800,2015
48373,43.5,46113,32805,5031,6543,12392,39662,17480,13758,3722,17480,81500,2015
48375,33.3,122352,57191,10966,45061,27782,38159,43227,24977,18250,43227,88200,2015
48377,41,7304,1108,1,5914,1773,32132,2634,1803,831,2634,59400,2015
48379,47.6,11037,9500,258,908,2992,48448,4201,3401,800,4201,98400,2015
48381,35.4,126782,95080,3293,23883,33292,60972,48770,33535,15235,48770,149000,2015
48383,35.9,3598,1111,61,2411,883,52181,1217,836,381,1217,82900,2015
48385,54.1,3356,2669,6,673,876,36523,1224,967,257,1224,109800,2015
48387,44.6,12567,9191,2208,899,3263,31563,5196,3734,1462,5196,69200,2015
48389,35.6,14179,2852,502,10578,2434,43540,3716,2763,953,3716,44600,2015
48391,42.7,7277,3126,427,3581,1916,44240,2753,2035,718,2753,74500,2015
48393,37.6,931,889,0,26,274,63889,350,296,54,350,109300,2015
48395,40.9,16532,9655,3419,3196,4222,46501,6065,4315,1750,6065,92600,2015
48397,36.9,85536,62282,4509,14309,23192,87524,28457,22875,5582,28457,193300,2015
48399,41.9,10445,6559,216,3506,2669,41526,3703,2814,889,3703,70000,2015
48401,38.5,53457,34720,9318,8395,12655,46173,17753,13271,4482,17753,101400,2015
48403,50.4,10440,9038,915,405,2456,31307,3795,3389,406,3795,84500,2015
48405,47.8,8695,5971,1933,602,1841,28275,2882,2319,563,2882,79000,2015
48407,43.6,27023,20359,2996,3244,6923,43029,9476,8000,1476,9476,87800,2015
48409,35.5,66070,26826,1184,36751,17174,52261,22781,15315,7466,22781,95000,2015
48411,42.1,5893,3913,190,1703,1367,39040,2126,1573,553,2126,72700,2015
48413,35.5,3224,1584,3,1627,821,55543,1074,806,268,1074,79200,2015
48415,36,17238,9494,784,6672,4137,56842,5832,4422,1410,5832,89100,2015
48417,43,3352,2961,4,361,955,48750,1377,1060,317,1377,79000,2015
48419,36.9,25725,16301,4500,4534,6237,37756,9396,6806,2590,9396,75100,2015
48421,38.3,3066,1712,6,1277,762,51987,986,777,209,986,79700,2015
48423,36.1,217552,132668,38481,40014,53709,46929,78778,51618,27160,78778,130600,2015
48425,40.6,8608,6816,52,1653,2571,51912,3386,2318,1068,3386,139800,2015
48427,29.1,62648,593,26,61842,13424,26172,16145,12138,4007,16145,65100,2015
48429,39.3,9452,6960,248,2121,2342,43951,3447,2645,802,3447,83900,2015
48431,36,1346,706,3,616,347,53456,451,341,110,451,86300,2015
48433,49,1414,1067,53,285,391,42155,580,469,111,580,49700,2015
48435,35.1,3966,1584,3,2331,1146,51667,1480,955,525,1480,88200,2015
48437,36.1,7713,3799,469,3219,1887,37040,2594,1901,693,2594,67200,2015
48439,34,1914526,954181,288833,528560,466070,58711,673737,410486,263251,673737,141000,2015
48441,32,134435,88135,9740,31179,32451,45396,49476,29700,19776,49476,101500,2015
48443,46.1,921,256,15,626,258,31111,466,309,157,466,64200,2015
48445,34.3,12687,5350,591,6630,2833,37475,4046,2916,1130,4046,64200,2015
48447,49.6,1545,1304,3,196,454,41042,701,504,197,701,64400,2015
48449,33.8,32553,15400,3109,13387,8060,44178,10461,7088,3373,10461,97500,2015
48451,33.9,115056,64062,4698,43091,27418,46711,42825,26465,16360,42825,108600,2015
48453,33,1121645,558905,88822,378387,244438,61451,428220,221425,206795,428220,237100,2015
48455,47.7,14405,11428,1474,1300,3366,34295,5325,4306,1019,5325,81000,2015
48457,42.8,21462,17047,2308,1598,5608,41360,7968,6723,1245,7968,81600,2015
48459,40.5,40096,32476,3475,3010,10104,46673,13844,10916,2928,13844,93700,2015
48461,31.9,3405,1522,155,1697,874,46131,1217,914,303,1217,57600,2015
48463,34.1,26952,7507,47,18927,5863,38568,8435,6205,2230,8435,77000,2015
48465,31.7,48980,8287,418,39377,11171,42174,14790,9590,5200,14790,92400,2015
48467,43.5,52736,44590,1228,5251,12919,44002,18613,14512,4101,18613,103400,2015
48469,35.7,90099,41908,5169,40496,23051,51758,32510,21403,11107,32510,119300,2015
48471,35,69330,39808,15716,12242,12271,37666,20685,11439,9246,20685,116100,2015
48473,29.1,45847,19713,11436,13352,10190,51348,13937,9610,4327,13937,144200,2015
48475,34.8,11225,4825,517,5690,2656,51345,3883,2830,1053,3883,72200,2015
48477,42,34236,22281,5846,5069,8409,51269,11952,8820,3132,11952,152800,2015
48479,28.3,263251,9641,728,250899,56626,38862,69668,43933,25735,69668,109500,2015
48481,37.3,41264,19043,5839,16171,10115,45176,14741,9980,4761,14741,102300,2015
48483,39,5618,3865,121,1482,1598,52221,2293,1603,690,2293,84000,2015
48485,34,131957,88483,13238,23635,30791,45543,47941,29453,18488,47941,89700,2015
48487,37.6,13158,7964,1166,3681,3295,41630,5212,3411,1801,5212,69200,2015
48489,32.3,22002,2297,343,19254,4562,26495,5553,4298,1255,5553,49700,2015
48491,35.2,473592,293907,29192,112691,117380,73750,161793,110795,50998,161793,196500,2015
48493,40.4,45509,26439,677,17637,12015,68100,15477,12931,2546,15477,159700,2015
48495,33,7576,2996,195,4307,1910,55756,2628,2084,544,2628,45200,2015
48497,39.3,61243,47865,711,11152,15989,56897,21068,16435,4633,21068,126900,2015
48499,48.2,42712,35746,2039,3998,11495,45686,16064,12849,3215,16064,111100,2015
48501,34.1,8213,2919,54,5091,2091,56153,2727,1983,744,2727,74600,2015
48503,41.9,18329,14521,201,3214,5274,44693,7115,5513,1602,7115,82000,2015
48505,29.2,14308,911,2,13395,3651,32162,4517,3399,1118,4517,55200,2015
48507,30.5,12060,767,52,11216,2642,26672,3627,2459,1168,3627,41900,2015
49001,33,6461,5742,10,694,1669,50282,2249,1688,561,2249,150000,2015
49003,32,50991,44646,146,4548,13223,55038,16404,12708,3696,16404,167500,2015
49005,25,117449,98763,798,12125,26545,50497,35685,23289,12396,35685,191900,2015
49007,35.1,20927,17443,137,2714,5255,46900,7798,5546,2252,7798,123900,2015
49009,41.3,776,743,0,18,186,56750,263,231,32,263,174700,2015
49011,30.2,323374,274418,3577,29054,79556,71112,97910,75683,22227,97910,225800,2015
49013,30.2,19817,17000,34,1514,5168,61133,6606,4990,1616,6606,172600,2015
49015,34.5,10728,10002,18,667,2739,49787,3531,2915,616,3531,132700,2015
49017,39.6,5069,4574,29,283,1213,42614,1751,1409,342,1751,156600,2015
49019,39.1,9388,7801,27,945,2258,41312,3789,2583,1206,3789,224800,2015
49021,28.1,47139,40825,286,3812,10825,43855,15095,9597,5498,15095,165900,2015
49023,30,10400,9636,11,456,2532,54761,3106,2552,554,3106,165200,2015
49025,43.6,7202,6624,13,307,1690,50194,2789,2221,568,2789,175300,2015
49027,34.9,12582,10614,47,1591,3188,51593,4160,3257,903,4160,138400,2015
49029,32.3,10276,9781,37,275,2594,74314,3024,2517,507,3024,266400,2015
49031,42.9,1865,1738,4,101,404,35980,557,468,89,557,140800,2015
49033,34.7,2292,2092,2,150,521,50781,640,506,134,640,173500,2015
49035,31.8,1078958,785919,16671,190241,247693,62117,351892,233092,118800,351892,234700,2015
49037,30.6,15152,6935,25,771,2921,41484,3923,3103,820,3923,139400,2015
49039,30.5,28261,24414,230,2686,6155,50323,7943,5883,2060,7943,164400,2015
49041,34.1,20871,19267,79,1012,5255,46291,7050,5442,1608,7050,149400,2015
49043,38.2,38521,32714,205,4482,10387,91773,13927,10388,3539,13927,497300,2015
49045,30.7,60893,50949,369,7207,14851,63552,18631,14347,4284,18631,177700,2015
49047,29.7,35721,29347,185,2840,8190,66815,10981,8365,2616,10981,189400,2015
49049,24.4,551957,460433,3041,61287,122204,62180,148464,99369,49095,148464,228400,2015
49051,33,26661,22438,14,3530,6194,66486,8095,5909,2186,8095,316800,2015
49053,34.6,148244,126337,916,14712,37180,50774,48920,33647,15273,48920,212600,2015
49055,40.3,2722,2518,18,130,706,40645,972,805,167,972,198600,2015
49057,31.8,238682,184377,2521,41704,58705,56581,80137,57074,23063,80137,168000,2015
50001,42.8,36943,34483,309,759,9532,59688,14336,10643,3693,14336,237300,2015
50003,46.1,36589,34768,177,625,10054,49573,15636,11243,4393,15636,211300,2015
50005,43.1,31012,29532,180,428,7595,45323,12287,9047,3240,12287,162400,2015
50007,36.3,159711,143706,3727,3341,36978,65350,63498,41223,22275,63498,271300,2015
50009,48.8,6207,5952,35,77,1744,36599,2701,2156,545,2701,122800,2015
50011,39.9,48418,45764,207,651,12962,58199,18685,13857,4828,18685,203000,2015
50013,47.1,6952,6504,0,115,2070,62608,2965,2354,611,2965,261300,2015
50015,40.5,25027,23768,186,386,6092,50939,10176,7360,2816,10176,220700,2015
50017,45,28929,27720,144,348,8025,53869,12148,9691,2457,12148,189400,2015
50019,44.8,27146,25972,138,354,7195,42831,11200,8789,2411,11200,154100,2015
50021,45.5,60530,58076,366,788,15567,49372,25459,17838,7621,25459,178500,2015
50023,43.2,59132,55829,504,1109,15144,58788,24512,18046,6466,24512,211200,2015
50025,45.8,43858,41102,375,921,11353,51045,19057,13188,5869,19057,209200,2015
50027,46.8,56150,53371,374,789,15146,52965,24507,17149,7358,24507,216300,2015
51001,45.3,33115,20169,9468,2909,9138,39412,13961,9919,4042,13961,153300,2015
51003,38.6,103108,79817,9539,5851,24854,68449,38853,25281,13572,38853,313800,2015
51005,47.2,16066,14781,850,232,4379,45007,6781,5337,1444,6781,112000,2015
51007,45.8,12777,9241,3108,130,3705,56850,4704,3824,880,4704,170800,2015
51009,43.6,32148,24300,5913,687,8414,47558,12502,9534,2968,12502,150100,2015
51011,42.3,15208,11669,3085,185,4530,48823,5931,4794,1137,5931,148200,2015
51013,33.9,223945,141107,18584,34629,45768,105763,98441,43697,54744,98441,607700,2015
51015,44.2,74053,67951,2939,1749,20731,54558,28150,22341,5809,28150,197400,2015
51017,48.3,4583,4179,157,159,1179,43646,2146,1495,651,2146,153700,2015
51019,45.3,76463,67590,5434,1461,21605,56316,30591,24850,5741,30591,196500,2015
51021,44.8,6662,6204,335,88,1766,45294,2614,2089,525,2614,100300,2015
51023,46.4,33155,30917,1128,467,9676,60454,12913,11314,1599,12913,208500,2015
51025,41.7,16930,6896,9424,326,3977,36919,5916,4319,1597,5916,105200,2015
51027,45.5,23486,22408,623,74,6584,29679,9442,7449,1993,9442,71500,2015
51029,42.2,17068,10410,5873,367,3864,40331,5603,4347,1256,5603,131800,2015
51031,42.4,55012,44348,7674,1054,15371,47699,21791,16572,5219,21791,151500,2015
51033,39.1,29349,18723,8400,1163,8179,59227,10970,8855,2115,10970,186800,2015
51035,46.1,29856,28448,228,876,8540,35000,12548,9915,2633,12548,107900,2015
51036,48.6,7118,2914,3419,119,1863,49563,2883,2344,539,2883,159600,2015
51037,44.6,12313,8228,3840,91,3103,35079,4723,3281,1442,4723,94300,2015
51041,38.2,328176,209074,73188,25423,83901,72609,116797,89151,27646,116797,216800,2015
51043,45.7,14299,12496,784,581,3676,71295,5526,4195,1331,5526,329500,2015
51045,47.1,5212,5002,8,1,1348,44330,2214,1794,420,2214,153000,2015
51047,38.9,48424,34628,6719,4367,12430,66697,16515,12023,4492,16515,251600,2015
51049,44.3,9859,6213,3268,12,2726,39301,4012,2893,1119,4012,137800,2015
51051,43.4,15463,15157,139,118,4382,33624,6205,4805,1400,6205,74100,2015
51053,42.4,28110,17585,9230,792,7079,51397,9939,7617,2322,9939,155300,2015
51057,44.8,11151,6164,4576,59,2716,42760,4332,3189,1143,4332,164400,2015
51059,37.4,1128722,593856,102194,181901,280010,112552,392355,265693,126662,392355,501200,2015
51061,41.5,67463,54741,4989,4711,17346,91609,23595,18674,4921,23595,357200,2015
51063,45.2,15523,14596,379,400,4278,48005,6271,4872,1399,6271,155300,2015
51065,41.6,26014,20472,3740,833,7254,63938,9891,8124,1767,9891,215600,2015
51067,45,56315,48995,4729,1497,16588,46870,23189,17950,5239,23189,168400,2015
51069,40.1,81340,69273,3587,5877,21743,69098,29455,23010,6445,29455,225300,2015
51071,43.9,16907,16123,263,204,4853,46390,7230,5499,1731,7230,104700,2015
51073,43.6,37001,31545,3002,1112,10210,61121,14280,11282,2998,14280,224100,2015
51075,47.2,21721,16795,3852,499,6316,79330,8148,7088,1060,8148,318400,2015
51077,47.6,15573,14387,427,457,4392,29942,6795,5059,1736,6795,91500,2015
51079,40.1,18938,16056,1222,920,5050,61550,7111,5512,1599,7111,241800,2015
51081,42.9,11760,4412,6739,452,2496,38012,3486,2495,991,3486,99800,2015
51083,45.3,35506,21285,13041,671,9329,35240,14300,10344,3956,14300,104700,2015
51085,41.9,101340,85830,9357,2532,28194,78645,37463,30348,7115,37463,255400,2015
51087,37.9,318864,176493,93184,16867,79485,61934,124589,78341,46248,124589,216300,2015
51089,46,52580,37147,11636,2725,14903,35293,22415,16711,5704,22415,95400,2015
51091,59,2244,2233,0,0,696,43914,1071,883,188,1071,169100,2015
51093,44.5,35740,25254,8133,899,10175,65741,13769,10749,3020,13769,243000,2015
51095,45.4,70673,54032,9438,3701,19872,75710,28000,20984,7016,28000,319100,2015
51097,45.9,7106,4679,1886,235,1956,48292,2894,2196,698,2894,155800,2015
51099,36.6,24933,18454,4352,1050,6353,81688,8379,6120,2259,8379,282500,2015
51101,40.7,16097,12245,3109,126,4552,62031,6036,4931,1105,6036,198500,2015
51103,55.6,11129,7678,3113,174,3005,50374,5164,3874,1290,5164,229100,2015
51105,42.8,25206,23434,922,444,6381,31086,9445,6906,2539,9445,78400,2015
51107,35.3,351129,208162,25125,46273,87905,123453,113432,87461,25971,113432,452300,2015
51109,43.7,33986,26174,5664,849,9271,57829,12829,10204,2625,12829,193700,2015
51111,44.7,12558,7536,4242,507,3103,39506,4516,3326,1190,4516,106600,2015
51113,44.6,13147,11215,1085,275,3406,47736,5003,3635,1368,5003,241200,2015
51115,51.1,8880,7658,911,124,2685,63845,3806,3152,654,3806,250900,2015
51117,47.2,31555,18845,11069,812,7789,37356,12482,9242,3240,12482,125400,2015
51119,52.7,10717,8367,2068,215,2911,54654,4342,3613,729,4342,245800,2015
51121,27.5,96467,81471,3984,2855,19017,46663,35199,19093,16106,35199,205100,2015
51125,48.4,14858,12144,1997,515,3997,47118,6339,4568,1771,6339,212000,2015
51127,43.1,19560,15607,2394,476,5659,73041,7299,6240,1059,7299,245000,2015
51131,48.3,12184,6598,4440,976,3117,35055,5248,3614,1634,5248,160900,2015
51133,55.1,12304,8630,3515,56,4020,51885,5861,4906,955,5861,242000,2015
51135,41.5,15711,8651,6043,618,3769,36284,5589,3651,1938,5589,132900,2015
51137,42.6,34596,27474,4399,1403,9308,65166,12810,9669,3141,12810,231200,2015
51139,44.1,23843,22569,381,426,6673,43895,9372,6596,2776,9372,176000,2015
51141,48,18264,16434,1168,491,5073,33982,7790,5974,1816,7790,111100,2015
51143,45.5,62794,46615,13418,1505,18080,41824,26204,20121,6083,26204,111900,2015
51145,43.7,28207,23526,3428,557,7808,77896,9730,8499,1231,9730,257300,2015
51147,32.1,23022,14340,7553,554,4775,41697,7409,4801,2608,7409,151500,2015
51149,37.1,37380,21065,11622,2668,8808,61857,11102,7835,3267,11102,207500,2015
51153,34,437271,202330,86180,93909,105896,98657,136794,97744,39050,136794,333100,2015
51155,45.2,34528,31435,2014,501,9847,47495,14619,10416,4203,14619,135700,2015
51157,49.1,7431,6648,311,251,2276,57210,3273,2492,781,3273,367000,2015
51159,43.7,8989,5506,2579,560,2038,47288,2875,2138,737,2875,150000,2015
51161,43.5,93633,81436,5197,2462,26027,60519,38164,28496,9668,38164,189200,2015
51163,48.3,22444,20927,637,337,6214,48901,9319,6927,2392,9319,188500,2015
51165,41.5,77785,70230,1395,4586,21349,53744,29625,22449,7176,29625,197300,2015
51167,43.8,28245,27321,293,320,7376,35045,11045,8614,2431,11045,96000,2015
51169,45.4,22570,21897,171,267,6476,37240,9379,7289,2090,9379,91900,2015
51171,43.8,42724,38050,904,2886,11758,49406,17096,12417,4679,17096,198900,2015
51173,44.3,31734,29974,657,585,8598,37983,12795,8942,3853,12795,88900,2015
51175,45.4,18410,11051,6582,240,4916,48962,6682,4656,2026,6682,159700,2015
51177,36.7,127691,90125,19966,10614,33531,78125,42823,32589,10234,42823,248300,2015
51179,34.7,137145,89952,22861,14625,35578,97144,43405,33314,10091,43405,305300,2015
51181,47.5,6823,3548,3035,111,1962,53673,2668,2134,534,2668,169000,2015
51183,38.5,11864,4572,6621,387,1912,39194,3149,2061,1088,3149,140400,2015
51185,43.1,43870,41260,1279,367,12044,37664,17832,13438,4394,17832,91400,2015
51187,40.4,38481,33831,1530,1509,10108,61454,14364,11020,3344,14364,213500,2015
51191,44.7,54759,52341,790,787,15163,43310,22673,17273,5400,22673,130200,2015
51193,46.6,17557,11153,4907,1070,4299,47911,6944,5179,1765,6944,191600,2015
51195,39.8,40530,37286,2128,490,10180,37407,15254,10627,4627,15254,87500,2015
51197,43.6,29190,27475,1051,316,7968,41360,11863,8270,3593,11863,123900,2015
51199,39.5,66471,48416,8673,3625,18908,81749,23997,17512,6485,23997,312600,2015
51510,36,149315,78235,31216,24728,32393,89134,66879,28410,38469,66879,502500,2015
51520,41.8,17524,15550,991,292,4901,35368,7718,4257,3461,7718,114500,2015
51530,33.8,6666,5927,70,91,1778,29097,2737,1605,1132,2737,115000,2015
51540,29.8,45084,29944,8664,2237,7887,49775,17752,7735,10017,17752,285300,2015
51550,36.5,230601,136438,67561,11661,61304,68620,81518,57374,24144,81518,253800,2015
51570,40,17515,13445,2231,875,4452,50304,7106,4461,2645,7106,169300,2015
51580,43.7,5736,4677,799,72,1416,34746,2476,1834,642,2476,68600,2015
51590,41.8,42450,19128,20561,1401,10777,32315,18559,10013,8546,18559,88600,2015
51595,43.4,5672,2222,3128,171,1509,28601,2459,1050,1409,2459,115000,2015
51600,39.3,23402,13990,1090,3840,5789,105297,8467,5925,2542,8467,470300,2015
51610,37.7,13308,9665,283,1294,3281,120522,5166,3031,2135,5166,718900,2015
51620,38,8457,3232,4956,88,2186,32399,3453,1648,1805,3453,178700,2015
51630,29.4,27395,16383,6080,3037,5663,51762,10080,3473,6607,10080,317900,2015
51640,45.6,6876,5228,382,1158,1790,30604,2961,1765,1196,2961,91000,2015
51650,35.4,137081,55141,67183,7133,32902,49190,52940,30486,22454,52940,188000,2015
51660,23.5,51388,35479,3358,9110,8243,38750,16409,5926,10483,16409,199400,2015
51670,36.9,22279,11390,8485,1516,5201,39064,8706,4470,4236,8706,123800,2015
51678,21.4,7071,5331,761,273,790,34017,1638,941,697,1638,242700,2015
51680,28.7,78158,49174,22124,2555,16366,39589,28528,14458,14070,28528,149200,2015
51683,33.3,40743,18181,5497,13403,9194,72890,12433,7988,4445,12433,276700,2015
51685,32.7,15625,6021,1883,5498,3383,73528,4723,3246,1477,4723,248300,2015
51690,42.4,13624,6454,6256,618,3238,29587,5857,3096,2761,5857,89100,2015
51700,32.8,181323,82039,71416,14901,42756,50077,69073,34694,34379,69073,193100,2015
51710,30,245452,108188,100975,17782,50257,44480,87045,37853,49192,87045,193400,2015
51720,39.3,4007,3469,137,97,955,27731,1783,908,875,1783,91600,2015
51730,39.5,32123,5025,24652,1361,7017,31798,12803,5301,7502,12803,111900,2015
51735,43.8,12077,11182,119,272,3424,83735,4642,3811,831,4642,307800,2015
51740,34.9,96135,37955,50125,3509,23230,45676,36757,20129,16628,36757,169800,2015
51750,22.3,17057,14237,1563,510,2397,29912,5477,2395,3082,5477,148600,2015
51760,32.9,213735,85328,103367,13580,40598,40758,87224,36875,50349,87224,193700,2015
51770,38,98736,59962,27148,5808,23614,39930,42239,22688,19551,42239,134400,2015
51775,40.5,25165,21582,1903,794,6327,50068,10045,6651,3394,10045,173100,2015
51790,42.3,24193,19749,2890,635,5818,40842,10387,5900,4487,10387,165400,2015
51800,38.3,86184,43223,35654,3102,22797,65499,30990,21882,9108,30990,235300,2015
51810,35,448290,283051,83784,33648,114380,66634,166242,105601,60641,166242,259900,2015
51820,38.5,21150,16526,2496,1421,5672,45643,9031,5215,3816,9031,156200,2015
51830,24.6,14754,10174,2210,1038,2172,48639,4538,2086,2452,4538,320600,2015
51840,37,27168,18444,2824,4430,6040,45363,10608,4758,5850,10608,216300,2015
53001,28.9,19081,6913,39,11728,4557,46564,5802,3788,2014,5802,138400,2015
53003,44.2,22040,20187,90,784,6035,44394,9341,6259,3082,9341,171900,2015
53005,35.5,184930,134307,2678,36903,46740,60251,67430,45508,21922,67430,184200,2015
53007,39.3,74267,51217,340,20199,18268,51837,27052,17761,9291,27052,246300,2015
53009,50.1,72397,60661,612,4119,18515,47253,31321,21864,9457,31321,217100,2015
53011,37.4,444506,356730,8013,37438,113110,60756,162441,104383,58058,162441,234800,2015
53013,49.5,3989,3531,14,255,1082,38581,1686,1243,443,1686,154800,2015
53015,41.2,102338,86840,586,8496,26082,47452,39763,26091,13672,39763,175300,2015
53017,37,39599,26183,81,11888,10878,53636,14212,10207,4005,14212,209700,2015
53019,47.7,7652,5670,20,309,1984,38125,3103,2209,894,3103,166000,2015
53021,29.1,86443,36603,1579,44516,19097,56980,24725,16595,8130,24725,166800,2015
53023,49.8,2230,2098,0,75,609,45855,953,650,303,953,140900,2015
53025,32.2,92070,51535,561,36545,22026,48714,30358,18369,11989,30358,157500,2015
53027,42.7,71419,57228,813,6855,17367,43538,27219,18452,8767,27219,158300,2015
53029,44,79329,64147,2216,5275,22371,58815,33125,22447,10678,33125,290900,2015
53031,55.6,30083,26669,237,1025,8093,49279,13422,10072,3350,13422,284500,2015
53033,37.2,2045756,1284684,123350,189808,488006,75302,819651,470632,349019,819651,384300,2015
53035,39.3,255441,198599,6516,18108,65501,62941,97739,65671,32068,97739,258700,2015
53037,33,42204,35720,398,3575,9451,46458,16953,9767,7186,16953,242900,2015
53039,45,20820,17134,154,2493,5281,48319,7863,5395,2468,7863,200600,2015
53041,42.8,75515,63944,553,7152,19625,44100,29515,19888,9627,29515,174000,2015
53043,48.3,10363,9551,25,297,2881,46069,4370,3451,919,4370,142500,2015
53045,45.4,60791,49816,587,5299,15047,50406,23026,17719,5307,23026,204300,2015
53047,42.6,41332,27587,248,7804,11133,40730,16619,11326,5293,16619,162700,2015
53049,51.7,20645,17177,58,1807,5522,37684,9100,6574,2526,9100,156200,2015
53051,49.3,12968,11561,24,455,3688,40599,5396,4069,1327,5396,179200,2015
53053,35.8,821952,565734,53391,81898,202396,59953,303586,185160,118426,303586,232600,2015
53055,54.4,15956,14245,86,933,4674,55960,7708,5507,2201,7708,465500,2015
53057,41,119343,90350,853,20905,31190,54129,45841,30610,15231,45841,249800,2015
53059,45.2,11243,9931,95,642,2975,52374,4495,3163,1332,4495,243000,2015
53061,37.6,746653,541202,18374,71133,187372,70722,274766,181256,93510,274766,293000,2015
53063,37.2,480832,412252,8294,24353,119767,50079,189471,119096,70375,189471,183300,2015
53065,46.2,43548,37985,213,1415,12272,41978,17679,13265,4414,17679,172600,2015
53067,38.5,262723,201709,7234,21174,68238,61677,102631,66262,36369,102631,239400,2015
53069,52.1,4035,3605,5,175,1190,44485,1716,1352,364,1716,178400,2015
53071,36.9,59726,43393,908,12528,13688,47946,21696,13944,7752,21696,192400,2015
53073,36.5,207100,166283,1705,18030,49259,53145,79767,50359,29408,79767,274700,2015
53075,24.2,46737,37533,993,2517,8677,36631,17399,7738,9661,17399,181800,2015
53077,32.5,247408,112714,1843,116577,57541,44749,79972,49969,30003,79972,158200,2015
54001,41.5,16731,16085,140,123,4239,37066,6041,4406,1635,6041,92600,2015
54003,38.4,108724,92630,7511,4235,28781,55239,40991,29992,10999,40991,162500,2015
54005,41.9,24000,23528,162,117,6692,39958,9547,7310,2237,9547,75700,2015
54007,44.5,14466,14090,64,83,3800,32750,5607,4202,1405,5607,79500,2015
54009,45.9,23665,22736,413,191,6345,46215,10030,7348,2682,10030,86500,2015
54011,38.5,96824,87459,4583,1271,23048,38344,39973,24421,15552,39973,112800,2015
54013,47,7557,7350,6,79,2094,35568,3090,2484,606,3090,71100,2015
54015,43.3,9141,8949,0,13,2422,31325,3460,2846,614,3460,78000,2015
54017,43.7,8201,7893,89,35,1760,39974,2674,2288,386,2674,92000,2015
54019,43.2,45534,42112,2350,468,12065,36293,17669,13569,4100,17669,77100,2015
54021,38.4,8644,6883,925,335,1725,37536,2744,2124,620,2744,78700,2015
54023,45.6,11815,11431,163,74,2770,39088,4175,3286,889,4175,124900,2015
54025,45.3,35666,33326,820,481,9873,39746,15339,11248,4091,15339,105300,2015
54027,44.6,23542,22621,313,288,4588,27995,10194,5542,4652,10194,121400,2015
54029,45.6,30201,28568,676,360,8289,39959,12894,9471,3423,12894,86400,2015
54031,44.5,13936,12774,607,516,3494,40303,5156,3929,1227,5156,118800,2015
54033,42,68998,65254,1225,1011,17775,43987,27502,20242,7260,27502,97800,2015
54035,42.6,29256,28483,194,13,7669,41314,11118,8668,2450,11118,111600,2015
54037,39.7,55214,46368,3776,2884,14353,66677,20331,15051,5280,20331,207300,2015
54039,42.8,190781,167969,8453,2004,50964,45882,82250,57133,25117,82250,103100,2015
54041,43.3,16434,15897,88,177,4383,37849,6526,4591,1935,6526,95500,2015
54043,41.9,21560,21175,103,24,5462,35800,7994,6149,1845,7994,81000,2015
54045,42.6,35760,34268,767,316,9860,36763,14043,10662,3381,14043,82100,2015
54047,44.1,20802,18503,1892,241,5400,24921,8180,6277,1903,8180,35500,2015
54049,41.1,56790,52887,2039,667,14742,43165,22481,17218,5263,22481,99800,2015
54051,44.3,32480,31475,279,317,9355,45182,13569,10501,3068,13569,94600,2015
54053,43,27177,26330,197,267,7244,36448,10838,8614,2224,10838,79600,2015
54055,42.3,61891,55983,3625,586,16753,36195,25451,18320,7131,25451,85200,2015
54057,43.2,27755,26135,843,239,6435,31790,11265,6456,4809,11265,118800,2015
54059,41.7,25931,24899,367,103,7572,33221,10844,8232,2612,10844,73200,2015
54061,30,101668,90471,3615,2072,19381,45467,37035,21173,15862,37035,167600,2015
54063,46.6,13525,13068,94,140,4124,36918,5822,4700,1122,5822,101600,2015
54065,46.1,17475,16785,135,230,4007,39324,7348,5194,2154,7348,165000,2015
54067,43.4,25930,25749,9,7,7576,39171,10787,8540,2247,10787,83100,2015
54069,43.3,43637,40308,1812,449,10574,40569,18408,12583,5825,18408,107500,2015
54071,49.1,7402,7029,202,82,2009,36953,3095,2430,665,3095,100500,2015
54073,43.6,7636,7357,21,82,2090,44288,2893,2407,486,2893,100800,2015
54075,48.4,8697,8356,129,59,2365,36827,3737,3013,724,3737,115500,2015
54077,42.3,33809,31440,1330,556,8694,45064,12472,9943,2529,12472,107100,2015
54079,41,56596,54115,849,584,15879,56774,21707,17999,3708,21707,148600,2015
54081,41.6,78493,68500,6480,1122,20812,41032,31274,22779,8495,31274,101700,2015
54083,43.2,29365,28254,557,233,7738,39457,11563,8435,3128,11563,101200,2015
54085,45.2,10140,9925,48,51,2520,37636,3942,3130,812,3942,73100,2015
54087,44.2,14636,14220,3,133,3825,31813,5872,4486,1386,5872,88900,2015
54089,46.3,13544,12404,667,243,3665,36651,5584,4374,1210,5584,89200,2015
54091,43,16977,16359,161,159,4609,43970,6732,5309,1423,6732,88800,2015
54093,47.7,6972,6810,16,34,2034,40533,3010,2382,628,3010,104000,2015
54095,46.2,9033,8863,15,58,2403,38854,3616,2789,827,3616,87100,2015
54097,41.8,24560,23676,260,274,6281,40330,9093,6910,2183,9093,108800,2015
54099,42.5,41499,40497,150,259,10919,36318,16691,12838,3853,16691,82800,2015
54101,46.3,8927,8724,11,23,2632,29086,3887,2869,1018,3887,64800,2015
54103,46,16157,15800,19,105,4278,39096,6525,5170,1355,6525,83500,2015
54105,45,5841,5681,49,9,1607,39352,2430,1981,449,2430,80300,2015
54107,42.5,86559,82684,917,849,23325,41884,36192,25791,10401,36192,107000,2015
54109,42.8,22866,22298,179,77,6504,33730,9199,7461,1738,9199,60200,2015
55001,51.4,20451,18529,613,784,5066,43640,7786,6588,1198,7786,131600,2015
55003,42.2,15993,13293,84,368,3911,39381,6718,4657,2061,6718,109000,2015
55005,43.9,45686,42985,579,1049,12589,45714,19120,13965,5155,19120,134100,2015
55007,50.8,15050,12852,92,221,4354,46665,6919,5691,1228,6919,161300,2015
55009,36.8,254717,209674,5474,20132,65128,53527,100640,66370,34270,100640,158400,2015
55011,45,13319,12834,63,264,3771,50196,5771,4350,1421,5771,145500,2015
55013,50.9,15334,13896,74,239,4637,41135,7312,5879,1433,7312,148800,2015
55015,39,49678,45568,347,1931,13904,67427,18583,15078,3505,18583,165200,2015
55017,40.6,63209,59514,842,914,16726,52109,24873,18024,6849,24873,148500,2015
55019,37.1,34518,32382,132,1417,8895,45048,12797,9866,2931,12797,113100,2015
55021,42,56607,53011,836,1598,15402,59769,22615,16817,5798,22615,175300,2015
55023,45.9,16483,15742,292,180,4186,44459,6623,4911,1712,6623,123500,2015
55025,34.6,510198,412357,25585,31486,122178,62865,211114,122677,88437,211114,230800,2015
55027,42,88547,80418,1809,3890,22114,53783,33322,24103,9219,33322,153100,2015
55029,51.7,27731,26297,146,731,8479,51928,12968,10209,2759,12968,194100,2015
55031,40.6,43799,40331,483,588,11377,47095,18581,12670,5911,18581,131200,2015
55033,34.1,44159,41212,252,746,10413,49788,16441,11111,5330,16441,153700,2015
55035,33.8,101281,92275,717,2212,23374,49513,39893,24678,15215,39893,152000,2015
55037,51.1,4476,4373,9,45,1286,48643,1904,1655,249,1904,140700,2015
55039,41,101920,92696,1140,4849,27232,55473,41069,29372,11697,41069,146100,2015
55041,45.3,9150,7407,45,180,2527,40636,3810,2926,884,3810,126500,2015
55043,36.1,51489,49238,656,697,12061,49067,19447,13770,5677,19447,133200,2015
55045,42.2,37044,35137,107,1072,10092,56219,14819,10873,3946,14819,160200,2015
55047,45.2,18966,17684,99,863,5230,46780,7939,5834,2105,7939,140300,2015
55049,42.9,23769,22871,92,396,6486,55188,9689,7452,2237,9689,163300,2015
55051,52.4,5907,5705,26,54,1795,42543,2910,2368,542,2910,104700,2015
55053,42.2,20543,17807,463,638,5255,47851,7960,5895,2065,7960,127000,2015
55055,39.1,84345,76047,633,5816,22005,56877,32413,23140,9273,32413,173000,2015
55057,44.4,26494,24394,601,757,6362,44961,9984,7646,2338,9984,116800,2015
55059,37.4,167738,129010,12057,20837,41587,54918,62330,41580,20750,62330,161800,2015
55061,43.5,20483,19563,64,492,5413,56863,8138,6610,1528,8138,148100,2015
55063,35.4,117048,106003,1604,1990,28033,50539,46345,30084,16261,46345,156700,2015
55065,41.4,16835,15976,65,595,4550,51445,6646,5083,1563,6646,124000,2015
55067,47.2,19551,18551,152,373,5420,41775,8713,6534,2179,8713,109700,2015
55069,46.1,28286,27172,143,379,8147,49721,12419,9381,3038,12419,132600,2015
55071,44.2,80521,73839,356,2782,21910,48398,33927,25502,8425,33927,126700,2015
55073,40.6,135177,121051,926,3392,36303,54083,53848,39406,14442,53848,144500,2015
55075,47.2,41287,39556,142,623,11341,43425,18319,13841,4478,18319,110500,2015
55077,48.6,15140,14321,66,446,4219,46242,6332,5088,1244,6332,144500,2015
55078,31.6,4451,468,19,246,925,35343,1259,875,384,1259,83500,2015
55079,34.2,955939,508095,249456,134114,217388,43873,381715,190470,191245,381715,151700,2015
55081,39.3,45274,41470,450,1795,11799,50694,17794,12016,5778,17794,135300,2015
55083,45.4,37476,35798,74,614,10867,52765,15486,12951,2535,15486,150900,2015
55085,49.9,35653,34014,223,483,9658,46516,15044,12525,2519,15044,162600,2015
55087,37.8,180430,159830,1997,7093,47627,58765,70505,50215,20290,70505,155900,2015
55089,43.8,87273,80776,1191,2290,24420,76433,34543,26494,8049,34543,245700,2015
55091,45.2,7372,7154,26,100,2023,49516,2954,2412,542,2954,141800,2015
55093,35.9,40799,38712,193,750,10253,61611,15177,10983,4194,15177,191000,2015
55095,44.1,43572,41604,169,735,12366,50714,17994,13862,4132,17994,155100,2015
55097,36.2,70432,64811,432,2073,17323,51613,27768,19054,8714,27768,151700,2015
55099,50.5,13800,13187,48,202,4255,43137,6700,5166,1534,6700,116700,2015
55101,39.7,194895,142862,21074,23900,50245,55584,75183,52516,22667,75183,164600,2015
55103,44.1,17746,16926,94,390,4970,44810,7547,5504,2043,7547,124200,2015
55105,38.9,160727,134642,5524,12998,42099,50324,63845,44177,19668,63845,131800,2015
55107,47.5,14357,13769,140,217,4126,39194,6239,4839,1400,6239,105200,2015
55109,37.6,86118,81368,615,1873,23942,70886,32459,25009,7450,32459,205400,2015
55111,40.9,62992,57817,322,2962,16601,51055,25331,17540,7791,25331,166700,2015
55113,49.3,16483,12817,114,341,4881,41665,7359,5521,1838,7359,160400,2015
55115,44.3,41563,36342,120,1068,11304,47861,16957,12919,4038,16957,131500,2015
55117,41.3,115226,99022,1622,6777,30905,53713,46701,33009,13692,46701,148200,2015
55119,43.1,20569,19909,100,342,5689,45420,8756,6750,2006,8756,127200,2015
55121,40.7,29412,26941,137,1941,7893,51077,11796,8603,3193,11796,140800,2015
55123,42.3,30279,29213,152,467,7938,47675,11758,9302,2456,11758,140900,2015
55125,52.6,21355,18256,52,379,6721,41061,10646,8070,2576,10646,194900,2015
55127,38.9,103039,88257,959,11228,26009,53445,39648,27018,12630,39648,189600,2015
55129,49.2,15700,14878,71,251,4602,42368,7141,5557,1584,7141,143600,2015
55131,42.1,132921,124434,1362,3853,37895,69237,52897,41284,11613,52897,215400,2015
55133,42.8,393873,352959,5469,17660,108506,76545,154991,118321,36670,154991,249300,2015
55135,44.4,52125,49524,186,1477,14043,51994,21532,16187,5345,21532,137300,2015
55137,47.9,24321,21879,439,1514,6440,45166,9689,7854,1835,9689,137300,2015
55139,37.7,169004,151662,3274,6451,41687,52018,68939,44892,24047,68939,143100,2015
55141,43.4,74012,68944,394,1948,20132,48961,31717,23618,8099,31717,120100,2015
56001,26.6,37565,31337,479,3431,7595,42834,15662,7591,8071,15662,216100,2015
56003,41.2,11895,10478,7,1055,2969,51679,4491,3321,1170,4491,141400,2015
56005,32.7,48013,42224,380,3935,12193,80060,17510,12651,4859,17510,212200,2015
56007,39,15739,12343,218,2731,4070,56825,6108,4217,1891,6108,146200,2015
56009,40.3,14101,12568,6,1054,4034,62307,5677,4229,1448,5677,190300,2015
56011,43.4,7229,6996,14,183,2153,60445,2958,2317,641,2958,205800,2015
56013,38.2,40755,28750,197,2674,10118,52773,15330,10875,4455,15330,186500,2015
56015,42.9,13544,11713,46,1409,3438,42689,5384,4124,1260,5384,148700,2015
56017,49.6,4809,4491,12,174,1307,45278,2182,1621,561,2182,151600,2015
56019,44.6,8600,8153,4,375,2150,54065,3649,2623,1026,3649,227700,2015
56021,36.7,95431,75571,2691,13372,24950,60706,37294,25632,11662,37294,190000,2015
56023,38.1,18316,16995,27,801,4922,66647,6797,5496,1301,6797,201700,2015
56025,36,80011,69745,883,6372,20267,56871,32131,21409,10722,32131,185600,2015
56027,43,2516,2303,7,65,594,40398,1045,715,330,1045,157900,2015
56029,43.6,28985,26226,236,1671,7783,56363,11822,8514,3308,11822,221300,2015
56031,47.9,8750,7827,3,672,2395,38500,3758,2893,865,3758,155500,2015
56033,42.2,29738,27270,241,1246,7912,55455,12578,8589,3989,12578,228000,2015
56035,38.1,10117,8916,0,777,2663,81772,3623,2664,959,3623,275600,2015
56037,33.6,44772,35751,375,7056,11412,69022,16679,11841,4838,16679,190900,2015
56039,38,22311,18115,35,3378,4840,75325,8187,4953,3234,8187,689000,2015
56041,34.6,20930,18378,41,1858,5345,56569,7502,5480,2022,7502,176700,2015
56043,43.4,8400,6921,57,1175,2233,47652,3512,2590,922,3512,160800,2015
56045,42.1,7152,6594,15,234,1886,57738,2986,2330,656,2986,178200,2015
72001,37.8,18962,40,0,18922,4617,10499,6322,3384,2938,6322,103000,2015
72003,39.5,40603,1361,23,38024,9849,16029,13110,9987,3123,13110,90000,2015
72005,39.7,57973,997,114,55700,14977,17267,20821,13104,7717,20821,126500,2015
72007,37.7,27693,210,0,27482,6713,14824,8848,5981,2867,8848,102900,2015
72009,40.2,24829,47,7,24769,6484,17307,8708,7044,1664,8708,129600,2015
72011,40.4,28579,257,13,28250,6975,17386,9572,7325,2247,9572,114100,2015
72013,40.2,92511,394,6,92055,23415,16485,32287,22408,9879,32287,99800,2015
72015,37.2,19018,30,0,18988,4449,15298,6281,4726,1555,6281,91600,2015
72017,37,24775,80,25,24627,6134,15212,8315,6479,1836,8315,106300,2015
72019,34.3,29805,0,3,29772,7200,14331,9319,6714,2605,9319,99000,2015
72021,39.3,197287,1073,249,195679,51010,24430,71375,49353,22022,71375,142800,2015
72023,41.1,50380,142,0,50238,11672,16499,17115,10037,7078,17115,115000,2015
72025,38.4,138262,956,29,137248,36136,23769,50500,34476,16024,50500,138000,2015
72027,39,33949,194,11,33744,9292,17532,11934,8621,3313,11934,100900,2015
72029,37.5,47432,29,31,47372,10763,20023,14698,11207,3491,14698,121100,2015
72031,39.7,168114,1373,124,166043,44994,27969,64366,44630,19736,64366,152800,2015
72033,36.9,26680,83,0,26492,6967,18326,9372,5756,3616,9372,124300,2015
72035,39.8,46647,238,0,46372,11773,20751,16575,11291,5284,16575,118100,2015
72037,39.7,12810,36,0,12745,3250,20702,4584,3587,997,4584,97300,2015
72039,38.9,17928,85,0,17843,4340,12630,5899,3963,1936,5899,108200,2015
72041,37.6,42298,129,0,42107,10983,23315,13905,10532,3373,13905,118200,2015
72043,37.7,40293,88,7,40197,9922,18233,13648,10535,3113,13648,93200,2015
72045,36.4,20339,24,0,20300,4713,13124,6492,4227,2265,6492,92700,2015
72047,36.4,35975,22,0,35914,8802,15098,11039,8466,2573,11039,101800,2015
72049,38.9,1557,53,0,1490,310,18649,518,358,160,518,122800,2015
72051,38.3,38166,696,66,37360,9578,26947,12332,9623,2709,12332,140300,2015
72053,39.1,34720,227,16,34444,8754,19320,12759,8887,3872,12759,106700,2015
72054,37.1,12408,30,0,12378,3513,14994,4364,3213,1151,4364,91300,2015
72055,39.6,18207,84,0,18123,4005,13682,5445,4046,1399,5445,90100,2015
72057,36.4,43700,116,12,43486,10237,15860,15179,10929,4250,15179,96000,2015
72059,38.3,20442,91,0,20330,5083,15067,6620,4940,1680,6620,84800,2015
72061,41.3,93899,1040,50,92613,23970,34719,34963,26029,8934,34963,200400,2015
72063,36.7,46765,393,84,46252,11248,29317,15306,12599,2707,15306,163600,2015
72065,39.4,41578,147,0,41307,10812,18687,14337,10551,3786,14337,129300,2015
72067,44,16845,39,22,16762,4413,20598,6418,4891,1527,6418,106900,2015
72069,39.7,56384,423,63,55788,13408,19342,18563,14045,4518,18563,102400,2015
72071,40,44438,293,70,43958,11014,15707,15303,9418,5885,15303,109000,2015
72073,35.2,15890,25,0,15865,3843,16033,4817,3319,1498,4817,91700,2015
72075,36.4,49259,130,6,49083,12735,18609,16619,13015,3604,16619,103700,2015
72077,36.1,40104,184,12,39908,9596,19141,12984,9563,3421,12984,117700,2015
72079,41.9,24722,21,0,24701,5963,13215,8417,4625,3792,8417,97800,2015
72081,39.2,28727,67,6,28604,7507,11905,10128,5670,4458,10128,91000,2015
72083,38,9306,98,0,9208,2281,13944,3144,2038,1106,3144,80200,2015
72085,37,38605,55,55,38457,9663,18838,12884,9163,3721,12884,114800,2015
72087,35.7,28454,8,0,28434,6529,18718,9007,6584,2423,9007,107200,2015
72089,39.3,19497,303,85,19043,4806,18170,6788,4646,2142,6788,111000,2015
72091,39.1,42167,422,111,41602,11443,18162,16075,11516,4559,16075,114900,2015
72093,40.7,6315,0,8,6307,1356,12606,1907,1380,527,1907,108700,2015
72095,41.5,11701,16,0,11685,3088,19541,4086,3006,1080,4086,99200,2015
72097,38.3,83418,603,58,82572,19070,14871,30431,17875,12556,30431,100400,2015
72099,37.3,38815,166,0,38497,9204,14427,12279,8637,3642,12279,99500,2015
72101,35.2,32294,33,0,32236,7455,16536,9788,6974,2814,9788,101200,2015
72103,36.1,26804,37,0,26736,6243,18704,8797,6952,1845,8797,94100,2015
72105,37,29751,39,0,29640,6687,17423,8632,6625,2007,8632,103300,2015
72107,36.5,22595,21,0,22574,5153,14110,6857,4949,1908,6857,107600,2015
72109,41.7,18441,19,0,18410,4111,13284,6436,4741,1695,6436,95400,2015
72111,35.1,22770,158,0,22612,5962,15497,7643,5878,1765,7643,82100,2015
72113,38.3,156054,838,125,154999,38403,16318,55497,36000,19497,55497,103000,2015
72115,39.1,25205,123,55,25013,6969,15806,9043,5436,3607,9043,114400,2015
72117,42.6,14841,744,0,13499,3774,16755,5437,4149,1288,5437,127200,2015
72119,38.6,53029,344,28,52635,12692,22246,16831,12952,3879,16831,116600,2015
72121,40.2,24307,242,0,24065,4878,14795,7075,5351,1724,7075,97700,2015
72123,36.5,30114,81,27,29901,7813,15240,11027,9011,2016,11027,85500,2015
72125,41.3,34125,92,20,33998,8096,14797,12430,8762,3668,12430,106800,2015
72127,40.4,371400,4448,917,364739,86944,21243,147316,78910,68406,147316,163100,2015
72129,39,39778,89,0,39681,9889,16538,13649,9694,3955,13649,119200,2015
72131,41.1,40471,227,0,40182,9993,14345,13652,8606,5046,13652,109700,2015
72133,35.5,22913,40,0,22873,5428,15674,7727,5789,1938,7727,91800,2015
72135,35.8,74603,195,41,74163,18751,29976,22569,19111,3458,22569,150000,2015
72137,37.6,85242,247,89,84774,20327,23303,28833,20965,7868,28833,135600,2015
72139,37.8,71886,283,14,71588,17883,30140,24812,16998,7814,24812,158900,2015
72141,39.7,31474,89,36,31349,7569,15725,10130,6654,3476,10130,95100,2015
72143,36.7,39319,445,15,38764,9334,18016,12572,9218,3354,12572,122200,2015
72145,38.5,56858,1938,74,54805,12741,16948,17309,14357,2952,17309,116200,2015
72147,42.8,9130,268,0,8829,1825,18104,2773,2317,456,2773,112700,2015
72149,35.9,24685,4,0,24605,6212,17818,8003,6090,1913,8003,95800,2015
72151,39.6,36279,57,0,36200,8643,15627,12171,8687,3484,12171,91600,2015
72153,40.8,39474,181,0,39278,7184,14708,10435,8135,2300,10435,92700,2015
01001,37.8,55049,41663,10113,1416,14653,53099,20800,15218,5582,20800,141000,2016
01003,42.3,199510,165950,18406,8712,50190,51365,75149,53905,21244,75149,173400,2016
01005,38.7,26614,12212,12745,1147,5968,33956,9122,5829,3293,9122,90300,2016
01007,40.2,22572,16876,4788,502,5272,39776,7048,5119,1929,7048,97200,2016
01009,40.8,57704,50582,899,5036,15439,46212,20619,16254,4365,20619,124200,2016
01011,39.2,10552,2288,7967,13,2318,29335,3556,2600,956,3556,68000,2016
01013,40.6,20280,10704,8825,253,5139,34315,7675,5393,2282,7675,83000,2016
01015,39.1,115883,84592,23561,3982,30700,41954,45071,31107,13964,45071,107900,2016
01017,43.1,34018,19303,13770,148,8654,36027,13851,9370,4481,13851,83000,2016
01019,45.7,25897,23792,1193,405,7919,38925,10999,8708,2291,10999,112500,2016
01021,38.7,43817,35321,4386,3341,11631,42594,16619,12635,3984,16619,99100,2016
01023,45.1,13287,7468,5611,74,3604,32622,5562,4479,1083,5562,64600,2016
01025,42,24847,13213,11304,43,6094,32735,9554,6422,3132,9554,85900,2016
01027,43.7,13483,10822,1988,419,3782,38815,5363,4025,1338,5363,90000,2016
01029,41.5,14991,13911,354,349,3888,36316,5834,4411,1423,5834,108100,2016
01031,39.3,50991,36393,8671,3344,13178,47872,19375,12917,6458,19375,142800,2016
01033,42.4,54377,42878,8509,1306,15052,43786,22105,15936,6169,22105,102500,2016
01035,44,12697,6440,5868,224,3444,27609,5090,3997,1093,5090,72300,2016
01037,44.9,10864,7064,3516,140,2600,31910,4206,3345,861,4206,76500,2016
01039,42.9,37729,31509,4896,578,10110,37313,15179,11343,3836,15179,93700,2016
01041,41.6,13896,9848,3290,234,3648,37557,5426,3805,1621,5426,77600,2016
01043,40.5,81316,75188,843,3426,21594,39297,31081,23583,7498,31081,118700,2016
01045,36.9,49607,34820,9625,2921,12499,44093,18794,11413,7381,18794,103800,2016
01047,38.9,41426,11628,28790,397,10047,28136,16099,9385,6714,16099,81000,2016
01049,39.3,70937,57470,1048,9942,17495,38248,24811,17938,6873,24811,99600,2016
01051,38.3,80957,59656,17092,2268,20757,53398,28890,21215,7675,28890,152500,2016
01053,39.9,37875,22950,12245,780,8802,32334,13536,9641,3895,13536,93900,2016
01055,40.9,103363,81069,15799,3752,27098,40478,39522,28044,11478,39522,101900,2016
01057,43.6,16783,14304,2054,144,4754,36205,6850,5336,1514,6850,76400,2016
01059,39.1,31573,24650,1282,5057,8111,36138,11697,8053,3644,11697,87000,2016
01061,42,26765,22499,2522,992,7488,36519,10657,8018,2639,10657,81500,2016
01063,41.3,8587,1472,6971,53,1951,21339,3107,2189,918,3107,68100,2016
01065,39.7,15159,6059,8835,183,3813,33351,5948,4467,1481,5948,89400,2016
01067,43.2,17187,11784,4793,435,4530,41045,6831,5471,1360,6831,101800,2016
01069,39.3,103891,70077,27401,3311,25986,41945,39363,25354,14009,39363,124800,2016
01071,42.8,52608,47080,1733,1435,13871,38422,19945,14527,5418,19945,103800,2016
01073,37.5,659096,333970,279059,24316,165637,47220,261773,164876,96897,261773,145700,2016
01075,44.3,14066,12116,1584,201,4114,34298,6010,4396,1614,6010,71100,2016
01077,41.3,92641,78737,9045,2217,24836,43657,38361,26319,12042,38361,124100,2016
01079,42.2,33433,25629,3800,691,9456,42339,13321,10626,2695,13321,97600,2016
01081,30.5,153947,104480,35541,5681,36318,45056,57901,34032,23869,57901,156400,2016
01083,39,90257,69892,11440,5135,22861,51115,32073,24364,7709,32073,142500,2016
01085,40.4,10565,2578,7886,50,2778,27914,4238,3118,1120,4238,68900,2016
01087,38.2,19684,3036,16049,324,4611,32390,7915,5222,2693,7915,77000,2016
01089,38.1,349973,228991,83934,16362,90135,60150,139949,95114,44835,139949,171200,2016
01091,42.2,20066,9120,10587,190,4802,30713,8149,5683,2466,8149,87900,2016
01093,43.9,30239,27834,982,726,8932,34074,12486,9552,2934,12486,85500,2016
01095,38.8,94534,77841,1976,12210,24025,39831,34461,24342,10119,34461,115700,2016
01097,37.2,414291,239671,145837,10957,102867,44263,154261,101766,52495,154261,123500,2016
01099,41.5,21975,12013,9321,136,5157,28182,8316,5100,3216,8316,87700,2016
01101,36,227392,81730,128907,7530,57078,45358,90281,53031,37250,90281,122000,2016
01103,39.8,119555,91602,14410,9339,31712,46883,46164,32717,13447,46164,124900,2016
01105,37.1,9856,2920,6760,94,2080,24912,3198,2345,853,3198,73700,2016
01107,42.2,20042,10994,8372,486,4800,31679,7618,5541,2077,7618,89100,2016
01109,31.2,33277,18822,12451,730,7480,33193,12802,7592,5210,12802,102300,2016
01111,42.8,22615,17060,4339,661,5954,37496,8691,6172,2519,8691,85600,2016
01113,34.8,58636,28565,24639,2974,14374,38400,22333,13103,9230,22333,114000,2016
01115,40,86576,74718,8099,1961,23359,54042,31832,25809,6023,31832,142800,2016
01117,38.1,205951,162487,23815,11861,54252,72310,75942,60224,15718,75942,195400,2016
01119,36.5,13285,3265,9520,39,2682,20428,4878,3225,1653,4878,73400,2016
01121,40.8,81057,51487,25979,1752,21290,37923,31461,22718,8743,31461,94200,2016
01123,43,40958,28291,11069,988,11355,39395,16338,11571,4767,16338,105200,2016
01125,32.1,202471,127514,62688,6666,46468,48022,70440,44393,26047,70440,160000,2016
01127,42.3,65593,58748,3711,1483,18118,37025,25194,18772,6422,25194,84800,2016
01129,41.4,16909,11001,4189,219,4529,40293,6113,5115,998,6113,81100,2016
01131,40.2,11119,3050,8000,62,2352,24442,3792,2376,1416,3792,81600,2016
01133,44.1,24013,22638,98,700,6389,33896,9436,7158,2278,9436,77700,2016
02013,42.8,3299,492,218,331,499,65926,788,443,345,788,124500,2016
02016,37.6,5714,1488,311,790,697,86964,1186,336,850,1186,211400,2016
02020,32.8,299321,179128,15902,26091,69876,80862,104969,63267,41702,104969,298000,2016
02050,26.8,17885,1864,135,359,3401,53296,4555,2921,1634,4555,151400,2016
02060,40.7,942,500,3,46,231,88000,360,197,163,360,199000,2016
02068,37.3,2125,1812,21,17,390,81302,707,533,174,707,228600,2016
02070,29.7,4980,838,12,147,967,56055,1375,832,543,1375,196400,2016
02090,30.7,100150,71633,3982,7486,22273,73831,35303,21005,14298,35303,224000,2016
02100,44.6,2528,1944,1,41,670,53125,1170,803,367,1170,198400,2016
02105,48.4,2107,1018,73,105,540,54091,836,597,239,836,235100,2016
02110,37.5,32524,21356,364,2048,7973,87436,12138,7816,4322,12138,329500,2016
02122,40.5,57637,46917,323,2214,13701,64891,21481,15382,6099,21481,229200,2016
02130,39.2,13715,8858,68,634,3290,64162,5209,3100,2109,5209,257100,2016
02150,32.7,13918,7067,16,1211,3305,73068,4585,2785,1800,4585,266700,2016
02158,23.3,7993,298,28,107,1458,38160,1734,1284,450,1734,101300,2016
02164,31.9,1411,286,11,29,322,43864,468,318,150,468,143800,2016
02170,34.8,98679,79313,971,4463,21899,73908,30839,23382,7457,30839,230100,2016
02180,27.7,9879,1510,75,212,2187,51563,2879,1732,1147,2879,138300,2016
02185,33.8,9681,3056,46,371,1515,72027,2018,1010,1008,2018,154100,2016
02188,26.3,7723,862,25,163,1492,61341,1904,1044,860,1904,146400,2016
02195,40.8,3196,2142,75,331,775,63940,1237,840,397,1237,213400,2016
02198,40.5,6374,2877,13,221,1453,51887,2267,1625,642,2267,171100,2016
02220,39.1,8921,5544,195,556,2043,70160,3504,1960,1544,3504,341600,2016
02230,44.1,1014,775,5,64,198,64853,428,233,195,428,305700,2016
02240,36.4,6970,5255,88,353,1432,63713,2085,1494,591,2085,201600,2016
02261,37.6,9522,6679,12,444,1973,82511,2937,2105,832,2937,227900,2016
02275,48.8,2401,1594,7,72,652,52986,1045,716,329,1045,183300,2016
02282,40.5,646,279,7,18,149,66875,247,149,98,247,165800,2016
02290,35.2,5600,1190,21,107,1268,38451,1981,1404,577,1981,90800,2016
04001,33.5,72346,13436,352,4303,13334,32460,19351,14882,4469,19351,77900,2016
04003,40.3,128177,72163,4761,44097,32393,45383,49230,33380,15850,49230,140700,2016
04005,30.7,138064,75410,1854,18930,29589,51106,47366,28005,19361,47366,231300,2016
04007,48.9,53179,33621,294,9864,14086,40593,21408,15383,6025,21408,139800,2016
04009,32.4,37529,19313,680,12046,7703,47422,10915,7570,3345,10915,121400,2016
04011,33.3,9224,4407,164,4290,2356,51813,3295,1500,1795,3295,81600,2016
04012,55.1,20304,11956,77,5316,5811,36321,9181,6885,2296,9181,71200,2016
04013,35.8,4088549,2327125,204984,1238292,959264,55676,1465840,884770,581070,1465840,204900,2016
04015,49.7,203629,159345,1938,31987,51907,39856,82145,54832,27313,82145,130000,2016
04017,35.8,108209,45369,728,11957,24668,36868,34090,23796,10294,34090,106100,2016
04019,38.1,1003338,534494,32104,362265,243175,46764,395390,242399,152991,395390,160800,2016
04021,38.3,397604,230156,17231,116072,93354,51190,130801,94847,35954,130801,142200,2016
04023,36.4,46547,7110,93,38736,11660,38941,15538,10288,5250,15538,135200,2016
04025,51.9,218586,177403,1133,30722,59635,46638,93445,65515,27930,93445,199300,2016
04027,34,203292,66568,3652,125972,53253,41467,70924,47826,23098,70924,113400,2016
05001,41.2,18569,13071,4783,556,4879,37330,7685,4967,2718,7685,77600,2016
05003,41.5,20989,14270,5440,1080,5932,36352,8338,6263,2075,8338,70900,2016
05005,51.8,40992,39042,101,836,11862,38115,18061,13608,4453,18061,123100,2016
05007,35.1,245231,183280,3502,39405,65191,59016,88014,58924,29090,88014,155900,2016
05009,42.4,37301,35190,127,859,10264,38664,14883,10714,4169,14883,114400,2016
05011,40.9,11096,6266,3223,1573,2932,34665,4550,2936,1614,4550,72500,2016
05013,44.9,5210,3796,1140,198,1400,35446,2079,1700,379,2079,71800,2016
05015,44.4,27690,22453,141,4021,7116,38145,10874,8266,2608,10874,118500,2016
05017,43.7,11189,4379,6067,578,2888,29628,4384,2902,1482,4384,59600,2016
05019,33.6,22684,15736,5348,1013,5494,35595,8783,5544,3239,8783,92700,2016
05021,44,15202,14596,76,275,4167,32404,6453,4683,1770,6453,66700,2016
05023,47.9,25587,24308,143,615,7083,41717,10360,7802,2558,10360,126100,2016
05025,42.5,8421,7132,885,189,2419,42429,3342,2519,823,3342,84000,2016
05027,36,24168,14312,8383,619,6411,36507,9518,6296,3222,9518,77100,2016
05029,41,21060,17225,2484,790,5594,38266,8360,6069,2291,8360,100300,2016
05031,33.9,102884,80214,14233,4856,25935,43892,39042,23001,16041,39042,131700,2016
05033,38.8,61927,52938,825,4328,17788,41792,23548,17991,5557,23548,109500,2016
05035,34.7,49511,21613,25033,1151,12288,39407,18496,10565,7931,18496,102800,2016
05037,40.3,17329,12686,4020,322,4729,39306,6703,4424,2279,6703,83900,2016
05039,43.4,7738,4128,3153,229,2059,35745,3222,2162,1060,3222,61000,2016
05041,39.3,12234,5617,5827,642,3297,26519,5224,2925,2299,5224,58800,2016
05043,36.8,18688,12540,5369,551,4682,33092,7094,4453,2641,7094,94200,2016
05045,31.9,120417,97912,13406,4754,28640,50872,43451,27050,16401,43451,149900,2016
05047,41,17799,16489,161,501,4614,39482,6779,4959,1820,6779,94000,2016
05049,48.2,12186,11657,9,158,3812,35593,5240,4062,1178,5240,88500,2016
05051,44.1,97119,80533,7927,5064,25643,40011,40353,26768,13585,40353,133700,2016
05053,39.3,18046,16809,783,168,5036,49195,6869,5464,1405,6869,117800,2016
05055,38.2,43745,41229,411,1144,11724,42755,16766,11135,5631,16766,105300,2016
05057,38.5,22208,12299,6712,2782,5257,34072,7729,5239,2490,7729,76300,2016
05059,40.9,33440,27741,3770,1093,8824,42589,12226,8921,3305,12226,85600,2016
05061,38.6,13487,8822,2839,1538,3531,34672,5068,3390,1678,5068,90100,2016
05063,39.2,37030,33066,722,2221,9773,37592,14316,10247,4069,14316,99900,2016
05065,48.1,13461,12871,166,254,3541,35188,5349,4166,1183,5349,77600,2016
05067,40.8,17495,13540,2983,469,3767,31245,6219,4265,1954,6219,63600,2016
05069,38.7,72385,28877,40590,1369,17021,36377,27660,17281,10379,27660,81900,2016
05071,38,26025,21108,396,3474,6811,34031,10014,7153,2861,10014,90100,2016
05073,45.3,7127,4228,2758,71,1820,29882,2947,2129,818,2947,63300,2016
05075,41.8,16915,16237,122,209,4437,33381,6603,4468,2135,6603,69700,2016
05077,40.9,9781,3978,5614,144,2172,25724,3541,1951,1590,3541,64600,2016
05079,37.6,13935,9001,4298,501,2842,32369,3940,2827,1113,3940,65000,2016
05081,41.6,12616,9226,2644,404,3311,35396,5191,3746,1445,5191,73700,2016
05083,42.8,21935,20039,381,593,5880,36463,8401,6256,2145,8401,87400,2016
05085,35.8,71279,61916,4201,2895,19316,56156,25993,18057,7936,25993,131700,2016
05087,42.3,15761,14271,7,827,4612,39839,6279,4741,1538,6279,100100,2016
05089,51.5,16404,15562,59,344,4585,33726,6667,5265,1402,6667,109700,2016
05091,37.6,43666,30419,10892,1266,11109,39955,17003,11029,5974,17003,99600,2016
05093,35.9,44199,26133,15368,1725,11144,35003,16835,9556,7279,16835,80700,2016
05095,45.5,7542,4122,3081,181,1990,31541,3306,2113,1193,3306,56400,2016
05097,49.2,9100,8318,53,355,2532,35103,3735,2984,751,3735,88200,2016
05099,44,8668,5521,2945,26,2144,30750,3509,2512,997,3509,65300,2016
05101,47.9,7988,7551,0,86,2174,33176,3243,2760,483,3243,84800,2016
05103,42.8,24728,13761,10038,494,6543,31233,10313,6981,3332,10313,66900,2016
05105,43.7,10246,9461,261,243,2718,45819,3730,2966,764,3730,84500,2016
05107,37.3,19929,6923,12400,332,4869,26829,7953,3883,4070,7953,62900,2016
05109,41.4,11017,9642,334,727,2952,34519,4298,3225,1073,4298,77300,2016
05111,39.9,24131,21187,1437,665,6572,35163,9471,5890,3581,9471,77900,2016
05113,44.1,20290,17958,77,1278,5204,33202,7925,6103,1822,7925,83900,2016
05115,34.9,63107,53766,1728,5175,14943,40534,22919,15382,7537,22919,120900,2016
05117,45.4,8334,7097,1114,34,2517,37500,3846,2669,1177,3846,67100,2016
05119,36.5,391806,210099,139929,23294,93671,47101,155440,91650,63790,155440,144000,2016
05121,42.9,17584,16758,184,312,5076,36318,7318,5286,2032,7318,79000,2016
05123,38,27023,10990,14265,1260,5734,35066,9308,5384,3924,9308,62700,2016
05125,39.2,115577,100169,6968,4895,30323,57632,42633,33089,9544,42633,143900,2016
05127,42,10661,9014,14,786,2805,37861,3965,2878,1087,3965,77700,2016
05129,47.5,7938,7441,34,107,2147,35542,3194,2550,644,3194,82800,2016
05131,37.1,127351,90441,8287,17041,32468,40023,50437,30098,20339,50437,114800,2016
05133,35.2,17193,10137,854,5560,4229,38956,6005,4458,1547,6005,70400,2016
05135,47.9,17027,16010,44,355,4396,31068,7320,5527,1793,7320,76700,2016
05137,49.1,12503,11901,10,213,3246,30486,4966,3762,1204,4966,104800,2016
05139,39.5,40334,24742,13299,1486,10992,39836,16383,11710,4673,16383,77800,2016
05141,47.2,16892,15830,11,488,4552,34576,6825,5352,1473,6825,92000,2016
05143,31.4,219930,159150,7406,35554,51445,45442,83467,44671,38796,83467,157400,2016
05145,36.1,78823,69893,3279,3214,20613,42197,29108,19699,9409,29108,113500,2016
05147,43.8,6873,4765,1831,43,1810,30383,2919,1883,1036,2919,62700,2016
05149,39.3,21716,16498,417,4191,5432,39323,7492,5148,2344,7492,100100,2016
06001,37.2,1605217,523797,176819,362070,375294,79831,564293,296634,267659,564293,593500,2016
06003,42.8,1184,804,10,92,236,62375,343,280,63,343,329500,2016
06005,50.3,36963,29436,860,4822,9646,57032,14248,10778,3470,14248,265900,2016
06007,36.9,223877,164398,3279,34503,50904,44366,85505,50051,35454,85505,228500,2016
06009,51.2,44787,36857,256,5028,11986,53502,17713,13643,4070,17713,259000,2016
06011,34.7,21361,7881,212,12351,5390,54946,6962,4489,2473,6962,205000,2016
06013,39.1,1107925,504792,93809,277676,276292,82881,387540,250055,137485,387540,472900,2016
06015,38.1,27628,17427,632,5326,5774,42363,9443,5748,3695,9443,183600,2016
06017,45.2,183000,144069,1576,22868,47835,72586,67528,50614,16914,67528,379200,2016
06019,31.6,963160,296265,45506,501136,217545,45963,299456,157227,142229,299456,204900,2016
06021,36.9,27976,14845,195,11255,6830,41699,9801,5635,4166,9801,215800,2016
06023,37.6,135182,101904,1374,14530,30516,42685,53689,29702,23987,53689,279000,2016
06025,32.2,178807,21334,4195,147880,35375,42560,45800,25544,20256,45800,159000,2016
06027,45.4,18326,11733,179,3867,4519,47278,7973,5204,2769,7973,235500,2016
06029,31.2,871337,313983,45298,449747,196707,49788,262337,149309,113028,262337,175600,2016
06031,31.4,150261,50536,8917,79862,31674,47241,41845,20980,20865,41845,172000,2016
06033,45.8,64076,46301,1329,12086,15738,36132,26194,16548,9646,26194,167300,2016
06035,36.4,31945,21101,2808,5880,5969,51457,9501,6136,3365,9501,174500,2016
06037,35.8,10057155,2687787,801182,4861648,2196172,57952,3281845,1499576,1782269,3281845,465000,2016
06039,33.5,153366,54887,4679,86265,33613,45742,43574,26458,17116,43574,204800,2016
06041,45.7,259358,186361,5849,40943,64449,100310,104400,66200,38200,104400,859400,2016
06043,50.6,17645,14381,226,1789,4854,49265,7255,5052,2203,7255,250800,2016
06045,42.3,87409,58018,499,20955,20233,43510,34594,19764,14830,34594,319100,2016
06047,30.6,265001,78119,8221,152475,60009,44397,78270,40889,37381,78270,171800,2016
06049,47.1,9033,7014,82,1335,2182,41194,3670,2740,930,3670,144600,2016
06051,38.9,14051,9254,74,3865,2708,58937,4950,2733,2217,4950,286100,2016
06053,33.7,430201,133626,10653,247084,91151,60889,125916,62601,63315,125916,393300,2016
06055,40.7,140823,75647,2849,47164,33965,74609,49375,30411,18964,49375,503100,2016
06057,49.5,98639,84469,472,9019,25777,57429,40587,29282,11305,40587,355900,2016
06059,37.3,3132211,1314672,47971,1070553,733815,78145,1017012,581506,435506,1017012,584200,2016
06061,41.5,370571,275220,5162,49904,95580,76926,136730,95824,40906,136730,380900,2016
06063,51.7,18754,15697,26,1578,4899,50125,8376,5967,2409,8376,221300,2016
06065,34.8,2323892,865631,137779,1102968,518922,57972,705716,454924,250792,705716,276300,2016
06067,35.7,1479300,685952,141420,332967,347087,57509,527335,291117,236218,527335,271300,2016
06069,35.1,58051,20984,416,33864,13979,73814,17390,10824,6566,17390,423100,2016
06071,32.7,2106754,642786,170376,1089104,469329,54469,618922,365576,253346,618922,256000,2016
06073,35.3,3253356,1519704,154251,1076319,739580,66529,1103128,581635,521493,1103128,454600,2016
06075,38.4,850282,350088,43758,129898,165652,87701,356797,131331,225466,356797,858800,2016
06077,33.7,714860,242025,47799,289329,165882,55045,221707,123450,98257,221707,246900,2016
06079,39,278680,194201,5188,61095,66178,64014,104404,61624,42780,104404,471800,2016
06081,39.5,754748,305123,17479,189305,180407,98546,261010,154344,106666,261010,845300,2016
06083,33.7,439395,201836,7622,195021,93928,65161,143051,74440,68611,143051,480000,2016
06085,36.8,1885056,625218,44874,496591,450869,101173,626579,354255,272324,626579,752400,2016
06087,37,270931,157652,2156,89587,59553,70088,95062,54853,40209,95062,615200,2016
06089,42.3,179228,145094,1700,16703,44734,45582,69713,43292,26421,69713,223500,2016
06091,55.2,2931,2519,2,305,781,43984,1275,1024,251,1275,170300,2016
06093,47.9,43668,33896,695,5100,11736,38524,19045,12123,6922,19045,173100,2016
06095,37.5,429596,169401,58604,109287,104617,69227,145315,86083,59232,145315,305900,2016
06097,41.2,497776,320566,6669,129634,119869,66833,189043,112774,76269,189043,464700,2016
06099,33.8,530561,234089,13102,234995,125982,51591,170328,96348,73980,170328,216000,2016
06101,35.6,95406,45750,1759,28485,23502,52943,32028,18290,13738,32028,213100,2016
06103,40.6,63015,44001,356,14959,16133,40687,23573,15644,7929,23573,178600,2016
06105,50.6,13180,10936,144,950,3450,35270,5468,3696,1772,5468,270100,2016
06107,30.4,455769,137157,5866,287144,104581,42789,134153,75761,58392,134153,169600,2016
06109,48.2,53864,43743,945,6233,14103,50731,22083,14984,7099,22083,259800,2016
06111,37.3,843110,393301,13395,353232,198043,78593,269338,170877,98461,269338,481400,2016
06113,30.9,209671,100824,4611,65448,45034,57663,72544,37194,35350,72544,346200,2016
06115,32.2,73897,42150,2198,19903,18451,48739,25655,14964,10691,25655,190700,2016
08001,33.3,479977,247948,14393,186852,112674,61444,158748,102279,56469,158748,216700,2016
08003,30.2,16353,8031,274,7470,3652,32385,5946,3384,2562,5946,141600,2016
08005,36.3,617668,382460,62039,115309,153555,66288,231844,144154,87690,231844,266600,2016
08007,49.5,12355,9486,105,2290,3495,45607,5382,4023,1359,5382,268400,2016
08009,47.5,3648,3149,45,363,976,37477,1545,1136,409,1545,69900,2016
08011,41.2,5816,3411,472,1838,1172,34773,1720,1166,554,1720,76800,2016
08013,36,313961,246248,2667,42914,72676,72282,123669,76493,47176,123669,391000,2016
08014,37.6,62449,48769,582,7448,16636,83334,24581,16646,7935,24581,328200,2016
08015,49.1,18507,16164,237,1876,5314,50993,7736,5868,1868,7736,289900,2016
08017,37.8,2071,1745,6,266,511,54375,776,591,185,776,89200,2016
08019,47.6,9238,8358,105,523,2647,68250,4411,3440,971,4411,297000,2016
08021,38.7,8213,3582,9,4435,1978,34630,2900,2301,599,2900,113800,2016
08023,50.5,3590,1141,13,2302,871,26610,1506,1150,356,1506,110800,2016
08025,39.6,5537,3334,294,1708,803,31719,1174,930,244,1174,74200,2016
08027,56.8,4375,3929,133,195,1379,38605,1950,1569,381,1950,230700,2016
08029,47.5,30221,24702,217,4499,8084,42011,12027,8489,3538,12027,196200,2016
08031,34.2,663303,353952,62320,204042,137023,56258,281072,138870,142202,281072,292700,2016
08033,46,1789,1651,0,93,473,32240,720,548,172,720,115900,2016
08035,37.8,314238,263439,3164,25735,88773,105759,114017,90730,23287,114017,376300,2016
08037,35.9,52894,35533,350,15724,11541,78763,17613,12007,5606,17613,438500,2016
08039,45.4,24225,21734,172,1514,6623,87288,8568,7607,961,8568,353700,2016
08041,33.8,665171,468302,38298,107654,170814,60219,249279,156244,93035,249279,227000,2016
08043,44.3,46835,37224,2312,6037,10767,42308,16327,11852,4475,16327,159000,2016
08045,36.1,57495,39578,250,16056,15032,61300,20771,13695,7076,20771,299700,2016
08047,44.8,5708,4912,17,534,1410,67544,2508,1945,563,2508,255000,2016
08049,43,14490,12662,115,1151,3621,67623,5788,4046,1742,5788,297500,2016
08051,34.4,15889,13960,59,1413,3733,50746,6577,3856,2721,6577,311700,2016
08053,56.4,856,800,0,26,274,51250,401,293,108,401,275400,2016
08055,54.5,6521,4217,0,2246,1722,33257,3132,2322,810,3132,153400,2016
08057,51.2,1306,1069,1,226,351,45053,616,421,195,616,170300,2016
08059,40.5,558810,440698,5710,84009,145417,72017,225320,158427,66893,225320,299100,2016
08061,40.7,1465,1304,7,97,400,38385,581,431,150,581,82700,2016
08063,39.2,8174,6182,306,1589,2070,44449,2975,2070,905,2975,123400,2016
08065,39.4,7401,4651,8,2554,1841,46928,3121,1737,1384,3121,184200,2016
08067,39,53994,42868,231,6684,12932,61910,21605,14621,6984,21605,340500,2016
08069,35.6,325228,271263,2678,35804,79518,61942,127067,81681,45386,127067,282500,2016
08071,45.7,14322,7575,119,6060,3826,42808,6090,4192,1898,6090,145800,2016
08073,37.5,5515,3693,461,1176,1001,40438,1502,1048,454,1502,126400,2016
08075,37.1,21862,17151,480,3350,4822,43340,8029,5062,2967,8029,137300,2016
08077,38.8,148166,121513,944,20788,38653,50070,59501,40475,19026,59501,201500,2016
08079,61.2,793,670,5,115,261,49125,409,354,55,409,277500,2016
08081,37.7,13034,10672,109,1904,3146,53664,4927,3499,1428,4927,170000,2016
08083,43.4,26006,19049,39,3149,6406,41622,10305,7247,3058,10305,187700,2016
08085,44.6,40866,31204,212,8255,11206,43890,16587,11546,5041,16587,193300,2016
08087,36.6,28288,16953,834,9958,7706,49495,10493,6909,3584,10493,152800,2016
08089,40.3,18440,10102,86,7613,5028,34477,7449,4797,2652,7449,92300,2016
08091,53.3,4651,4261,0,297,1364,62800,2166,1538,628,2166,399400,2016
08093,50,16440,14800,0,921,4708,61675,7398,6140,1258,7398,251700,2016
08095,41,4347,3447,7,771,1129,46955,1731,1155,576,1731,138500,2016
08097,43.2,17543,15103,224,1720,3798,69789,7601,4774,2827,7601,552900,2016
08099,37.5,12121,7356,55,4449,3322,41037,4897,3184,1713,4897,88100,2016
08101,38.8,162158,85440,2734,68992,40359,42000,62899,40032,22867,62899,142700,2016
08103,35.7,6658,5848,18,685,1619,56771,2450,1649,801,2450,208400,2016
08105,40.8,11623,6134,42,5151,3094,40177,4582,3054,1528,4582,136400,2016
08107,40,23980,21567,178,1649,5630,63505,9437,6358,3079,9437,424300,2016
08109,47.5,6255,3594,0,2383,1556,32457,2530,1827,703,2530,146600,2016
08111,49,552,419,0,130,127,41250,284,196,88,284,224100,2016
08113,41.4,7767,6761,12,756,1721,58170,3258,1932,1326,3258,505600,2016
08115,49.5,2367,1893,26,329,619,46977,1012,707,305,1012,94700,2016
08117,38.2,29269,23830,299,4143,5671,70192,9714,6532,3182,9714,496100,2016
08119,49.5,23472,21055,216,1432,6945,63723,9762,7845,1917,9762,244300,2016
08121,42.8,4814,4250,37,442,1366,46315,2005,1409,596,2005,118000,2016
08123,34,278065,185540,2804,80005,70780,62820,96616,67652,28964,96616,227100,2016
08125,37.2,10150,7791,55,2193,2352,42026,4009,2482,1527,4009,134900,2016
09001,39.9,941618,598017,98457,175480,235064,86670,335209,226707,108502,335209,413400,2016
09003,40.2,895699,566548,113377,151355,226548,68027,347207,222638,124569,347207,234900,2016
09005,46.4,185141,166479,2702,10003,49692,73519,74339,57013,17326,74339,249500,2016
09007,44.7,164438,139343,7671,9276,42763,79837,66467,49542,16925,66467,283800,2016
09009,39.8,860874,557698,104831,144549,205418,62715,326487,203568,122919,326487,244000,2016
09011,40.9,272033,207985,14186,26701,69424,67574,106170,70136,36034,106170,241500,2016
09013,37.8,151689,130289,4265,7629,35639,80129,54573,39679,14894,54573,247800,2016
09015,40.7,117078,98091,2185,12735,29865,60689,44261,30940,13321,44261,196900,2016
10001,37.2,171474,108515,40690,11326,43020,55184,62140,43088,19052,62140,199800,2016
10003,37.6,551997,326993,130912,51912,132924,66283,202524,139050,63474,202524,244300,2016
10005,47.6,211224,158057,25948,19424,56625,54218,83387,64802,18585,83387,231600,2016
11001,33.8,659009,235722,312557,69106,121101,72935,276546,112672,163874,276546,506100,2016
12001,31,256581,160261,50045,23079,51432,44702,96336,51757,44579,96336,165700,2016
12003,36.5,27312,22420,3790,633,6138,53327,8270,6557,1713,8270,108600,2016
12005,39.7,178361,138564,18777,10217,43758,48577,67939,41942,25997,67939,162500,2016
12007,41,26919,20132,5182,1022,5656,43373,8704,6337,2367,8704,92000,2016
12009,47,560683,424991,55160,52153,143200,49914,224373,160836,63537,224373,150500,2016
12011,40,1863780,731447,507221,513748,430122,52954,672988,422354,250634,672988,202300,2016
12013,40.6,14550,11235,1915,820,3085,37089,4555,3765,790,4555,80300,2016
12015,57.7,169642,143591,9391,11251,47226,44865,73299,57253,16046,73299,154400,2016
12017,55.7,140453,124822,3957,7194,38796,39054,61350,50206,11144,61350,114300,2016
12019,39.4,200346,150014,19155,18047,53017,59179,70527,52729,17798,70527,157600,2016
12021,49.2,348236,223646,23593,92751,89368,59783,133331,96043,37288,133331,291900,2016
12023,40.7,68198,49972,11984,3788,15232,42848,23911,17266,6645,23911,105100,2016
12027,40.2,35134,19338,4534,10782,7884,35513,11419,7833,3586,11419,82300,2016
12029,46.3,16084,13678,1207,608,3884,34634,6221,4812,1409,6221,69600,2016
12031,36,900890,492946,261399,77771,210979,49196,341906,199141,142765,341906,146400,2016
12033,37.1,309574,201903,66660,16686,68927,46117,115984,69888,46096,115984,121800,2016
12035,50.1,102917,77185,10710,10079,26625,48898,38150,29333,8817,38150,174700,2016
12037,43.8,11705,9168,1646,599,2814,40301,4250,3089,1161,4250,124500,2016
12039,40.3,46153,15177,25509,4628,11496,38533,16885,12012,4873,16885,105100,2016
12041,42.3,17033,14869,1020,909,4240,40881,6254,5152,1102,6254,94400,2016
12043,45.1,13420,8171,1627,2817,2595,34143,4019,3004,1015,4019,79200,2016
12045,44.5,15851,11703,2912,762,3698,40822,5349,3991,1358,5349,131400,2016
12047,40.9,14362,7860,4810,1297,3334,38980,4717,3426,1291,4717,71000,2016
12049,34.3,27302,12989,2084,11741,5614,36222,7558,5177,2381,7558,78800,2016
12051,33.8,38376,13005,4342,19625,8311,37552,11817,8006,3811,11817,70600,2016
12053,48.9,176797,141603,8607,20459,47673,42274,70918,55306,15612,70918,112300,2016
12055,52.6,98862,68067,9688,18267,25947,35865,40500,30617,9883,40500,86600,2016
12057,36.6,1323059,678024,206028,352295,313954,51681,495841,287014,208827,495841,167400,2016
12059,42.3,19569,17099,1552,310,4562,37437,6809,5433,1376,6809,90700,2016
12061,51.4,145342,111010,12832,17143,36210,47446,57829,43135,14694,57829,160900,2016
12063,41.3,48721,31997,12930,2240,10848,35470,16744,11865,4879,16744,92200,2016
12065,45.5,14082,8174,5015,569,3534,41696,5564,4368,1196,5564,123300,2016
12067,38.4,8742,6055,1442,1124,1633,36236,2320,1907,413,2320,112400,2016
12069,46.7,317586,228318,30665,43852,83348,47141,122036,90282,31754,122036,145100,2016
12071,47.3,680970,470769,55922,133752,170634,50390,258084,177971,80113,258084,171100,2016
12073,30.3,284788,163379,87712,17319,61335,48248,111111,58014,53097,111111,183800,2016
12075,46.6,39707,31947,3525,3148,9859,35480,15372,11552,3820,15372,86700,2016
12077,36.9,8285,6105,1474,510,1599,37917,2363,1788,575,2363,69500,2016
12079,41.6,18560,10112,7135,896,4295,29806,6665,5233,1432,6665,81100,2016
12081,47.1,353411,254680,30634,55380,89367,51483,135990,95106,40884,135990,178700,2016
12083,48.5,340341,244971,41745,40579,86202,40295,132277,98978,33299,132277,114400,2016
12085,51.1,153592,121895,8147,19777,38621,52622,62980,47589,15391,62980,209700,2016
12086,39.3,2664418,385471,443558,1769923,581051,44224,853624,449174,404450,853624,221100,2016
12087,46.7,77150,52712,5106,17364,16782,60303,29549,17790,11759,29549,400800,2016
12089,44.6,77187,67548,4803,2922,21180,59196,29214,22238,6976,29214,192600,2016
12091,36.8,195798,146704,18115,16347,50548,57655,76140,48190,27950,76140,191800,2016
12093,40.2,39420,25136,3347,9890,8666,36415,12850,9104,3746,12850,90800,2016
12095,34.5,1256055,535795,250975,368503,286844,49391,444852,241420,203432,444852,173700,2016
12097,35.8,311962,110836,29198,156730,69321,45536,93324,56161,37163,93324,146500,2016
12099,44.3,1398757,796265,249530,289651,336708,55277,538549,369536,169013,538549,222700,2016
12101,44.6,488310,377509,23321,65569,124863,46010,189292,137860,51432,189292,122100,2016
12103,47.4,939548,707014,94310,83145,225504,47090,405788,262145,143643,405788,157500,2016
12105,40.4,637691,394858,93290,125841,153104,44146,223060,151691,71369,223060,110400,2016
12107,44.5,72304,51963,11831,6901,16902,33003,27306,19905,7401,27306,84100,2016
12109,42.9,218362,183535,11058,13384,57404,69523,81308,61866,19442,81308,259900,2016
12111,44.3,293136,173831,56344,51763,72957,44140,108796,78137,30659,108796,137700,2016
12113,39.5,163903,136165,9218,8379,43677,60652,59455,43447,16008,59455,165500,2016
12115,54.5,398011,333095,17614,34234,106404,52796,175576,128489,47087,175576,196800,2016
12117,39.2,442905,280711,46854,85292,103528,58538,156216,103585,52631,156216,188400,2016
12119,66,113589,96163,9150,6357,33677,52594,49362,44521,4841,49362,227000,2016
12121,41.9,43653,32989,5878,3818,10783,37796,15315,10659,4656,15315,88700,2016
12123,41.3,22582,16298,4816,777,5072,36195,7544,5807,1737,7544,83200,2016
12125,39.7,15159,10638,3351,821,2688,37778,3892,2617,1275,3892,89100,2016
12127,46.5,510806,376072,51961,62994,125908,42240,205310,142935,62375,205310,139000,2016
12129,40.2,31314,24754,4698,1152,7770,54078,10726,8110,2616,10726,131500,2016
12131,43.4,61528,51959,3046,3623,15787,46910,24329,17335,6994,24329,183400,2016
12133,42,24627,19113,3863,847,5675,38330,8370,6531,1839,8370,93700,2016
13001,38.8,18410,12888,3357,1722,4793,37388,6711,4771,1940,6711,72100,2016
13003,35.3,8268,4661,1486,2046,1812,31296,2717,1955,762,2717,62900,2016
13005,36.9,11251,8336,1735,926,2752,37303,3871,2657,1214,3871,64100,2016
13007,45.9,3250,1631,1340,215,891,45903,1328,978,350,1328,90700,2016
13009,34.3,45808,24321,19068,995,8979,34595,15880,8551,7329,15880,103700,2016
13011,40.9,18336,16208,432,1164,4885,40721,6483,4896,1587,6483,120800,2016
13013,35,73340,54025,8195,7043,17971,53133,24000,17461,6539,24000,123200,2016
13015,37.4,101942,80341,10981,8153,26634,50565,36490,23472,13018,36490,128200,2016
13017,39.1,17405,9893,6254,1054,4261,29510,6452,3935,2517,6452,81100,2016
13019,39.2,18986,15647,1974,922,4926,35740,7108,5058,2050,7108,82300,2016
13021,35.8,154194,61455,82708,4796,35075,37108,57269,30028,27241,57269,117000,2016
13023,37.2,12835,8853,3534,333,2749,37060,4081,2970,1111,4081,99800,2016
13025,39.9,18403,17080,485,392,4889,36837,6423,5098,1325,6423,65600,2016
13027,42.6,15645,8950,5512,878,4071,34547,6482,4698,1784,6482,91400,2016
13029,34.9,34104,25479,4904,2198,9435,65862,11788,8181,3607,11788,202000,2016
13031,27.4,73141,46938,20720,2658,16140,37125,26210,13204,13006,26210,131600,2016
13033,37.1,22838,10748,11234,680,5962,34589,8082,5716,2366,8082,79800,2016
13035,38.5,23479,15696,6624,724,5596,40753,7737,5535,2202,7737,117000,2016
13037,38.4,6443,2090,3850,296,1173,28200,1852,1214,638,1852,55600,2016
13039,31.5,52092,36696,9489,3185,14058,53327,18658,10846,7812,18658,151700,2016
13043,37.6,10962,6878,2622,1212,2934,33379,4026,2489,1537,4026,89900,2016
13045,34.1,113756,81330,20751,7465,27767,45486,40287,25716,14571,40287,113700,2016
13047,39.3,65645,60216,1585,1768,17391,52265,24099,17806,6293,24099,135300,2016
13049,41.4,12968,8071,3405,1140,2646,43871,3474,2588,886,3474,80400,2016
13051,34.6,282613,139808,111488,17095,66067,49596,106749,57385,49364,106749,174500,2016
13053,23.1,11882,7133,2081,1761,1933,43929,2578,780,1798,2578,66400,2016
13055,40.3,25046,20765,2672,1157,6300,35245,9361,6240,3121,9361,67300,2016
13057,37.7,230629,184993,13961,22809,60232,72586,80378,62095,18283,80378,204400,2016
13059,26.8,122037,68220,33130,12838,21623,33116,44901,17301,27600,44901,152300,2016
13061,44.1,3068,894,1912,155,683,22120,1160,743,417,1160,71400,2016
13063,32.4,270269,32140,181492,35506,59998,42470,90182,45993,44189,90182,86700,2016
13065,37.2,6814,4504,1826,306,1605,24848,2524,1797,727,2524,65400,2016
13067,36.2,728388,392024,188713,91921,185738,68818,271975,173718,98257,271975,205600,2016
13069,35.6,43042,25376,12059,4753,9386,34536,14110,9308,4802,14110,84400,2016
13071,35.8,46002,26186,10181,8535,11316,33968,15380,9513,5867,15380,82600,2016
13073,36.5,139904,98941,22551,8455,35788,71962,45623,35559,10064,45623,176400,2016
13075,36.5,17103,11141,4784,997,4325,35199,5979,4114,1865,5979,80000,2016
13077,37.9,135625,97342,23609,8992,37253,65244,49457,35914,13543,49457,182300,2016
13079,43.7,12483,9198,2870,99,3376,40459,4643,3620,1023,4643,89900,2016
13081,38.4,23061,11707,9935,749,6139,31672,8509,4876,3633,8509,91000,2016
13083,40.3,16356,15373,105,349,4409,43463,6057,4612,1445,6057,119200,2016
13085,42.8,22939,21356,159,904,6453,59265,8522,6602,1920,8522,196400,2016
13087,37.8,27237,13943,11405,1533,6925,33514,10438,6257,4181,10438,111100,2016
13089,35.2,723902,211311,388222,63173,158376,52623,270903,146154,124749,270903,168100,2016
13091,40.4,20995,13718,5847,731,5464,35544,7987,5118,2869,7987,68900,2016
13093,42.3,14089,6001,6887,1024,3399,33319,5140,3296,1844,5140,83600,2016
13095,34.6,92326,24449,63072,2347,21937,33605,35156,16090,19066,35156,100500,2016
13097,36.1,138283,61692,59314,12445,34169,57384,47534,31228,16306,47534,127400,2016
13099,40.3,10480,4868,5266,216,2725,28599,4023,2596,1427,4023,82100,2016
13101,37.1,4025,2556,82,1196,1019,35354,1423,864,559,1423,55600,2016
13103,36.1,55852,44578,7251,2056,14246,62820,18695,14404,4291,18695,152300,2016
13105,42.1,19394,12370,5885,1052,5209,35739,7611,5329,2282,7611,83700,2016
13107,36.9,22723,13587,7687,1015,5390,31522,8227,5462,2765,8227,72300,2016
13109,37.1,10733,6110,3163,1250,2822,40594,3950,2549,1401,3950,86700,2016
13111,50.3,24017,22933,47,483,6670,39011,9927,7675,2252,9927,169800,2016
13113,43.5,109495,71177,22711,7653,30130,81689,38933,31416,7517,38933,240200,2016
13115,38.3,96199,68943,13951,9910,23776,42955,35114,21035,14079,35114,119600,2016
13117,38.1,203841,155785,5792,19121,54415,91842,66500,56003,10497,66500,281400,2016
13119,40.7,22188,18701,2099,956,5687,37298,8260,5588,2672,8260,99100,2016
13121,35,996757,401270,434218,73953,208020,58851,385103,197281,187822,385103,252700,2016
13123,46.1,28956,24918,142,3169,7844,43775,11131,8366,2765,11131,152200,2016
13125,40.6,3053,2674,207,47,747,43884,1105,844,261,1105,68900,2016
13127,40.6,82623,52908,20946,5427,21958,46475,32623,19760,12863,32623,161800,2016
13129,37,56079,43999,2212,8409,14819,41390,19779,12582,7197,19779,112300,2016
13131,39.8,25145,14793,7077,2678,6554,35518,9165,5434,3731,9165,108200,2016
13133,48.3,16535,9272,5990,1020,4581,44299,6673,4849,1824,6673,182800,2016
13135,34.8,874242,352246,222374,179634,212519,61865,278996,184363,94633,278996,173000,2016
13137,39.5,43724,34002,1420,6013,10398,41600,14856,11036,3820,14856,130600,2016
13139,35.8,190482,118296,13893,52154,46123,51902,62327,41012,21315,62327,164500,2016
13141,44.1,8747,2087,6420,169,1647,26386,2813,2164,649,2813,67700,2016
13143,40.8,28667,26120,1362,420,8039,42281,10886,7585,3301,10886,106600,2016
13145,42.8,32992,25528,5185,1036,9106,65336,11699,9776,1923,11699,200200,2016
13147,43.1,25518,19307,4843,919,6946,37983,10016,7262,2754,10016,122200,2016
13149,41.5,11571,9837,1215,71,3017,44185,4364,3093,1271,4364,94200,2016
13151,36.5,214171,102922,84550,13492,55125,62561,71000,51522,19478,71000,146100,2016
13153,35,149137,86539,43768,9613,37932,55480,54188,35295,18893,54188,136000,2016
13155,38.6,9365,6375,2610,107,2081,29846,3279,2383,896,3279,81800,2016
13157,38.5,62131,51326,4275,4319,16008,54246,21115,16010,5105,21115,155900,2016
13159,40.9,13571,9942,2779,523,3710,41434,5154,3764,1390,5154,115000,2016
13161,35.8,14953,10734,2426,1708,3914,36566,5216,3848,1368,5216,73900,2016
13163,38.7,16201,6760,8760,558,3723,28417,5855,3791,2064,5855,67800,2016
13165,42.2,9055,5374,3094,353,2163,27398,3554,2426,1128,3554,60600,2016
13167,39.8,9694,6045,3272,224,2230,32685,3168,2243,925,3168,63800,2016
13169,40.2,28701,20710,7028,393,7910,54020,10367,8476,1891,10367,129700,2016
13171,38.4,18195,11832,5359,400,4046,40364,6287,4464,1823,6287,121000,2016
13173,34.2,10382,7119,2606,546,2645,31682,3733,2372,1361,3733,112700,2016
13175,38.4,47802,28106,17430,1204,11710,33632,17622,10985,6637,17622,85300,2016
13177,36.8,29134,21331,5667,779,7900,62797,10126,7526,2600,10126,154800,2016
13179,27.4,63949,26383,25547,7706,16358,42484,22780,10368,12412,22780,122500,2016
13181,47.3,7712,5036,2497,109,2121,34720,3457,2548,909,3457,118000,2016
13183,31.7,17243,10169,3866,2031,3723,50848,5173,3421,1752,5173,99800,2016
13185,29.9,113898,62267,41009,6055,25435,38915,39809,20368,19441,39809,133700,2016
13187,36.8,31094,28283,548,1430,7303,40634,11255,7227,4028,11255,171900,2016
13189,38.1,21558,11752,8754,601,5797,37021,8067,4970,3097,8067,101100,2016
13191,48,13941,8574,4892,195,3603,45248,5207,4116,1091,5207,110200,2016
13193,40.1,13846,4551,8171,556,2919,28285,4546,2822,1724,4546,69800,2016
13195,40.4,28362,23656,2468,1315,7433,45063,10348,7567,2781,10348,122800,2016
13197,41.6,8646,5129,3121,141,2005,35484,3021,2206,815,3021,103300,2016
13199,42.3,21195,11976,8453,189,5696,34989,7982,5325,2657,7982,88400,2016
13201,40.3,5911,4064,1796,6,1551,36463,2251,1538,713,2251,89400,2016
13205,37.9,22778,10559,10809,998,5408,31111,8041,5321,2720,8041,78300,2016
13207,42.8,27044,19486,6400,628,6828,50625,9589,7224,2365,9589,157900,2016
13209,38.7,9005,5835,2346,574,2057,38111,3149,2264,885,3149,75600,2016
13211,44.1,17943,12872,4234,556,5113,54506,6648,4976,1672,6648,190100,2016
13213,37.4,39358,32971,387,5496,10401,38136,14266,9379,4887,14266,93700,2016
13215,33.6,200303,83631,89101,14805,46466,42661,73449,35639,37810,73449,138600,2016
13217,36.1,103901,51547,43904,5097,25004,51068,35090,23930,11160,35090,117900,2016
13219,39.8,35071,29866,1888,1630,9860,75946,12288,9984,2304,12288,242000,2016
13221,42.3,14743,11216,2450,590,3981,44403,5723,4263,1460,5723,113600,2016
13223,35.4,149830,110481,26193,8434,39162,60971,50017,39269,10748,50017,140600,2016
13225,34.9,26907,12320,12095,1950,6493,41128,9966,6596,3370,9966,124500,2016
13227,44.8,29992,28117,359,913,8591,56769,11377,8715,2662,11377,181100,2016
13229,38.9,19030,15989,1572,970,5273,42730,6947,5294,1653,6947,98100,2016
13231,39.4,17843,15468,1868,256,4680,50819,6026,5058,968,6026,154200,2016
13233,37.4,41263,29726,5061,5287,10415,39356,14868,9985,4883,14868,98000,2016
13235,41.4,11460,6809,3873,538,2601,38880,3829,2224,1605,3829,114100,2016
13237,45.3,21259,13905,5564,1382,5982,45762,8322,6165,2157,8322,156000,2016
13239,48.1,2095,1010,1025,21,573,29773,916,678,238,916,69700,2016
13241,48.4,16312,14205,319,1308,4309,38277,6629,4822,1807,6629,158800,2016
13243,41.4,7224,2531,4518,40,1831,30358,2819,1624,1195,2819,71600,2016
13245,33.5,201418,72527,110943,9333,43643,38595,72470,38092,34378,72470,100600,2016
13247,37.5,87569,31494,43730,8774,21264,51072,29940,20309,9631,29940,143100,2016
13249,38.3,5089,3498,1343,243,1423,41227,1895,1260,635,1895,99300,2016
13251,40.5,14114,7736,5881,246,3479,35047,5214,3613,1601,5214,77800,2016
13253,45.2,8696,5374,2980,257,2330,35410,3312,2463,849,3312,76800,2016
13255,38.5,64006,38284,21101,2789,15855,40548,22914,13986,8928,22914,110300,2016
13257,41.2,25584,21257,3228,754,6363,37088,9189,6564,2625,9189,95900,2016
13259,37.3,5791,1554,2751,1296,1056,20882,1775,1109,666,1775,52200,2016
13261,35,31070,12399,16122,1640,7806,33534,11698,6528,5170,11698,86900,2016
13263,47.9,6373,2546,3638,141,1863,36957,2729,2229,500,2729,75000,2016
13265,44,1904,600,1211,81,431,28152,748,516,232,748,57000,2016
13267,36.6,25260,14796,7350,2746,5574,35578,7899,5285,2614,7899,85600,2016
13269,42.7,8354,4835,3253,187,2321,27114,3368,2316,1052,3368,60200,2016
13271,39.6,16405,8064,5900,2378,3378,27657,5110,3141,1969,5110,57700,2016
13273,41.2,9132,3253,5578,236,2209,30438,3312,1957,1355,3312,86500,2016
13275,39.6,44977,25947,16148,1546,11537,38241,17269,10460,6809,17269,126500,2016
13277,35.2,40691,23040,11921,4526,10109,37613,14451,8328,6123,14451,118300,2016
13279,35.6,27160,16535,6814,3089,6972,33081,10376,6340,4036,10376,93600,2016
13281,53,10976,10442,106,258,3088,39321,4611,3664,947,4611,189400,2016
13283,40.3,6711,4497,2078,116,1669,40204,2586,1803,783,2586,71300,2016
13285,36.2,69314,40154,23905,2514,16995,42545,24619,14204,10415,24619,120300,2016
13287,39.2,8151,4481,3113,361,2186,34667,3071,2141,930,3071,73000,2016
13289,45.7,8363,4597,3566,41,2047,31625,2887,2306,581,2887,58600,2016
13291,53.6,22033,20804,143,636,6102,41686,8873,6941,1932,8873,185400,2016
13293,41.1,26394,17900,7446,609,6416,35699,10078,6744,3334,10078,83600,2016
13295,40.7,68143,62369,2946,1323,18087,41539,25581,18278,7303,25581,107500,2016
13297,38.9,87436,66910,14521,3368,23762,54459,30048,21795,8253,30048,157400,2016
13299,38.2,35671,22909,10382,1340,9777,34705,13847,8506,5341,13847,77100,2016
13301,45,5504,2067,3299,37,1330,31875,2204,1469,735,2204,62100,2016
13303,40.3,20680,9017,10897,454,5170,37417,7381,5153,2228,7381,79400,2016
13305,37.9,30006,21421,5966,1819,6961,39908,10016,6555,3461,10016,98600,2016
13307,39.8,2672,1319,1323,30,711,37072,1025,831,194,1025,50700,2016
13309,38.4,7932,4470,3282,160,1430,27779,2065,1362,703,2065,48300,2016
13311,44.5,28140,26078,695,835,7873,42264,11016,7971,3045,11016,155200,2016
13313,35.1,103653,62335,3879,34728,25253,41764,34814,22040,12774,34814,120200,2016
13315,39.3,8884,5205,3167,362,1787,34071,2698,1955,743,2698,67300,2016
13317,44.7,9924,5101,4266,415,2495,33462,3975,2697,1278,3975,87200,2016
13319,42.8,9312,5322,3564,236,2269,38827,3297,2512,785,3297,69600,2016
13321,41,20988,14092,6167,434,5576,38684,7873,5533,2340,7873,77800,2016
15001,41.8,193680,58882,1061,24027,44133,53936,66094,44013,22081,66094,306000,2016
15003,37.4,986999,186387,21503,92635,218344,77161,309548,170220,139328,309548,602700,2016
15005,56.5,91,29,0,3,13,65625,55,2,53,55,NA,2016
15007,42,70447,20949,443,7506,15404,68224,22430,14204,8226,22430,493800,2016
15009,40.5,162456,50038,761,17656,36827,68777,53903,31415,22488,53903,528500,2016
16001,36.1,425798,364242,4999,32905,104672,58099,160398,108274,52124,160398,200200,2016
16003,51.7,3865,3597,8,122,1079,41335,1655,1315,340,1655,160700,2016
16005,33,83815,71181,506,6678,20070,45216,30424,20731,9693,30424,146600,2016
16007,39.5,5928,5559,46,243,1733,46863,2395,1869,526,2395,136700,2016
16009,46,9068,7682,20,300,2420,42600,3592,2649,943,3592,147800,2016
16011,33,45261,33606,132,8037,11105,49943,14712,10901,3811,14712,143500,2016
16013,42.9,21427,16481,25,4444,5474,58086,8708,5857,2851,8708,384800,2016
16015,53.1,6891,6340,30,260,1926,44591,2994,2433,561,2994,188300,2016
16017,47.5,41389,38799,43,1143,11323,43697,17109,12489,4620,17109,212100,2016
16019,32.6,108989,91505,466,13517,26954,52831,37138,26540,10598,37138,157100,2016
16021,43.4,11141,10138,17,493,2805,39279,4393,3119,1274,4393,174500,2016
16023,45,2592,2450,31,101,689,39653,1061,878,183,1061,101300,2016
16025,40.3,968,881,0,82,246,42708,379,272,107,379,170600,2016
16027,33,202782,144636,743,49941,47489,44860,67155,45561,21594,67155,131300,2016
16029,36.8,6813,6283,13,363,1873,57957,2553,2117,436,2553,125900,2016
16031,31.8,23441,16585,44,6248,5902,46215,7717,5491,2226,7717,130100,2016
16033,30.3,960,496,1,454,233,32422,287,169,118,287,103600,2016
16035,50.3,8528,7778,18,329,2350,40266,3668,2822,846,3668,129500,2016
16037,52.1,4185,4007,0,132,1266,39497,1801,1420,381,1801,166800,2016
16039,31.1,26103,19326,658,4204,6939,44444,9832,5657,4175,9832,137800,2016
16041,32.8,13013,11889,37,871,3349,50500,4226,3361,865,4226,164100,2016
16043,36.9,12896,10995,41,1589,3518,49973,4466,3606,860,4466,147500,2016
16045,45.4,16853,14864,0,1362,4293,40767,6287,4529,1758,6287,143000,2016
16047,36.7,15157,10328,12,4388,3928,40704,5476,3660,1816,5476,132200,2016
16049,49.3,16251,14877,20,507,4350,38597,6443,5101,1342,6443,161300,2016
16051,31.4,27096,23622,18,2810,6567,54646,8150,6636,1514,8150,160300,2016
16053,32.4,22694,14525,20,7622,5661,44447,7647,5088,2559,7647,139700,2016
16055,39.7,147716,134752,470,6219,39564,50924,57213,39909,17304,57213,193300,2016
16057,28.3,38593,34617,274,1559,8434,42133,15218,8214,7004,15218,195800,2016
16059,52.6,7743,7241,16,231,2184,34762,3698,2614,1084,3698,178300,2016
16061,47.9,3826,3309,3,160,1008,38068,1624,1164,460,1624,116400,2016
16063,33.8,5292,3572,0,1577,1190,44500,1596,1107,489,1596,128900,2016
16065,23.3,38114,34110,225,2639,8333,33856,10508,5069,5439,10508,185200,2016
16067,35.4,20331,12937,45,6869,5580,46147,7261,5175,2086,7261,117400,2016
16069,41.2,39995,34963,146,1429,10503,49541,16127,11162,4965,16127,169500,2016
16071,38.9,4269,4017,0,162,1120,40564,1551,1214,337,1551,142700,2016
16073,37.7,11356,7739,14,3001,2775,34785,4068,2711,1357,4068,120500,2016
16075,39.1,22773,18030,87,3796,5728,45670,8195,6235,1960,8195,136400,2016
16077,34.7,7696,4856,17,2487,1944,46318,2465,1830,635,2465,125100,2016
16079,47.2,12551,11572,43,412,3474,37449,5660,3886,1774,5660,117600,2016
16081,35.6,10437,8439,18,1814,2498,58173,3725,2662,1063,3725,254600,2016
16083,34.6,80955,65504,511,12235,20923,45500,29200,19556,9644,29200,149100,2016
16085,48.8,9897,9670,1,111,2297,53630,3446,2645,801,3446,246300,2016
16087,44.6,10035,7896,0,1743,2512,37525,3886,2840,1046,3886,140600,2016
17001,41.1,66949,61782,2533,959,17600,48065,27240,19076,8164,27240,116400,2016
17003,41.9,7051,4305,2388,127,1509,29071,2534,1736,798,2534,50100,2016
17005,41.3,17137,15045,905,598,4098,52159,6051,4614,1437,6051,107200,2016
17007,38.3,53656,39964,1090,11020,13866,60063,18405,14549,3856,18405,146600,2016
17009,37.4,6836,5222,1248,249,1346,52500,2130,1650,480,2130,87400,2016
17011,43.6,33822,30043,230,2874,9470,51425,14017,10602,3415,14017,105300,2016
17013,46.7,4962,4851,6,52,1368,52949,1936,1581,355,1936,118100,2016
17015,47.7,14793,13852,175,503,4198,50052,6649,5025,1624,6649,98300,2016
17017,40.1,13068,10022,477,2411,3372,48887,5124,3707,1417,5124,77200,2016
17019,29.5,206420,142155,25683,11579,42766,48899,80442,44262,36180,80442,151400,2016
17021,42.5,33888,32276,519,512,8951,47417,13901,10389,3512,13901,85200,2016
17023,43.1,16089,15574,68,227,4505,48693,6673,4977,1696,6673,84600,2016
17025,43.1,13466,12991,84,182,3844,45984,5588,4335,1253,5588,76500,2016
17027,40.1,37858,34692,1271,1154,9511,63929,14012,11543,2469,14012,141200,2016
17029,33.6,52802,48195,1928,1224,12451,38800,21094,12934,8160,21094,92800,2016
17031,36.1,5227575,2241001,1232816,1300843,1185605,56902,1951606,1105168,846438,1951606,219800,2016
17033,42.5,19441,17714,814,415,4983,47364,7597,6026,1571,7597,82000,2016
17035,41.6,10890,10554,20,155,2874,44281,4208,3355,853,4208,91600,2016
17037,30.5,104458,81476,6988,11166,22883,56076,37367,21468,15899,37367,166000,2016
17039,43.3,16322,15522,48,393,4399,53510,6721,5275,1446,6721,99500,2016
17041,38,19770,17941,58,1399,5072,52984,7562,5564,1998,7562,101700,2016
17043,38.9,930514,635648,42320,129964,238201,81521,338987,247155,91832,338987,283500,2016
17045,44.1,17828,17331,76,198,5367,46440,7644,5668,1976,7644,79300,2016
17047,43.6,6612,6405,21,61,1783,47035,2768,2292,476,2768,71500,2016
17049,39.2,34356,33080,151,648,8849,52977,13316,10428,2888,13316,132900,2016
17051,40.4,22025,20241,976,461,5343,44745,7650,6284,1366,7650,81400,2016
17053,43.4,13758,13036,115,394,3618,49257,5666,4139,1527,5666,97300,2016
17055,41.9,39503,38028,214,603,10074,39507,16180,11725,4455,16180,68300,2016
17057,42.4,36047,33210,1286,982,9311,46183,14131,10841,3290,14131,82100,2016
17059,44.7,5325,5096,17,35,1529,41269,2295,1786,509,2295,67200,2016
17061,42.5,13390,12964,147,149,3536,42880,5278,4063,1215,5278,77100,2016
17063,37.2,50338,44013,713,4584,13431,67162,18509,13654,4855,18509,183200,2016
17065,43,8251,8170,41,22,2336,45076,3394,2688,706,3394,94100,2016
17067,46.4,18633,18001,91,253,5331,50077,7726,6108,1618,7726,84700,2016
17069,46.1,4173,3872,115,71,980,39926,1506,1231,275,1506,67500,2016
17071,49.2,6966,6723,7,101,2036,46216,3054,2403,651,3054,83800,2016
17073,42.3,49681,45183,873,2706,13864,54757,20131,15638,4493,20131,112700,2016
17075,44.3,28814,26171,342,1827,7973,47823,11899,9089,2810,11899,95100,2016
17077,30.8,59188,44379,8337,2460,12051,33845,23663,12285,11378,23663,109000,2016
17079,42.8,9592,9342,64,123,2605,56305,3719,3098,621,3719,98700,2016
17081,40.9,38523,33166,3178,898,9756,43467,15189,11089,4100,15189,88500,2016
17083,42.4,22441,21589,64,285,6156,52738,8760,6949,1811,8760,129900,2016
17085,48.6,22186,21070,89,652,6441,54702,9611,7528,2083,9611,140700,2016
17087,42.9,12866,11063,1215,436,3057,44179,4503,3732,771,4503,96000,2016
17089,36.2,526615,305349,28207,165114,129475,71602,173718,127075,46643,173718,215800,2016
17091,37.4,111493,80639,16783,10975,27263,54697,40480,27873,12607,40480,138900,2016
17093,34.4,121452,87391,7725,20608,31251,85736,39275,32152,7123,39275,205500,2016
17095,42.1,51752,43356,4243,2778,12020,40605,21146,13829,7317,21146,80100,2016
17097,37.8,702890,445468,46668,146608,178965,79886,243276,178807,64469,243276,246700,2016
17099,41.8,111935,96856,2629,10126,29340,51684,44368,32241,12127,44368,123200,2016
17101,39.6,16582,12793,2692,806,3817,42650,5557,4004,1553,5557,70800,2016
17103,42.7,34718,30220,1748,1989,8851,55067,13506,9893,3613,13506,114800,2016
17105,41.2,37278,33272,1614,1602,9648,54074,14525,10436,4089,14525,110400,2016
17107,40,29820,23610,3029,995,7211,52676,11016,7554,3462,11016,97500,2016
17109,30.7,31727,28023,1640,847,6542,41484,11841,7789,4052,11841,93300,2016
17111,39.6,307083,252800,3759,37727,82034,79836,110109,86922,23187,110109,208500,2016
17113,32.6,173254,138534,13804,8107,40841,63420,65956,42825,23131,65956,161800,2016
17115,40.7,108404,83430,15204,2285,27612,47477,44860,30976,13884,44860,95700,2016
17117,43,46482,44822,254,486,12854,52337,18754,14522,4232,18754,95500,2016
17119,39.7,266759,228856,21942,8133,69843,54573,107014,75786,31228,107014,129200,2016
17121,41.6,38503,35319,1354,687,10468,43427,15841,11867,3974,15841,72000,2016
17123,46.4,12060,11462,44,370,3222,54189,4953,4133,820,4953,104200,2016
17125,45.1,13931,13470,104,140,3958,43125,6084,4619,1465,6084,83100,2016
17127,44,14883,13238,955,381,3774,42706,5951,4493,1458,5951,82300,2016
17129,42.6,12576,12070,87,173,3681,60420,5219,3972,1247,5219,132700,2016
17131,44.8,15971,15335,87,336,4551,55750,6567,5115,1452,6567,98900,2016
17133,42.3,33703,32579,99,495,9904,72956,13030,10830,2200,13030,192600,2016
17135,42.4,29301,26018,2347,498,7483,45173,11287,8732,2555,11287,80000,2016
17137,41.1,34801,31058,2022,795,8878,47760,13797,9612,4185,13797,99300,2016
17139,40.7,14915,14509,54,170,3962,51432,5804,4386,1418,5804,101600,2016
17141,41.8,52034,45633,498,4990,13849,55832,20782,15762,5020,20782,138500,2016
17143,36.9,186818,132292,32163,8356,45735,51632,75406,48923,26483,75406,128800,2016
17145,41.6,21595,18674,1823,638,5124,43308,8089,6065,2024,8089,80600,2016
17147,43.3,16469,15918,65,207,4840,69160,6658,5546,1112,6658,126200,2016
17149,42.5,16054,15346,198,202,4311,40157,6615,5146,1469,6615,74800,2016
17151,50.6,4255,3872,200,84,1019,39243,1589,1343,246,1589,89300,2016
17153,43.5,5792,3677,1808,113,1323,32538,2285,1687,598,2285,60800,2016
17155,46.4,5746,5338,17,287,1655,64085,2440,1949,491,2440,119200,2016
17157,41.4,32934,28070,3442,984,7683,48343,11907,9115,2792,11907,97800,2016
17159,42.1,16072,15398,91,245,3981,45597,6452,4711,1741,6452,84500,2016
17161,40.1,146536,107454,13536,18092,37467,50208,60098,41522,18576,60098,114600,2016
17163,37.8,265569,165693,78968,10008,67542,50006,102672,67140,35532,102672,120500,2016
17165,42,24659,22628,831,405,6696,40290,10010,7183,2827,10010,71200,2016
17167,39.9,198639,161014,24887,4217,50485,56742,82952,57726,25226,82952,133400,2016
17169,45.5,7205,6764,349,21,1914,48396,2962,2422,540,2962,80100,2016
17171,43.3,5169,5025,0,60,1400,46210,2092,1587,505,2092,82600,2016
17173,44.4,22011,21462,138,211,6424,48572,9213,7406,1807,9213,86200,2016
17175,46.2,5840,5633,42,74,1574,52058,2381,1959,422,2381,83900,2016
17177,44.6,46283,38783,4285,1588,12517,45624,19573,13619,5954,19573,98700,2016
17179,40.6,135400,127716,1625,2995,37309,60178,54612,41628,12984,54612,137200,2016
17181,43.7,17458,15959,84,863,4652,45464,6771,5355,1416,6771,94200,2016
17183,40.1,79613,63041,10861,3744,19967,43552,31540,21765,9775,31540,75800,2016
17185,42.6,11587,11044,117,200,3155,46871,4846,3570,1276,4846,80200,2016
17187,39.9,17611,14960,486,1595,4530,44067,6811,5044,1767,6811,82500,2016
17189,42.8,14369,13832,115,208,3929,54936,5809,4608,1201,5809,108600,2016
17191,42.7,16517,15945,110,126,4684,46903,7037,5535,1502,7037,78000,2016
17193,44.5,14410,13953,47,188,3996,43678,6183,4673,1510,6183,69000,2016
17195,42.8,57155,48581,983,6669,15327,49151,23511,17710,5801,23511,99500,2016
17197,37,685378,447069,75365,113180,170326,77507,224959,182341,42618,224959,210600,2016
17199,40.9,67336,60901,2797,1632,17937,45902,26711,19176,7535,26711,101700,2016
17201,39.3,288896,204269,35533,34439,74799,49468,114299,74835,39464,114299,116200,2016
17203,40,39123,37477,200,667,10700,68040,14489,11878,2611,14489,158600,2016
18001,33.7,34813,32634,247,1533,8537,47572,12260,9367,2893,12260,114600,2016
18003,35.6,365565,273895,41422,25810,91811,49574,141483,96795,44688,141483,116400,2016
18005,37.9,80203,67286,1522,5079,20727,55874,31073,21779,9294,31073,137500,2016
18007,40.5,8709,8087,79,449,2316,48069,3388,2461,927,3388,81500,2016
18009,43.4,12364,11860,75,176,3493,38791,5207,3846,1361,5207,67100,2016
18011,38.9,61884,56986,807,1603,17210,72774,23427,17808,5619,23427,195900,2016
18013,48.3,14965,14363,41,230,4201,56323,5953,4751,1202,5953,171600,2016
18015,42.3,20007,18856,90,788,5423,54140,7770,6293,1477,7770,119200,2016
18017,40.5,38324,31086,559,5391,9580,43918,14536,10994,3542,14536,82500,2016
18019,38.8,113993,96063,7876,5833,28370,51844,43074,30735,12339,43074,129500,2016
18021,40.4,26568,25657,64,344,7565,49735,10541,7920,2621,10541,96600,2016
18023,38.6,32692,27318,204,4812,8203,50096,11769,8517,3252,11769,98700,2016
18025,43.3,10582,10210,19,154,2768,41173,4076,3307,769,4076,88600,2016
18027,34.6,32583,30190,535,1508,8310,47939,11483,8441,3042,11483,113600,2016
18029,42.3,49552,47758,417,584,13673,60834,18639,14720,3919,18639,159800,2016
18031,39.1,26340,25101,149,486,7217,51185,10120,7167,2953,10120,119300,2016
18033,38.9,42489,40471,94,1144,11136,50398,16221,12406,3815,16221,113800,2016
18035,35.1,116463,101757,6979,2481,27501,39537,46104,29461,16643,46104,87800,2016
18037,40.9,42345,38788,177,2831,11490,55154,16311,12519,3792,16311,140700,2016
18039,35.3,201640,152871,10970,30252,50709,49692,70822,48680,22142,70822,125300,2016
18041,42.4,23608,22650,578,231,6533,40851,9420,6517,2903,9420,79900,2016
18043,40,76290,67511,3899,2270,19524,57494,29034,20863,8171,29034,158300,2016
18045,42.5,16741,16022,67,395,4491,45924,6963,5140,1823,6963,88300,2016
18047,42.1,22887,22249,76,250,6584,52128,8710,6867,1843,8710,143000,2016
18049,41.5,20412,18870,184,994,5278,46310,7962,6184,1778,7962,93700,2016
18051,40.3,33684,31786,614,483,9180,49669,13297,10249,3048,13297,106300,2016
18053,39.8,68269,58405,4692,2772,16854,40272,26227,18047,8180,26227,84600,2016
18055,42.6,32633,31627,94,405,8386,45153,12688,10109,2579,12688,91400,2016
18057,36.3,303042,257075,10721,11350,81987,87782,111443,86624,24819,111443,230000,2016
18059,39.8,71955,67182,1463,1499,19484,68449,26680,20575,6105,26680,160900,2016
18061,42.5,39370,37782,28,657,10054,52926,14524,11762,2762,14524,133400,2016
18063,37.5,155817,134594,9160,5493,41052,73042,55744,44229,11515,55744,165200,2016
18065,42.5,48953,46023,988,783,11947,44509,17926,13013,4913,17926,94000,2016
18067,41.5,82728,71209,5747,2526,22223,45928,34411,23539,10872,34411,97900,2016
18069,40.1,36696,35015,282,754,9885,47042,14532,11036,3496,14532,99700,2016
18071,38.3,43637,39230,232,2677,11715,48546,16517,12198,4319,16517,115100,2016
18073,39.1,33461,30718,294,1976,8776,55485,12091,9300,2791,12091,149100,2016
18075,39.4,21196,20183,78,629,5474,42322,8062,6087,1975,8062,81100,2016
18077,40.5,32482,30298,627,800,8633,47065,12642,9025,3617,12642,112700,2016
18079,39.6,28023,26751,372,633,7235,47236,10519,7762,2757,10519,97600,2016
18081,37.4,147567,133962,2978,4920,39160,63023,53713,37876,15837,53713,146600,2016
18083,38.1,37956,35336,1134,660,9308,44624,14655,9666,4989,14655,85100,2016
18085,37.8,78461,69722,628,6062,21611,54482,30078,22702,7376,30078,136700,2016
18087,31.1,38395,36265,86,1496,9392,53947,11850,9705,2145,11850,170600,2016
18089,38.2,489698,267388,118723,88341,123242,50905,184140,126609,57531,184140,137800,2016
18091,40,110993,88964,12046,6747,28396,48165,43052,30572,12480,43052,123700,2016
18093,42.4,45696,43878,160,693,13014,46044,18426,14282,4144,18426,103400,2016
18095,40,129862,111072,10061,4814,33604,44795,51441,35677,15764,51441,90800,2016
18097,34.1,932142,534336,252707,91656,208284,43369,365472,195824,169648,365472,120500,2016
18099,39.8,46833,41379,283,4362,11856,49725,17093,12964,4129,17093,124600,2016
18101,42.7,10218,9931,42,22,2617,47457,4219,3285,934,4219,95400,2016
18103,39.8,36093,32337,1761,1004,9111,45646,13268,9619,3649,13268,85600,2016
18105,28.6,143292,121090,4332,4672,27674,43389,54278,29472,24806,54278,161300,2016
18107,40.4,38108,35245,340,1751,10176,50253,14852,10611,4241,14852,111600,2016
18109,41.2,69504,67021,237,979,18722,57521,25655,19518,6137,25655,144400,2016
18111,42.9,14022,12892,47,828,3885,50058,5482,4112,1370,5482,112500,2016
18113,38.4,47587,41805,170,4754,12806,49657,18013,13424,4589,18013,111200,2016
18115,46.2,6003,5811,139,37,1695,54653,2427,1963,464,2427,146400,2016
18117,40.9,19579,18751,250,261,5302,41438,7720,5768,1952,7720,88400,2016
18119,44.3,21038,20308,99,246,6003,45388,8581,6791,1790,8581,108500,2016
18121,41.6,17033,16169,315,244,4329,42664,6150,4813,1337,6150,88300,2016
18123,41.1,19301,18233,596,237,5021,47396,7318,5694,1624,7318,100000,2016
18125,43.4,12554,12166,100,56,3490,48076,4957,4166,791,4957,89500,2016
18127,39.4,167016,140836,5445,15662,44153,64874,62429,47915,14514,62429,168300,2016
18129,42.7,25527,24582,344,273,7330,59918,10017,8463,1554,10017,136900,2016
18131,41.6,12910,12235,27,360,3554,44884,5174,3924,1250,5174,92000,2016
18133,37.8,37626,34600,1307,985,8994,52465,12962,9544,3418,12962,121700,2016
18135,42,25403,23867,236,819,6881,42418,10483,7926,2557,10483,79000,2016
18137,40.8,28633,27435,113,500,7986,52372,10981,8357,2624,10981,138300,2016
18139,41.2,16873,16253,194,241,4776,46380,6747,4858,1889,6747,100300,2016
18141,36.4,267696,198186,34120,21797,64126,46174,100861,68638,32223,100861,116800,2016
18143,40.9,23734,22859,52,439,6219,46368,8844,6486,2358,8844,98400,2016
18145,41.5,44404,41212,573,1747,11521,52651,17309,12494,4815,17309,124800,2016
18147,42.8,20777,19795,132,575,5899,54870,8065,6593,1472,8065,118300,2016
18149,41.9,23069,21831,96,797,6149,43401,8727,7081,1646,8727,99100,2016
18151,42.1,34279,32263,85,1151,9206,50418,13451,10330,3121,13451,130000,2016
18153,41,21026,19408,929,350,5487,43786,7713,5517,2196,7713,77900,2016
18155,40.1,10484,10102,64,188,2972,43456,4102,2894,1208,4102,114200,2016
18157,27.9,183397,142612,8553,14628,38455,47406,68172,36400,31772,68172,139500,2016
18159,44.5,15447,14776,26,383,4376,54023,6401,5067,1334,6401,110600,2016
18161,43.1,7251,6973,12,1,1839,45104,2917,2120,797,2917,106100,2016
18163,37.7,181692,153310,16244,4500,44725,43311,74313,46835,27478,74313,118100,2016
18165,43,15752,15279,59,174,4181,44409,6600,5007,1593,6600,76200,2016
18167,36.1,108099,92988,6309,2708,25083,41221,40753,24878,15875,40753,91900,2016
18169,42.1,32177,30443,269,779,8602,47473,12767,9525,3242,12767,96200,2016
18171,44.5,8309,8037,57,113,2449,58623,3327,2760,567,3327,110700,2016
18173,40.6,61427,57203,922,1052,17110,61542,23290,18736,4554,23290,153000,2016
18175,41,27792,26962,13,355,7528,44883,10540,8060,2480,10540,104600,2016
18177,40.9,67423,59769,3274,1869,17280,39691,26664,18034,8630,26664,94300,2016
18179,40.7,27836,26513,176,721,7652,51568,10828,8714,2114,10828,118800,2016
18181,42.3,24265,21898,112,1833,6723,51547,9670,7552,2118,9670,106600,2016
18183,41.3,33354,31975,130,615,9409,54837,13232,10597,2635,13232,129800,2016
19001,46,7330,7102,21,117,2118,48765,3228,2482,746,3228,95000,2016
19003,47.2,3822,3701,19,31,1103,48598,1681,1243,438,1681,88900,2016
19005,45.1,14001,12823,118,792,3877,48089,6035,4724,1311,6035,116200,2016
19007,44.8,12602,12090,56,217,3264,40817,5430,4025,1405,5430,79300,2016
19009,48.3,5793,5630,13,35,1625,47048,2667,2149,518,2667,66300,2016
19011,41.8,25720,24887,140,355,7076,61222,10155,8179,1976,10155,143000,2016
19013,34.8,132821,109678,11723,5493,31060,50348,52506,35004,17502,52506,133800,2016
19015,41.1,26411,25052,324,626,6975,54513,10943,8153,2790,10943,122900,2016
19017,38.9,24663,23557,265,339,6461,64264,9343,7536,1807,9343,153200,2016
19019,38.5,21031,20300,72,301,5490,55881,8246,6554,1692,8246,129900,2016
19021,35.4,20445,12798,550,5046,5125,49942,7504,5099,2405,7504,106200,2016
19023,43.7,14933,14490,45,177,4282,52204,6282,5000,1282,6282,110500,2016
19025,45.4,9876,9369,164,180,2673,44635,4249,3232,1017,4249,76900,2016
19027,42,20555,19642,292,464,5489,53785,8580,6451,2129,8580,121800,2016
19029,44.6,13433,12870,35,316,3767,45469,6076,4293,1783,6076,91600,2016
19031,42.2,18389,17642,108,334,5116,60435,7599,5971,1628,7599,138600,2016
19033,44.3,43303,39666,674,1907,11440,47788,19250,13461,5789,19250,115900,2016
19035,46.5,11752,11075,83,365,3229,51590,5317,3904,1413,5317,86300,2016
19037,44.2,12164,11725,71,269,3391,48013,5244,4113,1131,5244,103700,2016
19039,39.7,9273,7928,27,1119,2425,46510,3837,2522,1315,3837,94900,2016
19041,41.7,16478,15521,47,527,4578,48888,7281,5210,2071,7281,111600,2016
19043,45.9,17735,17064,110,331,4887,48482,7622,5789,1833,7622,111500,2016
19045,42.2,47972,43989,1284,1416,12788,50067,19871,14703,5168,19871,110900,2016
19047,37.9,17147,11692,243,4677,4583,49699,6430,4691,1739,6430,88800,2016
19049,35,78074,67560,892,4778,20840,78918,30026,22269,7757,30026,204700,2016
19051,37.6,8768,8521,16,110,2345,49696,3230,2562,668,3230,104500,2016
19053,36.8,8210,7641,163,220,1994,38467,3166,2086,1080,3166,79200,2016
19055,43.2,17445,16971,33,210,4980,59452,6882,5575,1307,6882,123200,2016
19057,42.2,40114,35444,2221,1147,10645,44516,16659,12229,4430,16659,98000,2016
19059,48.8,17046,16437,62,295,5010,57914,8008,6048,1960,8008,170500,2016
19061,38.5,96359,88470,2558,2126,25249,56154,38006,27463,10543,38006,153000,2016
19063,42.5,9820,8673,136,890,2630,45536,4127,3205,922,4127,84700,2016
19065,43.1,20391,19249,270,455,5377,47711,8333,6319,2014,8333,89600,2016
19067,44.5,16004,14920,267,377,4484,46406,6891,4925,1966,6891,104600,2016
19069,42.5,10393,8963,126,1233,2830,47524,4227,3141,1086,4227,86400,2016
19071,46.3,7019,6688,25,176,1999,52922,2969,2230,739,2969,99300,2016
19073,45,9083,8659,14,232,2648,47264,3903,2963,940,3903,86400,2016
19075,42.5,12373,12026,42,151,3505,61606,5162,4131,1031,5162,127100,2016
19077,45.9,10691,10236,26,254,2983,52702,4490,3637,853,4490,104600,2016
19079,43,15227,13733,97,857,4264,53970,6381,4565,1816,6381,95900,2016
19081,44.2,11006,10353,86,411,3095,54813,4699,3674,1025,4699,95500,2016
19083,44.4,17324,16057,207,699,4469,51821,7093,5398,1695,7093,90400,2016
19085,44,14335,13835,7,228,3975,55845,6046,4596,1450,6046,107800,2016
19087,40.7,19941,17724,408,894,5095,49606,7619,5421,2198,7619,106100,2016
19089,42.1,9430,9129,31,144,2384,49199,3815,3047,768,3815,98300,2016
19091,43.3,9607,9072,15,354,2760,47478,4236,3050,1186,4236,90200,2016
19093,44.7,7041,6769,0,148,2057,49957,3077,2315,762,3077,88100,2016
19095,41.8,16326,15647,105,384,4853,55099,6779,5333,1446,6779,139500,2016
19097,44.6,19529,18729,70,264,5626,49115,8427,6277,2150,8427,116400,2016
19099,42.6,36715,34716,550,681,9786,55503,14644,10688,3956,14644,118600,2016
19101,41.1,17662,14333,1011,521,4158,45257,6896,4575,2321,6896,110700,2016
19103,29.9,142006,114067,8542,7558,31121,56808,56543,33209,23334,56543,202400,2016
19105,43.8,20481,19374,415,340,5702,55507,8244,6299,1945,8244,130300,2016
19107,44.1,10234,9924,1,147,2771,45227,4414,3419,995,4414,79500,2016
19109,45.9,15226,14569,68,310,4394,54231,6657,5280,1377,6657,95800,2016
19111,43.4,35172,31997,907,1196,9228,44568,14318,10660,3658,14318,88100,2016
19113,37.2,218076,191321,9802,6527,55227,60989,88006,64658,23348,88006,148600,2016
19115,40.7,11251,8887,120,1792,2997,51615,4366,3346,1020,4366,102400,2016
19117,45.5,8700,8461,11,37,2378,48768,3678,2895,783,3678,84700,2016
19119,38.2,11730,11290,6,286,3297,59888,4492,3716,776,4492,118900,2016
19121,40.9,15661,15095,70,250,4428,60326,6260,4822,1438,6260,163000,2016
19123,39.9,22324,21052,325,425,5900,49599,8983,6186,2797,8983,109100,2016
19125,39.2,33197,31496,204,602,8666,57412,13026,9466,3560,13026,144800,2016
19127,38.7,40735,29980,469,8064,10274,54193,15293,10993,4300,15293,104600,2016
19129,42.8,14841,14061,111,408,3884,66203,5444,4283,1161,5444,154200,2016
19131,43.7,10757,10401,9,140,2889,52564,4322,3607,715,4322,110500,2016
19133,47,9013,8602,50,150,2458,41455,4064,2893,1171,4064,80100,2016
19135,43.2,7964,7579,6,199,2129,47515,3349,2541,808,3349,93400,2016
19137,45.2,10380,9803,0,352,3093,42641,4607,3136,1471,4607,80700,2016
19139,38,42949,33694,718,7360,11409,55971,16390,12119,4271,16390,126600,2016
19141,43.4,14055,13122,68,602,3898,52474,6066,4361,1705,6066,107800,2016
19143,44.3,6154,5603,25,426,1658,48457,2621,1964,657,2621,85900,2016
19145,44,15552,14269,379,463,3990,46128,6388,4769,1619,6388,85800,2016
19147,42.6,9155,8691,149,198,2443,49109,3877,2871,1006,3877,86600,2016
19149,41.5,24972,23328,122,1006,6921,60339,10008,7908,2100,10008,143000,2016
19151,47.3,7061,6631,90,247,1908,46250,3222,2431,791,3222,70800,2016
19153,35,459159,362994,28582,36682,114612,61684,178520,119927,58593,178520,161100,2016
19155,39.3,93198,82670,1317,6746,24420,53260,36680,24978,11702,36680,128500,2016
19157,41,18622,17170,313,567,4653,50725,7365,5217,2148,7365,128100,2016
19159,46,5054,4860,11,108,1344,46927,2024,1507,517,2024,75700,2016
19161,45.9,10034,9601,50,261,2803,49570,4363,3416,947,4363,83200,2016
19163,37.7,171116,138630,13118,10752,42958,56454,67540,46252,21288,67540,150900,2016
19165,47,11944,11354,49,347,3231,52757,5061,4042,1019,5061,107900,2016
19167,33.3,34621,30464,146,3409,9035,63466,11940,9481,2459,11940,147700,2016
19169,25.8,94834,80633,2012,2990,19066,51201,36544,19333,17211,36544,167800,2016
19171,43.2,17423,14435,88,1432,4628,53833,6734,5157,1577,6734,103300,2016
19173,43.4,6209,5645,12,460,1821,46510,2715,1993,722,2715,74800,2016
19175,40.3,12539,11881,124,338,3319,45934,5382,3810,1572,5382,88100,2016
19177,44.8,7380,7153,27,98,2050,46769,2921,2460,461,2921,80400,2016
19179,39.5,35242,29827,820,3609,9429,42494,14454,10513,3941,14454,81400,2016
19181,38.2,48170,45720,186,1165,13331,67090,18231,13995,4236,18231,165200,2016
19183,41.2,22115,20302,175,1245,5985,56864,8757,6384,2373,8757,127500,2016
19185,43.9,6403,6187,41,77,1630,42088,2574,2044,530,2574,73200,2016
19187,39.5,37050,32808,1617,1614,8981,42196,15073,10245,4828,15073,90000,2016
19189,42.8,10580,9821,79,413,2911,49278,4545,3463,1082,4545,93300,2016
19191,40.6,20789,19817,178,437,5376,57009,8205,6354,1851,8205,159400,2016
19193,35.3,102426,77044,2999,15635,25633,49010,38536,25934,12602,38536,104300,2016
19195,44.6,7562,7185,64,205,2095,49472,3144,2511,633,3144,95100,2016
19197,44.4,12891,11256,63,1359,3427,46071,5528,4061,1467,5528,76700,2016
20001,41.7,12951,11775,245,422,3267,40911,5303,3822,1481,5303,73700,2016
20003,42,7858,7484,10,36,2128,42146,3214,2287,927,3214,91200,2016
20005,36.6,16557,14655,652,465,3709,46103,6057,4301,1756,6057,100300,2016
20007,44.3,4831,4488,35,152,1208,49455,1960,1388,572,1960,77400,2016
20009,40.1,27214,22397,279,3857,7412,44449,11255,7689,3566,11255,83700,2016
20011,38.1,14751,13392,503,350,3911,41529,5628,3896,1732,5628,82300,2016
20013,42.9,9810,8195,118,380,2653,44672,4025,2804,1221,4025,86000,2016
20015,38,66264,59540,1420,2920,17334,60338,24278,17661,6617,24278,137800,2016
20017,46.2,2694,2480,32,109,690,41889,1084,849,235,1084,83200,2016
20019,49,3470,3007,9,58,925,37927,1472,1164,308,1472,53900,2016
20021,41.7,20737,18409,127,473,5534,41240,7861,5884,1977,7861,74800,2016
20023,48.5,2679,2429,0,169,773,46058,1252,983,269,1252,84500,2016
20025,44.5,2131,1745,16,253,559,42976,904,618,286,904,67300,2016
20027,42,8346,7906,60,200,2369,53041,3355,2637,718,3355,99400,2016
20029,41.5,9302,8693,71,297,2307,40947,3904,2822,1082,3904,72500,2016
20031,44.4,8433,7905,78,208,2465,57442,3580,2671,909,3580,107300,2016
20033,47,1898,1756,0,119,488,43542,766,575,191,766,65900,2016
20035,38,35977,28994,943,3689,9011,44960,13768,9027,4741,13768,83000,2016
20037,32.5,39281,34457,885,2007,8756,37607,14965,9200,5765,14965,85100,2016
20039,52.1,2886,2748,12,82,728,41362,1423,1070,353,1423,61400,2016
20041,41.7,19384,17719,170,859,5182,48093,7916,5576,2340,7916,110300,2016
20043,39.6,7793,7038,293,207,2079,49375,3087,2235,852,3087,92000,2016
20045,29.1,116352,92804,4364,6714,23967,52698,44212,22704,21508,44212,181900,2016
20047,45.4,2975,2313,39,591,812,48684,1254,966,288,1254,58000,2016
20049,50.8,2635,2406,3,106,817,37393,1245,1016,229,1245,48800,2016
20051,32,29032,26271,311,1592,6610,50140,11682,7463,4219,11682,155900,2016
20053,43.8,6375,5510,287,384,1573,49134,2517,1891,626,2517,85700,2016
20055,30.5,36983,16074,746,17908,9238,50712,12637,7775,4862,12637,122700,2016
20057,31.1,34492,14335,794,18313,8209,49688,11226,6901,4325,11226,103600,2016
20059,39.3,25663,23402,417,1014,6679,51465,9820,7163,2657,9820,118200,2016
20061,26.2,36818,21415,5991,5526,8867,45243,12749,5178,7571,12749,136100,2016
20063,47.7,2682,2497,26,90,838,46681,1193,945,248,1193,77800,2016
20065,50.3,2577,2300,78,81,761,45982,1236,978,258,1236,72000,2016
20067,32.6,7748,4094,0,3579,2003,54919,2678,2097,581,2678,101000,2016
20069,35.8,6037,5112,0,888,1625,59629,2129,1589,540,2129,115300,2016
20071,49,1235,942,8,257,347,47000,478,342,136,478,89100,2016
20073,48.6,6304,5825,10,239,1720,39671,2779,2081,698,2779,59300,2016
20075,32.8,2567,1614,6,922,651,48523,903,619,284,903,88100,2016
20077,43.2,5798,5247,4,366,1525,46886,2395,1841,554,2395,66200,2016
20079,38.7,34814,29127,553,3963,9330,52463,13449,9353,4096,13449,120600,2016
20081,36.2,4087,2802,0,1181,995,55453,1325,964,361,1325,114800,2016
20083,48.9,1919,1725,0,135,576,56250,814,608,206,814,85900,2016
20085,41.3,13365,11309,77,563,3796,54700,5213,3907,1306,5213,121000,2016
20087,43.7,18880,17780,111,449,5329,56777,7585,6180,1405,7585,130100,2016
20089,51.2,3003,2871,4,71,888,37750,1398,1122,276,1398,53200,2016
20091,37.1,572428,463113,25122,41946,151387,78186,222067,153229,68838,222067,222400,2016
20093,35.1,3943,2580,30,1203,1034,49396,1327,1032,295,1327,91000,2016
20095,45.4,7697,7254,33,235,1994,56142,3001,2349,652,3001,90200,2016
20097,40.8,2520,2262,23,152,626,44896,1016,684,332,1016,118400,2016
20099,40.9,20833,17789,686,901,5750,41851,8374,5813,2561,8374,75300,2016
20101,43,1687,1580,9,89,479,58077,810,643,167,810,74700,2016
20103,37.3,78785,62499,6756,5282,19429,66046,27122,18180,8942,27122,168900,2016
20105,46.1,3134,2977,30,84,804,49583,1291,1066,225,1291,69300,2016
20107,43.4,9524,8965,58,231,2833,45790,4243,3338,905,4243,90500,2016
20109,41.3,2800,2545,0,141,750,48205,1168,860,308,1168,80500,2016
20111,32.8,33401,24005,746,6893,8135,40611,13305,7885,5420,13305,94500,2016
20113,41.8,29164,26865,284,1139,7937,56783,11885,8752,3133,11885,138800,2016
20115,45.1,12213,11394,84,381,3225,47926,4812,3871,941,4812,82600,2016
20117,45.2,9963,9477,40,230,2755,47532,4323,3291,1032,4323,92000,2016
20119,39.6,4310,3531,29,654,1253,52960,1665,1197,468,1665,91100,2016
20121,40.8,32787,30554,448,957,8894,63353,12620,9784,2836,12620,173400,2016
20123,43.8,6299,6036,21,129,1674,49755,2706,1985,721,2706,90000,2016
20125,40,33765,27093,1753,2050,8949,42646,13630,9507,4123,13630,71600,2016
20127,47.7,5694,5274,3,245,1614,48551,2328,1822,506,2328,89500,2016
20129,41,3033,2228,19,650,764,44100,1158,808,350,1158,105600,2016
20131,41.2,10177,9746,62,163,2778,50400,4141,3114,1027,4141,110400,2016
20133,39.9,16358,14832,121,811,4291,43867,6407,4566,1841,6407,74500,2016
20135,46.8,3047,2677,15,317,892,47298,1325,1058,267,1325,68800,2016
20137,43.7,5558,4987,150,277,1382,47651,2019,1492,527,2019,69700,2016
20139,42.7,16001,15023,42,447,4380,52171,6444,4899,1545,6444,101800,2016
20141,48.3,3746,3578,30,69,1019,41432,1713,1289,424,1713,60100,2016
20143,42.2,6004,5669,4,164,1711,52241,2446,2015,431,2446,92800,2016
20145,43.7,6840,5801,300,515,1557,46227,2598,1841,757,2598,77200,2016
20147,44.9,5484,5165,19,167,1503,45940,2345,1792,553,2345,76500,2016
20149,34.8,22920,20606,285,1202,6038,62500,8364,6489,1875,8364,165900,2016
20151,38.8,9729,8671,42,666,2390,48995,3778,2571,1207,3778,86300,2016
20153,50.3,2557,2365,6,136,755,49327,1178,883,295,1178,81500,2016
20155,40.1,63803,54265,1779,5663,16263,46000,25028,16680,8348,25028,96100,2016
20157,50.9,4768,4595,6,72,1236,41489,2238,1749,489,2238,55400,2016
20159,37.7,9949,8388,178,1104,2607,46335,3968,2924,1044,3968,74200,2016
20161,24.9,75026,58031,4691,5838,14384,46609,26544,11099,15445,26544,184500,2016
20163,43.7,5160,4897,25,126,1394,46750,2192,1681,511,2192,74600,2016
20165,48.3,3144,2971,1,99,844,40395,1424,1108,316,1424,66700,2016
20167,47.4,6988,6511,80,199,2068,42656,3195,2388,807,3195,85100,2016
20169,37.6,55547,44840,1804,5935,14414,48497,22400,14940,7460,22400,123200,2016
20171,41.5,4958,4085,0,746,1365,61886,2139,1564,575,2139,133500,2016
20173,34.8,508221,350524,45185,70597,124796,51157,193927,123556,70371,193927,128000,2016
20175,29.2,23185,7520,934,13675,5287,47507,7381,5077,2304,7381,89400,2016
20177,38.8,178567,133541,13086,20903,44317,52088,71015,45621,25394,71015,125900,2016
20179,46.5,2522,2376,4,102,766,50822,1151,897,254,1151,91400,2016
20181,38.1,6038,5135,66,716,1759,47036,2804,1765,1039,2804,80400,2016
20183,51.2,3701,3599,7,70,1052,43913,1698,1316,382,1698,65200,2016
20185,43,4284,3594,35,569,1213,46830,1770,1500,270,1770,64900,2016
20187,39.2,2115,1315,18,695,563,44567,810,630,180,810,76900,2016
20189,34.9,5738,3592,7,1989,1433,54333,1910,1419,491,1910,98600,2016
20191,40.5,23509,21211,224,1231,6028,50950,9103,6852,2251,9103,84200,2016
20193,36.2,7909,7248,89,408,2158,52074,3233,2371,862,3233,110100,2016
20195,50.4,2927,2814,3,24,866,54630,1334,1051,283,1334,82000,2016
20197,43.1,6960,6482,21,236,1916,57791,2707,2309,398,2707,112700,2016
20199,42.5,1584,1495,0,76,362,45804,587,443,144,587,82500,2016
20201,46.3,5613,5301,22,184,1612,47045,2412,1912,500,2412,73900,2016
20203,40.5,2168,1413,8,717,590,57596,839,629,210,839,81800,2016
20205,44,8956,8285,43,250,2525,43594,3878,2917,961,3878,61700,2016
20207,47.5,3186,2977,20,87,879,35321,1521,1220,301,1521,52100,2016
20209,33.5,161777,67910,37748,44658,37558,40757,59067,33778,25289,59067,90100,2016
21001,40.8,19156,17917,585,353,4934,33873,7126,5381,1745,7126,86100,2016
21003,40.3,20421,19505,310,378,5561,41166,7705,5404,2301,7705,98200,2016
21005,40.6,21867,20636,558,342,6016,53513,8554,6451,2103,8554,136300,2016
21007,42.9,8216,7676,298,96,2134,43923,3252,2647,605,3252,108400,2016
21009,40.2,43287,39314,1736,1280,11555,39034,16766,11208,5558,16766,108300,2016
21011,40.3,12113,11560,189,183,3123,34986,4450,3251,1199,4450,73500,2016
21013,41.1,27676,26183,930,119,7104,22603,10978,7193,3785,10978,59800,2016
21015,36.6,125656,111481,3425,4984,34536,69165,45649,32880,12769,45649,178300,2016
21017,41.6,20004,17045,1435,1327,5241,44232,8043,4954,3089,8043,140500,2016
21019,41.8,48716,45506,1252,784,13207,44140,19386,13495,5891,19386,100700,2016
21021,40.7,29650,25560,2073,926,7137,40758,10882,6999,3883,10882,136900,2016
21023,41,8404,8214,2,130,2222,35887,3412,2568,844,3412,96200,2016
21025,41,13476,13096,81,115,3443,25484,5304,3976,1328,5304,49600,2016
21027,43.2,20000,18945,353,243,5072,43390,7343,5824,1519,7343,91600,2016
21029,39.7,77727,73927,417,1320,21136,58702,28533,23544,4989,28533,149000,2016
21031,41,12828,12164,84,439,3595,38427,5153,3796,1357,5153,92300,2016
21033,42.4,12758,11621,780,196,3843,43491,5322,3725,1597,5322,95600,2016
21035,34.1,38302,34412,1386,974,8685,36692,15002,9396,5606,15002,123400,2016
21037,37.9,91456,84636,3034,1675,23253,56772,35954,24530,11424,35954,156600,2016
21039,42.4,4954,4690,92,111,1381,40913,2088,1645,443,2088,78800,2016
21041,38,10776,9597,226,724,2609,42882,4030,2455,1575,4030,104200,2016
21043,40.7,27292,26422,243,327,7522,37367,10647,8213,2434,10647,81000,2016
21045,42.6,15928,15174,106,430,4352,32315,6412,5070,1342,6412,76000,2016
21047,28.3,73936,49431,14735,5406,17519,40253,25382,11993,13389,25382,109200,2016
21049,42,35706,32308,1860,983,9814,49069,14183,9061,5122,14183,138000,2016
21051,39,21160,19602,825,455,5362,22174,7679,5560,2119,7679,54500,2016
21053,40.9,10172,9777,72,279,2584,29872,3863,2781,1082,3863,65900,2016
21055,43.3,9211,8892,117,79,2567,38739,3721,2927,794,3721,78500,2016
21057,45.2,6780,6401,223,14,1885,33268,2771,1995,776,2771,82100,2016
21059,39.1,98724,88078,4573,2706,26070,46675,39282,26747,12535,39282,119400,2016
21061,42.9,12086,11561,204,151,3474,41689,4712,3756,956,4712,86600,2016
21063,42.1,7661,7441,179,17,1850,27969,2624,2030,594,2624,70700,2016
21065,42.7,14406,14087,17,40,3959,29694,5622,3914,1708,5622,74200,2016
21067,34.1,311529,224681,44823,21322,72755,50661,126439,67730,58709,126439,170800,2016
21069,40.6,14543,13988,195,171,4075,36063,5730,4131,1599,5730,86400,2016
21071,41,38144,37141,266,275,10472,30540,15233,10662,4571,15233,69400,2016
21073,40.8,49982,41034,5080,1453,12497,50999,20978,13123,7855,20978,138800,2016
21075,43,6323,4500,1653,37,1590,26841,2611,1563,1048,2611,61600,2016
21077,37.2,8543,7813,35,437,2027,51180,2962,2051,911,2962,108700,2016
21079,42.4,17051,16063,207,385,4982,46373,6732,5184,1548,6732,129500,2016
21081,36.6,24705,23266,146,629,6118,44191,8327,5786,2541,8327,122000,2016
21083,40.3,37379,32594,1633,2217,9622,40268,14268,10446,3822,14268,94400,2016
21085,40,26092,24909,363,319,6794,36129,9736,7050,2686,9736,102700,2016
21087,44,11123,10511,249,101,3116,36681,4528,3574,954,4528,75000,2016
21089,43,36255,34952,279,373,10306,46771,14289,10975,3314,14289,99700,2016
21091,41.4,8716,8369,68,117,2524,49375,3254,2506,748,3254,105600,2016
21093,36,107573,82271,12058,5888,27424,51541,40422,25368,15054,40422,145700,2016
21095,41.2,28031,26717,667,229,7978,25350,11429,7908,3521,11429,52700,2016
21097,42.4,18629,17485,375,418,4882,40164,7135,4942,2193,7135,123700,2016
21099,40.8,18510,16987,882,317,5216,35738,7387,5345,2042,7387,83600,2016
21101,40.2,46362,40338,3282,1039,12504,41630,18914,11548,7366,18914,113500,2016
21103,41.5,15528,14262,539,507,4266,50412,5996,4092,1904,5996,122300,2016
21105,47.3,4691,4101,430,41,1162,39756,1856,1488,368,1856,68200,2016
21107,41,46359,41206,2924,851,12584,43169,18394,13190,5204,18394,92500,2016
21109,40.6,13357,13275,19,0,3978,30884,5546,4052,1494,5546,79400,2016
21111,38,759724,524730,157621,36568,185805,50099,310355,189981,120374,310355,154100,2016
21113,37.6,51015,45954,1903,1534,13985,52748,18401,11535,6866,18401,160500,2016
21115,41.6,23280,22723,103,171,6148,35060,8820,6549,2271,8820,83800,2016
21117,36.7,163393,145606,7010,4797,40510,56568,62746,41155,21591,62746,147000,2016
21119,41.3,15884,15466,152,55,4200,28165,6064,4829,1235,6064,50900,2016
21121,40.1,31740,30516,458,332,8297,26553,12333,8064,4269,12333,77000,2016
21123,40.8,14127,12971,497,443,3964,41050,5485,3916,1569,5485,111600,2016
21125,39.1,59950,57568,370,863,15831,36139,23029,15930,7099,23029,99900,2016
21127,41.1,15870,15455,71,128,4341,35016,6142,4742,1400,6142,82800,2016
21129,42.8,6896,6662,47,15,1646,21185,2821,2102,719,2821,63800,2016
21131,41.7,10869,10653,44,56,2832,25282,4074,3205,869,4074,44200,2016
21133,41.7,23382,22893,72,154,7177,29181,10017,7392,2625,10017,57300,2016
21135,40.9,13646,13367,55,96,3872,29088,5431,4034,1397,5431,63500,2016
21137,40.5,24424,23053,558,378,6681,35185,9721,7162,2559,9721,89400,2016
21139,46.5,9353,8989,19,141,2799,43333,3880,2892,988,3880,88700,2016
21141,40.6,26757,23764,1691,705,6894,39027,10682,7290,3392,10682,96500,2016
21143,49,8325,7596,460,114,2007,47861,3326,2697,629,3326,129400,2016
21145,42.4,65292,54628,7274,1508,16798,42303,27950,18604,9346,27950,127600,2016
21147,38.9,17850,16038,1003,539,4494,18972,6252,4383,1869,6252,62500,2016
21149,41.4,9492,9152,20,124,2746,43005,3751,2986,765,3751,98200,2016
21151,33.9,87324,78550,3887,1948,20152,43707,32409,19263,13146,32409,147400,2016
21153,41.2,12887,12743,4,125,3517,29463,5027,3579,1448,5027,56500,2016
21155,39.1,19497,17114,1564,480,4854,40392,7438,5429,2009,7438,99700,2016
21157,44.8,31213,30260,178,419,9136,45670,12856,10038,2818,12856,115300,2016
21159,38.1,12478,11550,616,219,2943,29052,4295,3074,1221,4295,75600,2016
21161,40.9,17229,15413,951,271,4535,38613,6804,4473,2331,6804,105600,2016
21163,37.1,28751,25690,956,1106,7816,50034,10631,7670,2961,10631,134700,2016
21165,44.1,6345,6208,4,53,1734,35280,2521,2012,509,2521,78500,2016
21167,43,21411,19587,789,533,6140,46130,8813,6220,2593,8813,134000,2016
21169,43.5,9983,9332,131,160,2750,33788,3922,3037,885,3922,77600,2016
21171,42.7,10692,10031,275,305,2972,34120,4421,3233,1188,4421,71600,2016
21173,38.9,27391,25511,802,703,7138,39750,10212,6563,3649,10212,114500,2016
21175,41.2,13379,12478,427,182,3620,32517,4946,3598,1348,4946,76900,2016
21177,41.5,31216,28801,1645,175,8067,40445,11510,9147,2363,11510,81400,2016
21179,38,44875,40673,2398,906,12394,51408,17236,13160,4076,17236,139000,2016
21181,42,7062,6790,70,127,1859,37993,2758,2023,735,2758,86200,2016
21183,40.6,24152,22762,317,683,6350,39479,8930,6915,2015,8930,85400,2016
21185,39.1,63876,56608,2567,2392,16313,86324,20148,17075,3073,20148,250500,2016
21187,41.6,10673,10142,191,272,2740,41597,3946,2919,1027,3946,97000,2016
21189,41.7,4552,4277,123,18,1192,22106,1681,1216,465,1681,66200,2016
21191,41.7,14509,14068,113,170,3865,49766,5296,4157,1139,5296,102100,2016
21193,41.1,27818,26623,385,260,7551,31578,11073,8109,2964,11073,72800,2016
21195,41.5,62791,60978,538,495,17809,32816,25861,18815,7046,25861,73100,2016
21197,38.7,12387,11955,65,177,3171,34048,4794,3310,1484,4794,80200,2016
21199,41.8,63772,60244,648,1480,16950,34673,25567,17793,7774,25567,109100,2016
21201,47.7,2191,2110,33,33,582,30964,961,753,208,961,115000,2016
21203,42.3,16893,16499,35,82,4732,33500,6488,4949,1539,6488,75100,2016
21205,31,24302,22994,321,541,5084,36216,8473,5214,3259,8473,117300,2016
21207,43.4,17684,16653,44,624,4586,31539,7081,5267,1814,7081,88600,2016
21209,36.1,51348,44773,2671,2202,14073,64329,18913,13109,5804,18913,167700,2016
21211,38.5,44967,36183,3144,3980,11900,61737,16123,11028,5095,16123,176800,2016
21213,40.1,17856,15231,1822,377,4628,42288,6958,4372,2586,6958,119700,2016
21215,40.6,17798,16828,275,337,5274,65700,6448,5431,1017,6448,186100,2016
21217,38.6,25315,22821,1138,537,6297,32977,9745,6203,3542,9745,104300,2016
21219,37.2,12465,10682,993,488,3263,41306,4534,3304,1230,4534,89700,2016
21221,45.1,14267,12588,1252,265,4207,45032,5977,4857,1120,5977,116600,2016
21223,40.9,8751,8442,0,252,2300,45935,3555,2690,865,3555,114400,2016
21225,37.7,15065,12452,1910,283,3709,41255,5565,3966,1599,5565,82100,2016
21227,32.9,121066,97247,11096,6010,29709,46929,45974,26377,19597,45974,146100,2016
21229,41,12017,10582,707,478,3055,43719,4490,3421,1069,4490,100700,2016
21231,42.1,20557,19275,463,600,5073,30260,7842,5528,2314,7842,80700,2016
21233,39.8,13331,11851,589,660,3600,38374,5136,3605,1531,5136,78700,2016
21235,36.7,35842,34461,350,398,9435,32397,12708,8697,4011,12708,79100,2016
21237,41.8,7221,7098,24,20,1912,21797,2899,1855,1044,2899,64000,2016
21239,41.9,25591,22082,1203,1686,7020,59471,9976,6918,3058,9976,182700,2016
22001,35.8,62372,48509,11162,1362,15583,39837,22655,16108,6547,22655,91600,2016
22003,38.6,25619,18206,4960,1092,5097,41801,7881,5815,2066,7881,82700,2016
22005,35,117009,81367,25485,5939,30669,71752,40663,32766,7897,40663,172300,2016
22007,39.3,22973,15170,6870,589,6131,47822,8676,6936,1740,8676,108600,2016
22009,38.1,41252,27071,12587,705,9958,34985,15016,10395,4621,15016,93000,2016
22011,37.4,36435,29088,4738,1299,9449,46599,13106,9958,3148,13106,108700,2016
22013,42.3,13924,7565,5757,246,3849,35722,5738,4102,1636,5738,78300,2016
22015,34.7,124720,84904,26615,7937,31437,51894,47505,30592,16913,47505,158400,2016
22017,36.8,253125,116429,122408,6830,60908,40815,97497,58771,38726,97497,132400,2016
22019,36.1,197233,135147,48657,5982,50641,46457,76270,51798,24472,76270,126600,2016
22021,39.7,9997,7907,1628,276,2344,29832,3635,2778,857,3635,61200,2016
22023,40.9,6739,6249,106,342,2090,65679,2653,2385,268,2653,94800,2016
22025,38.2,10145,6711,3239,130,2597,34736,3731,2777,954,3731,73700,2016
22027,41.3,16452,7541,8273,228,3794,28927,5828,3872,1956,5828,76100,2016
22029,37.4,20288,11564,8338,261,5045,28405,7579,4611,2968,7579,77800,2016
22031,39.6,27047,15620,10012,747,6900,42368,10259,7472,2787,10259,103600,2016
22033,33.3,445337,202782,202783,17240,101354,49942,168561,99384,69177,168561,173200,2016
22035,31.7,7419,1980,5277,58,1556,22093,2557,1080,1477,2557,55900,2016
22037,41.9,19756,10414,8847,292,4933,48997,6822,5557,1265,6822,137100,2016
22039,35.5,33765,22743,9247,1072,7751,30724,11871,7928,3943,11871,86600,2016
22041,38,20464,13416,6772,63,4945,32440,7520,5170,2350,7520,82100,2016
22043,37.5,22372,17144,3136,1334,4800,40389,7286,5277,2009,7286,87200,2016
22045,35.9,73799,43926,22952,2849,18769,44573,26185,18269,7916,26185,100300,2016
22047,38.4,33159,15824,16240,824,7709,46480,11162,8459,2703,11162,115500,2016
22049,39.5,15999,10685,4837,245,4239,38310,6052,4200,1852,6052,85300,2016
22051,38.8,435204,235260,112784,60284,106963,49457,169192,103928,65264,169192,173500,2016
22053,38,31399,24660,5167,679,7914,39202,11554,8216,3338,11554,97600,2016
22055,34.2,234963,156192,59653,10331,56123,52435,89288,57992,31296,89288,168300,2016
22057,36.7,97688,75336,12953,4190,25315,52071,35961,27049,8912,35961,138200,2016
22059,38.7,14927,12429,1844,379,3671,35339,5320,4044,1276,5320,69100,2016
22061,27.4,47480,25281,19169,1327,10335,34527,17144,9272,7872,17144,141300,2016
22063,35.6,135925,120650,8099,4566,34764,57334,48014,38210,9804,48014,152700,2016
22065,34.2,11803,4042,7445,228,2512,25404,4080,2184,1896,4080,62000,2016
22067,39.6,26739,13275,12872,320,6537,30279,10273,6671,3602,10273,80500,2016
22069,33.6,39258,20835,15874,824,8552,30697,14393,7968,6425,14393,105400,2016
22071,35.5,382922,117172,226915,20951,76776,37488,154844,71789,83055,154844,197000,2016
22073,34.9,156398,91518,58565,3285,37103,38974,56903,33903,23000,56903,128500,2016
22075,36.3,23584,15621,4829,1465,6297,50251,8644,6052,2592,8644,153700,2016
22077,42.7,22366,13549,7874,522,5759,44275,8802,6689,2113,8802,121400,2016
22079,37.3,132373,81460,42133,3860,32597,42132,48154,29720,18434,48154,129000,2016
22081,40,8757,5000,3271,167,2240,36831,3491,2577,914,3491,83900,2016
22083,37.8,20692,12570,7488,417,5311,35684,7581,5008,2573,7581,86900,2016
22085,40.8,24144,16494,4020,882,6112,39372,8984,6928,2056,8984,78900,2016
22087,33.2,44091,28360,9505,4268,10257,43565,14732,9879,4853,14732,133400,2016
22089,37.4,52708,34617,13790,2998,13952,61691,18586,14753,3833,18586,190200,2016
22091,38.5,10714,4762,5697,13,2678,36418,4033,3309,724,4033,89900,2016
22093,38.8,21581,10350,10743,322,5666,51386,7952,6129,1823,7952,134500,2016
22095,36.3,43888,16268,24101,2415,11394,51406,15363,11638,3725,15363,151000,2016
22097,36.4,83699,45952,34450,1603,20502,31424,30467,21178,9289,30467,95200,2016
22099,36.9,53385,34551,15569,1429,13685,46450,19268,15279,3989,19268,108900,2016
22101,38.1,53053,29913,16613,3431,12198,40771,20164,13091,7073,20164,95500,2016
22103,39.8,246269,195565,28349,12898,64957,63686,89893,69328,20565,89893,202000,2016
22105,34.7,127115,81065,37207,4975,31014,43690,46068,31228,14840,46068,143300,2016
22107,42.6,4793,2020,2666,83,1142,22385,1941,1173,768,1941,57200,2016
22109,35.4,113099,76408,21476,5477,27683,48166,39825,28885,10940,39825,139200,2016
22111,41.4,22460,15326,5724,1021,5522,37049,8194,6526,1668,8194,89500,2016
22113,36.9,59524,46812,8384,1878,15075,47083,21743,16372,5371,21743,103800,2016
22115,30.1,52101,36668,7296,4766,12638,46561,17789,9567,8222,17789,107900,2016
22117,39.4,46367,30536,13807,940,11396,31013,17487,12411,5076,17487,82100,2016
22119,40.7,40335,25185,13798,703,9833,31920,15806,11123,4683,15806,80800,2016
22121,35.5,25017,14308,9435,712,6520,53882,9253,6760,2493,9253,168600,2016
22123,39.9,11370,9094,1813,343,2958,36670,4185,3026,1159,4185,73100,2016
22125,39.6,15384,7984,6997,241,2597,53364,3879,2933,946,3879,197700,2016
22127,40.9,14695,9593,4605,273,3745,32063,5440,3537,1903,5440,71700,2016
23001,40.7,107376,98055,1666,1861,27537,48728,44747,28442,16305,44747,152100,2016
23003,46.9,69405,65658,558,736,18952,38087,29852,21522,8330,29852,95800,2016
23005,42.1,288204,262000,7614,5538,72298,61902,117871,79849,38022,117871,251300,2016
23007,45.3,30270,29015,131,384,7369,43007,11684,9332,2352,11684,132400,2016
23009,47.9,54483,51902,320,711,14724,50037,23748,17567,6181,23748,199800,2016
23011,44,120953,114931,1020,1730,31581,48570,50829,35652,15177,50829,151100,2016
23013,47.5,39717,38006,236,493,10564,52239,16813,12788,4025,16813,198100,2016
23015,50.1,34165,32816,50,352,9676,53515,15021,11699,3322,15021,209700,2016
23017,46,57299,54847,196,688,13360,42197,20723,16598,4125,20723,132900,2016
23019,41.6,152978,144082,1136,1895,38266,45302,61787,42271,19516,61787,137000,2016
23021,50,17044,16284,70,210,4683,36938,7572,5626,1946,7572,106800,2016
23023,45.8,35134,33332,238,518,9814,55766,15613,11920,3693,15613,194600,2016
23025,45.4,51363,49360,232,507,13792,40484,21376,16351,5025,21376,107100,2016
23027,45.4,39071,37486,198,446,10646,45480,16820,13039,3781,16820,158400,2016
23029,47.3,31925,28801,123,581,8812,39469,14065,10693,3372,14065,107400,2016
23031,44.4,200536,190031,1684,3122,53557,59132,82588,60617,21971,82588,229600,2016
24001,41.6,73060,63922,5889,1233,17157,41559,28167,19268,8899,28167,118800,2016
24003,38.3,559737,393514,87090,39402,142363,91918,204829,151331,53498,204829,338500,2016
24005,39.1,825666,491772,223862,40850,203891,68989,312826,205922,106904,312826,246900,2016
24009,40.7,90527,71639,10972,3092,23705,96808,31479,25783,5696,31479,344300,2016
24011,40,32653,25071,4374,2101,8619,50830,12010,8472,3538,12010,192600,2016
24013,42.4,167535,151109,5399,5096,44606,87060,60449,49112,11337,60449,324300,2016
24015,40.2,102175,87900,6607,4087,26123,67938,36993,26935,10058,36993,239900,2016
24017,37.9,154357,68377,65188,7939,39377,91373,54105,41874,12231,54105,287600,2016
24019,44.2,32451,20869,8937,1516,8773,47907,13206,8628,4578,13206,188100,2016
24021,39.2,243465,183905,21390,20485,64219,85715,88995,65946,23049,88995,306100,2016
24023,44.8,29677,28718,187,301,8177,46277,11644,9025,2619,11644,169400,2016
24025,40.3,249776,193351,32624,10208,66516,81052,92497,72265,20232,92497,278100,2016
24027,38.7,308447,170445,55373,19595,82123,113800,109872,80655,29217,109872,434700,2016
24029,46.5,19819,15490,2933,870,4654,55028,7683,5329,2354,7683,238800,2016
24031,38.6,1026371,471476,177896,190550,256128,100352,367764,241201,126563,367764,460100,2016
24033,36.1,897693,122505,562034,150268,202160,75925,306711,189084,117627,306711,261400,2016
24035,43.8,48712,42329,3510,1668,13162,85891,17785,14383,3402,17785,343900,2016
24037,36.3,110675,83555,15383,5136,27876,86810,38978,28033,10945,38978,295900,2016
24039,37,25899,13358,10749,937,5147,35886,8328,5366,2962,8328,131800,2016
24041,49.4,37668,29369,4104,2298,11001,61395,16481,11454,5027,16481,320500,2016
24043,40.7,149571,121197,14690,6283,37610,56316,56094,36204,19890,56094,198900,2016
24045,35.7,101527,65431,24798,4968,24539,53508,37170,22888,14282,37170,173100,2016
24047,49.4,51441,41177,6998,1726,13421,57227,21010,15776,5234,21010,243600,2016
24510,34.7,621000,171911,387631,29537,124615,44262,242416,112849,129567,242416,153000,2016
25001,51.8,214703,194526,5479,5661,58419,65382,94351,74679,19672,94351,367200,2016
25003,46.1,128563,115083,3210,5220,32850,52253,54854,37504,17350,54854,204200,2016
25005,40.7,554868,464617,18788,38919,139756,59343,212933,132218,80715,212933,273700,2016
25007,46.5,17137,14897,604,286,3791,63534,6134,4695,1439,6134,656000,2016
25009,40.7,769362,560502,23197,144843,192613,70886,288291,182306,105985,288291,362200,2016
25011,45.4,70916,64844,740,2599,17991,56347,30389,20860,9529,30389,224200,2016
25013,38.6,468072,303211,36337,109127,115047,51005,177153,109090,68063,177153,196500,2016
25015,36,161035,136253,4321,8460,33972,62608,58448,38672,19776,58448,270100,2016
25017,38.5,1567610,1161178,73972,117082,380358,89019,587735,366548,221187,587735,432300,2016
25019,39.1,10694,8015,711,1268,2301,89428,3836,2451,1385,3836,966600,2016
25021,41,691218,535390,42275,27586,171505,90226,260061,178170,81891,260061,414000,2016
25023,42.4,506657,418833,44024,18014,129695,77627,182252,138410,43842,182252,333600,2016
25025,32.4,767719,353628,154542,167446,148626,57439,299658,107263,192395,299658,398000,2016
25027,39.9,813589,639034,34982,85228,200270,67005,302794,195877,106917,302794,254100,2016
26001,57.4,10461,10057,26,145,3119,38160,4973,4397,576,4973,97500,2016
26003,49,9396,7941,688,127,2218,41270,3433,2967,466,3433,118500,2016
26005,40,113666,101100,1503,8049,30797,55630,42097,34161,7936,42097,144600,2016
26007,47.3,28929,27807,147,375,7981,39832,12670,9742,2928,12670,92700,2016
26009,50,23215,22096,75,454,6875,48825,9841,8268,1573,9841,145100,2016
26011,48.9,15327,14566,76,291,4294,39240,6514,5411,1103,6514,88400,2016
26013,43.1,8612,6299,1552,122,1812,42810,2962,2495,467,2962,90900,2016
26015,42.6,59316,56251,282,1528,16311,56883,22858,18557,4301,22858,139300,2016
26017,42.7,106107,96048,1436,5350,27823,45851,43714,34047,9667,43714,94500,2016
26019,48.6,17462,16437,75,397,4673,48694,7169,6198,971,7169,158100,2016
26021,41.7,155134,116825,22783,7833,40796,45980,62282,43542,18740,62282,137000,2016
26023,40.8,43603,39743,966,1890,10918,46428,16118,12381,3737,16118,95200,2016
26025,40,134691,105967,14273,6509,33814,44681,53089,36955,16134,53089,99400,2016
26027,44.6,51795,44886,2464,1800,13998,47991,20246,16417,3829,20246,128200,2016
26029,47.3,26172,24622,84,451,7187,48603,11043,8854,2189,11043,155100,2016
26031,49.6,25579,23601,186,324,7448,41023,11185,9148,2037,11185,113300,2016
26033,39.8,38330,27001,2502,639,8586,42287,13905,9599,4306,13905,109700,2016
26035,46.5,30608,29104,131,570,8332,34911,12918,10582,2336,12918,83300,2016
26037,40.4,77245,69794,1154,3363,20355,62646,28919,23083,5836,28919,160000,2016
26039,49.7,13840,13183,70,244,3940,41034,6064,4843,1221,6064,93500,2016
26041,46.6,36570,34180,89,417,10035,42353,15816,12392,3424,15816,103900,2016
26043,46.5,25889,24802,140,346,7368,43373,11175,8882,2293,11175,88100,2016
26045,41,108544,90816,6603,5601,28407,56472,43908,31195,12713,43908,137300,2016
26047,44.8,33091,30257,205,506,9223,51096,14144,10544,3600,14144,166100,2016
26049,39.9,413090,299437,82931,13426,106975,43246,166244,115243,51001,166244,91800,2016
26051,49.1,25367,24442,88,354,7063,39629,10838,9082,1756,10838,95700,2016
26053,48.5,15650,14052,695,188,3882,35833,6636,5176,1460,6636,69800,2016
26055,42.5,90715,84069,1120,2378,22926,55597,35708,27332,8376,35708,173900,2016
26057,39.2,41676,36194,2292,2348,9827,42145,14721,10836,3885,14721,89000,2016
26059,41.9,46024,43844,264,975,11876,44458,17775,13710,4065,17775,99400,2016
26061,33,36565,33820,271,529,7719,39080,13378,9293,4085,13378,96100,2016
26063,48.3,32021,30600,125,698,9072,43082,13885,11280,2605,13885,93000,2016
26065,31.6,284559,201920,30716,21480,60936,46842,111118,64169,46949,111118,119100,2016
26067,38.2,64126,56666,2255,2974,15738,50037,22293,17244,5049,22293,113100,2016
26069,52.1,25373,23969,172,498,7069,38900,11483,9131,2352,11483,85500,2016
26071,53.5,11393,10850,53,190,2965,33137,5401,4458,943,5401,74800,2016
26073,27,70574,60757,1729,2613,13772,40706,24712,15061,9651,24712,127100,2016
26075,40.8,159483,135666,13466,5307,40218,47709,60803,44020,16783,60803,115700,2016
26077,34.1,258605,202746,27358,11859,60594,49693,101589,64827,36762,101589,140900,2016
26079,44.6,17259,16383,117,293,4576,42612,7031,5752,1279,7031,100200,2016
26081,34.9,629352,470602,58390,63915,155307,54673,234570,161125,73445,234570,144300,2016
26083,55.1,2195,2144,14,24,633,41472,1023,905,118,1023,98800,2016
26085,51.8,11415,9741,827,292,2650,30824,4394,3646,748,4394,79100,2016
26087,43.5,88310,81456,1091,3982,24151,54174,32757,26929,5828,32757,141200,2016
26089,53.3,21764,19680,109,872,6223,59018,8984,7727,1257,8984,243500,2016
26091,41.2,98673,85991,2486,7567,25028,49300,37856,29398,8458,37856,119400,2016
26093,42.5,185841,176100,921,4094,51502,76764,69763,59228,10535,69763,204000,2016
26095,44.5,6451,5067,449,182,1453,38167,2316,1743,573,2316,80300,2016
26097,51.7,10998,8151,237,167,3152,40747,5230,3834,1396,5230,124100,2016
26099,40.9,859703,695078,90785,21027,223985,55951,338893,247442,91451,338893,134800,2016
26101,48.5,24465,21914,634,680,6224,42530,9977,8146,1831,9977,109800,2016
26103,38.9,67418,62332,1053,941,15799,46822,26293,18429,7864,26293,137700,2016
26105,45.8,28755,26407,246,1257,8039,43497,12171,9243,2928,12171,123200,2016
26107,35.8,43259,39622,1122,895,9433,41827,15528,11345,4183,15528,111300,2016
26109,47.8,23568,22051,65,383,6368,41235,10586,8324,2262,10586,93700,2016
26111,41.3,83559,76720,1203,2090,22909,54852,33757,25214,8543,33757,131100,2016
26113,43.2,15032,14240,80,380,4032,42077,5843,4832,1011,5843,103900,2016
26115,41.9,149945,137728,3474,5049,40144,56968,58516,46588,11928,58516,141500,2016
26117,40.4,62922,57898,1228,2095,15992,43126,23057,18057,5000,23057,96500,2016
26119,55,9317,8969,23,116,2563,37145,4122,3496,626,4122,95100,2016
26121,39,172148,132051,23347,9173,43732,43920,64914,48072,16842,64914,101400,2016
26123,42.7,47957,43505,632,2747,12662,44049,18394,15295,3099,18394,101200,2016
26125,40.9,1235215,904354,169220,46483,321873,69850,496727,348976,147751,496727,191500,2016
26127,42.6,26152,21572,296,3771,7247,41952,10043,8029,2014,10043,104800,2016
26129,49.5,21103,20123,64,395,6064,36941,9318,7690,1628,9318,88600,2016
26131,56.6,6165,5887,17,74,1697,35038,2969,2601,368,2969,69500,2016
26133,43.1,23172,22024,216,387,5998,39247,8847,6988,1859,8847,89400,2016
26135,51.6,8374,8027,49,110,2288,35175,3662,3115,547,3662,80700,2016
26137,44.6,24198,22952,105,381,6815,50793,9809,7936,1873,9809,121600,2016
26139,34.7,276583,234003,3700,25658,71677,61367,97687,75408,22279,97687,160500,2016
26141,53.9,12955,12463,67,145,3901,41570,5911,5208,703,5911,94000,2016
26143,54.9,23900,22803,47,364,6994,35959,11344,9165,2179,11344,92400,2016
26145,40.4,195201,136263,35471,16003,49188,43712,77928,56220,21708,77928,92800,2016
26147,42.9,160069,146482,3387,5058,43108,50930,64529,48786,15743,64529,126900,2016
26149,39.3,60923,53032,1532,4456,16046,45410,23198,17027,6171,23198,109700,2016
26151,44.6,41761,39336,208,1520,11058,42037,16881,13351,3530,16881,98500,2016
26153,50.4,8186,7056,48,72,2078,36649,3318,2677,641,3318,98700,2016
26155,41.7,68800,64994,293,1899,19132,48470,27480,20844,6636,27480,105500,2016
26157,43.8,54014,50648,627,1714,14898,44193,21459,17595,3864,21459,95200,2016
26159,41.4,75216,61508,2425,8282,19359,47141,28623,22192,6431,28623,121400,2016
26161,33.4,358082,253885,42485,15908,80101,62484,138672,82693,55979,138672,218100,2016
26163,37.8,1767593,878264,691963,99752,416334,42043,669412,415477,253935,669412,86000,2016
26165,41.9,32829,31155,195,580,8838,40417,12975,9781,3194,12975,92400,2016
27001,53.6,15722,14798,58,186,4992,44524,7640,6313,1327,7640,165300,2016
27003,37.9,341249,284385,17374,13847,90305,73579,125260,100028,25232,125260,193200,2016
27005,42.2,33375,28956,152,587,9155,54115,13495,10662,2833,13495,177600,2016
27007,33.4,45644,33257,383,945,10736,45201,16906,11647,5259,16906,148600,2016
27009,35.8,39457,36337,1046,791,10318,51841,15726,10860,4866,15726,158400,2016
27011,49.2,5098,4986,9,64,1441,47132,2226,1753,473,2226,96900,2016
27013,30.5,65524,58539,2110,2016,14383,52119,25081,15791,9290,25081,166200,2016
27015,43.3,25327,23877,57,987,6798,53319,10641,8389,2252,10641,132300,2016
27017,41.1,35482,31353,525,590,8809,55607,13289,10491,2798,13289,160900,2016
27019,37.1,97143,87319,1318,3927,26142,88638,34990,27913,7077,34990,277600,2016
27021,48.4,28633,23956,93,521,8918,47926,12806,10334,2472,12806,174000,2016
27023,43.1,12126,10833,61,730,3259,54041,4997,3561,1436,4997,102400,2016
27025,40.7,54041,50845,664,1044,14193,72908,19790,16832,2958,19790,195600,2016
27027,32.6,61402,54717,1237,2583,14899,59614,23034,16078,6956,23034,166600,2016
27029,42.6,8764,7478,29,150,2260,44203,3435,2702,733,3435,116500,2016
27031,51.8,5215,4497,15,98,1653,51793,2661,1968,693,2661,242200,2016
27033,43.2,11557,10136,63,786,3094,47407,4822,3778,1044,4822,88800,2016
27035,43.8,63321,60348,389,860,17657,50893,26398,19841,6557,26398,181800,2016
27037,37.6,411402,330497,21702,27048,109336,77321,157696,117132,40564,157696,226900,2016
27039,37.8,20361,18876,67,988,5587,68718,7583,6299,1284,7583,162000,2016
27041,44.4,36862,35503,200,532,10285,56347,15688,12080,3608,15688,189900,2016
27043,46.9,14119,12974,28,877,4046,49101,6347,4837,1510,6347,85400,2016
27045,43,20877,20263,85,266,5798,54358,8540,6737,1803,8540,143700,2016
27047,44.4,30751,26684,400,2880,8342,48827,13046,9858,3188,13046,106600,2016
27049,43.3,46450,43032,562,1446,12777,60452,19051,14409,4642,19051,185800,2016
27051,45.9,5943,5696,2,113,1749,53828,2547,2040,507,2547,100800,2016
27053,36.2,1209265,847424,148315,82312,284568,67989,493832,307266,186566,493832,235800,2016
27055,45.4,18791,18134,86,172,5401,55550,7989,6455,1534,7989,162300,2016
27057,48.3,20640,19251,127,384,6134,49742,8741,7129,1612,8741,177800,2016
27059,39.5,38461,36323,219,683,9989,62733,14403,11706,2697,14403,166900,2016
27061,45.9,45356,41818,213,568,12957,49507,19126,15337,3789,19126,155400,2016
27063,43.4,10163,9482,23,333,2913,55114,4335,3362,973,4335,115100,2016
27065,44.3,15918,15179,54,246,4299,48042,6290,5072,1218,6290,136600,2016
27067,39.6,42510,35171,1517,4993,11532,53514,16737,12152,4585,16737,164300,2016
27069,48,4436,4270,27,86,1183,51484,1913,1561,352,1913,72400,2016
27071,48.2,12930,12091,119,25,3654,44929,5732,4545,1187,5732,105500,2016
27073,50,6916,6617,70,145,2013,49210,3111,2496,615,3111,81000,2016
27075,50.4,10721,10289,96,149,3285,52320,5207,4198,1009,5207,164700,2016
27077,50.8,3901,3666,4,48,973,45732,1551,1309,242,1551,122400,2016
27079,41.5,27650,25380,190,1553,7528,62462,10805,8777,2028,10805,182000,2016
27081,46.3,5793,5617,13,93,1580,49438,2477,1964,513,2477,89600,2016
27083,35.4,25670,22113,760,1586,6420,51920,10072,6818,3254,10072,134500,2016
27085,40.4,35926,33084,55,1982,9893,57738,14780,11387,3393,14780,148400,2016
27087,36.1,5480,2552,19,188,1341,41597,1977,1418,559,1977,96800,2016
27089,43.6,9406,8829,21,385,2667,56340,3991,3238,753,3991,99100,2016
27091,45.2,20193,18954,46,802,5605,51984,8777,6536,2241,8777,108500,2016
27093,42.1,23094,21874,92,805,6280,58574,9119,7255,1864,9119,157600,2016
27095,40.6,25788,23129,126,528,6743,51232,10012,7418,2594,10012,143500,2016
27097,41.5,32850,31597,196,491,8999,51456,13275,10474,2801,13275,155600,2016
27099,39.5,39248,31984,1327,4293,10031,51778,15414,11216,4198,15414,114100,2016
27101,47.6,8463,7954,35,285,2375,51801,3715,2998,717,3715,105000,2016
27103,35.8,33226,29928,951,1384,8433,61501,12559,9142,3417,12559,174200,2016
27105,35.8,21729,13306,907,5661,5493,53269,7890,5594,2296,7890,113100,2016
27107,44.9,6638,5967,50,320,1810,52083,2696,2193,503,2696,86000,2016
27109,36.8,150104,122628,7867,6957,39084,69308,58692,43310,15382,58692,178000,2016
27111,46.8,57694,53879,729,1791,16142,53351,23962,18847,5115,23962,168900,2016
27113,39.6,14156,12913,214,479,3561,51156,5923,4334,1589,5923,123300,2016
27115,44,29067,26046,577,803,7008,45379,10993,8548,2445,10993,144800,2016
27117,42.4,9285,8386,114,491,2633,48944,3998,3036,962,3998,92400,2016
27119,38.5,31550,27939,438,1880,7962,53059,12608,9191,3417,12608,145100,2016
27121,46.4,10975,10609,49,130,3156,55180,4815,3862,953,4815,153000,2016
27123,34.6,531528,339924,58160,38985,121263,57717,207327,122386,84941,207327,199200,2016
27125,42.1,4042,3753,20,129,1057,49800,1676,1350,326,1676,103700,2016
27127,43.5,15578,13659,99,451,3995,48891,6262,4965,1297,6262,96900,2016
27129,44.8,14995,13410,45,1146,4015,54824,6188,4901,1287,6188,99300,2016
27131,36.5,65116,54730,2694,5059,15531,61683,22654,16795,5859,22654,184400,2016
27133,41.6,9554,9031,75,246,2663,52835,3932,2912,1020,3932,131700,2016
27135,41.1,15609,14479,112,166,4176,54827,6106,4856,1250,6106,115700,2016
27137,41.1,200353,183515,3003,2943,49347,49395,85059,60174,24885,85059,143200,2016
27139,35.7,139490,115599,4055,6617,36352,90198,47154,39103,8051,47154,258400,2016
27141,35.5,91188,84129,1885,2233,23597,78081,30781,25454,5327,30781,193300,2016
27143,41.7,14957,13390,70,1237,4117,59596,6009,4698,1311,6009,134300,2016
27145,34.1,153661,136076,6868,4745,37075,56977,57695,39719,17976,57695,168200,2016
27147,39.5,36541,32026,1047,2636,9686,58141,14354,10916,3438,14354,149700,2016
27149,32.9,9762,8760,65,447,2168,55941,3567,2411,1156,3567,146400,2016
27151,44.2,9483,8819,160,407,2660,49956,4177,2963,1214,4177,97100,2016
27153,43.1,24335,22368,64,1299,6571,47549,9866,8043,1823,9866,132100,2016
27155,49.1,3397,3091,15,77,981,50333,1544,1267,277,1544,72800,2016
27157,43.9,21327,20245,32,613,6202,58865,9004,7232,1772,9004,160900,2016
27159,43,13755,13057,109,236,3483,42689,5657,4254,1403,5657,113400,2016
27161,39.4,19034,17024,492,1079,4992,53199,7329,5595,1734,7329,142800,2016
27163,39,248745,209476,9683,9493,66293,86689,91282,73415,17867,91282,253300,2016
27165,39.7,10996,8225,70,2489,2853,50068,4465,3295,1170,4465,94900,2016
27167,44.1,6479,6111,47,82,1826,52963,2871,2202,669,2871,110800,2016
27169,34,51145,46899,754,1400,11491,52840,19078,13440,5638,19078,156500,2016
27171,35.8,129922,120966,1480,3502,34931,75705,45887,37520,8367,45887,201500,2016
27173,43,10038,9097,24,416,2858,54717,4174,3268,906,4174,98100,2016
28001,40.4,31747,11891,16933,2538,7550,31283,11586,7371,4215,11586,89400,2016
28003,39.7,37309,31071,4282,1154,10065,38892,14776,10058,4718,14776,86500,2016
28005,46.1,12692,7280,5332,35,2915,27334,4957,4208,749,4957,73100,2016
28007,40.6,19085,10428,7990,371,5052,33018,7268,5275,1993,7268,74700,2016
28009,42.1,8378,5042,3098,190,2233,36302,3126,2621,505,3126,73300,2016
28011,34.9,33615,10865,21606,703,7966,27457,12598,6717,5881,12598,86100,2016
28013,40.5,14724,9629,3999,814,3878,31141,5820,4207,1613,5820,67400,2016
28015,45.2,10301,6648,3442,52,2824,40278,3674,3057,617,3674,89900,2016
28017,37.1,17357,8873,7533,728,4326,31048,6398,4725,1673,6398,60000,2016
28019,43,8320,5621,2612,22,2046,32953,3184,2345,839,3184,77400,2016
28021,33,9209,1162,7822,122,2070,25000,3134,2157,977,3134,56200,2016
28023,42,16203,10312,5627,163,4566,36441,6598,5430,1168,6598,68200,2016
28025,38.6,20147,7923,11721,257,5439,33142,7781,5337,2444,7781,81600,2016
28027,33.9,24804,5446,19126,51,6002,28217,9084,4775,4309,9084,62500,2016
28029,38,28780,12889,14774,831,6929,34738,9851,7610,2241,9851,88800,2016
28031,38.2,19503,11936,7239,145,4781,31684,6950,5709,1241,6950,72300,2016
28033,36.2,170890,115200,42198,8109,44727,60111,60575,44174,16401,60575,155000,2016
28035,32,76274,43788,28045,2344,17654,37017,28022,15291,12731,28022,111300,2016
28037,42.5,7818,4941,2792,81,2252,40081,3096,2323,773,3096,74400,2016
28039,36.8,23313,20503,1630,545,5486,47313,7410,6366,1044,7410,97700,2016
28041,37.4,13941,10004,3557,146,2849,40069,4164,3466,698,4164,88300,2016
28043,40.3,21518,11909,9407,26,4987,33026,7508,5324,2184,7508,94900,2016
28045,41.8,46028,39207,4378,1694,12690,46542,18782,13670,5112,18782,129900,2016
28047,35.7,198570,128944,46926,10569,50289,43095,76660,42925,33735,76660,138400,2016
28049,34,244596,62951,173790,3716,57861,38773,89335,52901,36434,89335,107300,2016
28051,33.8,18547,2920,15393,58,4207,20800,6314,3926,2388,6314,51800,2016
28053,35.6,8822,1895,6664,237,1915,23442,3058,1732,1326,3058,61500,2016
28055,42.3,1352,530,814,8,336,24306,478,255,223,478,57400,2016
28057,40,23511,21366,1544,338,6197,35380,8858,6686,2172,8858,84400,2016
28059,38,140850,96710,30016,7756,33764,49158,50365,35356,15009,50365,120800,2016
28061,41.6,16538,7541,8859,54,5130,34993,6771,5647,1124,6771,65500,2016
28063,36.3,7528,993,6488,10,1524,23773,2457,1444,1013,2457,59900,2016
28065,43.1,11771,4501,7209,40,3043,26429,4903,3787,1116,4903,81400,2016
28067,36.8,68313,44406,19807,2891,17420,37846,24870,18139,6731,24870,85400,2016
28069,41.1,10128,3445,6106,151,2164,29925,3552,2788,764,3552,63400,2016
28071,29.2,52193,36825,12473,1232,10626,43162,18788,10914,7874,18788,163500,2016
28073,34.3,59623,44600,11863,1468,15767,53888,21800,14554,7246,21800,169500,2016
28075,37.4,79233,42156,33661,1709,19418,38399,29689,19162,10527,29689,87800,2016
28077,40.1,12603,8249,4154,81,3510,38155,4859,3847,1012,4859,90100,2016
28079,35.5,23011,10985,9561,987,5767,32657,8259,6106,2153,8259,78200,2016
28081,36.9,85281,56962,24170,2062,22339,43224,32591,22030,10561,32591,120400,2016
28083,32.8,30500,7138,22191,761,6484,25356,10671,5399,5272,10671,73600,2016
28085,38.1,34691,23316,10688,349,9380,36250,12936,9604,3332,12936,91400,2016
28087,36.9,59785,31395,26017,1145,15470,41219,22821,13969,8852,22821,118800,2016
28089,37.1,101791,56854,38790,2806,27091,65924,37415,26732,10683,37415,208800,2016
28091,39.8,25810,16797,8305,362,6924,30914,9659,7380,2279,9659,76400,2016
28093,39.5,36196,17322,17294,1242,9317,40598,13213,10109,3104,13213,93100,2016
28095,40.9,36029,24190,10974,386,9665,37345,13949,10562,3387,13949,82000,2016
28097,42.3,10353,5413,4632,151,2860,31207,4351,3360,991,4351,76400,2016
28099,36,29474,17423,6260,556,7437,35991,10777,7813,2964,10777,79700,2016
28101,37.8,21652,13425,6568,374,5800,35527,7984,6135,1849,7984,80400,2016
28103,36.1,11098,2923,7682,439,2860,31472,4012,2847,1165,4012,67700,2016
28105,25.2,49424,28167,18243,804,8969,33431,17109,8912,8197,17109,148900,2016
28107,36.5,34319,16306,17198,555,8261,37556,12184,8920,3264,12184,75300,2016
28109,40.9,55167,45259,7150,1619,14324,41598,20494,15743,4751,20494,120300,2016
28111,40.8,12174,9447,2436,156,3023,34774,4431,3625,806,4431,76700,2016
28113,36.9,39939,17727,21076,570,9494,31511,14717,10023,4694,14717,87600,2016
28115,37.3,30862,23877,4641,1886,7668,39869,10801,7887,2914,10801,87800,2016
28117,39.5,25339,21107,3394,328,6716,33509,9572,6879,2693,9572,82200,2016
28119,39,7634,2121,5379,89,1880,24835,3047,2025,1022,3047,52700,2016
28121,37.1,147930,111218,29330,3765,39572,59370,54377,40410,13967,54377,157000,2016
28123,36.1,28268,14153,10630,3039,6838,32615,9848,7112,2736,9848,69600,2016
28125,38.7,4662,1189,3430,18,1189,28878,1804,1043,761,1804,52600,2016
28127,37.9,27279,16812,9659,483,6686,37285,9418,7476,1942,9418,84100,2016
28129,40.6,16137,12037,4005,43,4259,33696,5895,4545,1350,5895,77800,2016
28131,37.6,17995,13851,3501,315,4471,44995,5805,4502,1303,5805,112900,2016
28133,34.5,27424,6705,20157,434,5739,27126,8507,4818,3689,8507,71100,2016
28135,35.2,14776,5290,6882,2243,2639,29837,4313,3270,1043,4313,61500,2016
28137,36.7,28338,18414,8663,698,7234,43883,9919,7366,2553,9919,110000,2016
28139,38.7,22061,17098,3645,1050,6155,37109,8400,6343,2057,8400,82700,2016
28141,42.7,19503,18251,470,536,5573,35364,7768,5827,1941,7768,79300,2016
28143,32.4,10407,2057,8050,179,2654,31918,3999,1579,2420,3999,87500,2016
28145,38,27989,22048,4030,1220,7192,37898,10298,7382,2916,10298,86700,2016
28147,40.3,14812,7808,6764,77,3578,30571,5879,5026,853,5879,93300,2016
28149,38,47834,22970,23123,1002,12334,40475,18476,11660,6816,18476,109500,2016
28151,36.4,48824,12612,34930,670,11789,28452,18148,10099,8049,18148,73000,2016
28153,36.9,20517,11956,8082,297,5462,34458,7496,6121,1375,7496,74000,2016
28155,40.1,9922,7743,1903,137,2895,37083,3950,2869,1081,3950,79900,2016
28157,36.8,9233,2584,6566,32,1836,25846,2877,2317,560,2877,61900,2016
28159,40.8,18519,9357,8850,211,5403,32820,7634,5188,2446,7634,80400,2016
28161,42.1,12380,7230,4876,182,3391,34749,5146,3830,1316,5146,72300,2016
28163,35.6,27719,9989,16282,1007,5782,27560,8754,5277,3477,8754,72100,2016
29001,27.7,25547,23191,565,631,5126,37967,9462,5587,3875,9462,112100,2016
29003,42,17347,16493,154,385,4985,54804,6837,5269,1568,6837,131800,2016
29005,47.7,5380,5205,27,66,1447,43438,2494,1729,765,2494,81700,2016
29007,40.1,25868,22568,1532,743,5925,41930,9255,6345,2910,9255,93400,2016
29009,43.3,35716,31068,62,3078,9349,37869,13248,9919,3329,13248,112900,2016
29011,40.8,12075,11226,28,285,3419,38877,4910,3359,1551,4910,94900,2016
29013,41.2,16513,15650,165,332,4400,41520,6617,4675,1942,6617,107500,2016
29015,52.9,18825,17940,70,340,5411,33428,8128,6632,1496,8128,110000,2016
29017,43.5,12282,11878,35,129,3289,39493,4805,3890,915,4805,94400,2016
29019,30.3,172773,137969,14159,5494,38617,50813,67833,37049,30784,67833,171400,2016
29021,36.9,89415,75429,4459,5457,20708,46680,33330,20994,12336,33330,112400,2016
29023,40.2,42887,38271,2268,821,11068,36302,16616,10626,5990,16616,97200,2016
29025,42.8,9057,8598,70,180,2499,44722,3738,2800,938,3738,99100,2016
29027,37.8,44693,40360,1690,877,10482,50362,16018,11541,4477,16018,124900,2016
29029,50.1,44152,41765,301,1147,11697,46747,16389,12723,3666,16389,171700,2016
29031,36.2,78089,67698,5953,1764,18840,48458,29831,19320,10511,29831,147400,2016
29033,42.8,9009,8562,82,127,2479,41537,3703,2756,947,3703,79900,2016
29035,40.6,6249,5906,5,138,1524,37162,2480,1738,742,2480,95600,2016
29037,39.4,101324,89920,3546,4200,27971,63613,38045,28619,9426,38045,161000,2016
29039,44.4,13932,13256,7,263,3671,33720,5886,4017,1869,5886,87800,2016
29041,45.4,7615,7275,170,61,1885,41773,2905,2224,681,2905,80200,2016
29043,37.5,82053,76946,482,2268,22769,54392,30093,22045,8048,30093,148000,2016
29045,43.7,6860,6671,19,18,1923,45169,2837,2137,700,2837,85900,2016
29047,36.8,233135,192205,13137,15082,59439,63702,88389,61755,26634,88389,156600,2016
29049,40.9,20494,19242,351,395,5928,57486,8118,5992,2126,8118,138400,2016
29051,37.9,76603,62545,8730,2076,19082,54130,29658,20123,9535,29658,150700,2016
29053,38.8,17613,15607,1108,281,4223,44917,6550,4626,1924,6550,122900,2016
29055,41.6,24545,23513,53,442,6175,36983,9290,6721,2569,9290,116500,2016
29057,46.9,7590,7146,27,144,2121,37904,3099,2401,698,3099,80300,2016
29059,43.3,16508,15590,14,315,4565,37695,6150,4487,1663,6150,101300,2016
29061,40.8,8257,7957,95,118,2042,43669,3040,2375,665,3040,97700,2016
29063,40.4,12706,10344,1298,491,2491,43538,3774,2378,1396,3774,104600,2016
29065,43.1,15578,14800,87,235,3897,38020,5889,4206,1683,5889,100300,2016
29067,47.4,13467,13171,12,171,3595,31333,5110,3969,1141,5110,99900,2016
29069,39.6,31271,25496,3017,1930,8069,31220,12680,7949,4731,12680,68500,2016
29071,40.6,102063,97368,967,1672,28194,50895,40197,29301,10896,40197,152700,2016
29073,45.7,14875,14357,71,190,4201,45505,6168,4602,1566,6168,126600,2016
29075,41.8,6745,6532,71,73,1808,44024,2677,1980,697,2677,84800,2016
29077,35.7,285449,252632,9181,9664,69549,41908,119141,69465,49676,119141,133700,2016
29079,40.8,10231,9713,55,202,2623,40187,4056,2786,1270,4056,83300,2016
29081,42.5,8649,8277,70,176,2372,41173,3586,2553,1033,3586,73900,2016
29083,43.8,21930,20634,321,470,6071,42707,9420,7060,2360,9420,88600,2016
29085,54.2,9267,8852,14,129,2676,33113,3962,3203,759,3962,89800,2016
29087,47.8,4537,4379,18,9,1388,41017,2109,1469,640,2109,90200,2016
29089,38.9,10148,9215,528,139,2472,45762,3760,2847,913,3760,107600,2016
29091,40.5,40265,38136,123,788,11023,33964,16214,11276,4938,16214,103500,2016
29093,44.1,10220,9648,194,176,2682,36354,4050,2814,1236,4050,81800,2016
29095,36.5,683643,428412,160868,59377,162972,48104,276857,161850,115007,276857,127400,2016
29097,35.8,117376,99716,2431,8871,29920,42648,45731,29460,16271,45731,108900,2016
29099,38.8,222453,210839,2143,3954,60784,58232,82308,66206,16102,82308,152300,2016
29101,29.8,54229,46880,2409,2114,13109,48977,19934,11844,8090,19934,142800,2016
29103,43.6,3997,3857,14,39,1121,38816,1653,1261,392,1653,72200,2016
29105,40.1,35505,33380,168,798,9741,40436,13740,9341,4399,13740,105500,2016
29107,42.1,32789,30260,655,869,9394,50830,13301,9855,3446,13301,118000,2016
29109,39.6,38204,34352,190,2676,10138,40505,14574,10512,4062,14574,99000,2016
29111,39.3,10146,9416,294,173,2434,45708,3807,2758,1049,3807,81900,2016
29113,36.7,54286,50751,941,1217,13495,55249,18415,14082,4333,18415,146200,2016
29115,42.8,12319,11728,41,239,3244,39286,4936,3625,1311,4936,75700,2016
29117,41.5,15057,14050,421,229,3792,44266,5737,3890,1847,5737,106800,2016
29119,37.2,22720,17881,421,2597,6006,38846,8294,5969,2325,8294,90200,2016
29121,42.9,15399,14494,334,183,3704,37099,6097,4501,1596,6097,87300,2016
29123,42.9,12403,11779,177,104,3252,36359,4685,3493,1192,4685,95800,2016
29125,43.9,8987,8635,44,170,2434,40542,3642,2703,939,3642,116600,2016
29127,39.4,28858,26085,1303,451,7348,43828,11286,7369,3917,11286,107700,2016
29129,43.9,3702,3567,17,47,955,41817,1425,1064,361,1425,82100,2016
29131,41.4,25011,23805,134,437,6287,40057,9408,7121,2287,9408,119100,2016
29133,38.5,14112,10174,3326,268,3493,29214,5125,3018,2107,5125,71600,2016
29135,38,15840,14221,533,707,3874,48974,5492,4061,1431,5492,116400,2016
29137,45.1,8642,8086,247,124,2323,41201,3524,2584,940,3524,98300,2016
29139,44,11820,11190,166,196,3204,41096,4876,3545,1331,4876,104400,2016
29141,46.3,20182,19102,188,412,4901,32807,7883,5912,1971,7883,111900,2016
29143,40.9,18229,14637,2872,297,4923,31615,7305,4422,2883,7305,74100,2016
29145,39.6,58741,50978,521,2926,15423,44474,22023,15575,6448,22023,112500,2016
29147,28.7,23026,21405,619,349,4955,39908,8465,4703,3762,8465,121600,2016
29149,46.5,10922,10315,19,173,2779,30442,4339,3331,1008,4339,77800,2016
29151,40,13704,13381,103,102,3542,54119,5046,4165,881,5046,138500,2016
29153,51,9450,9047,5,157,2893,31087,4267,3279,988,4267,81600,2016
29155,37.8,17599,12171,4686,428,4348,31671,6939,3703,3236,6939,70400,2016
29157,40.2,19152,18330,93,397,5322,53014,7438,5802,1636,7438,126200,2016
29159,37.5,42193,36134,1238,3482,10718,40467,16004,10706,5298,16004,104800,2016
29161,34.5,44833,39991,1035,1061,10341,41603,16838,10163,6675,16838,117700,2016
29163,38.9,18475,16337,1131,397,4366,42779,6653,4821,1832,6653,97100,2016
29165,38.1,94970,78295,6385,5332,25115,70879,37699,24357,13342,37699,196000,2016
29167,37.4,31113,29251,263,708,7889,42483,11864,7857,4007,11864,117700,2016
29169,26.9,53302,37322,7053,5581,10328,49216,15298,7517,7781,15298,141900,2016
29171,46.8,4877,4716,17,69,1398,38125,2121,1541,580,2121,86700,2016
29173,44.9,10225,9797,118,131,2944,48919,3967,3253,714,3967,120200,2016
29175,39,25081,22376,1262,480,5564,40638,8471,6257,2214,8471,89300,2016
29177,41.6,22921,21557,345,527,6014,53459,8670,6729,1941,8670,125700,2016
29179,46.8,6530,6187,112,85,1797,36736,2652,2122,530,2652,82200,2016
29181,42.2,13936,13299,24,167,3698,34145,5353,4036,1317,5353,82300,2016
29183,37.7,379856,334319,16630,11715,102281,75603,140664,111998,28666,140664,192900,2016
29185,49.8,9444,8934,73,201,2654,33750,3990,3074,916,3990,78100,2016
29186,42.2,17937,17070,193,183,5035,49356,7176,5622,1554,7176,136500,2016
29187,38.8,66230,61044,3124,950,16088,41461,24759,16810,7949,24759,106100,2016
29189,40.3,1000560,673914,235082,27008,259427,61103,401716,279989,121727,401716,176000,2016
29195,37.4,23214,18850,1226,2201,5789,40645,8785,5919,2866,8785,92800,2016
29197,41.3,4396,4284,47,15,1188,37583,1726,1213,513,1726,80800,2016
29199,39,4893,4777,82,16,1112,41336,1786,1323,463,1786,77200,2016
29201,39.6,38994,32777,4726,817,10384,40276,15267,10524,4743,15267,99500,2016
29203,44.8,8256,7786,16,146,2043,32284,3176,2394,782,3176,90400,2016
29205,42.1,6148,5916,112,93,1616,41351,2480,1804,676,2480,73100,2016
29207,42.2,29788,28542,459,468,7579,38096,11855,8195,3660,11855,89700,2016
29209,52.1,31197,29742,43,616,8949,41944,12667,9985,2682,12667,155500,2016
29211,41.4,6416,5015,87,1175,1507,42639,2384,1762,622,2384,78500,2016
29213,41.7,53853,48359,462,2892,14660,38040,21769,12665,9104,21769,120100,2016
29215,41.5,25690,23475,451,513,6067,35730,9239,6669,2570,9239,103000,2016
29217,40.7,20836,19637,200,425,5532,40655,8204,5395,2809,8204,93200,2016
29219,40.4,33290,30653,703,1054,8934,51509,11823,9207,2616,11823,158900,2016
29221,40.7,25002,23628,594,79,6416,36701,9045,7400,1645,9045,80400,2016
29223,46.8,13341,12755,90,195,3805,33954,5612,4295,1317,5612,69600,2016
29225,37.6,37075,35093,431,696,9688,44814,13122,9498,3624,13122,119500,2016
29227,47.9,2061,1983,0,33,636,44974,917,678,239,917,58900,2016
29229,41.9,18378,17558,113,304,4873,30581,7395,5020,2375,7395,89800,2016
29510,34.8,316030,135068,150948,12216,64648,36809,140116,60601,79515,140116,120900,2016
30001,42.7,9317,8534,8,358,2287,38194,4008,2530,1478,4008,168000,2016
30003,30,13214,3706,13,691,2891,44136,3602,2197,1405,3602,96500,2016
30005,34,6609,3086,15,158,1535,36875,2273,1384,889,2273,86000,2016
30007,46.7,5692,5336,10,70,1593,50946,2417,1956,461,2417,192400,2016
30009,49.6,10340,9801,1,246,2737,52869,4385,3419,966,4385,217700,2016
30011,51,1295,1251,0,18,373,46985,535,433,102,535,86400,2016
30013,38,82049,70666,949,3353,21409,45469,34138,21763,12375,34138,165800,2016
30015,41.1,5837,4455,3,124,1549,38735,2263,1421,842,2263,121900,2016
30017,40.7,11980,11110,43,353,3063,50146,4872,3392,1480,4872,145100,2016
30019,46,1787,1731,0,38,493,51108,894,690,204,894,119300,2016
30021,41.4,9431,8760,62,263,2798,57591,3997,2709,1288,3997,158900,2016
30023,47.3,9176,8327,32,282,2316,39212,3889,2762,1127,3889,122700,2016
30025,38.3,2913,2752,38,50,800,50114,1194,837,357,1194,151700,2016
30027,46.9,11429,10795,18,94,3139,42357,4924,3511,1413,4924,119700,2016
30029,42.1,94696,88370,234,2417,24849,48407,37622,26719,10903,37622,236800,2016
30031,33.2,97958,90700,353,3075,22785,57021,38781,23577,15204,38781,285200,2016
30033,45.5,1061,1053,0,8,312,42614,447,324,123,447,117900,2016
30035,31.1,13695,4290,36,386,2613,29181,4188,2470,1718,4188,100600,2016
30037,54.6,730,659,0,49,228,44000,330,241,89,330,94200,2016
30039,53.5,3212,3042,2,64,851,48688,1300,955,345,1300,216000,2016
30041,34.5,16529,11697,3,541,3936,42979,6119,4010,2109,6119,131300,2016
30043,47.9,11601,10813,8,254,3227,62939,4468,3777,691,4468,247900,2016
30045,52,1981,1923,0,30,588,45347,915,678,237,915,136500,2016
30047,41.5,29311,19304,72,1197,7939,39898,11952,8393,3559,11952,226300,2016
30049,41.2,65989,60601,277,1954,16684,59170,26765,18501,8264,26765,212600,2016
30051,46.7,2292,2219,0,17,526,46597,833,557,276,833,104100,2016
30053,51.4,19268,17987,11,516,5007,35461,8539,6767,1772,8539,173900,2016
30055,50.2,1678,1547,0,15,492,42330,727,596,131,727,138500,2016
30057,52.7,7810,7361,13,235,1974,47617,3365,2609,756,3365,240300,2016
30059,48.6,1960,1879,0,38,492,39032,786,536,250,786,122200,2016
30061,52.4,4223,4108,2,56,853,37143,1618,1139,479,1618,166800,2016
30063,35.3,113101,101865,470,3413,26516,46371,47116,27602,19514,47116,243700,2016
30065,48.5,4778,4438,11,127,1293,41557,2001,1428,573,2001,148800,2016
30067,46.4,15843,14899,50,412,4047,43385,7131,5160,1971,7131,222500,2016
30069,50.4,445,445,0,0,135,38250,212,129,83,212,83000,2016
30071,47.3,4150,3537,0,90,1149,38692,1801,1266,535,1801,118500,2016
30073,41.9,6166,4992,24,116,1407,42193,2242,1588,654,2242,116600,2016
30075,52,1648,1556,0,25,488,47955,748,493,255,748,108700,2016
30077,45,6928,6260,29,170,1514,43064,2357,1616,741,2357,136600,2016
30079,51.2,1414,1356,0,21,386,44643,552,505,47,552,80600,2016
30081,48.1,41130,38374,32,1322,10796,40546,16752,12106,4646,16752,238100,2016
30083,38,11392,10251,0,566,2984,65638,4546,2858,1688,4546,203700,2016
30085,30.2,11230,4050,6,331,2050,34481,3172,1778,1394,3172,117000,2016
30087,36.3,9348,5343,18,424,2244,55609,3239,2302,937,3239,113200,2016
30089,51.9,11375,10266,18,299,3300,34336,5035,3808,1227,5035,183100,2016
30091,47.2,3645,3334,3,84,1001,52308,1624,1239,385,1624,144300,2016
30093,40.7,34560,31512,202,1411,8087,39580,14881,9817,5064,14881,133700,2016
30095,46.6,9342,8747,33,311,2634,59603,3784,2992,792,3784,213100,2016
30097,48.1,3634,3402,7,66,1018,50813,1447,1063,384,1447,217300,2016
30099,44.6,6067,5709,4,86,1513,49047,2391,1673,718,2391,147900,2016
30101,40.7,5114,4508,3,171,1255,46588,1930,1134,796,1930,129600,2016
30103,48.9,846,774,0,42,261,42500,372,242,130,372,81400,2016
30105,44.3,7576,6460,6,166,2236,49977,3350,2324,1026,3350,143000,2016
30107,42.9,2109,2003,0,50,505,36076,869,580,289,869,89700,2016
30109,51,1143,1126,0,17,344,40833,496,386,110,496,109600,2016
30111,38.2,155344,135565,829,8171,39235,55032,62459,42365,20094,62459,201500,2016
31001,37.7,31536,27543,259,2809,8002,51201,12719,8683,4036,12719,110600,2016
31003,46.1,6421,6127,17,202,1911,46381,2747,2115,632,2747,78400,2016
31005,41,437,426,0,0,101,40375,183,114,69,183,102300,2016
31007,47.9,793,689,10,77,246,50833,314,208,106,314,129200,2016
31009,43.6,580,572,0,0,177,50350,251,145,106,251,106500,2016
31011,45.4,5353,5188,29,94,1593,51890,2236,1752,484,2236,104400,2016
31013,40.5,11279,9308,30,1333,3068,54444,4722,3271,1451,4722,99500,2016
31015,51.4,2006,1925,16,15,553,42463,909,740,169,909,56200,2016
31017,47.7,3022,2926,1,31,936,37328,1498,1088,410,1498,80100,2016
31019,32.6,48402,42446,407,4085,11650,54098,18512,11791,6721,18512,155900,2016
31021,47.4,6594,6190,48,172,1879,47137,2823,2166,657,2823,90500,2016
31023,44.1,8205,7819,53,239,2309,51166,3479,2748,731,3479,108200,2016
31025,42,25463,24048,202,746,6826,65385,9706,7929,1777,9706,160900,2016
31027,44.5,8657,8405,5,146,2447,54391,3571,2869,702,3571,110500,2016
31029,43.3,4061,3444,1,551,1143,53496,1693,1339,354,1693,95900,2016
31031,43.7,5781,5144,1,158,1768,53059,2691,1666,1025,2691,122300,2016
31033,40.5,10090,9076,7,663,2633,54215,4462,3100,1362,4462,114300,2016
31035,43.6,6313,5637,25,554,1751,51613,2600,1994,606,2600,82100,2016
31037,33.9,10499,5515,281,4603,2547,52712,3659,2647,1012,3659,93100,2016
31039,44,9055,8042,7,870,2479,49181,3783,2594,1189,3783,109200,2016
31041,43.7,10784,10280,66,285,3125,47083,4781,3441,1340,4781,93000,2016
31043,34.1,20697,10496,850,7824,5536,52336,7314,4882,2432,7314,108400,2016
31045,34.1,9082,7798,63,416,2243,42685,3676,2269,1407,3676,104200,2016
31047,36.3,23924,14595,1221,7822,6214,49943,8791,5926,2865,8791,95600,2016
31049,47.4,1932,1770,0,120,517,51786,850,658,192,850,72900,2016
31051,42.4,5809,4999,20,702,1593,52813,2290,1762,528,2290,86200,2016
31053,39.1,36679,31433,172,4181,9938,49830,15063,9897,5166,15063,114700,2016
31055,34.1,543253,383597,59928,65203,130079,56003,210931,129562,81369,210931,149300,2016
31057,48.3,1823,1694,3,105,501,44583,815,565,250,815,70700,2016
31059,47.5,5676,5338,43,211,1573,52070,2460,1824,636,2460,75000,2016
31061,50.2,3076,2969,7,57,941,46531,1389,1160,229,1389,60400,2016
31063,44.9,2599,2517,1,28,736,51192,1097,833,264,1097,95000,2016
31065,46.2,4850,4587,9,168,1354,40445,2227,1534,693,2227,62500,2016
31067,44.8,21778,20727,98,464,5955,48731,9251,6433,2818,9251,108000,2016
31069,50.2,1930,1793,3,84,584,49805,867,688,179,867,83100,2016
31071,51,1968,1907,3,41,594,45227,920,697,223,920,92400,2016
31073,46.9,1977,1941,0,11,572,60711,811,565,246,811,113000,2016
31075,50.9,647,627,0,20,180,45625,272,211,61,272,52500,2016
31077,45.8,2447,2356,13,48,707,48220,1025,824,201,1025,65600,2016
31079,35.7,61105,42095,1268,15966,15084,51355,22572,13854,8718,22572,128200,2016
31081,42.5,9118,8705,76,270,2646,59760,3705,2994,711,3705,123200,2016
31083,49.8,3465,3235,19,150,973,44630,1590,1209,381,1590,84400,2016
31085,47.7,1013,953,0,58,325,44602,441,292,149,441,80500,2016
31087,48,2866,2830,4,24,752,41131,1288,968,320,1288,59000,2016
31089,45.3,10360,9767,5,425,2960,49607,4569,3372,1197,4569,96900,2016
31091,59.5,669,631,6,29,201,38616,301,230,71,301,77900,2016
31093,43.3,6365,6098,7,153,1711,52247,2601,2024,577,2601,115100,2016
31095,45.7,7354,6952,0,249,2040,44616,3303,2499,804,3303,76900,2016
31097,42.1,5167,4186,308,510,1247,47938,1880,1390,490,1880,80900,2016
31099,40.1,6548,6110,10,349,1776,55068,2752,1906,846,2752,119000,2016
31101,48.7,8103,7378,42,516,2442,43100,3926,2584,1342,3926,104600,2016
31103,52.5,736,719,1,8,225,43333,338,238,100,338,79000,2016
31105,46.6,3713,3313,1,295,1013,40344,1591,1074,517,1591,83000,2016
31107,47.3,8551,7399,16,222,2382,47692,3648,2715,933,3648,84500,2016
31109,33,301707,249390,11415,19707,71698,53730,119254,70622,48632,119254,157000,2016
31111,40.2,35777,31735,297,2888,9636,52179,14965,9816,5149,14965,119600,2016
31113,43.3,830,802,2,16,230,51346,352,237,115,352,116500,2016
31115,51,542,531,0,0,179,56750,248,201,47,248,119500,2016
31117,48,425,413,0,4,134,53750,195,131,64,195,147900,2016
31119,36.8,35125,28539,406,4994,9199,48673,14056,9169,4887,14056,121900,2016
31121,43.8,7793,7254,70,311,2149,50464,3311,2438,873,3311,88300,2016
31123,41.6,4843,3992,36,733,1329,43942,2008,1355,653,2008,84700,2016
31125,45.8,3607,3513,3,88,1008,42429,1568,1219,349,1568,81600,2016
31127,37.8,7101,6703,111,178,1848,52736,2873,2028,845,2873,109200,2016
31129,49,4352,4157,4,117,1258,41576,2042,1500,542,2042,56700,2016
31131,41.8,15890,14310,21,1137,4265,52108,6463,4760,1703,6463,124100,2016
31133,49.5,2695,2575,0,50,758,40139,1249,963,286,1249,65900,2016
31135,43.9,2911,2784,5,109,807,56797,1241,947,294,1241,99400,2016
31137,41.7,9236,8586,12,485,2493,51264,3773,2627,1146,3773,114300,2016
31139,41.7,7179,6956,16,114,2014,53125,2949,2343,606,2949,96900,2016
31141,38.4,32703,26409,93,5527,8439,58473,12737,9139,3598,12737,131200,2016
31143,45.6,5242,4908,10,227,1510,57991,2112,1650,462,2112,102300,2016
31145,41.5,10884,10057,175,522,2833,42457,4572,3492,1080,4572,88400,2016
31147,47.4,8149,7546,25,147,2316,45929,3768,2826,942,3768,71300,2016
31149,52.4,1407,1347,4,10,405,48750,695,498,197,695,67100,2016
31151,36.6,14356,10328,114,3348,3498,49332,5119,3315,1804,5119,99100,2016
31153,33.9,172460,141965,6394,14507,46247,72269,62907,43961,18946,62907,167600,2016
31155,41.1,20946,20070,40,420,5664,64475,7991,6325,1666,7991,155700,2016
31157,39.6,36599,26887,235,8349,9534,46632,14544,9940,4604,14544,111200,2016
31159,38.1,17113,16315,75,390,4394,61563,6348,4579,1769,6348,154200,2016
31161,45.9,5259,4341,26,228,1410,42802,2227,1588,639,2227,78900,2016
31163,49.7,3090,2995,23,59,874,46299,1367,1051,316,1367,84900,2016
31165,47.4,1274,1177,4,31,381,46667,544,389,155,544,97500,2016
31167,41.1,6022,5556,44,318,1777,58553,2342,1978,364,2342,111200,2016
31169,48.3,5163,4940,7,114,1473,45590,2375,1832,543,2375,68900,2016
31171,41.9,675,648,0,4,197,54286,298,211,87,298,103700,2016
31173,28.4,6989,2607,10,327,1503,42979,2096,1271,825,2096,75600,2016
31175,46.1,4240,4072,12,112,1285,44657,1916,1353,563,1916,89900,2016
31177,41.2,20338,19307,135,550,5827,65565,8022,6279,1743,8022,178000,2016
31179,30.7,9414,8501,309,512,2360,55141,3567,2241,1326,3567,129100,2016
31181,47.6,3665,3387,4,159,934,40313,1551,1216,335,1551,77900,2016
31183,50,805,802,0,0,233,47452,373,280,93,373,100500,2016
31185,40.1,13842,12682,112,648,3846,55156,5670,3997,1673,5670,120800,2016
32001,38.8,24148,17991,555,3126,6065,45368,9491,5759,3732,9491,157800,2016
32003,36.7,2070153,931097,219410,628456,470867,52629,735475,384329,351146,735475,186700,2016
32005,50.1,47426,38629,312,5710,13860,59769,19928,13784,6144,19928,282500,2016
32007,33.5,52029,35044,552,12522,12621,74672,17618,12384,5234,17618,197500,2016
32009,42,1069,907,0,136,233,43125,454,254,200,454,77900,2016
32011,47.1,1730,1700,1,8,445,70000,766,535,231,766,93800,2016
32013,35.2,17091,11192,82,4419,4112,67295,6174,4649,1525,6174,165100,2016
32015,37,5907,3949,6,1533,1380,78077,2102,1691,411,2102,128200,2016
32017,39.6,5155,4271,147,442,1303,49406,1835,1253,582,1835,130700,2016
32019,43.7,51897,39674,461,8197,13251,49007,19586,13446,6140,19586,143200,2016
32021,49.2,4519,2677,53,586,1077,37750,2065,1353,712,2065,85200,2016
32023,51.2,43198,33375,1266,6110,11473,42266,17464,12058,5406,17464,109100,2016
32027,41.3,6690,4431,322,1580,1366,45192,2016,1355,661,2016,105100,2016
32029,54.4,3941,3411,16,244,1079,65508,1752,1480,272,1752,192700,2016
32031,37.9,439914,282598,9343,103468,104501,54955,169015,96055,72960,169015,236900,2016
32033,39.1,9893,7242,405,1486,1938,58156,3158,2309,849,3158,127100,2016
32510,43.1,54412,37320,509,12474,13121,47948,21802,12093,9709,21802,199500,2016
33001,46.5,60392,57471,322,953,16465,61245,24464,18501,5963,24464,219200,2016
33003,50.9,47416,45599,168,645,13913,56289,20783,16523,4260,20783,227300,2016
33005,42.2,76320,72181,526,1289,19176,58359,30473,21388,9085,30473,187300,2016
33007,47.9,32219,30694,631,537,8712,45154,13917,9904,4013,13917,122000,2016
33009,42.4,89164,81506,717,1936,21399,58107,34903,23907,10996,34903,214100,2016
33011,40.3,404948,348784,8164,24490,104618,73189,156114,103116,52998,156114,248500,2016
33013,42.7,147715,137993,1675,2810,37603,67181,56790,40245,16545,56790,225200,2016
33015,43.8,300365,280542,2029,7546,82409,82398,118672,90849,27823,118672,288300,2016
33017,37.1,125913,115388,1144,2691,30709,63533,47779,31102,16677,47779,214000,2016
33019,45.8,43051,41113,189,603,11472,58454,17478,13018,4460,17478,171800,2016
34001,40.8,274026,155570,39702,50170,68225,55456,101083,67793,33290,101083,222200,2016
34003,41.5,930310,546048,49047,171201,243146,88487,337069,218041,119028,337069,443400,2016
34005,41.3,450236,309122,70210,33575,114525,80034,164623,125666,38957,164623,245000,2016
34007,38.4,511145,296745,93169,80127,125569,63028,185722,124727,60995,185722,193500,2016
34009,48.4,95404,81874,4315,6836,25836,59338,40073,30605,9468,40073,296100,2016
34011,36.7,155744,74799,28141,45376,35123,49537,50718,32632,18086,50718,161900,2016
34013,37,792586,249787,308463,174414,180784,54860,279480,123300,156180,279480,356300,2016
34015,39.8,291286,231306,29052,16238,74964,78592,104762,83145,21617,104762,213200,2016
34017,34.7,668526,193874,73268,287817,155981,60894,251693,77459,174234,251693,341300,2016
34019,45.5,125708,108947,3006,7530,34064,108177,46935,39122,7813,46935,389500,2016
34021,38.5,371101,191695,73118,60982,88385,73966,130129,83401,46728,130129,277400,2016
34023,37.9,831852,376818,77191,166115,206018,80716,283279,180794,102485,283279,324500,2016
34025,42.6,627532,475096,42129,65243,161743,87297,232868,171673,61195,232868,387500,2016
34027,42.2,498215,361301,14871,63251,129543,102798,179734,135369,44365,179734,428900,2016
34029,42.8,586166,498857,16720,52014,148913,63108,222609,178376,44233,222609,264200,2016
34031,36.5,507204,216076,54527,202234,118127,61664,161534,85909,75625,161534,333400,2016
34033,41.8,64504,48719,8584,5092,16286,61341,24255,17259,6996,24255,186200,2016
34035,41.1,331686,194082,29696,46906,84367,102405,116456,88257,28199,116456,404100,2016
34037,43.8,144694,126630,2834,10480,38892,87388,53648,44474,9174,53648,265600,2016
34039,38.2,550436,227794,111489,165481,133871,70476,186890,109931,76959,186890,347500,2016
34041,43.1,107095,89471,4386,8749,28761,72999,41454,29861,11593,41454,254400,2016
35001,36.8,674777,269464,16946,331567,160337,48994,262520,163779,98741,262520,186500,2016
35003,58.1,3547,2788,30,684,858,38142,1425,1316,109,1425,161200,2016
35005,35.1,65610,26879,1091,36047,16187,41356,23153,15389,7764,23153,102400,2016
35006,35.8,27373,5567,236,10364,5866,36160,8787,6336,2451,8787,86900,2016
35007,48.3,12716,6035,49,6226,3062,32693,5383,3692,1691,5383,110600,2016
35009,30.8,50544,25182,2817,20405,12059,42170,18297,10786,7511,18297,125900,2016
35011,49.7,1977,930,0,942,299,31197,563,430,133,563,70000,2016
35013,32.6,213825,60935,3296,143707,51818,38636,74989,47363,27626,74989,137300,2016
35015,36.4,56369,27817,786,26318,14757,59625,20941,14981,5960,20941,134100,2016
35017,46.4,28879,13582,131,14311,7243,38890,11941,8884,3057,11941,135000,2016
35019,41.1,4469,863,57,3462,668,26692,1168,808,360,1168,84200,2016
35021,58,565,326,0,237,109,32404,193,152,41,193,65800,2016
35023,42.3,4531,1891,15,2592,1204,34528,1763,1218,545,1763,77800,2016
35025,31.8,68930,26345,2257,38493,16071,58152,21542,14811,6731,21542,111400,2016
35027,50.9,19726,12606,117,6217,4782,40065,8016,6325,1691,8016,170400,2016
35028,43.5,17895,13163,95,3002,5064,105902,7586,5510,2076,7586,274200,2016
35029,38.4,24627,7891,260,16011,5311,27326,8728,5667,3061,8728,85300,2016
35031,30.8,74346,6737,349,10214,13221,29272,18968,13601,5367,18968,68000,2016
35033,41.3,4598,637,5,3674,753,21190,1540,1166,374,1540,88000,2016
35035,35.7,65333,33003,2206,24037,14998,41502,23043,14798,8245,23043,105000,2016
35037,46.5,8555,4357,168,3792,1749,28159,3174,2207,967,3174,72600,2016
35039,39.8,39924,5119,165,28509,8221,33972,13343,10178,3165,13343,159100,2016
35041,29.7,19618,10535,445,7957,4394,34933,7110,4316,2794,7110,116400,2016
35043,39.4,138117,62255,2706,51452,34164,60158,48534,39654,8880,48534,176700,2016
35045,34.8,122537,49962,445,24234,28967,48624,41036,29834,11202,41036,142500,2016
35047,42.2,28350,5183,399,21999,5315,27000,10630,7511,3119,10630,123100,2016
35049,45,147320,63530,970,75265,36110,55370,61286,42741,18545,61286,274800,2016
35051,56,11442,7586,73,3387,3050,29679,5341,3879,1462,5341,89900,2016
35053,35.8,17324,6173,29,8562,2731,34542,4786,3428,1358,4786,120200,2016
35055,47.6,32961,11716,31,18647,7575,35323,13006,9508,3498,13006,213800,2016
35057,43.7,15599,8316,287,6430,3457,32067,5373,4374,999,5373,108800,2016
35059,40.4,4292,2271,76,1753,897,36420,1545,949,596,1545,87600,2016
35061,38.9,75993,25959,781,45334,18858,41788,26841,21228,5613,26841,133100,2016
36001,37.8,307891,226677,36350,17098,67725,60904,124108,71279,52829,124108,211100,2016
36003,38.5,47700,45116,677,740,11670,44085,18032,13334,4698,18032,72100,2016
36005,33.3,1436785,137901,423684,796193,322587,35302,490740,93569,397171,490740,363600,2016
36007,39.8,197381,166815,9622,7614,47242,47744,78738,51475,27263,78738,112300,2016
36009,41.5,78506,71489,1236,1530,19813,43884,31502,22606,8896,31502,85100,2016
36011,42.4,78783,71408,3225,2120,19556,53114,31039,21993,9046,31039,117800,2016
36013,42,131748,115969,3162,9288,32750,43211,52718,36888,15830,52718,85500,2016
36015,41,87742,76000,4942,2579,21499,49578,34887,23815,11072,34887,101800,2016
36017,44.1,49286,46832,439,1024,12522,46979,19837,14968,4869,19837,93400,2016
36019,39.4,81505,73464,3291,2233,20301,50502,31648,21598,10050,31648,127500,2016
36021,47,61860,53996,2516,2679,16136,59916,25295,18331,6964,25295,222300,2016
36023,36.2,48713,45234,695,1250,10909,50910,17683,11511,6172,17683,111400,2016
36025,46.5,46480,43041,803,1663,11708,46055,18817,13787,5030,18817,135200,2016
36027,41.6,295905,214840,28072,33945,71696,72706,106949,73505,33444,106949,274300,2016
36029,40.4,922129,703823,120062,46752,228584,52744,382822,249815,133007,382822,134600,2016
36031,46.4,38598,35529,1115,1187,10010,53244,15298,11316,3982,15298,144100,2016
36033,40.1,51007,41819,2832,1681,12438,49782,19299,13956,5343,19299,100900,2016
36035,43,54297,50653,870,1485,14349,46090,22450,15808,6642,22450,108300,2016
36037,43.2,59053,53678,1360,1772,15663,52641,23825,17456,6369,23825,108700,2016
36039,45.4,48069,41293,2969,2608,10825,51013,17125,12895,4230,17125,175900,2016
36041,53.5,4697,4482,28,66,822,52708,1239,1055,184,1239,165500,2016
36043,43.3,63558,60383,560,1246,16474,48893,25670,18066,7604,25670,97300,2016
36045,32,117966,97364,6392,8359,29705,49911,43428,24333,19095,43428,144400,2016
36047,34.5,2606852,933985,806316,506102,587692,50640,938803,276447,662356,938803,590500,2016
36049,41.8,27107,26005,226,445,7155,49976,10307,7849,2458,10307,122000,2016
36051,40.4,64622,58893,1519,2158,15445,52724,24217,17745,6472,24217,123000,2016
36053,41.1,72089,67399,1254,1468,17123,55858,26121,19703,6418,26121,128000,2016
36055,38.6,749236,534425,108624,60840,181392,53568,300289,191707,108582,300289,140200,2016
36057,41.3,49667,41397,666,6239,12445,44455,19540,13040,6500,19540,99100,2016
36059,41.4,1356801,843923,149065,218178,337726,102044,440230,353420,86810,440230,451700,2016
36061,36.7,1634989,769598,206008,423526,311464,75513,753385,174361,579024,753385,871500,2016
36063,42.9,213374,184173,15120,5555,54676,50094,87638,62309,25329,87638,111500,2016
36065,41.2,232858,193370,13193,12140,55982,49838,90260,60083,30177,90260,117600,2016
36067,38.8,468050,363214,49860,21351,111967,55717,184925,120159,64766,184925,137000,2016
36069,43.3,109450,99162,2516,4643,28569,58070,44180,32075,12105,44180,148400,2016
36071,36.9,376242,248344,35477,72877,88380,71910,125144,85306,39838,125144,258700,2016
36073,42.6,41938,36369,2517,1946,10687,48731,16132,12186,3946,16132,92000,2016
36075,39.5,120513,113850,918,2869,30494,49571,45374,32850,12524,45374,96000,2016
36077,41.6,60979,55980,1027,2111,14662,49689,23539,17350,6189,23539,140600,2016
36079,43.4,99408,80275,2239,13066,25910,97606,34102,27961,6141,34102,354800,2016
36081,37.9,2310011,592151,398786,647005,525378,59758,779304,341363,437941,779304,462300,2016
36083,39.8,159959,134833,9251,7182,39418,61754,63553,40749,22804,63553,180700,2016
36085,39.6,473324,296338,44570,85119,122894,74021,166014,114502,51512,166014,448000,2016
36087,36.3,322642,205185,37202,54700,74009,86134,99038,68276,30762,99038,420700,2016
36089,38,111529,102729,2477,2495,26286,46313,41466,29591,11875,41466,87400,2016
36091,42,224929,205458,3272,6431,60037,74080,90896,65099,25797,90896,238600,2016
36093,39.9,154845,115034,14386,10165,33239,59959,55027,36997,18030,55027,165000,2016
36095,43.6,31667,29619,440,943,7884,50607,12373,9287,3086,12373,143700,2016
36097,46,18336,17481,151,316,4796,47229,7376,5767,1609,7376,111300,2016
36099,42.2,35036,31333,1509,1124,8329,50073,13672,9922,3750,13672,98200,2016
36101,42.3,98151,92151,1450,1534,25951,48823,40438,28545,11893,40438,94300,2016
36103,40.9,1498130,1036423,107402,272306,361577,90128,489758,389182,100576,489758,376000,2016
36105,42.5,75818,55311,5826,11358,17682,52027,28007,18762,9245,28007,165900,2016
36107,43.9,49649,47392,354,842,13446,58115,19705,15415,4290,19705,112300,2016
36109,30.3,104268,81106,3738,4926,20126,54133,38269,21175,17094,38269,182600,2016
36111,43.4,180505,144798,9461,17382,43049,60393,69335,48343,20992,69335,219800,2016
36113,45.6,64911,61303,737,1439,16615,57174,26944,19037,7907,26944,191500,2016
36115,43.2,62465,57929,1786,1581,16311,51449,24027,17368,6659,24027,143900,2016
36117,43.4,91874,83010,2801,3772,24764,51627,36576,28037,8539,36576,115100,2016
36119,40.5,969229,532570,130525,228843,236644,86226,341762,210004,131758,341762,507300,2016
36121,41.4,41239,37068,2128,1322,10317,53612,15780,11936,3844,15780,104200,2016
36123,41.5,25106,23924,184,518,6477,50105,9532,7346,2186,9532,126900,2016
37001,39.6,156372,102444,28814,18879,41098,43209,62053,40256,21797,62053,143500,2016
37003,42.4,37211,32502,2133,1662,9353,40404,13796,10261,3535,13796,125500,2016
37005,48.5,10868,9513,262,1014,3469,38352,4798,3629,1169,4798,140700,2016
37007,39.9,25883,11671,12612,940,6132,34656,9511,6183,3328,9511,79900,2016
37009,46.9,26992,24998,193,1382,8260,37360,11905,8806,3099,11905,143700,2016
37011,44,17633,15731,651,884,4420,35891,6756,5117,1639,6756,130900,2016
37013,45.2,47513,31323,11994,3553,12383,40906,19021,13206,5815,19021,122100,2016
37015,45,20324,7020,12579,394,4819,31129,7673,5644,2029,7673,79900,2016
37017,42.9,34454,18688,11963,2580,9190,30408,14110,9666,4444,14110,85700,2016
37019,50.9,119167,97089,12401,5640,34669,49356,50562,38378,12184,50562,189500,2016
37021,41.7,250112,209841,15143,15738,60222,46902,102118,65544,36574,102118,198100,2016
37023,43.3,89082,73303,5441,5170,22605,39759,34199,24045,10154,34199,113600,2016
37025,37.7,192296,132653,31254,18877,50320,58970,68289,48622,19667,68289,171000,2016
37027,43.5,81623,71986,3927,3998,21192,37118,31912,22517,9395,31912,108900,2016
37029,40.9,10228,8228,1450,271,2998,60714,3804,3060,744,3804,216600,2016
37031,46.9,68537,59183,3915,2850,19205,50599,29563,21428,8135,29563,197600,2016
37033,45.3,23094,14137,7506,823,6165,38310,8874,6751,2123,8874,99500,2016
37035,41.1,155461,119163,12964,13956,41101,45450,59710,40959,18751,59710,137600,2016
37037,46.9,68778,49321,8043,8500,18821,58555,27397,21167,6230,27397,243900,2016
37039,50.4,27226,24968,375,780,7181,35284,10857,8649,2208,10857,140700,2016
37041,45.3,14556,8736,4878,496,4197,41156,5931,4098,1833,5931,131500,2016
37043,50.8,10730,10317,45,338,3055,36296,4666,3635,1031,4666,145800,2016
37045,41.5,97113,71438,20026,3113,24792,39134,37178,25015,12163,37178,108100,2016
37047,41.6,57015,34132,17336,2825,14143,35847,22108,15354,6754,22108,84800,2016
37049,36.1,104190,69104,21795,7293,27665,47957,40609,25702,14907,40609,154000,2016
37051,31.5,325841,145778,116320,35520,79528,44810,123178,63899,59279,123178,129000,2016
37053,43.2,24864,21768,1516,891,7082,61086,9582,7982,1600,9582,227400,2016
37055,45.3,35187,30888,707,2437,9638,54787,14706,10062,4644,14706,283000,2016
37057,41.9,164058,133224,14604,10989,44526,44469,64064,45690,18374,64064,132000,2016
37059,44.3,41568,35290,2609,2667,11075,51662,15646,12102,3544,15646,169300,2016
37061,39.2,59121,30784,14647,12603,15073,35364,21770,15344,6426,21770,88200,2016
37063,34.6,294618,123833,109558,39257,69119,54093,118681,63056,55625,118681,186800,2016
37065,40.3,54669,20073,30960,2252,14186,32298,21103,12579,8524,21103,82200,2016
37067,38,364691,210368,93756,45145,91501,46283,144898,89439,55459,144898,151300,2016
37069,40.4,62989,40042,16120,4969,16360,44272,23719,17288,6431,23719,134500,2016
37071,40,211753,157018,32311,13527,53998,44288,79904,52637,27267,79904,126000,2016
37073,44.6,11615,7260,3837,139,3320,51582,4524,3616,908,4524,136800,2016
37075,44.8,8651,7595,34,259,2248,34778,3252,2671,581,3252,122300,2016
37077,41.9,58341,34075,17762,4365,14240,50317,20527,14814,5713,20527,141200,2016
37079,39.8,21241,10029,7496,3124,5002,37190,7215,5096,2119,7215,88300,2016
37081,37.1,511815,266061,169141,38767,127106,46896,200298,117757,82541,200298,157300,2016
37083,42.4,52849,20560,27396,1370,13831,32549,21354,13532,7822,21354,87700,2016
37085,33.7,126620,79151,26147,15035,31129,47930,43036,27987,15049,43036,140800,2016
37087,47.2,59577,55604,617,2153,17114,43097,26296,18871,7425,26296,165800,2016
37089,46.8,110905,92992,3249,10806,30633,48138,46985,34141,12844,46985,185800,2016
37091,41.9,24285,8197,14026,807,5572,34523,8706,5746,2960,8706,86900,2016
37093,31.7,51853,21161,16913,6541,12559,42704,17343,11316,6027,17343,134100,2016
37095,41.8,5629,3433,1855,326,1406,37741,1936,1406,530,1936,75600,2016
37097,40.4,167493,128348,20274,12130,44488,53937,61716,44333,17383,61716,169300,2016
37099,37.1,41227,33392,929,2220,9866,40278,16048,10454,5594,16048,172800,2016
37101,37.7,182155,125897,27156,23824,46313,51980,63219,45255,17964,63219,147500,2016
37103,47,10074,6285,3066,422,2832,34080,4141,2997,1144,4141,91000,2016
37105,37.6,59540,34747,11296,11418,14637,46402,21349,14271,7078,21349,134800,2016
37107,42.1,58343,29241,22323,4227,15077,36956,23015,14214,8801,23015,93400,2016
37109,42.4,79783,68051,4061,5628,22579,49283,30612,23414,7198,30612,153500,2016
37111,43.1,45013,39589,1804,2619,12458,37590,17581,12403,5178,17581,104500,2016
37113,49,33991,30492,389,2246,9693,39593,15215,11145,4070,15215,167500,2016
37115,43.9,21130,19880,391,509,5736,40408,8400,6202,2198,8400,162500,2016
37117,46.2,23510,12254,10151,824,6164,34957,9416,6579,2837,9416,84000,2016
37119,34.7,1011774,490524,310187,127614,239135,59268,386804,220137,166667,386804,192700,2016
37121,46.9,15263,14210,60,719,4227,39658,6422,5079,1343,6422,143500,2016
37123,41.4,27475,17386,5161,4144,7156,34819,10781,7540,3241,10781,95700,2016
37125,45,93070,71986,11648,5786,24700,51873,37766,28131,9635,37766,205300,2016
37127,41.2,94385,48648,36483,6163,23940,43804,36678,23720,12958,36678,120500,2016
37129,38.4,216430,166391,30210,11574,52228,51232,89599,51589,38010,89599,215800,2016
37131,48.2,20628,7910,11800,413,5748,31543,8670,5900,2770,8670,81000,2016
37133,26.4,185755,124663,26572,21908,45020,46786,62633,32851,29782,62633,153300,2016
37135,33.6,139807,97356,15740,11545,31651,61130,51728,31658,20070,51728,281700,2016
37137,50.4,12892,9594,2337,453,3587,43808,5308,4019,1289,5308,147200,2016
37139,37.8,39909,21906,14560,1864,9906,45750,14590,8700,5890,14590,156400,2016
37141,42.7,56358,41975,9216,3625,14004,46580,20534,15943,4591,20534,160300,2016
37143,47.9,13470,9677,3243,329,3918,45208,5710,4369,1341,5710,165000,2016
37145,42.8,39196,26061,10414,1605,10400,43297,15474,10986,4488,15474,116000,2016
37147,31.7,175150,97286,59862,10375,40839,42308,68804,35963,32841,68804,135000,2016
37149,51.3,20324,17898,1084,1149,5693,47396,8662,6321,2341,8662,208000,2016
37151,41.1,142588,114328,8309,15468,37865,43010,54884,39725,15159,54884,118900,2016
37153,40,45710,26430,14429,2796,12056,32526,18458,11865,6593,18458,80500,2016
37155,35.6,134576,34960,32525,11213,31577,31298,45914,29367,16547,45914,71000,2016
37157,44.1,91898,66968,16829,5419,24955,40003,37503,25426,12077,37503,107200,2016
37159,40.3,138694,101408,22151,11191,35157,44494,51454,34713,16741,51454,130500,2016
37161,44.1,66701,55820,6817,2680,17892,36144,26490,19142,7348,26490,107600,2016
37163,39.5,63713,33172,16076,11627,15655,36742,23451,16266,7185,23451,87900,2016
37165,39.4,35711,15868,13688,977,8865,30013,13120,8196,4924,13120,83200,2016
37167,42.1,60610,49407,6353,2345,16199,44140,23588,16933,6655,23588,129300,2016
37169,45.1,46453,42484,1922,1299,13423,42489,19190,14807,4383,19190,120900,2016
37171,43,72767,61626,2665,7222,19779,37345,28837,20861,7976,28837,119300,2016
37173,40.7,14234,9019,186,673,3471,33598,5425,3792,1633,5425,121900,2016
37175,50.4,33062,29538,1273,1024,9357,43918,13841,10526,3315,13841,203100,2016
37177,45.3,4128,2147,1497,424,994,32165,1457,1097,360,1457,112400,2016
37179,37.7,217614,159798,25041,23393,57561,67194,72304,57482,14822,72304,206000,2016
37181,40.5,44508,18149,22072,3179,10423,32733,16653,9971,6682,16653,96700,2016
37183,35.6,998576,608211,201975,98800,249387,70620,373245,236794,136451,373245,241600,2016
37185,46.5,20324,7727,10235,793,4753,33913,7753,5426,2327,7753,95100,2016
37187,44.9,12503,5624,6078,611,3264,33286,5203,3374,1829,5203,82400,2016
37189,30.1,52745,48578,614,1799,10750,39443,20320,11955,8365,20320,230700,2016
37191,37,124447,67544,38079,13625,31258,40457,47013,28050,18963,47013,114200,2016
37193,44.1,68888,60726,2882,4071,18670,34846,27583,20625,6958,27583,119100,2016
37195,40.3,81617,39138,31712,8029,20745,40260,31942,19137,12805,31942,117100,2016
37197,43,37819,32104,1285,4010,10476,38623,15287,11670,3617,15287,126900,2016
37199,46.3,17599,16344,206,857,5110,36993,7479,5627,1852,7479,140500,2016
38001,45.1,2348,2186,21,20,694,53295,1030,776,254,1030,124000,2016
38003,43.5,11033,10295,88,202,3028,55778,5070,3433,1637,5070,96700,2016
38005,30.8,6802,2823,0,166,1605,41530,2257,1419,838,2257,65400,2016
38007,45.8,936,887,8,30,281,67969,405,280,125,405,167200,2016
38009,45.2,6650,6146,54,141,1843,55958,3047,2297,750,3047,128000,2016
38011,42.6,3238,3012,4,154,907,62955,1404,1064,340,1404,145700,2016
38013,38.6,2239,2094,10,79,619,65521,1001,716,285,1001,116400,2016
38015,36.7,90560,81953,1072,1791,23693,66057,38005,26227,11778,38005,220800,2016
38017,32,166852,146666,6275,4018,39335,54926,70841,36679,34162,70841,183800,2016
38019,50.3,3867,3710,5,50,1153,65645,1788,1481,307,1788,90500,2016
38021,43.2,5160,4836,76,172,1423,55882,2192,1582,610,2192,105500,2016
38023,50.3,2369,2231,16,8,628,62470,1059,860,199,1059,115800,2016
38025,39.9,4284,3596,40,122,1074,66964,1548,1206,342,1548,162700,2016
38027,46.6,2370,2137,0,43,607,55489,1043,756,287,1043,70900,2016
38029,51.1,3426,3309,0,0,925,45472,1520,1276,244,1520,84900,2016
38031,46.7,3345,3221,2,39,1013,55625,1500,1064,436,1500,110400,2016
38033,41,1895,1787,0,34,433,37014,836,556,280,836,115700,2016
38035,29.5,69793,59800,1988,2656,16261,50652,28991,14547,14444,28991,168900,2016
38037,53.6,2369,2289,7,15,674,45978,1108,929,179,1108,80600,2016
38039,51.9,2311,2224,28,10,686,50250,1045,742,303,1045,85800,2016
38041,48.6,2639,2441,8,73,775,55230,1109,927,182,1109,106000,2016
38043,45.9,2419,2284,0,123,783,58527,1083,835,248,1083,100100,2016
38045,48.2,4111,4007,6,36,1139,55900,1810,1434,376,1810,87300,2016
38047,52.6,1939,1876,1,29,557,55068,878,734,144,878,72300,2016
38049,42.4,5912,5615,9,142,1604,60741,2614,2143,471,2614,118100,2016
38051,52.6,2737,2603,4,42,819,43650,1303,1031,272,1303,67900,2016
38053,31.3,10718,8324,105,663,2261,78179,3617,2138,1479,3617,202800,2016
38055,46.6,9576,8590,5,215,2851,59976,4292,3412,880,4292,150300,2016
38057,44.5,8671,8104,81,210,2528,73801,3675,3042,633,3675,152200,2016
38059,37.5,29633,27024,200,710,8011,63549,12673,9306,3367,12673,173400,2016
38061,35.2,9675,6165,19,620,2129,68082,3161,2188,973,3161,161400,2016
38063,52.6,3032,2916,20,73,876,51280,1517,1150,367,1517,77500,2016
38065,49.2,1768,1622,9,28,551,66196,760,647,113,760,125600,2016
38067,48.1,7136,6587,18,234,2039,56813,3273,2503,770,3273,80200,2016
38069,46.9,4373,4224,52,35,1149,43086,2032,1480,552,2032,102900,2016
38071,42.7,11578,9861,4,269,2813,50776,5004,3142,1862,5004,112100,2016
38073,44.8,5457,5207,25,93,1437,57088,2350,1586,764,2350,113600,2016
38075,39.2,2573,2404,17,97,660,65927,1011,771,240,1011,120400,2016
38077,38.2,16329,15056,83,411,4237,58125,6677,4757,1920,6677,109000,2016
38079,30.3,14607,2794,79,53,3309,37313,4786,3249,1537,4786,73900,2016
38081,45.3,3889,3648,65,115,1093,57472,1775,1311,464,1775,83000,2016
38083,51.3,1395,1358,0,15,440,48375,686,541,145,686,71800,2016
38085,26.9,4431,562,2,163,858,39539,1101,458,643,1101,74300,2016
38087,52.1,665,620,32,2,196,58750,306,257,49,306,117800,2016
38089,34.5,29837,26587,487,1498,6952,76817,11570,7644,3926,11570,222200,2016
38091,49.8,1969,1927,0,42,554,58603,943,737,206,943,73600,2016
38093,40.2,21108,19695,200,450,5196,53685,9146,5985,3161,9146,120500,2016
38095,47.8,2292,1975,0,53,609,53929,982,755,227,982,70300,2016
38097,41,8075,7519,73,255,2028,55764,3310,2448,862,3310,115300,2016
38099,45.2,10995,9418,33,1183,3024,51181,4841,3594,1247,4841,81300,2016
38101,31.1,68954,58642,2287,3597,16316,63037,26772,16205,10567,26772,207600,2016
38103,51.8,4179,4084,0,37,1266,50685,2026,1629,397,2026,74900,2016
38105,32,31643,26893,874,1681,7524,90080,12390,7980,4410,12390,224000,2016
39001,42.1,28111,27176,100,147,7453,34709,10885,7467,3418,10885,94300,2016
39003,38.2,104664,85353,12423,2874,26008,45575,40039,26597,13442,40039,107500,2016
39005,40,53343,51267,355,630,13861,48509,20391,14571,5820,20391,120700,2016
39007,42.2,99175,89288,3215,3843,24966,41158,38800,27737,11063,38800,104700,2016
39009,28.2,65103,58523,1593,1191,12121,34221,22328,12516,9812,22328,113900,2016
39011,41.2,45871,44146,172,656,12462,55914,18231,13717,4514,18231,138700,2016
39013,44.1,69228,64459,2823,573,17858,44719,27732,20520,7212,27732,94300,2016
39015,41.1,44059,42596,424,360,12029,47999,17047,12789,4258,17047,116500,2016
39017,36.5,373638,308906,28772,16338,93212,59652,135100,92855,42245,135100,159800,2016
39019,44.7,28108,27138,214,329,7813,48545,10871,8655,2216,10871,113300,2016
39021,41.6,39175,36631,666,583,10684,53673,15162,11086,4076,15162,124400,2016
39023,41.2,136175,115228,11150,4222,35609,44154,54681,35768,18913,54681,103200,2016
39025,39.7,201092,189211,2682,3460,53431,61265,75236,55391,19845,75236,159100,2016
39027,39.4,41854,39138,989,661,10919,48675,16077,10313,5764,16077,121700,2016
39029,43.4,105230,99287,2297,1560,28780,45389,41782,29973,11809,41782,104100,2016
39031,41.2,36665,35268,378,342,9840,43380,14397,10758,3639,14397,97100,2016
39033,42.9,42485,40756,269,603,11417,40563,17657,12331,5326,17657,85200,2016
39035,40.4,1258710,755023,370032,68117,304828,45289,534559,315085,219474,534559,122200,2016
39037,42,52185,50348,382,743,14265,47043,20831,15031,5800,20831,112100,2016
39039,39.9,38488,33493,657,3661,10675,50822,15378,11488,3890,15378,109400,2016
39041,38,188996,164066,6555,4546,50644,94234,66544,54052,12492,66544,267600,2016
39043,44.5,75808,63576,5948,3050,20116,48276,31731,21975,9756,31731,130900,2016
39045,39.3,150163,131689,10067,2987,40102,61473,55138,39239,15899,55138,164400,2016
39047,41.3,28719,26749,565,539,7834,41954,11666,7171,4495,11666,107100,2016
39049,33.9,1232118,802454,263960,62758,286706,54037,489010,260835,228175,489010,153100,2016
39051,40,42466,38096,193,3502,11683,55860,16240,12660,3580,16240,131100,2016
39053,40.5,30376,28479,816,368,8009,39423,11495,8598,2897,11495,101200,2016
39055,44.2,94020,90106,1181,1217,26346,74165,34890,29806,5084,34890,221500,2016
39057,38,164325,138696,11537,4308,42153,61116,64279,42968,21311,64279,161600,2016
39059,42.3,39478,37507,491,427,10363,41566,15863,11495,4368,15863,98600,2016
39061,37,805965,534797,206765,23300,194795,50399,335334,193350,141984,335334,143700,2016
39063,38.9,75672,68059,1025,3835,19929,51604,31549,21885,9664,31549,130700,2016
39065,35.8,31652,30203,190,472,7716,44842,11588,8359,3229,11588,93500,2016
39067,46.2,15521,14781,315,131,4340,44000,6242,5045,1197,6242,85300,2016
39069,41.4,27890,25246,126,2037,7870,54941,11035,8783,2252,11035,113600,2016
39071,40.2,43109,41225,433,384,11131,40593,16635,11702,4933,16635,102300,2016
39073,42.7,28690,27733,259,245,7970,43382,11326,8346,2980,11326,114400,2016
39075,30.6,43702,42808,75,392,10128,53619,12500,9505,2995,12500,170500,2016
39077,39.4,58704,53329,712,3528,15534,48838,22521,15914,6607,22521,117000,2016
39079,40.3,32717,31470,244,316,8558,40330,12814,8525,4289,12814,90800,2016
39081,44.5,67607,61260,3658,900,17844,42327,27776,19339,8437,27776,87100,2016
39083,39,60878,58187,534,855,15223,48619,23029,16276,6753,23029,135600,2016
39085,43.3,229266,205230,8424,9018,62208,59958,95249,70303,24946,95249,149300,2016
39087,41.4,61503,58400,1385,541,15497,44256,23243,17109,6134,23243,101600,2016
39089,39.8,169762,155199,5703,2820,44806,57571,64034,45865,18169,64034,153900,2016
39091,41.2,45388,42616,741,637,12908,51136,18720,13741,4979,18720,124400,2016
39093,41.2,304091,240839,23852,28288,79657,53459,117609,83884,33725,117609,138600,2016
39095,37.9,434800,303240,81711,29012,105877,42917,178477,107459,71018,178477,105500,2016
39097,40.2,43537,38821,2489,741,10290,58326,14809,10369,4440,14809,150900,2016
39099,43.4,233015,178720,34824,12442,60361,41872,97484,66569,30915,97484,98300,2016
39101,40.5,65620,58339,3649,1605,16430,43557,24418,16694,7724,24418,93400,2016
39103,41.8,175543,165491,2536,3288,47804,69319,66465,52972,13493,66465,182100,2016
39105,42.8,23345,22625,288,130,6322,39640,9204,7140,2064,9204,86300,2016
39107,40,40886,39222,200,718,11473,55220,16109,12236,3873,16109,134800,2016
39109,41.4,103864,96583,2029,1574,27237,53432,41106,28744,12362,41106,137600,2016
39111,46.3,14442,14083,44,72,4261,41368,5986,4534,1452,5986,93200,2016
39113,39.4,532761,381909,109245,13960,133983,45394,222677,135392,87285,222677,109600,2016
39115,43.8,14857,13738,470,118,4115,38941,5932,4551,1381,5932,91400,2016
39117,41.5,35032,33710,196,491,9365,53032,12606,10259,2347,12606,137800,2016
39119,40.2,85991,79039,2832,844,22686,42464,34178,22913,11265,34178,110500,2016
39121,47.9,14429,13195,795,114,3214,41398,4863,4057,806,4863,88100,2016
39123,47.8,40981,37937,467,1971,11737,54580,17384,13587,3797,17384,144200,2016
39125,41.3,19057,17644,198,867,5350,48003,7659,5963,1696,7659,91100,2016
39127,39.8,35947,34859,97,268,10047,43674,13535,9926,3609,13535,96100,2016
39129,39.3,56804,52870,1782,755,14004,58706,19173,14240,4933,19173,150100,2016
39131,40.8,28298,27016,199,266,7376,41128,10908,7445,3463,10908,97800,2016
39133,37.7,161796,146103,6493,2595,39693,52427,61585,42335,19250,61585,150400,2016
39135,42.2,41561,40198,205,302,11524,51356,16048,12273,3775,16048,116600,2016
39137,39.4,34116,31658,101,2013,9628,60245,13092,10518,2574,13092,143200,2016
39139,41.2,121888,104823,9112,2078,30724,42849,47935,32518,15417,47935,102600,2016
39141,40.4,77193,69367,3348,890,19672,44587,28308,20068,8240,28308,111700,2016
39143,41.5,59870,50998,1847,5711,15980,49032,23666,17420,6246,23666,111300,2016
39145,39.7,77366,72370,2073,964,18950,37936,29778,20360,9418,29778,92000,2016
39147,39.4,55711,50414,1289,2684,14374,48415,21349,15417,5932,21349,97000,2016
39149,39.5,48949,45695,1450,722,13334,56169,18428,13051,5377,18428,134400,2016
39151,41.7,374762,326192,26949,6939,99415,48714,151101,103854,47247,151101,124000,2016
39153,40.8,541372,423586,77108,10170,138243,51562,221887,145616,76271,221887,134300,2016
39155,43.8,204908,179332,16799,3311,55179,43811,86508,60787,25721,86508,99400,2016
39157,40.9,92579,88094,745,2175,24676,46992,36325,25506,10819,36325,114400,2016
39159,38.2,53955,49033,1265,818,13876,71282,18798,14566,4232,18798,174300,2016
39161,41.4,28501,26935,333,823,7912,50547,11427,8685,2742,11427,98900,2016
39163,41,13128,12718,29,28,3376,41080,4942,3778,1164,4942,84100,2016
39165,39.1,222184,194312,7514,5630,59436,76200,79466,61132,18334,79466,196200,2016
39167,43.6,61154,58319,673,620,16646,44763,25306,18875,6431,25306,114000,2016
39169,38.8,115747,108846,1796,2081,30431,51363,43037,31079,11958,43037,136400,2016
39171,41.6,37270,34763,402,1507,9696,45044,15077,11233,3844,15077,95200,2016
39173,34.7,129418,114946,3401,6761,31025,55985,50025,33290,16735,50025,149100,2016
39175,41.7,22359,21345,93,580,6130,50723,9144,6696,2448,9144,111500,2016
40001,37.1,22161,9099,79,1362,5703,33184,7876,5510,2366,7876,77100,2016
40003,44.1,5784,4325,125,289,1361,52226,2028,1499,529,2028,67600,2016
40005,40.7,13847,9963,509,471,3636,36528,5198,3779,1419,5198,93200,2016
40007,41,5479,4204,9,1191,1506,52908,2087,1612,475,2087,97000,2016
40009,34.9,23290,17806,803,3215,5243,48851,7508,4788,2720,7508,123200,2016
40011,41.7,9777,7264,505,938,2400,44216,3709,2788,921,3709,82900,2016
40013,37.5,44529,32212,815,2462,10646,39936,16633,10741,5892,16633,96100,2016
40015,37.2,29510,17017,729,3451,6980,40199,10368,7232,3136,10368,79400,2016
40017,35.7,129571,100739,2981,10250,31951,66664,43247,33203,10044,43247,148800,2016
40019,38.2,48530,34570,3257,3181,11896,46913,18071,12530,5541,18071,102200,2016
40021,34.9,48267,23533,600,3238,10667,38585,16386,10954,5432,16386,108700,2016
40023,42.4,15051,9312,1698,572,3806,30870,5927,4169,1758,5927,84200,2016
40025,44.6,2269,1710,6,476,646,44550,971,708,263,971,57100,2016
40027,33.4,271818,199546,12136,21658,66964,58488,101112,65936,35176,101112,150400,2016
40029,42.4,5755,4060,18,228,1530,39231,2252,1611,641,2252,85200,2016
40031,32,124583,71317,20388,15486,28273,47238,42929,23342,19587,42929,118700,2016
40033,41,6062,4661,123,429,1711,48732,2368,1799,569,2368,79300,2016
40035,42.6,14683,9479,439,480,3666,40036,5380,4030,1350,5380,91400,2016
40037,40.6,70931,54780,1530,2631,18708,46517,26264,19657,6607,26264,106600,2016
40039,30.5,29248,20500,896,4887,7218,47250,10457,6177,4280,10457,125100,2016
40041,46.2,41433,26665,129,1458,11242,38438,16502,12463,4039,16502,110500,2016
40043,40.6,4862,4075,8,309,1256,51654,1811,1311,500,1811,85600,2016
40045,43.9,4123,3596,0,303,1057,52222,1626,1267,359,1626,79900,2016
40047,36,62481,47816,1834,7055,16761,49675,23981,15632,8349,23981,100800,2016
40049,39.5,27570,21189,677,2117,6901,41250,10447,7216,3231,10447,89100,2016
40051,38.4,53955,44280,1144,2897,14359,54043,19554,14911,4643,19554,114900,2016
40053,45,4497,4010,61,202,1290,54040,1967,1468,499,1967,78400,2016
40055,41,6081,4617,465,654,1274,36891,2107,1461,646,2107,73800,2016
40057,41.1,2813,1686,193,768,758,35676,1170,826,344,1170,50000,2016
40059,39.9,3785,2892,4,799,910,48173,1361,1086,275,1361,73700,2016
40061,40.4,12835,9216,92,500,3388,36067,4785,3546,1239,4785,84500,2016
40063,39.9,13727,8843,799,652,2893,35257,4224,3165,1059,4224,68500,2016
40065,34.3,25864,16503,1901,5918,6732,44331,10151,5965,4186,10151,89100,2016
40067,42.1,6280,4941,79,598,1575,35063,2424,1740,684,2424,60000,2016
40069,40.1,11027,7751,207,519,2755,38155,4157,2963,1194,4157,76600,2016
40071,38.6,45398,34456,868,3305,11419,42831,18132,12370,5762,18132,80700,2016
40073,38.3,15392,11964,130,2290,4118,62912,5645,4459,1186,5645,126100,2016
40075,43.3,9239,6956,344,1000,2631,38853,3956,2712,1244,3956,59600,2016
40077,39,10643,7088,128,349,2881,39701,4041,2751,1290,4041,81000,2016
40079,39.7,49885,35999,1181,3380,12877,37548,18313,13343,4970,18313,83400,2016
40081,41.1,34640,28824,612,1061,9267,46592,13047,10240,2807,13047,99900,2016
40083,37.8,45171,35166,4005,2512,11063,55698,15273,12030,3243,15273,151100,2016
40085,39.2,9768,7100,168,1402,2333,46646,3113,2469,644,3113,90900,2016
40087,38.3,37222,29702,356,2842,10189,58673,13532,10718,2814,13532,158600,2016
40089,38.9,33071,20981,2693,1833,9078,33439,12973,9122,3851,12973,74700,2016
40091,47.4,20161,13836,676,509,5657,36878,8302,6427,1875,8302,96000,2016
40093,41.2,7721,6621,38,702,2128,51602,2975,2239,736,2975,91700,2016
40095,42.6,16079,10720,232,2647,4118,42886,5969,4545,1424,5969,85300,2016
40097,39.7,40923,26847,174,1300,11224,43302,15735,11696,4039,15735,106200,2016
40099,42,13792,10162,240,795,3681,51752,5387,3591,1796,5387,99300,2016
40101,37.8,69939,39838,7667,4006,17506,41117,26168,17480,8688,26168,94800,2016
40103,41.5,11470,9421,126,378,3423,49367,4699,3463,1236,4699,92800,2016
40105,42,10510,7052,224,300,2873,40302,4087,3100,987,4087,78700,2016
40107,39.9,12212,7553,970,468,2733,36044,3959,2881,1078,3959,79300,2016
40109,34.3,764698,439118,112956,125150,182660,48987,294672,172902,121770,294672,137500,2016
40111,39.1,39322,24827,3297,1443,9552,38712,14835,10464,4371,14835,80600,2016
40113,42,47923,30705,5424,1570,12754,46342,18218,14176,4042,18218,105100,2016
40115,38.4,32022,21119,263,1677,8157,37139,11982,8327,3655,11982,82300,2016
40117,41.9,16444,12767,181,447,4547,45902,6238,4744,1494,6238,87000,2016
40119,27.1,79953,62106,2848,3571,16325,38085,30164,14831,15333,30164,142800,2016
40121,40.8,44643,31325,1508,2059,11888,43601,17903,12856,5047,17903,96700,2016
40123,35.3,38213,25597,775,1866,9459,44041,14625,9389,5236,14625,113100,2016
40125,37.5,71551,52473,2166,3402,17848,44351,25938,17753,8185,25938,105800,2016
40127,44.9,11149,8127,109,357,2903,33784,4655,3539,1116,4655,71600,2016
40129,40.2,3732,3171,4,242,852,48462,1324,962,362,1324,93300,2016
40131,38.9,89970,65533,873,3779,25111,59828,33570,26358,7212,33570,148600,2016
40133,39.4,25403,16648,1232,1154,6286,36870,9162,6461,2701,9162,70200,2016
40135,40,41344,26410,749,1549,11077,36301,15467,11007,4460,15467,90900,2016
40137,40.2,44631,36225,878,3125,11557,43493,17527,12409,5118,17527,100400,2016
40139,32,21499,9973,648,9683,4906,51503,7038,4494,2544,7038,98600,2016
40141,40.8,7611,4643,613,1929,2126,37880,3159,2335,824,3159,55300,2016
40143,35.4,629823,400518,61606,74451,157721,50654,248811,146954,101857,248811,141700,2016
40145,38.5,76190,55221,2674,4170,20888,57590,27871,22096,5775,27871,144900,2016
40147,40.4,51892,38334,1277,2932,13845,50038,20810,14588,6222,20810,111900,2016
40149,38.5,11626,9776,9,1101,3305,48715,4539,3274,1265,4539,80800,2016
40151,33.6,9125,7689,247,578,2045,57079,3347,2291,1056,3347,92700,2016
40153,36.1,21111,17103,151,2509,5110,58569,7301,5230,2071,7301,122200,2016
41001,48.2,16030,14657,65,615,4282,41722,7011,4731,2280,7011,147100,2016
41003,32.6,87455,71510,851,6100,19033,52015,34193,19561,14632,34193,276900,2016
41005,41.4,394967,328760,3163,32503,103760,68915,151150,104124,47026,151150,319100,2016
41007,43.7,37660,32445,267,3074,9706,47492,15876,9567,6309,15876,245400,2016
41009,43.3,49645,44362,303,2301,12801,55146,18941,13606,5335,18941,213200,2016
41011,48.2,62944,53888,403,3910,15774,39110,25755,16700,9055,25755,169900,2016
41013,48.3,21334,18903,39,1588,5922,39583,9155,6316,2839,9155,172600,2016
41015,55.1,22364,19513,87,1457,5901,38661,10396,6863,3533,10396,222100,2016
41017,42,170813,150077,797,13029,44969,54211,67880,44313,23567,67880,275300,2016
41019,47,107375,95301,380,5649,28883,42052,43937,29688,14249,43937,170000,2016
41021,46.5,1913,1657,6,186,516,40556,788,501,287,788,112800,2016
41023,52.4,7227,6650,30,253,2064,40193,3151,2293,858,3151,158800,2016
41025,46.1,7214,6294,46,356,2091,38431,3059,2160,899,3059,104300,2016
41027,39.1,22842,14741,111,7046,5207,56581,8213,5305,2908,8213,325200,2016
41029,42.9,210916,173329,1321,25058,53989,46343,83969,52858,31111,83969,224500,2016
41031,40.2,22305,13410,226,4421,5391,47063,7577,5213,2364,7577,159400,2016
41033,47.9,84063,73736,297,5850,22221,37867,34778,22940,11838,34778,225100,2016
41035,42.6,65946,52273,394,7823,17545,41951,27084,17362,9722,27084,148100,2016
41037,48.7,7799,6679,44,592,1908,33453,3409,2105,1304,3409,116600,2016
41039,39.3,360273,299530,3442,29403,86986,45222,146692,86210,60482,146692,221000,2016
41041,50.7,46685,38725,205,4028,12331,41303,20434,12893,7541,20434,216300,2016
41043,39.5,119862,103248,591,10054,30829,46782,45378,29268,16110,45378,173100,2016
41045,36.4,30474,18902,306,10015,6904,34720,10294,6100,4194,10294,123400,2016
41047,36,326527,218448,3547,83659,79250,50775,115196,68730,46466,115196,192900,2016
41049,37.4,11207,6857,15,3886,2928,54441,3848,2767,1081,3848,124400,2016
41051,36.7,778193,553241,41100,86579,171550,57449,313181,168631,144550,313181,297300,2016
41053,37.3,78470,62253,621,10232,19687,54010,28725,18567,10158,28725,215000,2016
41055,50.1,1705,1506,8,87,460,41389,804,494,310,804,150600,2016
41057,48.1,25552,21733,79,2573,6376,43777,10154,7138,3016,10154,222700,2016
41059,35.9,76582,51612,519,19596,18228,49287,26669,16931,9738,26669,143400,2016
41061,39.7,25758,23106,170,1131,6509,45564,10119,6453,3666,10119,170500,2016
41063,52.7,6836,6407,27,174,1919,42349,3039,2062,977,3039,211200,2016
41065,41.6,25657,19499,109,4289,6501,46814,9883,6310,3573,9883,182300,2016
41067,36.2,564088,382165,10013,91495,141787,69743,209309,125763,83546,209309,301600,2016
41069,59.2,1369,1291,0,26,442,33400,696,518,178,696,114700,2016
41071,38.1,102217,79759,777,15768,24960,54951,35002,23546,11456,35002,236300,2016
42001,43.1,101759,91341,1376,6721,27320,61927,38269,29759,8510,38269,194800,2016
42003,40.8,1230360,976515,157794,23255,303753,54357,531075,343625,187450,531075,134400,2016
42005,46,67512,65713,634,456,18908,45879,28250,21373,6877,28250,95700,2016
42007,44.8,169205,152033,10140,2409,45872,51887,69921,51180,18741,69921,123800,2016
42009,45.4,48852,47388,231,545,13584,46746,19757,15772,3985,19757,125000,2016
42011,39.8,414097,306740,16919,77946,105227,57068,152451,109472,42979,152451,169000,2016
42013,43.1,125917,119652,1984,1430,32372,44033,50954,36009,14945,50954,112600,2016
42015,44.3,61808,59417,341,886,16667,51035,24483,18310,6173,24483,139200,2016
42017,43.3,626220,533846,23269,30399,166486,79559,233517,178754,54763,233517,311600,2016
42019,43,185974,177021,1953,2440,50894,63345,74762,57355,17407,74762,183200,2016
42021,44.7,137762,128193,4380,2102,36128,42917,57214,42387,14827,57214,88200,2016
42023,50.4,4807,4663,29,39,1292,40347,2187,1508,679,2187,68400,2016
42025,45.5,64330,59621,1029,2616,16910,50822,25813,20138,5675,25813,141300,2016
42027,30.8,159178,137126,5526,4390,32853,54407,57037,34796,22241,57037,206000,2016
42029,40.3,512028,412876,29039,36161,131242,88995,186721,140527,46194,186721,331000,2016
42031,40.8,38939,37514,417,301,9948,42890,15848,10988,4860,15848,108100,2016
42033,43.9,81170,75736,1847,2309,20671,43361,31303,24239,7064,31303,88300,2016
42035,37.9,39536,37712,607,537,9779,47163,14710,10394,4316,14710,119500,2016
42037,40.1,66772,62444,1180,1685,16767,46952,26356,18343,8013,26356,140100,2016
42039,42.6,87027,82829,1573,1017,23147,45637,34526,25380,9146,34526,106700,2016
42041,40.7,243838,213028,8384,8282,62004,62640,96501,68118,28383,96501,191700,2016
42043,39.6,271962,184457,47610,22415,69660,54968,110211,69706,40505,110211,161000,2016
42045,39,562316,385607,115486,19528,136213,66576,203610,141292,62318,203610,233300,2016
42047,46.6,31111,30332,142,223,8538,47917,13362,10503,2859,13362,92200,2016
42049,38.9,279133,237669,18681,10844,69521,47094,110047,72472,37575,110047,120300,2016
42051,44.4,134229,123837,5340,1385,33477,40511,53654,38988,14666,53654,92000,2016
42053,42.8,7493,4455,2292,565,1061,36594,1816,1538,278,1816,85600,2016
42055,40.9,152707,135863,5643,7724,41017,55751,59392,42175,17217,59392,174400,2016
42057,44,14653,14138,196,158,4161,49420,5989,4689,1300,5989,151700,2016
42059,42,37669,34881,1563,536,9545,49116,14400,10483,3917,14400,102100,2016
42061,42.7,45844,41757,2353,853,11482,45250,16975,12799,4176,16975,120600,2016
42063,39,87491,82198,1992,1106,21365,45118,34059,24142,9917,34059,107600,2016
42065,43.8,44575,43413,280,363,12346,43913,18360,13742,4618,18360,94200,2016
42067,43.2,24811,23581,234,766,6430,49028,9326,7064,2262,9326,146200,2016
42069,42.2,213006,186142,5626,13462,51845,46673,85174,56117,29057,85174,147100,2016
42071,38.5,533110,443295,18835,52083,138123,59237,196171,134255,61916,196171,191400,2016
42073,44.6,88528,81656,3329,1103,24098,45764,36302,26755,9547,36302,99300,2016
42075,41.2,136950,115065,2434,16007,35822,56191,52247,36350,15897,52247,164900,2016
42077,39.5,358792,242465,18937,78318,90319,57685,135363,89060,46303,135363,192300,2016
42079,43,318917,270608,10589,29797,80743,46577,127514,86663,40851,127514,123500,2016
42081,41.2,116313,105644,5483,2075,29609,48731,45587,31989,13598,45587,141100,2016
42083,42.5,42609,39872,1026,887,11041,44023,17259,12816,4443,17259,76000,2016
42085,44.1,114598,103682,6484,1514,30115,45831,45350,33291,12059,45350,111000,2016
42087,43.5,46585,44864,295,633,12525,42019,18695,13118,5577,18695,99700,2016
42089,42,167126,113840,21363,24474,40649,58980,57127,44224,12903,57127,170600,2016
42091,41.2,815876,628870,70800,38600,212317,81902,309884,223629,86255,309884,293800,2016
42093,43.2,18404,16993,317,441,4558,55233,7361,5342,2019,7361,170700,2016
42095,41.9,300520,235672,13725,36294,78084,62753,112819,80275,32544,112819,207700,2016
42097,44.2,93590,87199,2307,2852,24877,43701,39192,27836,11356,39192,109200,2016
42099,42.5,45647,43804,392,769,12651,58585,17883,14277,3606,17883,161800,2016
42101,33.9,1559938,550157,648187,214770,310729,39770,582594,305214,277380,582594,147300,2016
42103,46.7,56210,45883,3085,5657,15231,61199,21135,17793,3342,21135,180600,2016
42105,46.3,17239,16672,86,207,4271,40921,6623,5088,1535,6623,101300,2016
42107,44.1,145503,133944,3782,5219,37832,46573,58341,43484,14857,58341,95200,2016
42109,39.5,40246,38342,369,864,10522,51110,14528,10600,3928,14528,152500,2016
42111,45.5,76201,72235,1987,1021,20406,45424,29630,23197,6433,29630,100000,2016
42113,52.4,6302,5894,149,109,1626,44926,2647,2186,461,2647,145800,2016
42115,46.9,41832,40347,229,713,11719,50160,17368,13345,4023,17368,154100,2016
42117,43.2,42031,40484,220,523,10998,48449,16340,12165,4175,16340,129900,2016
42119,39.1,45178,38103,2897,2572,9912,51349,14649,10395,4254,14649,164900,2016
42121,45.8,53460,51390,390,567,14904,43885,21962,16606,5356,21962,82700,2016
42123,46.4,40649,39435,187,406,10839,44977,16904,12953,3951,16904,90900,2016
42125,44.3,208269,193163,5870,3133,55418,57534,83745,63190,20555,83745,156000,2016
42127,47,51307,46713,1654,2080,12938,50595,19173,15167,4006,19173,174500,2016
42129,46.3,359377,338647,8531,3825,100335,54142,150697,116661,34036,150697,140600,2016
42131,43.7,27975,26821,243,498,7282,53397,10801,8513,2288,10801,162400,2016
42133,40.8,440604,373304,23152,29299,116599,59853,168008,125132,42876,168008,168300,2016
44001,44.1,49228,45812,618,1252,12624,73096,19299,13574,5725,19299,330000,2016
44003,43.7,164886,148288,2193,6742,43204,65592,68661,48122,20539,68661,208400,2016
44005,44.2,82714,71313,2446,4408,21282,71347,35268,21473,13795,35268,352900,2016
44007,37.3,631344,399290,50217,132321,146674,50637,237459,125723,111736,237459,209800,2016
44009,43.9,126319,115575,1874,3652,32680,74302,49553,35856,13697,49553,315100,2016
45001,43.6,24951,17196,6777,326,6258,34652,9499,7372,2127,9499,88100,2016
45003,40.8,165146,110512,40155,8925,43701,46454,64455,47110,17345,64455,134000,2016
45005,39.3,9589,2176,7076,289,2074,24817,3357,2171,1186,3357,53700,2016
45007,40.5,192709,149934,30909,6550,51795,43518,74814,52969,21845,74814,130300,2016
45009,41,15057,5331,9419,167,3585,32321,5732,4267,1465,5732,65200,2016
45011,40.4,21917,11236,9848,490,5671,34787,8206,5856,2350,8206,76600,2016
45013,43.6,175316,117777,31877,19775,45793,59227,67345,47483,19862,67345,273000,2016
45015,35.6,199081,127620,47945,12126,49576,54484,70482,49196,21286,70482,160900,2016
45017,45.8,14886,7964,6223,521,3919,42779,6102,4642,1460,6102,98500,2016
45019,36.8,380673,242074,106727,19072,88557,54931,150921,91242,59679,150921,252700,2016
45021,39.1,56274,41228,11254,2269,13059,35719,20353,14159,6194,20353,90400,2016
45023,41.3,32435,19107,12082,588,7926,34319,12265,8985,3280,12265,89300,2016
45025,41.5,46083,28126,14813,1885,12655,35733,18172,12940,5232,18172,79100,2016
45027,43.1,34056,16081,16504,1001,8918,34106,13282,9868,3414,13282,87200,2016
45029,42.2,37884,21329,14352,1123,9737,33918,14865,10754,4111,14865,85800,2016
45031,41.2,67689,37386,27566,1247,17221,34773,26407,18033,8374,26407,84700,2016
45033,37.5,31273,14560,14216,831,7486,30955,11133,7220,3913,11133,65800,2016
45035,36,148517,96401,37109,7252,37449,56345,53005,36921,16084,53005,169700,2016
45037,42.3,26388,14855,9656,1498,6562,48114,9084,6893,2191,9084,119300,2016
45039,44.8,23025,8626,13026,447,5844,33798,8878,6562,2316,8878,96300,2016
45041,38.5,138575,73259,58004,3342,35408,42523,51749,34372,17377,51749,126100,2016
45043,47.9,60804,38325,19279,1849,17076,45299,24379,18591,5788,24379,165400,2016
45045,37.9,482191,334238,87132,41910,122239,51595,182466,119890,62576,182466,160900,2016
45047,39.1,69881,42119,21545,4041,17425,37631,26806,16885,9921,26806,109700,2016
45049,40.1,20296,8350,11206,439,4560,31734,7290,5433,1857,7290,75500,2016
45051,43.8,300418,231875,40448,17928,78709,44746,122125,84447,37678,122125,162100,2016
45053,37.9,27186,11154,11918,3652,6698,38991,9298,6415,2883,9298,112100,2016
45055,41.8,63090,43596,15300,2592,17000,46328,24106,19452,4654,24106,120600,2016
45057,41.5,83704,58703,18740,4132,20952,46852,30270,23833,6437,30270,157700,2016
45059,40.8,66442,45371,16560,2871,17914,39848,25465,17842,7623,25465,86500,2016
45061,40.8,18189,5944,11403,415,4209,31169,6400,4881,1519,6400,68100,2016
45063,38.8,277702,210760,39756,15664,73031,55412,107527,79187,28340,107527,143900,2016
45065,52.4,9806,4797,4697,117,2747,41029,3980,3061,919,3980,120800,2016
45067,40.2,31975,12493,18077,845,8079,30562,12090,8467,3623,12090,73400,2016
45069,39.4,27702,10874,13993,920,6611,32601,9736,6561,3175,9736,63300,2016
45071,41.3,37750,22649,11577,2740,9877,39841,14504,10555,3949,14504,100600,2016
45073,44.9,75375,64187,5497,3700,20932,41818,30867,22517,8350,30867,151100,2016
45075,39.1,89731,29984,55273,1810,20738,34763,33361,22898,10463,33361,91200,2016
45077,35.8,120722,104294,7814,4124,29368,43531,45622,31182,14440,45622,124900,2016
45079,32.9,401743,175864,184183,19969,89094,50899,147329,86952,60377,147329,151500,2016
45081,41.2,20113,11712,5111,2994,5193,41458,7106,5174,1932,7106,93300,2016
45083,38.2,294229,203304,60338,18616,76248,45219,111462,76452,35010,111462,124900,2016
45085,35.8,107682,49625,50141,3979,27839,40777,40815,26634,14181,40815,108900,2016
45087,43.7,27928,18263,8611,349,7662,34953,11598,8216,3382,11598,74500,2016
45089,41.5,32816,10240,21364,741,8002,28494,12035,9017,3018,12035,68100,2016
45091,38.2,245606,175708,45843,12240,65394,56482,92298,65104,27194,92298,166700,2016
46003,41.4,2732,2431,41,173,725,52620,1143,902,241,1143,69000,2016
46005,38.3,18155,14586,50,1631,4593,48423,7513,4909,2604,7513,106400,2016
46007,29.4,3445,1047,34,207,708,45820,975,597,378,975,60900,2016
46009,43.7,7001,6136,95,219,1598,48023,2507,1881,626,2507,75900,2016
46011,26.3,33435,30455,470,827,7040,52086,12361,7336,5025,12361,160500,2016
46013,37.7,38430,34276,598,929,10111,53073,16128,10844,5284,16128,149000,2016
46015,40,5312,4532,0,124,1487,50696,2083,1450,633,2083,106900,2016
46017,25.1,2052,293,8,33,414,31293,496,216,280,496,60000,2016
46019,40.6,10268,9428,70,353,2662,43750,4181,3094,1087,4181,119000,2016
46021,49.8,1553,1470,0,3,402,45800,682,556,126,682,63800,2016
46023,36.3,9277,5863,5,266,2131,43376,3218,2231,987,3218,90800,2016
46025,42.4,3639,3439,49,62,871,48563,1501,1156,345,1501,77000,2016
46027,24.9,14029,12423,214,367,2561,38399,5317,2742,2575,5317,137500,2016
46029,38.1,27886,25979,69,576,7231,50133,11857,7800,4057,11857,159300,2016
46031,29.7,4170,1248,16,28,956,32115,1230,612,618,1230,56000,2016
46033,53.2,8447,7666,17,253,2590,52891,3852,3184,668,3852,202000,2016
46035,38.1,19824,18216,126,473,5269,48310,8625,5163,3462,8625,137900,2016
46037,48.5,5588,4829,0,119,1642,40647,2562,1863,699,2562,83600,2016
46039,44.5,4309,4265,0,30,1207,54781,1824,1534,290,1824,117700,2016
46041,28.5,5652,1178,8,57,1095,40585,1651,986,665,1651,63200,2016
46043,48.4,2961,2811,0,24,874,51290,1278,1026,252,1278,75100,2016
46045,44.5,4000,3829,5,43,1150,62467,1593,1327,266,1593,112300,2016
46047,52.6,6874,5875,66,254,1825,45750,3082,2187,895,3082,115900,2016
46049,50,2354,2214,1,51,571,43529,974,747,227,974,84300,2016
46051,44,7195,6786,29,219,2196,54180,3230,2600,630,3230,116200,2016
46053,46.3,4217,3738,0,59,1176,40045,1917,1331,586,1917,63400,2016
46055,46.5,2073,1841,0,23,608,39554,869,667,202,869,74800,2016
46057,36.3,5995,5678,12,211,1644,60169,2209,1801,408,2209,114800,2016
46059,48.2,3311,3262,1,13,921,52266,1468,1040,428,1468,96000,2016
46061,35.5,3390,3162,127,20,781,60089,1060,929,131,1060,114100,2016
46063,42.9,1277,1216,8,17,312,51458,495,342,153,495,88100,2016
46065,38.5,17518,14430,84,517,4147,58934,7260,4616,2644,7260,170700,2016
46067,44.6,7264,6931,29,131,1945,47356,2875,2174,701,2875,74400,2016
46069,48.3,1440,1221,0,15,374,55000,578,462,116,578,80800,2016
46071,30,3268,1430,7,54,673,41510,994,617,377,994,54700,2016
46073,47.2,2029,1957,0,51,564,51442,868,638,230,868,80500,2016
46075,53.1,767,730,16,4,213,39276,419,290,129,419,58100,2016
46077,46.5,5070,4820,0,113,1480,54568,2331,1836,495,2331,93800,2016
46079,42.2,12331,11565,63,287,3080,57239,4696,3546,1150,4696,147100,2016
46081,41.4,24859,22680,238,776,6562,48220,10750,7012,3738,10750,190000,2016
46083,34.2,51396,48256,445,910,13506,77455,18230,14287,3943,18230,198500,2016
46085,35.4,3855,2182,2,76,996,45921,1380,971,409,1380,73500,2016
46087,42.4,5616,5341,37,166,1560,58485,2210,1705,505,2210,115200,2016
46089,52.3,2252,1959,5,100,596,41338,1004,757,247,1004,55500,2016
46091,41.8,4743,3960,27,208,1119,55398,1737,1229,508,1737,88700,2016
46093,36.2,26840,23666,448,1094,7420,53069,10653,7712,2941,10653,166200,2016
46095,33,2083,820,0,111,491,29471,709,483,226,709,44400,2016
46097,41.1,2299,2180,31,51,610,48542,974,766,208,974,73900,2016
46099,34.8,182014,152761,8050,8512,44933,55293,71569,45426,26143,71569,160100,2016
46101,40,6445,5051,57,205,1812,54383,2661,1927,734,2661,121300,2016
46102,24.6,14263,556,34,494,2404,26330,2932,1567,1365,2932,19800,2016
46103,37.5,107298,86530,1275,5136,26828,51084,42225,28461,13764,42225,166900,2016
46105,47.6,3019,2858,2,48,809,45855,1294,910,384,1294,68600,2016
46107,53.5,2306,2246,0,7,610,47991,1033,834,199,1033,81400,2016
46109,38.6,10294,5998,59,258,2419,50108,3704,2565,1139,3704,92500,2016
46111,47.7,2349,2252,0,59,704,51167,1072,800,272,1072,75600,2016
46115,44.2,6539,6219,10,124,1669,49859,2634,1919,715,2634,74400,2016
46117,41.1,2964,2633,0,73,917,60046,1299,1000,299,1299,142100,2016
46119,42.8,1456,1444,0,3,393,59800,592,452,140,592,122600,2016
46121,24.3,10019,881,32,407,2025,30800,2746,1172,1574,2746,46800,2016
46123,46.5,5475,4486,0,28,1521,41210,2559,1718,841,2559,78800,2016
46125,43.9,8289,7945,45,165,2407,54707,3471,2692,779,3471,107000,2016
46127,41.6,14842,13794,99,431,3873,63890,6037,4494,1543,6037,156500,2016
46129,44.6,5538,4443,23,95,1363,46526,2332,1599,733,2332,80000,2016
46135,41.3,22649,20348,442,791,5671,48723,9035,6050,2985,9035,130500,2016
46137,28.3,2818,658,0,23,620,36552,792,405,387,792,57500,2016
47001,43.3,75545,67876,2756,1908,19683,44241,30660,20554,10106,30660,132300,2016
47003,36.9,46331,36218,3484,5315,12461,43819,17053,11465,5588,17053,121700,2016
47005,46.6,16173,15066,466,355,4305,33611,6786,5212,1574,6786,88200,2016
47007,43,14073,12653,462,295,3444,38535,4635,3480,1155,4635,119400,2016
47009,43,126192,115547,3518,3820,34039,49532,49379,36895,12484,49379,168000,2016
47011,39.3,102860,89366,4876,5729,26979,43721,39178,25591,13587,39178,145000,2016
47013,43.5,40008,38697,230,484,11021,33628,15902,10998,4904,15902,89000,2016
47015,42.1,13855,13105,193,262,3753,43654,5392,3910,1482,5392,135400,2016
47017,42.9,28417,24149,2960,671,7598,36212,11363,8252,3111,11363,85300,2016
47019,44,56707,54017,706,934,15449,33177,23772,16891,6881,23772,111500,2016
47021,40.2,39575,37044,549,1045,10466,53179,14543,11503,3040,14543,163700,2016
47023,37.1,17355,14977,1569,404,4409,42376,6001,4368,1633,6001,107300,2016
47025,42.3,31701,30273,333,353,8699,33428,12783,9061,3722,12783,98500,2016
47027,47.4,7769,7374,111,169,2209,28147,3151,2388,763,3151,89400,2016
47029,44.5,35256,33007,548,735,9700,31081,14564,9984,4580,14564,100100,2016
47031,40.1,53808,48074,1125,2158,14504,45456,21412,14539,6873,21412,116500,2016
47033,39.6,14558,10927,1876,1447,3551,38043,5446,3805,1641,5446,94200,2016
47035,50.1,57895,54911,316,1580,17099,40123,24500,19180,5320,24500,136800,2016
47037,34.2,667885,377904,183425,66461,150156,50484,269078,145206,123872,269078,177700,2016
47039,45.5,11703,10751,325,364,3306,38180,4792,3626,1166,4792,90700,2016
47041,40.9,19159,17156,232,1370,4974,37640,7163,4838,2325,7163,128100,2016
47043,40,50926,45864,2037,1601,13476,47137,18876,13732,5144,18876,143500,2016
47045,40.3,37970,30522,5130,1183,10647,42833,15036,9553,5483,15036,103400,2016
47047,44.4,39071,26612,10774,949,11088,55972,14919,11833,3086,14919,183000,2016
47049,44.3,17936,17377,23,241,5112,31714,7390,5583,1807,7390,105200,2016
47051,41.9,41348,36824,1410,1217,11061,44837,16345,12046,4299,16345,110700,2016
47053,40.3,49511,38150,9031,1219,13449,38854,19406,13795,5611,19406,93000,2016
47055,42.9,29034,24628,2751,606,7761,40635,11478,8001,3477,11478,113900,2016
47057,44.2,22813,21689,117,654,6493,37522,8865,6983,1882,8865,102300,2016
47059,44,68502,64027,1453,1825,18204,36711,27461,19711,7750,27461,113700,2016
47061,43,13494,10835,72,26,3359,28467,5012,3834,1178,5012,79900,2016
47063,40.5,63203,51931,2202,7063,16820,39270,24442,16192,8250,24442,126200,2016
47065,39.3,351305,251303,68661,17813,86646,49434,137309,88678,48631,137309,162900,2016
47067,44.3,6609,6426,26,48,1772,27973,2751,2121,630,2751,83400,2016
47069,39.9,25975,14228,10796,428,5888,33566,8592,6127,2465,8592,84800,2016
47071,45.1,25839,23823,960,531,6888,37244,9940,7694,2246,9940,103900,2016
47073,43.8,56567,54005,709,759,15665,37883,23001,17135,5866,23001,111000,2016
47075,40.4,18129,8097,9067,766,4441,35094,7056,4303,2753,7056,100500,2016
47077,40.4,27952,24542,2200,603,7304,41478,10695,7642,3053,10695,94000,2016
47079,45.1,32291,28307,2777,711,9120,38378,13503,9906,3597,13503,95500,2016
47081,40.4,24251,22049,1150,534,6062,37546,8855,6754,2101,8855,103600,2016
47083,43.5,8234,7604,239,172,2123,40680,3106,2377,729,3106,93200,2016
47085,41.7,18216,16977,612,387,4603,40995,6936,5327,1609,6936,103900,2016
47087,46.1,11526,11055,53,213,3208,32676,4522,3452,1070,4522,99500,2016
47089,42.7,52851,48943,1169,1777,14071,43673,19767,14519,5248,19767,130900,2016
47091,44.8,17923,16534,689,323,4595,30180,6915,5195,1720,6915,114200,2016
47093,37.3,448164,371652,39700,17201,111480,50366,181336,116064,65272,181336,164700,2016
47095,40.7,7643,5159,2151,162,1430,29893,2145,1285,860,2145,76000,2016
47097,37.6,27261,16481,9484,649,6843,32353,9745,5698,4047,9745,79900,2016
47099,39.9,42406,39933,782,807,11441,40457,16106,12070,4036,16106,98700,2016
47101,43.6,11907,11125,193,263,3291,36920,4687,3605,1082,4687,89600,2016
47103,42.9,33582,29383,1715,1048,9234,41038,13620,9851,3769,13620,114000,2016
47105,47.2,50637,44943,584,4010,14810,52995,20060,15450,4610,20060,185900,2016
47107,42.9,52606,47245,1978,1872,13539,38661,20016,14620,5396,20016,116900,2016
47109,42.9,26057,23485,1570,490,6588,31956,9839,7268,2571,9839,85400,2016
47111,39.6,22924,21619,49,1105,6236,34098,8977,6598,2379,8977,106400,2016
47113,37.8,98128,55651,36560,3525,25111,44237,37189,23631,13558,37189,123400,2016
47115,43.2,28363,26163,494,471,8115,41477,11219,8083,3136,11219,119000,2016
47117,39.6,31335,26901,2255,1513,8456,44900,12044,8570,3474,12044,114700,2016
47119,39.1,85767,68486,9919,4556,22907,49597,32889,22256,10633,32889,146000,2016
47121,43.9,11804,11180,157,173,3242,35209,4675,3663,1012,4675,103900,2016
47123,43.1,45482,41603,880,1775,12704,37054,17311,13119,4192,17311,113600,2016
47125,30.3,189709,123496,35189,18001,48488,51528,67090,39631,27459,67090,148600,2016
47127,46.5,6314,5912,222,20,1854,49496,2560,2048,512,2560,161800,2016
47129,41.1,21688,20276,1006,248,5342,39728,7221,5859,1362,7221,94300,2016
47131,42.5,30900,25887,3111,1171,8837,38933,12719,8485,4234,12719,87200,2016
47133,42.6,22090,21310,150,281,6122,35065,8881,6947,1934,8881,107200,2016
47135,43.3,7891,7346,233,170,2240,31274,3209,2632,577,3209,81900,2016
47137,49.8,5096,4940,37,32,1642,39014,2128,1807,321,2128,118300,2016
47139,44.6,16697,15946,31,300,4871,41520,6766,5149,1617,6766,109600,2016
47141,36.1,74652,66522,1748,4328,18927,36350,30100,18593,11507,30100,150100,2016
47143,40.3,32461,29609,768,1437,8471,38355,12408,8706,3702,12408,108100,2016
47145,46.3,52983,49414,1252,863,14048,42299,21532,16060,5472,21532,127900,2016
47147,38.5,67905,57227,4950,4165,18593,56331,24730,18586,6144,24730,158800,2016
47149,32.9,290289,213105,39244,20775,71875,58032,103562,67686,35876,103562,164800,2016
47151,38.8,22029,21510,69,161,5497,30897,8368,5896,2472,8368,86700,2016
47153,42.5,14710,12586,35,499,4194,46541,5549,4177,1372,5549,135000,2016
47155,42.4,94537,86054,608,5130,25932,42586,36982,25035,11947,36982,158200,2016
47157,35.1,936990,344997,496478,55763,222005,46854,349956,196638,153318,349956,132200,2016
47159,41.2,19176,17885,480,473,5360,44272,7555,5561,1994,7555,118100,2016
47161,43.4,13257,12194,168,327,3622,41835,5187,3942,1245,5187,125200,2016
47163,44.5,156644,146965,2904,2669,43267,40983,65896,48060,17836,65896,125200,2016
47165,39.5,172786,148094,11678,7500,46190,58972,63240,46137,17103,63240,184900,2016
47167,37.3,61558,46852,11247,1574,16298,54650,21355,15037,6318,21355,140400,2016
47169,39,7970,6826,937,33,2010,47667,2958,2265,693,2958,129100,2016
47171,45.6,17945,16860,126,767,4827,35390,7628,5567,2061,7628,112300,2016
47173,41.5,19081,18444,89,284,5329,38540,7271,5502,1769,7271,112500,2016
47175,45.8,5641,5401,22,51,1584,42813,2141,1890,251,2141,95200,2016
47177,39.9,40099,34614,460,3402,10384,36245,15584,10787,4797,15584,101800,2016
47179,39.7,126044,112748,4904,4012,33187,44444,52409,34417,17992,52409,149200,2016
47181,41.9,16842,15241,1128,312,4286,34008,6020,4999,1021,6020,87600,2016
47183,37.5,34024,29678,3039,741,8629,38040,13459,9155,4304,13459,98200,2016
47185,43.5,26373,24768,485,595,6836,35989,9677,7514,2163,9677,96400,2016
47187,39,205645,176139,8698,9513,57036,100140,71043,57221,13822,71043,368100,2016
47189,40.3,125616,108370,8356,4620,33882,63426,45431,34984,10447,45431,211700,2016
48001,38.9,57772,34680,12246,9799,11573,42146,16572,11896,4676,16572,85800,2016
48003,31.2,17215,7250,256,9360,4172,70121,5392,3893,1499,5392,122000,2016
48005,36.7,87657,54060,12783,18505,22178,44185,30495,19815,10680,30495,89300,2016
48007,50.7,24729,16836,400,6496,6410,44851,9552,7143,2409,9552,154500,2016
48009,44.1,8750,7751,60,722,2452,62407,3331,2729,602,3331,113300,2016
48011,45.9,1913,1601,14,243,515,65000,702,561,141,702,113100,2016
48013,35.4,47710,16610,351,30094,11468,53181,15343,11330,4013,15343,93000,2016
48015,40.8,29107,18573,2468,7423,8255,56681,11222,8260,2962,11222,164300,2016
48017,34.4,7131,2533,152,4401,1767,40589,2317,1733,584,2317,62700,2016
48019,51.3,21015,16636,142,3718,5493,55434,8256,6863,1393,8256,159200,2016
48021,38.5,78286,42621,6108,27528,18665,55808,25822,20106,5716,25822,142100,2016
48023,48.6,3639,3153,67,304,998,34382,1703,1312,391,1703,72600,2016
48025,35.8,32706,10682,2613,18940,6191,44005,8698,5319,3379,8698,76400,2016
48027,30.4,330859,159103,68794,77879,80666,51529,113027,62225,50802,113027,130900,2016
48029,33.2,1858699,536935,132227,1105240,421221,52353,623321,363215,260106,623321,134400,2016
48031,48.7,10918,8515,2,2061,3024,56573,4174,3143,1031,4174,192000,2016
48033,33,698,653,0,33,189,77569,251,176,75,251,103800,2016
48035,46.3,17953,14239,246,3049,5035,45419,7098,5473,1625,7098,95000,2016
48037,37.8,93483,60614,22300,6756,22888,42683,33586,21935,11651,33586,103900,2016
48039,35.5,338419,169092,43217,98927,84461,72006,114290,81646,32644,114290,157100,2016
48041,25.5,209896,120182,21558,51664,41916,41654,75797,34076,41721,75797,164600,2016
48043,42.5,9188,4789,25,4040,2276,38440,4014,2294,1720,4014,117500,2016
48045,43.2,1672,1049,34,522,499,40385,698,524,174,698,63800,2016
48047,31.5,7217,385,7,6819,1472,24913,2031,1337,694,2031,57000,2016
48049,40.9,37935,27742,1569,7967,8963,43235,13361,9495,3866,13361,91000,2016
48051,43,17417,11486,2147,3463,4536,52513,6385,5099,1286,6385,98500,2016
48053,43.9,44584,33231,804,9589,11796,54259,16299,12124,4175,16299,163800,2016
48055,35.6,39848,16667,2782,19853,8960,49533,12664,8384,4280,12664,119400,2016
48057,38.1,21805,9518,594,10432,5499,54167,7800,5394,2406,7800,111500,2016
48059,43.5,13596,11845,188,1213,3292,40568,5239,4260,979,5239,73200,2016
48061,31.3,418785,40622,1597,372685,95923,34578,121290,81071,40219,121290,79900,2016
48063,38.8,12631,7125,2094,2989,3270,40045,4544,3201,1343,4544,80300,2016
48065,40.4,6027,5231,51,576,1666,64554,2324,1999,325,2324,99200,2016
48067,43,30346,23236,5268,1285,8052,39366,11770,9049,2721,11770,85500,2016
48069,34.7,7875,2675,66,4951,1919,42733,2490,1659,831,2490,70400,2016
48071,35.5,38072,25934,3049,8047,10091,70396,12967,10436,2531,12967,158700,2016
48073,37.7,51257,31514,7005,11328,12839,40769,17683,13050,4633,17683,89300,2016
48075,33.5,7059,4605,502,1432,1492,37125,2356,1372,984,2356,73200,2016
48077,45.9,10367,9406,81,571,2826,45341,4106,3456,650,4106,82300,2016
48079,33.8,2955,1121,87,1679,720,38625,1007,795,212,1007,33000,2016
48081,49.1,3228,2484,26,678,956,41756,1567,1114,453,1567,74000,2016
48083,47.2,8476,6588,234,1465,2384,42049,3407,2460,947,3407,63800,2016
48085,36.2,886633,532872,80357,132845,233129,86188,314918,208116,106802,314918,240700,2016
48087,36.9,3032,1767,104,994,810,40257,1097,838,259,1097,57600,2016
48089,43.9,20792,11996,2864,5854,5470,45398,7624,6215,1409,7624,106200,2016
48091,42.5,124234,86024,2430,32746,33770,69666,45338,33941,11397,45338,227000,2016
48093,44.4,13506,9578,138,3637,3602,39054,5079,3988,1091,5079,79400,2016
48095,41.3,4142,1771,29,2297,580,48516,790,582,208,790,100800,2016
48097,40.4,38878,29910,1020,6580,10554,56269,14896,10412,4484,14896,134000,2016
48099,31,75710,45356,10191,13276,16794,49275,22791,12880,9911,22791,103400,2016
48101,48,1560,855,235,446,436,33750,679,454,225,679,42600,2016
48103,33.1,4823,1654,198,2963,1125,60133,1543,1214,329,1543,77800,2016
48105,40.5,3836,1359,14,2421,1018,50646,1431,1083,348,1431,76600,2016
48107,38.7,5987,2454,238,3251,1520,39026,2110,1429,681,2110,56100,2016
48109,40.5,2259,381,9,1764,526,33981,762,505,257,762,60100,2016
48111,31,7052,3672,93,3007,1605,43897,2360,1362,998,2360,79000,2016
48113,33.2,2513054,774653,554464,987849,584003,51411,894542,452284,442258,894542,138600,2016
48115,33.1,13317,4962,736,7401,2911,42354,4329,3095,1234,4329,62200,2016
48117,31.4,19039,5121,173,13458,4510,47219,6081,4018,2063,6081,87400,2016
48119,43.8,5226,4252,431,351,1434,40529,1971,1450,521,1971,71200,2016
48121,34.5,754650,464580,66503,142619,188988,76678,265790,170389,95401,265790,212200,2016
48123,42,20660,11611,1965,7017,5015,50582,7105,5380,1725,7105,104300,2016
48125,42.8,2237,1509,95,625,574,42118,869,631,238,869,50700,2016
48127,34,10842,1464,15,9340,2118,32204,3457,2523,934,3457,61300,2016
48129,40.9,3506,2879,138,363,811,40560,1287,968,319,1287,66400,2016
48131,37.3,11510,1035,148,10256,2755,33115,3892,2638,1254,3892,48400,2016
48133,42.5,18252,14646,387,2852,3875,34434,6752,4947,1805,6752,58800,2016
48135,30.4,153177,54725,6200,88372,35527,58335,50950,33790,17160,50950,112300,2016
48137,49.2,2028,925,2,1100,460,39457,718,636,82,718,73100,2016
48139,35.9,160225,101530,14506,40134,42074,64382,53803,38847,14956,53803,150300,2016
48141,31.6,833592,107156,25358,681709,195728,42075,261415,160380,101035,261415,114700,2016
48143,30.2,40641,30831,632,8217,8786,42492,14197,8651,5546,14197,127100,2016
48145,39.3,17265,8920,4156,3887,3622,38547,5447,3933,1514,5447,65200,2016
48147,41.7,33757,26906,2283,3516,8557,45471,12022,9020,3002,12022,94500,2016
48149,47.7,24909,18039,1589,4953,6624,51290,9553,7411,2142,9553,154700,2016
48151,43.4,3847,2474,137,1203,1039,41531,1650,1201,449,1650,62700,2016
48153,37,6088,2356,157,3479,1817,43070,2444,1718,726,2444,57900,2016
48155,49.5,1320,1078,26,216,331,48068,526,413,113,526,48600,2016
48157,35.7,683756,238565,138876,164065,175964,91152,214126,167037,47089,214126,217600,2016
48159,43.3,10571,8440,450,1445,2828,42652,4114,2999,1115,4114,116600,2016
48161,41.4,19585,13286,3110,2822,5279,45134,7339,5570,1769,7339,82500,2016
48163,31.6,18542,3108,655,14528,3508,37163,4660,3224,1436,4660,71900,2016
48165,28.4,19485,11111,409,7742,4352,58788,5630,4263,1367,5630,102400,2016
48167,37.5,314485,183283,40140,74081,79854,63064,115685,76547,39138,115685,161100,2016
48169,37.9,6614,2672,225,3652,1388,52708,1625,1095,530,1625,83300,2016
48171,50.1,25732,19644,41,5613,7230,55850,10498,8088,2410,10498,254500,2016
48173,37.4,1253,786,0,467,356,62159,438,294,144,438,191500,2016
48175,45.7,7463,4388,391,2634,2151,54375,2798,2295,503,2798,124700,2016
48177,37.3,20370,8710,1246,10108,4706,46630,6611,4489,2122,6611,98800,2016
48179,36.8,23028,14957,981,6300,5438,45264,8201,5974,2227,8201,73700,2016
48181,40.2,124231,95498,7171,15356,32311,50212,47161,31785,15376,47161,110000,2016
48183,35.2,123283,72558,24548,22025,30370,47140,45446,26933,18513,45446,125700,2016
48185,40.4,27140,16069,4320,6250,6213,47839,9000,6946,2054,9000,105800,2016
48187,36.7,147313,76796,9774,54412,37628,64599,49930,37636,12294,49930,169200,2016
48189,32.7,35007,12278,1427,20428,8187,44995,11335,6937,4398,11335,77700,2016
48191,44.2,3162,1816,212,1075,852,27244,1235,764,471,1235,47800,2016
48193,48.3,8232,7060,59,947,2265,45105,3231,2369,862,3231,102300,2016
48195,35.7,5552,2965,3,2534,1460,41335,1979,1437,542,1979,89400,2016
48197,43.3,3952,2630,322,911,927,35156,1590,1154,436,1590,38400,2016
48199,39.1,55624,48496,3091,2879,14835,54352,20408,16222,4186,20408,105100,2016
48201,32.9,4434257,1382851,821066,1855604,1045868,55584,1536259,837912,698347,1536259,145600,2016
48203,37.7,66431,42652,14184,8193,16989,46230,23473,17160,6313,23473,110100,2016
48205,39.5,5966,3748,490,1515,1317,64614,1812,1118,694,1812,148200,2016
48207,42.7,5812,3897,179,1543,1423,41067,2193,1656,537,2193,49200,2016
48209,31.1,185686,104286,6473,68832,41793,60495,64324,40514,23810,64324,195800,2016
48211,33.4,4151,2558,49,1446,1111,67773,1374,940,434,1374,127600,2016
48213,43.7,79213,62852,5136,9312,20977,43434,29785,22287,7498,29785,94100,2016
48215,28.8,828334,57238,3454,757725,185716,36094,227477,154244,73233,227477,81400,2016
48217,42.5,34901,25086,2384,6835,9061,43441,12806,9354,3452,12806,89100,2016
48219,33,23377,11218,841,10843,5880,50331,8103,5465,2638,8103,80800,2016
48221,46.8,54217,46262,365,6308,14116,58315,21040,16106,4934,21040,162600,2016
48223,39.2,35844,26663,2408,5732,9791,45748,13259,9450,3809,13259,96300,2016
48225,44.5,22802,14151,5697,2408,5256,32434,8221,5788,2433,8221,77400,2016
48227,36.9,36423,18500,1820,14757,7314,50977,11229,7460,3769,11229,81800,2016
48229,40.1,3481,653,40,2729,706,26635,940,763,177,940,44300,2016
48231,38.1,89068,65367,7325,13218,21508,45643,31154,21558,9596,31154,96400,2016
48233,36.5,21782,15613,466,4830,5320,50114,7910,6061,1849,7910,72800,2016
48235,42.5,1631,1211,0,379,486,64100,632,483,149,632,153000,2016
48237,40,8866,6952,388,1408,2254,50390,3066,2448,618,3066,77700,2016
48239,38.5,14678,8803,1030,4640,3622,56601,5164,3724,1440,5164,89900,2016
48241,40.4,35640,26573,5902,2322,8108,44552,11910,9003,2907,11910,89300,2016
48243,51.9,2221,1379,12,797,585,50174,1013,768,245,1013,112100,2016
48245,36,252993,107034,84956,47963,59114,44965,94097,58702,35395,94097,99500,2016
48247,36,5218,506,0,4701,1195,34769,1592,1215,377,1592,65500,2016
48249,34.2,41486,7736,253,33159,10124,43321,13557,9468,4089,13557,73300,2016
48251,36.8,157544,117123,3919,31135,41482,59095,53880,39690,14190,53880,124500,2016
48253,39,19944,11130,2870,5354,3862,47007,5580,4161,1419,5580,73200,2016
48255,35.8,14984,5768,1352,7818,2865,46058,4288,3197,1091,4288,90000,2016
48257,35.8,111830,75630,11127,21428,27517,60179,35739,27275,8464,35739,141500,2016
48259,43.4,39010,29055,269,8732,10144,76350,13390,9735,3655,13390,285900,2016
48261,31.7,558,160,0,397,112,24000,170,63,107,170,NA,2016
48263,48.6,667,545,3,116,163,50625,284,202,82,284,72900,2016
48265,48,50505,35511,742,12966,13323,44261,20476,14159,6317,20476,162600,2016
48267,54.5,4453,3386,1,1007,1375,41263,2119,1575,544,2119,114900,2016
48269,39.8,274,210,0,64,66,57083,114,30,84,114,72200,2016
48271,43.5,3578,1338,3,2237,699,34398,1139,911,228,1139,72700,2016
48273,28,31877,6842,1159,22935,6826,41469,10777,5891,4886,10777,86600,2016
48275,41,3807,2300,247,1235,939,42188,1374,1027,347,1374,43300,2016
48277,40.6,49626,37352,6044,3589,13344,40283,19077,12308,6769,19077,86300,2016
48279,36.3,13561,5524,501,7318,3289,41401,4817,3384,1433,4817,65700,2016
48281,41.1,20357,14934,727,3808,5607,50358,7583,5490,2093,7583,138700,2016
48283,33.1,7319,987,87,6123,1356,40094,2101,1454,647,2101,63500,2016
48285,44.3,19654,14658,1309,3484,5582,47753,7741,5920,1821,7741,131000,2016
48287,41,16754,10700,1934,3873,4363,54346,6014,4546,1468,6014,127000,2016
48289,44.8,16923,12968,1220,2365,4419,47441,6279,5025,1254,6279,99600,2016
48291,36.2,78598,52544,8011,16282,18689,49655,25611,19193,6418,25611,89100,2016
48293,39.1,23469,14015,4144,4881,5450,37431,8046,5912,2134,8046,83200,2016
48295,34.8,3507,2364,13,1023,879,60163,1235,928,307,1235,95300,2016
48297,42.2,11976,6699,342,4542,2478,50741,3670,2906,764,3670,84900,2016
48299,56.4,19624,17160,255,1876,5754,48562,8796,6701,2095,8796,169200,2016
48301,58.2,76,55,0,12,17,56875,37,17,20,37,NA,2016
48303,30.6,294682,162620,20186,99863,68162,46859,109024,61357,47667,109024,117100,2016
48305,37.2,5723,2815,107,2711,1568,40722,2157,1532,625,2157,70600,2016
48307,43.9,8242,5206,197,2551,2206,40784,3101,2309,792,3101,75800,2016
48309,33,243394,139471,34520,61161,57827,44246,87185,50710,36475,87185,118200,2016
48311,39.6,671,342,0,323,175,57589,233,174,59,233,78100,2016
48313,35.5,13843,7752,2534,3071,2731,43209,4121,2805,1316,4121,103900,2016
48315,49.2,10191,7220,2422,390,2708,35424,4387,3443,944,4387,89600,2016
48317,32,5451,2862,38,2514,1225,63992,1629,1224,405,1629,108900,2016
48319,49.9,4064,2908,1,1013,1101,38496,1688,1286,402,1688,136600,2016
48321,37.1,36719,16681,3776,14927,9138,41253,13666,9167,4499,13666,98700,2016
48323,29.7,56830,1578,48,54242,13256,37155,16221,11145,5076,16221,93100,2016
48325,38.6,47920,21622,1004,24367,11360,58333,15104,12215,2889,15104,126000,2016
48327,41.8,2163,1218,27,852,614,37917,936,599,337,936,56300,2016
48329,31.9,155817,75541,9175,65856,37822,71424,53960,35878,18082,53960,175700,2016
48331,41.8,24372,15495,2018,6158,6036,39213,9423,6283,3140,9423,82400,2016
48333,46.1,4871,4007,15,832,1293,44375,1875,1575,300,1875,123100,2016
48335,35.5,8995,4353,914,3528,1873,51555,2660,2008,652,2660,60800,2016
48337,43.9,19384,16790,19,2021,5471,46383,8083,5785,2298,8083,93000,2016
48339,36.6,518849,356462,22110,116429,133422,70805,179587,128765,50822,179587,190000,2016
48341,31.1,22186,7544,611,11827,5357,50552,6772,4482,2290,6772,98200,2016
48343,42.9,12653,8304,3046,1108,3621,37902,5015,3702,1313,5015,77000,2016
48345,48.9,1022,883,3,114,276,35433,475,329,146,475,55200,2016
48347,30.4,65556,39447,11600,12238,15125,38915,23942,13536,10406,23942,114300,2016
48349,38.1,48177,27913,6431,12347,12931,43388,17409,11775,5634,17409,83800,2016
48351,40.7,14138,10397,2984,479,2847,36829,4629,3592,1037,4629,72300,2016
48353,38,15017,8672,810,5379,3790,38411,5625,3832,1793,5625,65400,2016
48355,34.9,355667,109553,12914,222473,87518,51882,128133,73535,54598,128133,116600,2016
48357,31.2,10577,4802,9,5517,2631,50011,3587,2549,1038,3587,91800,2016
48359,33.2,2069,1518,107,335,463,52292,616,466,150,616,81100,2016
48361,37.9,83751,68496,6809,5709,22819,51443,32269,24249,8020,32269,101500,2016
48363,41.5,27922,21142,638,5470,7049,42824,10416,7108,3308,10416,87000,2016
48365,38.3,23771,17507,3915,2025,6208,50712,8905,6908,1997,8905,92900,2016
48367,39.7,123601,104775,1813,13788,32856,67979,43270,33492,9778,43270,170100,2016
48369,33.5,9921,3537,146,6127,2483,48589,3219,2232,987,3219,83600,2016
48371,35.4,15826,4176,677,10789,2873,51735,4334,3096,1238,4334,69800,2016
48373,43.4,46583,33214,4893,6654,12518,40864,17790,13595,4195,17790,84600,2016
48375,33.3,121883,55999,11027,45287,27834,40340,43154,24682,18472,43154,88700,2016
48377,40.8,7144,1058,0,5843,1720,33453,2565,1667,898,2565,61600,2016
48379,47.8,11087,9533,264,932,3012,50405,4252,3328,924,4252,95500,2016
48381,35.5,128603,95556,3392,24941,33372,62635,48893,33618,15275,48893,151800,2016
48383,34.9,3625,1158,62,2392,869,59257,1190,833,357,1190,85000,2016
48385,55.5,3348,2681,5,658,769,37059,1192,912,280,1192,110600,2016
48387,45.8,12455,9125,2168,896,3301,35016,5163,3825,1338,5163,62700,2016
48389,35.2,14438,2661,627,10801,2509,46464,3764,2662,1102,3764,44400,2016
48391,42.8,7315,3128,347,3608,1922,50145,2761,2013,748,2761,77100,2016
48393,35.6,939,900,0,27,283,72500,342,270,72,342,119500,2016
48395,41.2,16537,9619,3311,3273,4465,49142,6366,4620,1746,6366,99900,2016
48397,37.2,88010,64065,4821,14720,23790,89161,29392,23563,5829,29392,206700,2016
48399,41.8,10411,6543,140,3485,2740,41339,3792,2819,973,3792,75600,2016
48401,38.4,53197,34553,9146,8439,12935,47424,17795,13174,4621,17795,107800,2016
48403,50.6,10367,8951,734,398,2358,32500,3682,3209,473,3682,80700,2016
48405,47.9,8556,5883,1855,576,1951,29426,2972,2393,579,2972,80200,2016
48407,43.4,27172,20399,2731,3341,7021,44878,9631,8253,1378,9631,88000,2016
48409,35.3,66706,26751,1083,37428,17384,52659,23237,15875,7362,23237,97800,2016
48411,41,5881,3880,191,1717,1317,40718,2110,1422,688,2110,80500,2016
48413,35.9,3171,1538,8,1616,846,59766,1091,846,245,1091,72300,2016
48415,35.4,17314,9415,820,6783,3951,55661,5908,4311,1597,5908,89400,2016
48417,41.8,3323,2850,5,382,900,50285,1317,1044,273,1317,76400,2016
48419,37.1,25705,16111,4533,4523,6156,36312,9120,6497,2623,9120,74900,2016
48421,37.9,3069,1739,14,1290,773,52969,1017,787,230,1017,82900,2016
48423,36.3,219745,133593,38577,40831,53429,48683,78040,50889,27151,78040,137600,2016
48425,40.7,8673,6843,45,1657,2467,50562,3241,2303,938,3241,158900,2016
48427,28.7,63008,479,29,62352,13363,26682,16219,11967,4252,16219,66600,2016
48429,38.5,9787,7040,246,2284,2275,45217,3338,2590,748,3338,77500,2016
48431,41.1,1233,752,3,465,355,50156,453,358,95,453,95100,2016
48433,49.6,1233,887,54,284,321,47969,501,381,120,501,53900,2016
48435,36.4,3936,1603,3,2297,1078,54567,1481,980,501,1481,92100,2016
48437,35.4,7639,3696,437,3242,1896,35167,2630,1863,767,2630,71900,2016
48439,34.1,1947529,957988,298394,541947,473777,60373,682967,412427,270540,682967,148100,2016
48441,32.1,135234,88085,9949,31634,32612,47044,49489,28773,20716,49489,107600,2016
48443,47.7,778,223,10,542,199,24821,396,269,127,396,64600,2016
48445,34.3,12724,5273,584,6761,3016,40407,4214,3027,1187,4214,65900,2016
48447,51.3,1520,1232,5,230,460,39438,725,527,198,725,64100,2016
48449,33.8,32592,15316,2989,13518,8314,45026,10573,7116,3457,10573,97200,2016
48451,34,116264,64113,4645,44253,27310,47637,43311,26381,16930,43311,116500,2016
48453,33.3,1148176,570282,90819,387357,248106,64422,437831,227590,210241,437831,253600,2016
48455,48.1,14360,11397,1422,1302,3523,35865,5459,4384,1075,5459,78000,2016
48457,43,21371,17040,2281,1549,5375,45427,7608,6528,1080,7608,81800,2016
48459,40.6,40295,32618,3483,3091,9940,47724,13941,10929,3012,13941,96500,2016
48461,32.9,3475,1448,163,1823,856,48220,1263,934,329,1263,61300,2016
48463,33.8,27055,7455,18,19059,5914,39011,8512,6069,2443,8512,78200,2016
48465,31.6,48862,8042,547,39538,11290,44170,14977,9535,5442,14977,93900,2016
48467,43.5,53070,44903,1348,5316,13214,46555,19059,14846,4213,19059,105900,2016
48469,35.5,90989,41882,5166,41372,22964,54697,32513,21218,11295,32513,124100,2016
48471,35.1,69926,40041,16076,12313,12278,40090,20695,11134,9561,20695,123600,2016
48473,28.8,47049,20303,11734,13657,10189,53508,14082,9632,4450,14082,153800,2016
48475,34.3,11396,4809,548,5856,2614,56796,3926,2801,1125,3926,82000,2016
48477,42,34544,22379,5827,5208,8496,52718,11984,9156,2828,11984,156000,2016
48479,28.3,266006,9264,717,253982,57240,38711,71092,45045,26047,71092,110500,2016
48481,37.5,41377,18941,5743,16401,10188,46445,14979,10138,4841,14979,107000,2016
48483,39.3,5642,3859,150,1493,1649,51082,2330,1552,778,2330,86300,2016
48485,34.1,132148,88177,13047,24012,31131,45371,48615,29332,19283,48615,91700,2016
48487,37.5,13061,7859,1152,3664,3292,43635,5219,3312,1907,5219,71000,2016
48489,33.6,21944,2442,121,19270,4692,28817,5798,4535,1263,5798,49400,2016
48491,35.6,490619,302516,29923,116943,119467,75935,165425,113460,51965,165425,209400,2016
48493,40.4,46444,26978,619,17999,12044,68737,15474,12916,2558,15474,162300,2016
48495,32.6,7723,2921,198,4516,1860,54261,2623,2048,575,2623,49700,2016
48497,38.8,62089,48431,726,11425,16269,56396,21427,16412,5015,21427,132700,2016
48499,47.8,43198,36070,2176,4061,11561,47814,16097,12913,3184,16097,113800,2016
48501,33.6,8316,2850,0,5285,2060,56655,2674,2057,617,2674,81000,2016
48503,41.8,18275,14456,230,3229,5421,46978,7146,5651,1495,7146,86300,2016
48505,29.3,14335,841,2,13492,3566,36976,4501,3462,1039,4501,60100,2016
48507,30.4,12107,702,72,11299,2645,26639,3638,2488,1150,3638,39800,2016
49001,33.1,6437,5707,9,696,1666,48083,2261,1628,633,2261,146900,2016
49003,32.1,51528,45066,167,4622,13317,55514,16655,12698,3957,16655,169200,2016
49005,25,118824,99736,862,12276,26845,51935,36093,23194,12899,36093,197700,2016
49007,35.6,20733,17242,183,2724,5129,47793,7744,5598,2146,7744,126800,2016
49009,48.7,751,720,0,18,172,75938,217,202,15,217,206700,2016
49011,30.4,329292,278951,4004,29852,81152,72661,99495,76434,23061,99495,234300,2016
49013,30.2,20078,17197,33,1579,5160,61244,6573,4932,1641,6573,174900,2016
49015,34.3,10570,9665,17,656,2761,51276,3514,2891,623,3514,135100,2016
49017,39.6,5020,4516,20,280,1205,45221,1654,1323,331,1654,159100,2016
49019,39.7,9428,8290,24,930,2394,43529,3820,2658,1162,3820,223900,2016
49021,28.5,47751,41331,279,3941,10962,43799,15210,9815,5395,15210,172100,2016
49023,30.3,10507,9725,26,472,2567,54861,3155,2521,634,3155,169900,2016
49025,43.4,7216,6617,16,323,1574,50517,2592,2008,584,2592,187300,2016
49027,34.9,12604,10586,40,1609,3199,53902,4163,3251,912,4163,142700,2016
49029,32.3,10645,10112,50,283,2742,80865,3079,2610,469,3079,283400,2016
49031,42.5,1859,1770,1,81,401,37112,545,479,66,545,136300,2016
49033,34.3,2284,2054,2,187,495,52569,625,469,156,625,169800,2016
49035,32.1,1092518,792767,17149,193768,251421,64601,356061,236147,119914,356061,243700,2016
49037,30.6,15540,7041,16,805,2950,41108,3950,3168,782,3950,137600,2016
49039,31.2,28551,24606,185,2719,6299,48866,8082,5940,2142,8082,164700,2016
49041,34.9,20913,19291,72,1021,5408,48872,7121,5473,1648,7121,149200,2016
49043,38.2,39009,33109,237,4488,10695,91470,14542,10632,3910,14542,515500,2016
49045,30.9,61986,51852,393,7363,15260,64149,19066,14764,4302,19066,182300,2016
49047,29.8,36308,29750,148,2949,7954,67943,10722,8021,2701,10722,190900,2016
49049,24.4,564177,470245,2931,62919,124185,64321,151342,101740,49602,151342,239300,2016
49051,33.2,27895,23404,17,3710,6772,71337,8693,6134,2559,8693,336100,2016
49053,35.4,151959,129410,901,15075,38182,52865,50256,35515,14741,50256,221700,2016
49055,40.1,2716,2507,11,137,709,41684,978,812,166,978,195900,2016
49057,32.1,241328,186012,2450,42432,58632,59660,80159,57710,22449,80159,171200,2016
50001,43,36926,34381,360,765,9480,61020,14429,10571,3858,14429,236400,2016
50003,46.3,36503,34618,191,634,9832,51489,15399,11232,4167,15399,207300,2016
50005,43.6,30859,29395,245,423,7489,46931,12098,9016,3082,12098,164200,2016
50007,36.4,160510,143797,3971,3499,36783,66414,64012,40846,23166,64012,275000,2016
50009,49.2,6173,5907,43,78,1760,39467,2691,2146,545,2691,123800,2016
50011,39.7,48625,45859,201,671,12688,58884,18472,13472,5000,18472,206500,2016
50013,47.4,6945,6476,0,113,2051,64295,2905,2339,566,2905,259600,2016
50015,40.8,25136,23854,199,395,6296,53316,10342,7432,2910,10342,220300,2016
50017,45.4,28897,27672,149,360,7976,54263,12306,9809,2497,12306,191700,2016
50019,45.1,27076,25881,122,355,7288,43959,11360,8900,2460,11360,156800,2016
50021,45.9,60133,57594,378,805,15311,50029,25317,17766,7551,25317,179200,2016
50023,43.3,58963,55693,440,1080,15210,58171,24581,17930,6651,24581,213200,2016
50025,46.2,43609,40856,352,910,11230,50917,19011,12876,6135,19011,209500,2016
50027,47.1,55894,53171,399,812,14858,54763,24184,17126,7058,24184,215800,2016
51001,45.4,33060,20031,9547,2910,8935,38503,13819,9605,4214,13819,151900,2016
51003,38.9,104287,80744,9719,5832,25352,70342,39431,25584,13847,39431,317300,2016
51005,48,15919,14636,829,228,4342,45538,6845,5396,1449,6845,111500,2016
51007,44.3,12793,9237,3010,152,3457,58269,4540,3845,695,4540,171500,2016
51009,43.9,31999,24195,5710,699,8559,47002,12306,9434,2872,12306,149400,2016
51011,42.8,15314,11736,3149,186,4588,52134,5972,4757,1215,5972,149600,2016
51013,34.1,226092,142177,18996,34776,46952,108706,100707,44531,56176,100707,623300,2016
51015,44.5,74330,68122,2932,1804,20655,56802,28425,22601,5824,28425,199700,2016
51017,47.2,4558,4178,96,137,1151,44985,2104,1430,674,2104,146400,2016
51019,45.6,76933,67997,5333,1512,21807,56725,30821,25056,5765,30821,196900,2016
51021,44.9,6612,6251,286,39,1811,47800,2561,2107,454,2561,102200,2016
51023,46.9,33192,30934,982,482,9712,61470,13305,11442,1863,13305,209700,2016
51025,42.6,16573,6772,9071,329,3987,38858,6148,4391,1757,6148,109100,2016
51027,45.9,23158,22083,647,63,6287,30335,9124,7163,1961,9124,70500,2016
51029,42.4,17030,10380,5818,403,3886,43514,5689,4351,1338,5689,123800,2016
51031,42.8,55061,44296,7694,1088,15330,47005,22294,16897,5397,22294,152600,2016
51033,39.8,29640,18829,8414,1226,7911,57294,10965,8523,2442,10965,189000,2016
51035,46.7,29733,28325,203,878,8596,37048,12642,9849,2793,12642,109400,2016
51036,49.2,7086,2907,3327,127,1856,54167,2854,2350,504,2854,163400,2016
51037,44.7,12232,8230,3750,116,2988,33837,4594,3154,1440,4594,99900,2016
51041,38.6,331839,210157,73814,26360,85700,73869,118908,89857,29051,118908,218700,2016
51043,45.4,14307,12517,642,622,3650,71986,5591,4162,1429,5591,333000,2016
51045,47,5195,5097,8,1,1323,40500,2314,1678,636,2314,153700,2016
51047,38.9,48952,35086,6825,4562,12575,66160,16904,12118,4786,16904,255000,2016
51049,44.4,9769,6144,3272,15,2737,37489,4085,2977,1108,4085,139900,2016
51051,43.4,15304,14997,117,114,4171,31226,6055,4541,1514,6055,72700,2016
51053,42.2,28155,17545,9048,861,7317,51579,10344,7800,2544,10344,153800,2016
51057,45,11130,6095,4555,28,2784,47527,4447,3177,1270,4447,166200,2016
51059,37.6,1132887,592735,103934,181940,280739,114329,393358,265351,128007,393358,516800,2016
51061,41.6,68025,55271,5133,4883,17262,91221,23890,18660,5230,23890,363800,2016
51063,45.8,15587,14608,346,423,4312,47288,6303,4903,1400,6303,153700,2016
51065,42.6,26046,20503,3603,858,7317,66425,9829,7804,2025,9829,222500,2016
51067,45.4,56230,48962,4621,1512,16471,48720,22976,18209,4767,22976,167900,2016
51069,40.3,82321,69922,3322,6123,22227,68929,29914,23366,6548,29914,231400,2016
51071,43.6,16871,16056,421,255,4898,47675,7290,5466,1824,7290,105300,2016
51073,44.3,37021,31540,2926,1159,10195,62878,14511,11130,3381,14511,225100,2016
51075,47.7,21979,17027,3726,540,6310,82326,8177,7033,1144,8177,302600,2016
51077,48.2,15180,14192,345,444,4223,31002,6710,5294,1416,6710,91500,2016
51079,40.4,19085,16120,1159,986,5092,61615,7107,5546,1561,7107,241000,2016
51081,41.2,11698,4371,6726,451,2555,40559,3705,2815,890,3705,95900,2016
51083,45.7,35305,21142,12905,676,9349,37001,14264,10152,4112,14264,109200,2016
51085,42.4,102199,86555,9207,2710,28398,81170,37724,30630,7094,37724,258900,2016
51087,38.1,321921,176826,94062,16853,79939,63699,125478,78606,46872,125478,216400,2016
51089,46.2,52209,36778,11563,2721,14630,34992,22136,16253,5883,22136,95500,2016
51091,59.8,2230,2220,0,0,699,44877,1121,957,164,1121,160800,2016
51093,44.4,36027,25532,8049,945,10115,66835,13902,10851,3051,13902,244600,2016
51095,45.9,71900,54904,9352,3802,20103,80226,28352,21308,7044,28352,318700,2016
51097,45.8,7140,4714,1891,221,1823,48852,2807,2214,593,2807,170000,2016
51099,37,25260,18643,4224,1122,6369,84342,8669,6349,2320,8669,288000,2016
51101,40.9,16156,12320,2993,125,4729,64297,6066,5100,966,6066,200100,2016
51103,56.4,11055,7593,3119,186,3017,50118,5097,3822,1275,5097,227000,2016
51105,43.2,24911,23153,1027,448,6251,31577,9282,6655,2627,9282,78600,2016
51107,35.5,362435,212241,25634,48207,91442,125672,117073,90656,26417,117073,462100,2016
51109,44,34350,26605,5387,876,9459,54662,13146,10288,2858,13146,202100,2016
51111,45.2,12450,7454,3907,525,3195,39911,4670,3319,1351,4670,109200,2016
51113,44.6,13122,11181,934,291,3553,48271,5042,3657,1385,5042,241300,2016
51115,51.5,8848,7610,869,89,2710,64049,3837,3246,591,3837,232000,2016
51117,48.2,31209,18749,11065,818,7674,40040,12066,8660,3406,12066,123300,2016
51119,53.1,10728,8329,2110,63,3007,53093,4474,3678,796,4474,248800,2016
51121,27.9,97227,81878,4014,2936,19406,49712,35701,19130,16571,35701,202900,2016
51125,48.7,14831,12123,1929,544,4084,50994,6378,4649,1729,6378,231500,2016
51127,44,20051,16014,2431,524,5754,75303,7537,6335,1202,7537,249100,2016
51131,48.4,12118,6561,4313,999,3137,37011,5075,3412,1663,5075,164600,2016
51133,55.5,12272,8578,3553,44,3943,54440,5776,4990,786,5776,256400,2016
51135,41.9,15641,8605,6075,598,3654,36849,5676,3578,2098,5676,125500,2016
51137,42.1,34873,27677,4271,1468,9570,66990,13245,10331,2914,13245,236100,2016
51139,44.7,23759,22463,374,437,6584,45030,9523,6712,2811,9523,171300,2016
51141,48.4,18180,16360,1051,497,5150,35999,7805,6014,1791,7805,115300,2016
51143,46,62392,46346,13160,1519,18195,43087,26327,20094,6233,26327,114400,2016
51145,44.3,28286,23738,3368,560,7770,77684,9866,8737,1129,9866,254200,2016
51147,31.5,23077,14360,7514,564,4621,42283,7294,4711,2583,7294,151200,2016
51149,37,37664,21083,11770,2746,8652,64805,11191,7667,3524,11191,205400,2016
51153,34.4,443630,202037,88386,97117,106561,98546,138102,98292,39810,138102,345900,2016
51155,45.6,34417,31351,1820,525,9923,49469,14553,10455,4098,14553,136700,2016
51157,49.1,7416,6633,311,257,2255,58026,3247,2412,835,3247,362100,2016
51159,43.5,8868,5442,2308,561,2124,44919,3084,2259,825,3084,153300,2016
51161,43.7,93655,81399,5328,2517,25889,60380,38322,28492,9830,38322,189800,2016
51163,48.5,22450,20917,572,351,6166,52478,9277,7176,2101,9277,193300,2016
51165,41.6,78427,70540,1456,4864,21359,55029,29883,22148,7735,29883,200900,2016
51167,44.1,27973,27078,277,318,7049,38370,10937,8505,2432,10937,94100,2016
51169,45.7,22378,21688,151,284,6343,38017,9104,6982,2122,9104,92200,2016
51171,44.8,42857,38099,782,2871,11680,50450,17222,12189,5033,17222,200100,2016
51173,44.3,31513,29741,652,614,8671,38906,12930,9061,3869,12930,91100,2016
51175,45.6,18291,11050,6433,251,4940,51032,6727,4610,2117,6727,161500,2016
51177,37.3,129181,90614,20240,11136,33196,79742,43105,33249,9856,43105,252900,2016
51179,35,139548,90289,23118,15614,35967,97528,44311,33330,10981,44311,314800,2016
51181,48.2,6731,3496,3103,24,2025,56632,2707,2212,495,2707,166600,2016
51183,42.2,11733,4495,6550,316,2429,37917,3793,2456,1337,3793,128300,2016
51185,43.7,43367,40797,1313,385,12004,38238,17595,13208,4387,17595,94400,2016
51187,40.8,38807,34133,1490,1546,10239,63734,14174,10737,3437,14174,223300,2016
51191,45.3,54562,52098,692,772,14871,43835,22512,17178,5334,22512,136600,2016
51193,46.5,17528,11162,4702,1070,4427,51566,7124,5510,1614,7124,198300,2016
51195,40,40074,36846,2060,493,10265,36352,15225,10447,4778,15225,86000,2016
51197,43.9,29171,27436,987,321,7951,42888,12039,8643,3396,12039,128200,2016
51199,39.5,66919,48512,8623,3803,18721,83410,23872,17207,6665,23872,314400,2016
51510,36.2,151473,78821,31913,25359,33043,89200,68063,28710,39353,68063,520700,2016
51520,42,17340,15269,1160,343,4855,35801,7671,4423,3248,7671,109100,2016
51530,35.1,6610,5851,110,83,1779,29109,2709,1608,1101,2709,112400,2016
51540,30.3,45538,30038,8488,2295,8391,50727,17980,7579,10401,17980,280100,2016
51550,36.7,233194,137343,68246,12294,61678,69978,82573,57851,24722,82573,256500,2016
51570,40.6,17554,13268,2277,931,4583,49639,7206,4350,2856,7206,166800,2016
51580,43,5650,4603,822,71,1452,34703,2472,1856,616,2472,70900,2016
51590,41.5,42360,18802,20683,1519,10824,33721,18653,10065,8588,18653,90800,2016
51595,39.5,5565,1760,3559,181,1448,27169,2210,873,1337,2210,122600,2016
51600,39.6,23620,13953,1127,3938,5937,104065,8476,5992,2484,8476,487700,2016
51610,38.9,13597,9802,731,1349,3266,115244,5301,3162,2139,5301,724000,2016
51620,38.7,8413,3177,4930,90,2202,38333,3424,1703,1721,3424,171700,2016
51630,29.5,27853,16732,6062,3015,5491,53980,10271,3575,6696,10271,321500,2016
51640,45.1,6858,5091,470,1197,1736,31110,2767,1564,1203,2767,101600,2016
51650,35.6,136789,54326,67398,7236,32733,49890,53656,30150,23506,53656,187700,2016
51660,24,51979,35519,3320,9452,8526,40494,16626,6224,10402,16626,197400,2016
51670,36.5,22332,11142,8677,1604,5490,40814,8866,4444,4422,8866,125400,2016
51678,21.5,7036,5667,633,294,793,34464,1856,1042,814,1856,230500,2016
51680,28.6,78755,49615,22231,2630,16290,40728,28282,14291,13991,28282,149600,2016
51683,33.4,41149,17896,5358,14030,9476,74371,12430,7727,4703,12430,293500,2016
51685,33.1,15827,5931,1999,5781,3420,75027,4730,3112,1618,4730,257800,2016
51690,42.7,13551,6315,6295,638,3336,31719,5787,3061,2726,5787,88700,2016
51700,32.9,181606,81214,71568,15229,42383,50089,69247,34240,35007,69247,189000,2016
51710,30.2,245724,107732,101615,18244,50685,45268,87367,37396,49971,87367,193100,2016
51720,39.6,3978,3434,237,103,940,26000,1858,842,1016,1858,92500,2016
51730,38.8,31997,4796,24493,1439,7311,32169,13175,5429,7746,13175,111300,2016
51735,43.4,12068,11150,129,284,3318,84643,4610,3830,780,4610,301800,2016
51740,35,96071,37413,50170,3728,23009,47050,36840,19820,17020,36840,169400,2016
51750,22.7,17186,14268,1704,508,2449,31457,5604,2451,3153,5604,153900,2016
51760,33.2,216773,86343,104831,13729,40638,41187,88958,36829,52129,88958,199300,2016
51770,38.1,99329,59666,27914,5928,23628,39201,42541,22157,20384,42541,133000,2016
51775,40.6,25290,21679,1882,847,6244,52351,10060,6464,3596,10060,173800,2016
51790,42.6,24234,19806,2680,655,5842,42948,10383,6028,4355,10383,163000,2016
51800,38.4,87061,43568,36016,3265,23470,65435,31741,21992,9749,31741,236600,2016
51810,35.4,449733,282741,83430,34388,115381,67719,167509,105833,61676,167509,262200,2016
51820,39.5,21366,16540,2553,1547,5497,45097,9044,5237,3807,9044,158800,2016
51830,24.4,14988,10299,2209,1111,2161,50091,4627,2157,2470,4627,319500,2016
51840,37,27349,18496,2602,4509,6181,46466,10596,4822,5774,10596,218600,2016
53001,28.6,19100,6813,59,11820,4431,47554,5733,3882,1851,5733,146400,2016
53003,44.6,22113,20230,56,791,5775,45550,9297,6222,3075,9297,177600,2016
53005,35.5,187519,135362,2589,38146,47260,61147,68418,46825,21593,68418,188300,2016
53007,39.8,74761,51466,303,20307,18219,51845,27200,17878,9322,27200,246100,2016
53009,50.3,72969,61008,687,4274,18888,47180,31438,21948,9490,31438,220200,2016
53011,37.8,450893,360807,8084,39042,114774,62879,164354,106320,58034,164354,249400,2016
53013,49.9,3971,3491,15,270,1061,42083,1689,1213,476,1689,162200,2016
53015,41.7,102854,87013,600,8640,26092,49127,39671,26107,13564,39671,180000,2016
53017,37.1,40101,26177,90,12247,10666,53758,14348,10197,4151,14348,214900,2016
53019,48.2,7639,5636,13,316,1901,39555,3039,2148,891,3039,164400,2016
53021,29.3,87810,36534,1752,45685,19369,58284,25157,17072,8085,25157,169700,2016
53023,47.7,2231,2058,0,74,652,51395,952,674,278,952,138500,2016
53025,32.3,92530,51364,604,37124,21568,50145,29783,18247,11536,29783,153800,2016
53027,43,71233,56988,744,6864,17509,44521,27472,18430,9042,27472,159400,2016
53029,44.3,80113,64659,2385,5402,22782,60261,33388,22416,10972,33388,295800,2016
53031,56.2,30333,26912,267,1045,8368,50928,13561,10026,3535,13561,291200,2016
53033,37.2,2079550,1294359,124303,194189,497100,78800,831995,476551,355444,831995,407400,2016
53035,39.2,257488,200165,6159,18375,65840,65017,98250,66181,32069,98250,262400,2016
53037,33.7,42785,36177,474,3653,9361,47898,17164,9521,7643,17164,246300,2016
53039,45.5,20930,17217,138,2520,5279,49633,8069,5439,2630,8069,197500,2016
53041,43.1,75724,63979,502,7292,19578,44526,29426,20058,9368,29426,174800,2016
53043,48.7,10326,9506,32,308,2894,47676,4337,3390,947,4337,145300,2016
53045,45.9,61060,49879,578,5465,14892,51764,22454,17304,5150,22454,201800,2016
53047,43,41299,27387,246,7869,11329,41158,16804,11263,5541,16804,165300,2016
53049,52.2,20743,17167,59,1855,5506,38387,8986,6625,2361,8986,159200,2016
53051,49.8,13001,11566,30,455,3700,46036,5409,4160,1249,5409,181700,2016
53053,36,832896,571006,53881,84021,203625,61468,307106,186670,120436,307106,239400,2016
53055,55.1,16056,14308,97,937,4524,58029,7623,5538,2085,7623,456800,2016
53057,41.3,120475,90922,839,21310,31383,56433,46108,31134,14974,46108,255100,2016
53059,45.4,11316,9989,104,668,3006,53082,4577,3174,1403,4577,243000,2016
53061,37.8,758649,546155,19427,72859,189818,73528,278626,184237,94389,278626,309800,2016
53063,37.3,485859,415979,8346,25143,120184,50550,191222,119350,71872,191222,186500,2016
53065,46.4,43744,38114,200,1468,12165,44115,17442,13236,4206,17442,174800,2016
53067,38.8,266311,203511,7611,21856,68650,62854,103468,66018,37450,103468,242900,2016
53069,53.1,4051,3633,5,188,1217,48116,1789,1443,346,1789,197000,2016
53071,37.3,59809,43428,887,12508,13716,48705,21851,14161,7690,21851,191700,2016
53073,36.8,209729,168060,1958,18517,49193,54207,81019,50415,30604,81019,283000,2016
53075,24.2,47494,37902,950,2681,8487,38636,17185,7662,9523,17185,188100,2016
53077,32.6,247681,111448,1835,118091,57451,45700,80196,50246,29950,80196,160700,2016
54001,41.1,16892,16189,118,143,4178,36733,6169,4395,1774,6169,99600,2016
54003,38.4,110173,93712,7853,4285,29217,57148,41720,30646,11074,41720,163800,2016
54005,42,23645,23146,182,134,6593,37820,9466,7193,2273,9466,72900,2016
54007,45,14463,14057,29,186,3772,38092,5417,4094,1323,5417,84500,2016
54009,46.2,23473,22510,390,198,6271,46265,9934,7249,2685,9934,89200,2016
54011,38.3,96623,87187,4749,1312,22323,37760,39954,24321,15633,39954,114000,2016
54013,47.6,7482,7286,11,83,1972,39384,2913,2400,513,2913,80000,2016
54015,43.4,9033,8841,3,9,2330,33639,3375,2735,640,3375,77700,2016
54017,41.9,8363,8006,98,26,1679,39381,2625,2253,372,2625,95700,2016
54019,43.4,45192,41804,2304,458,12121,37846,17845,13872,3973,17845,81300,2016
54021,37.8,8497,7075,906,304,1743,37286,2709,2038,671,2709,84500,2016
54023,46.2,11770,11391,174,135,2802,38703,4158,3286,872,4158,130700,2016
54025,45.4,35580,33233,887,493,9586,40026,14944,11030,3914,14944,110000,2016
54027,45.1,23455,22538,259,289,5089,32177,9977,5938,4039,9977,125600,2016
54029,45.7,30024,28294,692,397,8116,40316,12844,9221,3623,12844,86600,2016
54031,44.7,13942,12673,580,576,3753,39840,5350,3934,1416,5350,121100,2016
54033,41.8,68775,65022,1206,1029,17662,44845,27652,20204,7448,27652,102900,2016
54035,42.9,29199,28423,21,94,7898,40949,11190,8860,2330,11190,113400,2016
54037,40.1,55531,46692,3719,2902,14516,69753,20634,15324,5310,20634,215300,2016
54039,42.9,189636,166701,9812,2017,50159,46528,81708,56493,25215,81708,107100,2016
54041,43.4,16422,15875,52,132,4502,37827,6541,4647,1894,6541,93100,2016
54043,42.9,21482,21066,113,96,5370,36232,7965,6023,1942,7965,82400,2016
54045,42.9,35166,33756,645,301,9683,37262,13976,10572,3404,13976,85600,2016
54047,44.3,20273,17983,1891,281,5373,25206,7963,6231,1732,7963,33600,2016
54049,41.3,56716,52678,2066,650,14792,46430,22427,17148,5279,22427,107100,2016
54051,44.5,32296,31283,312,304,9029,44464,13306,10167,3139,13306,98100,2016
54053,43.6,27060,26205,126,165,7431,37322,10901,8594,2307,10901,76900,2016
54055,42.4,61476,55596,3682,619,16540,37255,25062,18195,6867,25062,87400,2016
54057,43.3,27606,26013,897,241,6777,36153,11289,6901,4388,11289,128300,2016
54059,41.6,25549,24531,389,90,7465,32441,10853,8134,2719,10853,70600,2016
54061,30.6,102827,91124,3993,2096,20027,47060,37820,21793,16027,37820,170700,2016
54063,47,13496,13024,89,155,4169,35995,5932,4670,1262,5932,102500,2016
54065,46.6,17514,16781,156,245,4292,43234,7207,5429,1778,7207,168900,2016
54067,44.5,25743,25060,89,135,7612,39901,10752,8555,2197,10752,87300,2016
54069,43.2,43257,39969,1808,459,10785,41986,18519,12453,6066,18519,110000,2016
54071,49.6,7291,6919,235,62,2035,37035,3133,2451,682,3133,106400,2016
54073,43.9,7612,7324,10,132,2132,45191,2863,2387,476,2863,104300,2016
54075,48.3,8620,8249,100,77,2286,36026,3646,2927,719,3646,113000,2016
54077,42.4,33793,31213,1505,619,8675,45221,12441,10073,2368,12441,105900,2016
54079,41.4,56743,54192,824,608,15680,56640,21780,17851,3929,21780,151800,2016
54081,41.5,78051,68001,6215,1152,20677,41533,30880,22425,8455,30880,105500,2016
54083,43.1,29287,28169,507,239,7620,40308,11626,8311,3315,11626,99300,2016
54085,45.3,10044,9821,34,76,2536,40850,3967,3065,902,3967,80400,2016
54087,44.2,14513,14085,6,139,3830,34144,5672,4446,1226,5672,88000,2016
54089,46.5,13325,12211,709,226,3645,35620,5497,4220,1277,5497,88900,2016
54091,43.1,16949,16322,162,164,4446,44371,6732,5318,1414,6732,97800,2016
54093,47.9,6922,6762,12,45,1975,43529,2924,2350,574,2924,105800,2016
54095,46.3,9000,8820,42,64,2280,38674,3518,2692,826,3518,88400,2016
54097,41.5,24632,23734,349,291,6301,42240,9105,6901,2204,9105,111200,2016
54099,42.7,41237,40216,136,253,10969,38311,16447,12576,3871,16447,85000,2016
54101,46.2,8820,8782,2,9,2682,29982,3952,2864,1088,3952,66700,2016
54103,45.6,15997,15609,69,77,3992,39446,6238,4950,1288,6238,86500,2016
54105,44.8,5826,5673,45,26,1499,38101,2432,2042,390,2432,78300,2016
54107,42.6,86262,82362,969,891,23376,43944,36225,25662,10563,36225,109100,2016
54109,43.1,22537,21968,153,58,6570,35469,9222,7431,1791,9222,66700,2016
55001,52.2,20294,18394,635,774,5083,43554,7950,6806,1144,7950,129100,2016
55003,41.6,15936,13217,74,392,3999,40297,6670,4607,2063,6670,108700,2016
55005,44.1,45548,42821,529,1059,12457,46863,19017,13906,5111,19017,140900,2016
55007,51.2,14987,12755,83,243,4340,48132,6798,5631,1167,6798,162800,2016
55009,36.8,256621,210514,5411,20833,65560,54172,101888,66424,35464,101888,160700,2016
55011,45.4,13256,12743,53,280,3793,52447,5707,4288,1419,5707,151400,2016
55013,51.6,15259,13846,70,235,4673,42441,7308,5906,1402,7308,150300,2016
55015,39.4,49653,45477,403,1949,14079,70042,18839,15281,3558,18839,166600,2016
55017,41,63355,59590,833,972,16918,52657,24973,18100,6873,24973,152400,2016
55019,37.3,34486,32312,137,1450,8810,46783,12732,9900,2832,12732,115500,2016
55021,42.2,56650,52868,808,1704,15550,61004,23019,17179,5840,23019,177200,2016
55023,46.1,16415,15636,288,197,4181,45780,6652,5065,1587,6652,123800,2016
55025,34.7,516818,416468,25959,32088,122922,64773,213519,124505,89014,213519,236000,2016
55027,42.1,88404,80120,1844,3965,22095,54111,33627,23991,9636,33627,153900,2016
55029,52.2,27669,26179,141,762,8568,53980,13023,10273,2750,13023,201900,2016
55031,41,43705,40246,509,623,11387,48190,18538,12527,6011,18538,135600,2016
55033,34.5,44348,41377,192,771,10449,51787,16445,11332,5113,16445,154500,2016
55035,34,101907,92619,813,2275,23604,50538,40202,25023,15179,40202,153200,2016
55037,52.1,4474,4397,11,46,1309,46595,1958,1699,259,1958,136900,2016
55039,41.1,101968,92498,1168,4912,27280,56376,41029,29416,11613,41029,147000,2016
55041,46.2,9108,7303,116,185,2537,41378,3940,2989,951,3940,129300,2016
55043,36,51723,49390,710,733,11903,49077,19353,13654,5699,19353,135400,2016
55045,42.6,37050,35086,136,1100,10073,57416,14772,10966,3806,14772,161900,2016
55047,45.4,18881,17579,106,864,5153,47174,7939,5801,2138,7939,137800,2016
55049,42.9,23751,22778,112,393,6522,56641,9692,7325,2367,9692,166900,2016
55051,53.2,5850,5625,39,61,1782,41270,2954,2291,663,2954,107600,2016
55053,42,20566,17823,408,634,5327,49608,8066,5934,2132,8066,129100,2016
55055,39.5,84538,76125,662,5821,22047,57290,32366,22712,9654,32366,175500,2016
55057,44.8,26399,24268,601,778,6307,47243,9978,7554,2424,9978,118800,2016
55059,37.6,167896,128780,11998,21080,41528,56086,62994,41316,21678,62994,162400,2016
55061,43.8,20459,19492,74,512,5584,58152,8211,6554,1657,8211,151200,2016
55063,35.4,117538,106416,1427,2027,27621,51477,46657,30048,16609,46657,158700,2016
55065,41.5,16793,15915,57,589,4560,53038,6692,5082,1610,6692,124100,2016
55067,47.7,19414,18396,169,363,5291,43501,8521,6492,2029,8521,108100,2016
55069,46.6,28171,26990,187,392,8201,52221,12546,9530,3016,12546,134200,2016
55071,44.4,80178,73368,423,2856,21764,49613,33991,25650,8341,33991,127500,2016
55073,40.7,135367,121043,873,3503,36364,54227,54003,39239,14764,54003,145900,2016
55075,47.5,41090,39356,151,612,11331,43893,18380,13794,4586,18380,114000,2016
55077,49.1,15082,14174,75,455,4063,48445,6328,5075,1253,6328,142500,2016
55078,30.8,4457,405,14,254,881,37147,1215,830,385,1215,84500,2016
55079,34.3,955306,503039,249463,136609,217235,45263,382778,189161,193617,382778,150000,2016
55081,39.2,45365,41516,548,1825,11731,53394,17813,12177,5636,17813,139100,2016
55083,45.8,37475,35734,78,618,10807,54018,15440,12839,2601,15440,153400,2016
55085,50.3,35604,33940,212,483,9637,49715,14965,12477,2488,14965,163800,2016
55087,37.9,181799,160789,2062,7343,47929,59806,71194,50480,20714,71194,157200,2016
55089,43.9,87625,80882,1161,2327,24884,78415,34763,26291,8472,34763,248800,2016
55091,45.5,7349,7118,26,114,2001,51346,2948,2414,534,2948,141900,2016
55093,36,40881,38812,205,759,10281,64364,15101,11044,4057,15101,193000,2016
55095,44.5,43483,41480,169,782,12337,52039,18188,14141,4047,18188,156000,2016
55097,36.3,70551,64777,485,2082,17157,52411,27844,19195,8649,27844,155900,2016
55099,51.3,13707,13063,68,207,4233,43547,6676,5170,1506,6676,117600,2016
55101,39.9,194873,142372,20978,24266,50897,56359,75291,52065,23226,75291,163900,2016
55103,44.5,17642,16811,116,382,4889,46564,7506,5562,1944,7506,128000,2016
55105,39.1,160986,134652,5481,13213,41871,50968,63941,44028,19913,63941,132500,2016
55107,47.9,14272,13638,141,229,4084,39904,6245,4796,1449,6245,105400,2016
55109,37.9,86726,81887,681,1891,23906,73743,32811,24830,7981,32811,213100,2016
55111,41.4,63317,57957,370,3011,16518,53225,25293,17321,7972,25293,169500,2016
55113,49.5,16438,12707,109,373,4909,41869,7488,5525,1963,7488,159800,2016
55115,44.7,41384,36164,133,1041,11194,48773,16940,12853,4087,16940,132500,2016
55117,41.4,115269,98647,1700,6888,31046,54392,47152,33048,14104,47152,148200,2016
55119,43.4,20521,19813,77,358,5667,47306,8751,6606,2145,8751,129000,2016
55121,40.8,29521,26906,124,2074,7882,52438,11840,8498,3342,11840,145800,2016
55123,42.4,30442,29352,141,463,8087,49476,11843,9355,2488,11843,146100,2016
55125,52.9,21373,18198,21,430,6628,41632,10648,8018,2630,10648,201000,2016
55127,39,103021,88301,1020,11224,26319,55575,39967,27099,12868,39967,189500,2016
55129,50,15685,14834,72,255,4587,44437,7151,5534,1617,7151,147300,2016
55131,42.4,133422,124652,1437,3966,37939,70325,53187,41452,11735,53187,215700,2016
55133,43,395377,353750,5546,17775,108819,78268,155776,118740,37036,155776,254700,2016
55135,44.8,51974,49303,183,1497,13883,52441,21412,16073,5339,21412,137700,2016
55137,48.5,24238,21770,375,1506,6416,46581,9749,7922,1827,9749,137200,2016
55139,37.9,169487,151773,3384,6510,41540,53501,69169,44768,24401,69169,144300,2016
55141,43.7,73621,68527,522,1962,20105,49926,31884,23456,8428,31884,124000,2016
56001,26.6,37836,31506,509,3492,7460,43043,15565,7606,7959,15565,220900,2016
56003,41.8,11931,10492,28,1057,2909,50820,4459,3279,1180,4459,148200,2016
56005,32.8,48473,42547,360,4051,12098,80822,17534,12241,5293,17534,214000,2016
56007,38.1,15696,12231,195,2770,4146,56972,6095,4273,1822,6095,153700,2016
56009,40.4,14223,12637,1,1094,4020,66737,5576,4095,1481,5576,194500,2016
56011,43.1,7284,7047,12,175,2122,60307,2976,2348,628,2976,217500,2016
56013,38.4,40683,28559,210,2758,10021,53559,15159,10718,4441,15159,189600,2016
56015,42.8,13546,11705,20,1425,3505,44883,5350,4084,1266,5350,153000,2016
56017,51.4,4781,4505,7,147,1391,46087,2262,1668,594,2262,147500,2016
56019,44.9,8572,7849,38,183,2372,54594,3668,2688,980,3668,247800,2016
56021,36.7,96459,76226,2662,13697,25233,61201,37362,25590,11772,37362,195900,2016
56023,38.5,18543,17171,39,819,4937,64579,7002,5540,1462,7002,204300,2016
56025,35.9,80871,70379,937,6630,20522,56983,32422,21298,11124,32422,193200,2016
56027,39.2,2498,2236,3,106,572,40640,981,689,292,981,155200,2016
56029,43.7,29083,26351,241,1634,8049,61185,11826,8512,3314,11826,231100,2016
56031,47.2,8740,7810,5,683,2482,41051,3680,2776,904,3680,164000,2016
56033,42.4,29924,27452,259,1231,8039,53914,12697,8688,4009,12697,237700,2016
56035,37.5,10032,9194,0,784,2280,76004,3203,2285,918,3203,264700,2016
56037,33.8,44812,35767,388,7107,11200,68233,16533,11994,4539,16533,190700,2016
56039,38.4,22623,18370,139,3433,4981,75594,8576,5132,3444,8576,720000,2016
56041,34.8,20893,18327,39,1872,5399,53323,7432,5227,2205,7432,179500,2016
56043,43.5,8351,6881,66,1166,2222,46212,3493,2604,889,3493,156900,2016
56045,43.8,7175,6617,18,72,2001,55640,3134,2406,728,3134,172300,2016
72001,38.9,18760,28,0,18724,4637,11296,6305,3333,2972,6305,90900,2016
72003,40,40083,1540,22,37471,9523,15543,12934,9697,3237,12934,89900,2016
72005,40.2,56893,710,186,54991,14681,17191,20999,12971,8028,20999,124100,2016
72007,39.2,27323,147,0,27176,6471,15409,8675,5796,2879,8675,109100,2016
72009,40.3,24438,55,6,24338,6488,18145,8569,6881,1688,8569,119900,2016
72011,40.7,28250,411,15,27668,6702,17712,9373,7295,2078,9373,100400,2016
72013,41,91096,340,10,90685,22884,16796,32121,21911,10210,32121,98200,2016
72015,37.8,18778,29,0,18749,4446,16387,6203,4762,1441,6203,92300,2016
72017,37.9,24699,98,30,24542,5869,15549,8330,6560,1770,8330,108200,2016
72019,34.8,29548,0,1,29547,7099,14778,9376,7114,2262,9376,102500,2016
72021,39.8,192974,1243,283,191151,50270,24612,70950,49026,21924,70950,141100,2016
72023,41.7,50096,125,0,49971,11582,17088,17130,10012,7118,17130,112800,2016
72025,38.8,136372,1189,45,135062,35956,24278,50327,34496,15831,50327,137300,2016
72027,39.1,33481,229,14,33238,9034,17206,11816,8327,3489,11816,105300,2016
72029,38.2,47174,46,19,47066,10915,20426,14664,11232,3432,14664,116600,2016
72031,40.5,165040,1414,94,163072,44641,28611,64408,44184,20224,64408,150300,2016
72033,37.8,26137,118,0,25919,6715,18562,9190,5686,3504,9190,127100,2016
72035,40.4,46071,242,0,45801,11765,20577,16629,11120,5509,16629,120800,2016
72037,40.1,12538,121,0,12391,3273,20038,4585,3488,1097,4585,96200,2016
72039,39.8,17644,68,0,17576,4360,12511,5883,3850,2033,5883,103700,2016
72041,38.4,41782,120,10,41606,10403,21846,13519,9992,3527,13519,120000,2016
72043,38.7,40090,233,8,39847,9537,18453,13609,10447,3162,13609,90500,2016
72045,37.8,20153,74,0,20061,4419,13164,6249,3987,2262,6249,89000,2016
72047,37.4,35484,245,0,35222,8800,14733,11011,8638,2373,11011,93500,2016
72049,33.4,1508,74,0,1420,305,20956,509,327,182,509,104800,2016
72051,39,38013,548,48,37336,9353,28133,12036,9219,2817,12036,148600,2016
72053,39.8,33912,234,33,33601,8845,19482,12691,8526,4165,12691,105300,2016
72054,37.5,12287,53,0,12234,3393,16793,4305,3200,1105,4305,94300,2016
72055,41.3,17788,56,0,17732,3890,13242,5526,4092,1434,5526,90000,2016
72057,36.9,43210,294,30,42807,9715,15078,14879,10944,3935,14879,95200,2016
72059,39.2,20025,73,0,19930,5056,14848,6659,4807,1852,6659,82600,2016
72061,42.2,92444,944,30,91212,23715,33979,34724,25495,9229,34724,199100,2016
72063,37.7,46990,546,120,46291,11222,31070,15473,13079,2394,15473,156700,2016
72065,39.8,41327,77,0,41250,10613,18480,14339,10736,3603,14339,112800,2016
72067,44.6,16678,55,38,16585,4131,20589,6233,4718,1515,6233,109200,2016
72069,40.4,55621,478,36,55003,13209,19349,18763,13936,4827,18763,98300,2016
72071,40.4,43919,386,104,43310,10861,15947,15084,9611,5473,15084,109000,2016
72073,35.8,15605,25,0,15580,3732,15893,4720,3128,1592,4720,90300,2016
72075,36.7,48658,91,6,48522,12412,20231,16143,12255,3888,16143,99000,2016
72077,37.1,39942,222,12,39708,9218,19084,12746,9234,3512,12746,116100,2016
72079,43.1,24323,29,0,24294,5935,12785,8375,4525,3850,8375,93900,2016
72081,40.4,28052,112,7,27904,7429,12410,10148,5636,4512,10148,87500,2016
72083,39.2,9093,97,0,8996,2210,13132,3104,2036,1068,3104,75500,2016
72085,37.6,38466,52,75,38311,9672,20119,12876,9226,3650,12876,114100,2016
72087,36.5,27857,8,6,27797,6350,18154,8810,6404,2406,8810,105500,2016
72089,39.6,19237,225,9,18933,4857,19658,6691,4645,2046,6691,111900,2016
72091,40,41468,409,107,40919,11410,18534,15946,11518,4428,15946,109600,2016
72093,42,6274,11,0,6263,1379,11909,1952,1451,501,1952,94200,2016
72095,42.6,11506,143,0,11363,2897,18815,4035,2845,1190,4035,93900,2016
72097,39,81594,501,49,80866,18747,15017,30099,17648,12451,30099,101400,2016
72099,37.5,38289,127,0,37953,9410,14157,12473,8511,3962,12473,96300,2016
72101,36,32087,29,0,32014,7524,17649,9827,7148,2679,9827,99400,2016
72103,36.6,26722,52,0,26611,6096,18973,8586,6825,1761,8586,94600,2016
72105,37.7,29467,39,0,29383,6727,18828,8645,6735,1910,8645,100700,2016
72107,37.2,22258,46,0,22212,5135,14662,6858,4749,2109,6858,98400,2016
72109,42.7,18135,35,0,18088,4162,13975,6458,4617,1841,6458,94000,2016
72111,35.7,22231,78,0,22153,5794,16764,7398,5649,1749,7398,77500,2016
72113,38.9,152594,1049,129,151338,37802,16561,54722,35448,19274,54722,99900,2016
72115,39.3,24904,149,80,24657,6513,15641,8773,5287,3486,8773,108900,2016
72117,43.7,14700,843,0,13282,3540,17784,5210,4073,1137,5210,127500,2016
72119,39.6,52479,260,0,52199,12074,22990,16292,12587,3705,16292,116800,2016
72121,40.6,24013,173,0,23840,5140,14877,7413,5624,1789,7413,98100,2016
72123,37.3,29722,74,25,29507,7781,16540,10809,8848,1961,10809,86400,2016
72125,42.2,33546,104,23,33404,8033,14988,12263,8805,3458,12263,101600,2016
72127,41,363744,4681,829,357016,86883,21395,147790,78148,69642,147790,161100,2016
72129,39.5,39283,30,0,39220,9826,16916,13716,9910,3806,13716,116900,2016
72131,41.3,39755,305,0,39389,10132,13866,13870,8756,5114,13870,103400,2016
72133,36,22732,80,0,22652,5471,15295,7757,5677,2080,7757,93100,2016
72135,36.5,74467,256,43,73908,18402,29578,22375,19125,3250,22375,146900,2016
72137,38.3,83645,364,115,83045,19730,23889,28261,20412,7849,28261,135100,2016
72139,38.6,70737,428,16,70256,17832,30427,24660,16603,8057,24660,155700,2016
72141,40.7,30869,114,12,30743,7315,15875,10058,6577,3481,10058,93000,2016
72143,37.2,39018,440,16,38411,9566,18312,12677,9029,3648,12677,119100,2016
72145,39.2,55866,1815,65,53941,12738,17634,17356,14433,2923,17356,112400,2016
72147,43.3,9046,291,0,8717,1571,17535,2673,2228,445,2673,109600,2016
72149,36.9,24186,9,0,24173,6107,18974,7870,5957,1913,7870,93000,2016
72151,40.7,35670,31,0,35630,8278,16308,12011,8642,3369,12011,90800,2016
72153,41.5,38519,130,0,38383,7208,14666,10658,8286,2372,10658,92500,2016
01001,37.8,55036,41509,10419,1467,14904,55317,21054,15430,5624,21054,143000,2017
01003,42.6,203360,168951,19238,9029,50029,52562,76133,55470,20663,76133,182000,2017
01005,39.7,26201,11985,12528,1104,6041,33368,9191,5745,3446,9191,89300,2017
01007,39.8,22580,16849,4959,531,5302,43404,6916,5212,1704,6916,105500,2017
01009,40.9,57667,50381,879,5197,15309,47412,20690,16246,4444,20690,122200,2017
01011,40.8,10478,2264,7925,35,2424,29655,3670,2570,1100,3670,66800,2017
01013,40.7,20126,10515,8998,64,4565,36326,7050,4940,2110,7050,88800,2017
01015,39.1,115527,84006,23553,4121,30704,43686,45099,31295,13804,45099,110100,2017
01017,43,33895,19045,13335,730,8690,37342,13694,9103,4591,13694,86400,2017
01019,46.1,25855,23731,1287,409,7566,40041,10795,8435,2360,10795,116300,2017
01021,38.9,43805,35207,4154,3371,11920,43501,16768,12625,4143,16768,98600,2017
01023,45.8,13188,7420,5553,71,3594,32122,5463,4379,1084,5463,69000,2017
01025,42.2,24625,13057,11246,58,6038,33827,9602,6336,3266,9602,93500,2017
01027,43.8,13407,10753,1972,417,3742,37287,5338,4082,1256,5338,89300,2017
01029,41.7,14939,13842,424,356,3879,37396,5773,4296,1477,5773,111800,2017
01031,39.3,51073,36261,8755,3402,13431,49821,19620,12822,6798,19620,147800,2017
01033,42.5,54435,42877,8676,1313,14964,45477,21983,16009,5974,21983,108500,2017
01035,44.5,12649,6362,5855,231,3107,30434,4716,3658,1058,4716,76100,2017
01037,45.9,10955,7150,3640,16,2548,34792,4204,3377,827,4204,87300,2017
01039,43.4,37519,31320,4879,586,10316,39467,15285,11476,3809,15285,96200,2017
01041,41.4,13866,9872,3209,253,3601,38937,5358,3805,1553,5358,76800,2017
01043,40.6,81703,75434,900,3466,21549,40997,31097,23271,7826,31097,121900,2017
01045,37.1,49393,34306,9485,2994,12724,44711,18825,11237,7588,18825,108000,2017
01047,39.3,40755,11306,28603,409,10318,30065,16487,9755,6732,16487,80800,2017
01049,39,71194,57507,1009,10178,17992,38842,25482,18155,7327,25482,102900,2017
01051,38.5,80989,59460,17180,2316,20929,54981,29115,21245,7870,29115,155300,2017
01053,39.6,37621,22661,12107,809,8513,35026,13226,9490,3736,13226,94500,2017
01055,40.9,103132,80750,15847,3794,26410,42064,39061,28096,10965,39061,105100,2017
01057,43.6,16657,14163,1917,277,4903,36541,6955,5345,1610,6955,83200,2017
01059,37.7,31507,24474,1471,5146,8003,39501,11533,7942,3591,11533,87600,2017
01061,42.7,26572,22318,2440,1004,7540,39293,10693,7873,2820,10693,87800,2017
01063,42,8533,1459,6851,101,1843,20954,3025,2058,967,3025,67700,2017
01065,39.8,14995,5925,8795,196,3661,34679,5664,4241,1423,5664,88800,2017
01067,43.5,17110,11757,4762,435,4545,45569,6727,5531,1196,6727,112600,2017
01069,39.6,104108,69963,27576,3366,25917,42803,39560,25570,13990,39560,127100,2017
01071,43,52326,46738,1699,1493,14140,39281,20368,14992,5376,20368,105000,2017
01073,37.6,659460,332267,279928,24692,165380,49321,261390,164199,97191,261390,149000,2017
01075,44.5,14021,12061,1520,212,4049,36016,6019,4560,1459,6019,71500,2017
01077,41.5,92590,78605,9103,2285,24532,44888,38634,26430,12204,38634,126800,2017
01079,42,33288,25492,3801,701,9325,43779,13056,10443,2613,13056,98700,2017
01081,31,156597,105864,35923,5813,37148,47564,59001,34932,24069,59001,157100,2017
01083,39.1,91695,70776,11989,5323,23089,52831,32386,24979,7407,32386,146300,2017
01085,40.7,10362,2515,7708,71,2997,29785,4309,3163,1146,4309,63000,2017
01087,38,19358,2992,15772,315,4614,32308,7852,5079,2773,7852,77100,2017
01089,38.2,353213,230104,84675,16734,91730,61318,142253,96031,46222,142253,173400,2017
01091,42.1,19743,8909,10689,88,4617,32255,7975,5689,2286,7975,88100,2017
01093,44.1,30058,27637,963,741,8780,35719,12453,9421,3032,12453,87200,2017
01095,38.8,94738,77467,2084,12600,24212,41104,34588,24437,10151,34588,118500,2017
01097,37.3,414328,238405,145960,11416,102345,45802,153794,102051,51743,153794,124500,2017
01099,41.7,21745,11842,8874,286,5107,26036,8207,5006,3201,8207,88000,2017
01101,35.9,227120,79926,129745,7628,56232,46545,89776,53063,36713,89776,124100,2017
01103,40.1,119157,91006,14692,9485,31591,47529,45904,32858,13046,45904,128200,2017
01105,37.6,9680,2843,6735,67,1810,22973,3039,2287,752,3039,69100,2017
01107,42.1,20170,10914,8162,826,4929,36220,7620,5615,2005,7620,91800,2017
01109,31.4,33287,18759,12629,282,7320,35684,12284,7277,5007,12284,109200,2017
01111,42.7,22530,16955,4381,665,6069,39485,8867,6448,2419,8867,85200,2017
01113,35.3,58480,27955,24769,3050,14481,38988,22690,13368,9322,22690,114700,2017
01115,40.1,86937,74972,8084,2003,23503,53483,32486,26116,6370,32486,142800,2017
01117,38.5,208721,163877,24443,12045,55148,74063,76868,61189,15679,76868,199500,2017
01119,35.9,13084,3217,9256,34,2738,21663,5073,3274,1799,5073,69500,2017
01121,40.6,80888,51055,26004,1791,21221,39219,31651,22859,8792,31651,95200,2017
01123,43.3,40756,28081,11072,968,11456,42181,16369,11763,4606,16369,107000,2017
01125,32.3,204424,127567,63839,7128,47165,50513,71507,44920,26587,71507,161700,2017
01127,42.3,64927,58038,3902,1531,17640,38872,25143,19019,6124,25143,87300,2017
01129,43.5,16746,10907,4120,81,4321,42185,6001,4946,1055,6001,83900,2017
01131,40.5,10919,2937,7874,52,2347,27012,3841,2388,1453,3841,81600,2017
01133,44.6,23968,22556,124,717,6306,35362,9439,7295,2144,9439,82900,2017
02013,42.7,3338,516,160,324,517,66607,812,482,330,812,124700,2017
02016,37.7,5784,1435,291,780,707,85192,1218,367,851,1218,238800,2017
02020,33.1,298225,176518,15649,26415,70757,82271,106012,63722,42290,106012,304500,2017
02050,26.9,17957,1826,120,393,3406,53853,4524,2861,1663,4524,152600,2017
02060,41.8,917,461,4,41,233,79500,358,205,153,358,186700,2017
02068,38.4,2303,1905,4,17,373,83295,678,533,145,678,224200,2017
02070,30.1,4974,808,22,155,1005,58708,1405,871,534,1405,189500,2017
02090,31,100031,71100,4006,7714,23329,76250,36396,21466,14930,36396,230600,2017
02100,45,2537,2003,1,71,600,70640,1087,769,318,1087,243100,2017
02105,48.9,2146,935,59,117,541,57900,802,590,212,802,226800,2017
02110,38,32434,21214,330,2067,7879,90749,12273,8033,4240,12273,343100,2017
02122,40.6,57961,46943,300,2293,13915,65279,21779,15508,6271,21779,234600,2017
02130,39.5,13745,8854,75,655,3410,67321,5270,3261,2009,5270,265700,2017
02150,33.1,13773,6901,23,1219,3175,74167,4538,2679,1859,4538,267700,2017
02158,24,8129,307,35,132,1456,36468,1752,1296,456,1752,88600,2017
02164,32.3,1301,283,9,20,279,45208,408,278,130,408,118500,2017
02170,34.9,101135,80824,1033,4666,21543,74887,30613,23409,7204,30613,235600,2017
02180,27.9,9869,1466,75,234,2198,53821,2897,1755,1142,2897,143000,2017
02185,34.6,9757,3052,53,401,1591,77266,2041,1060,981,2041,153900,2017
02188,26.6,7715,856,42,196,1414,61533,1849,1055,794,1849,145800,2017
02195,41.7,3275,2199,19,346,811,63490,1255,856,399,1255,205000,2017
02198,41,6473,2931,10,238,1502,52114,2315,1690,625,2315,169100,2017
02220,38.9,8810,5498,85,555,2112,70765,3545,2008,1537,3545,350900,2017
02230,42.9,1038,816,2,71,202,70673,423,220,203,423,293800,2017
02240,36.6,6889,5162,99,356,1412,63866,2139,1533,606,2139,191700,2017
02261,40,9439,6628,13,453,1823,86019,2849,2092,757,2849,252200,2017
02275,49.1,2475,1595,4,78,699,56094,1084,722,362,1084,194000,2017
02282,39.4,682,298,6,38,146,64583,255,154,101,255,185000,2017
02290,34.7,5453,1164,5,117,1230,37819,1959,1379,580,1959,80600,2017
04001,34.2,71602,13212,355,4374,13405,32360,19530,15164,4366,19530,72800,2017
04003,40.5,126516,70407,4548,44275,32650,47847,49160,33878,15282,49160,144400,2017
04005,30.6,138639,75269,1729,19265,29453,53523,47588,28235,19353,47588,241400,2017
04007,49.3,53145,33360,238,9910,14228,41179,21585,15729,5856,21585,153600,2017
04009,33.1,37700,19292,695,12264,7670,48173,10976,7469,3507,10976,123500,2017
04011,33.4,9368,4457,183,4348,2429,56298,3364,1586,1778,3364,87500,2017
04012,56,20477,12027,167,5383,5664,36479,8798,6533,2265,8798,77400,2017
04013,36,4155501,2340105,211228,1271746,976254,58580,1489533,908516,581017,1489533,225000,2017
04015,50.4,204691,159694,1997,32591,53129,41567,83902,57336,26566,83902,138700,2017
04017,35.9,107902,44929,772,12054,24394,38798,34251,23595,10656,34251,115100,2017
04019,38.2,1007257,529974,32055,368612,245163,48676,398530,246837,151693,398530,166300,2017
04021,38.5,405537,232950,17249,120075,92921,52628,133513,96928,36585,133513,157200,2017
04023,36.6,46358,6974,135,38653,11785,39630,15568,10468,5100,15568,138400,2017
04025,52.2,220972,178765,1144,31508,59801,48259,94343,66683,27660,94343,215000,2017
04027,34.1,204281,65003,3651,128465,53669,43253,71670,48381,23289,71670,117000,2017
05001,40.9,18352,12874,4774,543,4833,38532,7692,4822,2870,7692,80300,2017
05003,41.8,20771,14126,5309,1083,5560,36407,8182,6054,2128,8182,68200,2017
05005,51.8,41093,39079,74,879,12048,40072,18398,13864,4534,18398,124400,2017
05007,35.2,251823,186902,4020,40980,66933,61271,90906,60275,30631,90906,163000,2017
05009,42.2,37212,35067,143,866,10185,40727,14887,10729,4158,14887,116600,2017
05011,40.6,10994,6143,3200,1625,2927,36310,4566,2828,1738,4566,74300,2017
05013,45.2,5194,3771,1135,203,1489,37225,2061,1714,347,2061,71000,2017
05015,44.6,27782,22392,137,4101,7044,39686,10832,8398,2434,10832,121100,2017
05017,43.3,11008,4309,5957,571,2825,32412,4323,2868,1455,4323,63000,2017
05019,33.8,22495,15540,5364,1035,5515,37144,8820,5470,3350,8820,95000,2017
05021,43.4,15190,14547,104,289,4021,32219,6428,4515,1913,6428,70000,2017
05023,48.9,25361,24048,150,623,7111,42312,10646,7988,2658,10646,127000,2017
05025,42.6,8332,7057,919,148,2366,44840,3292,2436,856,3292,87200,2017
05027,36.2,23992,14242,8362,610,6203,37072,9337,6138,3199,9337,76200,2017
05029,41.2,20954,17139,2302,796,5522,39638,8185,5803,2382,8185,98700,2017
05031,34,104246,80625,13919,5095,26218,45672,39838,23238,16600,39838,134600,2017
05033,38.7,62119,52830,830,4532,17587,43504,23870,18066,5804,23870,112500,2017
05035,35,49278,21277,24082,1177,12099,38558,18659,10587,8072,18659,106300,2017
05037,40.7,17164,12523,3899,325,4769,41081,6726,4543,2183,6726,79400,2017
05039,43.7,7585,4037,3036,233,2003,35794,3144,2156,988,3144,64500,2017
05041,40.2,12094,5531,5744,700,3365,27036,5230,3039,2191,5230,56700,2017
05043,36.5,18620,12463,5358,571,4476,36092,7038,4625,2413,7038,93200,2017
05045,32.3,121282,97800,13814,4855,28714,50316,43835,27329,16506,43835,153500,2017
05047,41.4,17803,16453,173,513,4633,39472,6862,5052,1810,6862,90600,2017
05049,48.1,12092,11555,40,158,3685,36051,5117,3997,1120,5117,91300,2017
05051,44.7,97994,80927,7952,5263,25186,41672,40062,26839,13223,40062,131500,2017
05053,39.9,18076,16812,517,449,5057,49968,6851,5469,1382,6851,123500,2017
05055,37.7,44197,41486,461,1203,12140,45566,16821,11323,5498,16821,110400,2017
05057,38.9,22154,12226,6531,2764,5455,38701,7930,5461,2469,7930,76200,2017
05059,41.7,33480,27722,3666,1127,8573,40626,12291,9197,3094,12291,88900,2017
05061,38.5,13472,8751,2809,1614,3483,34851,5042,3339,1703,5042,94100,2017
05063,39.8,37097,33074,723,2258,9886,39945,14288,10105,4183,14288,104400,2017
05065,48,13521,12646,258,284,3400,39135,5189,4082,1107,5189,79400,2017
05067,40.5,17429,13460,2953,476,3714,32783,6179,4362,1817,6179,61300,2017
05069,39,71373,28256,40183,1410,16781,37630,27377,17387,9990,27377,81800,2017
05071,37.8,26155,21015,415,3589,6817,35758,9900,7011,2889,9900,95400,2017
05073,45.8,7051,4180,2665,82,1828,32500,2860,2076,784,2860,65900,2017
05075,42,16777,16068,157,221,4507,37603,6584,4422,2162,6584,77100,2017
05077,41.9,9614,3911,5466,133,2180,27901,3541,1963,1578,3541,67100,2017
05079,38.6,13885,8963,4325,499,2842,38873,3928,2946,982,3928,66100,2017
05081,42.5,12494,9146,2559,414,3297,36963,5300,3691,1609,5300,72400,2017
05083,42.2,21802,19801,462,635,5816,37982,8269,6062,2207,8269,90400,2017
05085,35.8,71568,61925,4307,3046,19780,57290,26281,17996,8285,26281,135100,2017
05087,42.5,15907,14342,8,863,4559,42894,6190,4735,1455,6190,108500,2017
05089,51.8,16374,15501,28,353,4540,36113,6663,5224,1439,6663,117300,2017
05091,38.5,43760,30382,10668,1336,11450,41862,17020,10802,6218,17020,108500,2017
05093,36.1,43534,25564,15289,1753,11201,36417,17238,9722,7516,17238,81400,2017
05095,46.1,7420,4034,3026,189,1935,31584,3328,2054,1274,3328,54500,2017
05097,50,9059,8238,26,374,2649,35252,3855,3147,708,3855,96900,2017
05099,43.8,8528,5403,2852,34,2265,36995,3452,2571,881,3452,62700,2017
05101,48.8,7898,7449,1,108,2145,38134,3152,2683,469,3152,91600,2017
05103,42.8,24378,13541,9925,521,6339,32136,10016,6734,3282,10016,67900,2017
05105,43.7,10320,9520,220,291,2752,46168,3692,3006,686,3692,99100,2017
05107,38.2,19518,6748,12250,338,4802,26652,7823,3725,4098,7823,67100,2017
05109,41.8,10893,9538,304,713,2929,36893,4313,3329,984,4313,78600,2017
05111,39.7,24098,21061,1342,684,6728,37487,9483,6138,3345,9483,78200,2017
05113,43.8,20212,17792,102,1302,5458,33870,8058,6150,1908,8058,87100,2017
05115,34.9,63372,53699,1842,5396,14881,40668,23147,15511,7636,23147,126100,2017
05117,45.7,8309,7059,1112,47,2550,41244,3920,2776,1144,3920,65300,2017
05119,36.7,392848,208969,140952,23616,93912,48850,155435,91503,63932,155435,148300,2017
05121,42.2,17514,16648,165,327,5039,35930,7339,5282,2057,7339,81500,2017
05123,38.4,26688,10779,14763,704,5776,33102,9325,5462,3863,9325,61900,2017
05125,39,116252,99831,7436,5186,30763,58985,43314,33424,9890,43314,147400,2017
05127,41.2,10584,8942,22,795,2691,37396,3972,2930,1042,3972,69800,2017
05129,47.3,7925,7406,15,175,2256,36716,3336,2649,687,3336,89700,2017
05131,37.3,127362,89716,8533,17499,32435,40932,50301,30067,20234,50301,116800,2017
05133,35,17206,10038,828,5655,4217,43675,5984,4504,1480,5984,75400,2017
05135,47.3,17041,15996,69,364,4581,31792,7296,5360,1936,7296,79900,2017
05137,49.5,12443,11814,10,227,3325,33091,4910,3790,1120,4910,107300,2017
05139,39.7,40022,24446,13087,1516,10769,41106,16189,11892,4297,16189,79900,2017
05141,47.6,16751,15693,61,489,4717,34428,6867,5288,1579,6867,98900,2017
05143,31.5,223683,160864,7630,36813,52180,47452,84460,45031,39429,84460,162900,2017
05145,36.3,78706,69609,3143,3306,20521,44074,29217,19632,9585,29217,116400,2017
05147,45.3,6763,4680,1858,33,1724,30097,2874,1892,982,2874,63700,2017
05149,39.7,21601,16325,430,4261,5338,39696,7555,5355,2200,7555,100300,2017
06001,37.3,1629615,524881,175063,367041,379405,85743,569070,301667,267403,569070,649100,2017
06003,44.9,1203,777,18,117,206,63438,304,253,51,304,343800,2017
06005,50.6,37306,29571,764,4943,9472,60636,14185,10921,3264,14185,278600,2017
06007,36.9,225207,164184,3282,35445,51488,46516,86167,50844,35323,86167,238200,2017
06009,51.6,45057,36932,258,5166,11896,54800,17812,13931,3881,17812,273400,2017
06011,34.7,21479,7800,186,12539,5309,56481,7047,4521,2526,7047,223600,2017
06013,39.2,1123678,504818,93140,284003,279729,88456,389597,255201,134396,389597,522300,2017
06015,38.7,27442,17233,484,5281,5735,41287,9683,5996,3687,9683,185900,2017
06017,45.5,185015,145153,1614,23279,48175,74885,68084,51948,16136,68084,405900,2017
06019,31.8,971616,293677,45217,509442,219884,48730,301824,160001,141823,301824,220600,2017
06021,36.8,27935,14663,212,11407,7193,46260,9936,5724,4212,9936,214600,2017
06023,37.7,135490,101460,1389,14986,30401,43718,53966,30500,23466,53966,285800,2017
06025,32.2,179957,20372,4109,150108,35069,44779,45198,25507,19691,45198,167700,2017
06027,45.6,18195,11557,172,3894,4354,51500,8026,5109,2917,8026,243100,2017
06029,31.3,878744,310638,45024,458907,198056,50826,264993,151564,113429,264993,190600,2017
06031,31.5,150183,49728,8916,80715,32205,49742,42349,21925,20424,42349,185600,2017
06033,45.8,64095,45957,1362,12445,16029,40446,26327,17362,8965,26327,182000,2017
06035,36.2,31470,20812,2708,5829,6086,54083,9441,6230,3211,9441,177500,2017
06037,36,10105722,2676982,799579,4893579,2203922,61015,3295198,1512364,1782834,3295198,495800,2017
06039,33.7,154440,54145,4753,87852,34547,48210,44458,27701,16757,44458,220400,2017
06041,46.1,260814,186382,5463,41391,64821,104703,104846,67296,37550,104846,908800,2017
06043,51.1,17658,14309,215,1870,4803,51385,7434,5259,2175,7434,259500,2017
06045,42.4,87497,57682,560,21402,20811,46528,34182,20230,13952,34182,338000,2017
06047,30.8,267390,77092,8007,155650,60461,46338,79261,41206,38055,79261,196200,2017
06049,47.8,9017,7035,65,1317,2114,39296,3638,2655,983,3638,143100,2017
06051,38.3,14058,9288,53,3815,2452,60595,4899,2750,2149,4899,311700,2017
06053,33.9,433168,132600,10621,250913,91206,63249,125939,63873,62066,125939,441000,2017
06055,40.8,141005,75010,2877,47547,33746,79637,49044,30954,18090,49044,560500,2017
06057,49.8,98838,84389,541,9109,25858,60610,40386,29975,10411,40386,379800,2017
06059,37.5,3155816,1306398,49560,1079172,739052,81851,1024976,588551,436425,1024976,620500,2017
06061,41.6,374985,276754,5399,51131,97335,80488,138564,98153,40411,138564,413300,2017
06063,52.1,18724,15640,160,1599,4869,50266,8287,6016,2271,8287,228900,2017
06065,35,2355002,861271,140810,1130033,522332,60807,711724,462788,248936,711724,304500,2017
06067,35.9,1495400,684141,142416,340656,351693,60239,532050,295276,236774,532050,299900,2017
06069,35.4,58671,20872,437,34561,14008,80760,17440,11103,6337,17440,459700,2017
06071,32.9,2121220,632557,168985,1108996,473703,57156,623642,369329,254313,623642,280200,2017
06073,35.4,3283665,1517153,154599,1095458,747245,70588,1111739,589144,522595,1111739,484900,2017
06075,38.3,864263,353000,43961,131949,168738,96265,358772,133812,224960,358772,927400,2017
06077,33.9,724153,240170,48175,295606,166555,57813,223808,124734,99074,223808,281100,2017
06079,39,280119,194355,4958,62174,66465,67175,105044,63052,41992,105044,499800,2017
06081,39.6,763450,304751,17457,190045,181969,105667,261796,156400,105396,261796,917700,2017
06083,33.7,442996,200723,7469,198556,93819,68023,144015,75308,68707,144015,509400,2017
06085,37,1911226,622266,45479,498253,453108,106761,630451,358864,271587,630451,829600,2017
06087,37.3,273263,157988,2204,91096,60178,73663,95536,56992,38544,95536,659900,2017
06089,41.8,178919,143919,1951,17218,45292,47258,70486,44095,26391,70486,233500,2017
06091,55,2885,2509,4,290,703,44190,1208,963,245,1208,157100,2017
06093,47.9,43530,33587,669,5218,11774,40884,19018,12457,6561,19018,176600,2017
06095,37.7,434981,169436,59862,112098,106136,72950,147352,88381,58971,147352,342000,2017
06097,41.4,500943,319805,6972,132018,120389,71769,190058,114608,75450,190058,513300,2017
06099,33.9,535684,232230,13607,240816,127189,54260,171324,97790,73534,171324,244100,2017
06101,35.7,95583,45239,1768,28910,23496,54347,32188,18357,13831,32188,234500,2017
06103,41.1,63247,43779,376,15316,16214,42512,23712,15934,7778,23712,191400,2017
06105,51.4,13037,10796,104,937,3428,36563,5462,3758,1704,5462,286500,2017
06107,30.6,458809,135372,5973,291867,105173,44871,135144,75975,59169,135144,180200,2017
06109,48.6,53899,43565,924,6385,14269,54325,22267,15458,6809,22267,273500,2017
06111,37.5,847834,391128,13416,358244,198226,81972,270046,170678,99368,270046,520300,2017
06113,30.9,212605,101045,4705,66787,45369,61621,72845,37809,35036,72845,370800,2017
06115,32.4,74644,42018,2407,20479,18363,51776,25880,15063,10817,25880,207100,2017
08001,33.4,487850,249239,14662,191857,115202,64087,162508,105226,57282,162508,241900,2017
08003,30.3,16345,7948,264,7488,3714,36315,6049,3443,2606,6049,152900,2017
08005,36.4,626612,384195,63646,118350,155492,69553,235263,147380,87883,235263,292900,2017
08007,49.8,12592,9661,136,2309,3680,48016,5553,4076,1477,5553,274000,2017
08009,47.6,3581,3069,52,376,1040,35898,1603,1148,455,1603,79800,2017
08011,40.4,5806,3530,352,1857,1209,32500,1760,1101,659,1760,77700,2017
08013,36.2,316782,247610,2527,43558,73339,75669,125026,77815,47211,125026,423500,2017
08014,37.8,64283,49891,670,7756,17198,85639,25938,17307,8631,25938,356500,2017
08015,49.9,18818,16053,300,1895,5412,53762,7900,6091,1809,7900,313200,2017
08017,35.8,2127,1702,1,317,507,54907,776,570,206,776,90000,2017
08019,47.2,9257,8320,81,567,2661,68534,4374,3377,997,4374,317000,2017
08021,38.2,8147,3579,27,4354,2044,35657,2992,2336,656,2992,113100,2017
08023,51,3628,1164,13,2314,924,29000,1568,1119,449,1568,114200,2017
08025,38.2,5514,3439,237,1693,814,35292,1215,898,317,1215,79700,2017
08027,58.2,4505,4042,112,205,1473,41330,2093,1714,379,2093,248300,2017
08029,47.8,30217,24662,195,4525,8074,42487,12119,8608,3511,12119,206200,2017
08031,34.4,678467,363712,62166,207100,139696,60098,287262,143874,143388,287262,322900,2017
08033,49.4,1736,1585,0,79,481,40352,707,564,143,707,122000,2017
08035,38.1,320940,267369,3450,26740,89330,111154,113799,90431,23368,113799,407100,2017
08037,36.5,53726,36163,404,15884,11965,83803,17765,12509,5256,17765,471100,2017
08039,45.6,24553,21945,157,1604,6847,92849,8866,7965,901,8866,380000,2017
08041,34,674826,471773,39136,111329,171919,62535,249745,157971,91774,249745,238200,2017
08043,44.8,46601,37036,2114,6058,11215,44712,16762,12556,4206,16762,160000,2017
08045,36.2,57945,39775,216,16276,15296,66503,21055,13909,7146,21055,323800,2017
08047,45.2,5793,4992,34,534,1453,72544,2603,2073,530,2603,301700,2017
08049,44.1,14793,12849,56,1194,3495,66489,5724,3947,1777,5724,285000,2017
08051,34.5,16215,14173,42,1478,3664,52651,6495,3812,2683,6495,313900,2017
08053,57.2,820,745,0,49,252,53056,368,257,111,368,325400,2017
08055,54.9,6498,4171,12,2257,1781,35801,3173,2282,891,3173,137400,2017
08057,49.2,1372,1027,0,335,388,45994,597,420,177,597,171300,2017
08059,40.4,564029,443660,5641,85489,146870,75170,227805,161274,66531,227805,334100,2017
08061,41.1,1368,1204,8,60,364,39250,576,438,138,576,83200,2017
08063,38.4,7846,5984,249,1510,2104,45881,2995,2093,902,2995,130200,2017
08065,39.3,7481,4808,9,2538,1987,46176,3324,1914,1410,3324,197600,2017
08067,39.7,54469,43051,251,6846,13388,62533,21818,14880,6938,21818,356700,2017
08069,35.7,330976,275297,2868,36993,81507,64980,130502,84626,45876,130502,306600,2017
08071,46,14151,7459,112,6004,3842,40586,6327,4169,2158,6327,145900,2017
08073,38.5,5520,3665,497,1253,984,44725,1477,1021,456,1477,132100,2017
08075,37.5,21885,17083,251,3402,4805,44876,8151,5052,3099,8151,148700,2017
08077,38.9,148798,121655,1010,21177,39054,51971,60562,40554,20008,60562,207900,2017
08079,58.5,834,699,13,105,264,50385,404,345,59,404,279000,2017
08081,37.7,13056,10634,126,1948,3363,53010,5103,3563,1540,5103,169200,2017
08083,44.1,25770,18836,47,3153,6768,45645,10520,7385,3135,10520,197900,2017
08085,44.7,40908,31180,159,8367,11322,44865,16951,11728,5223,16951,202500,2017
08087,36.6,28123,16662,824,10055,7714,51456,10599,6809,3790,10599,162900,2017
08089,40.2,18325,9985,136,7612,5027,35051,7490,4813,2677,7490,91800,2017
08091,53.7,4653,4303,0,263,1367,61333,2204,1530,674,2204,420600,2017
08093,50.6,16900,15154,13,991,4745,61644,7389,6006,1383,7389,262300,2017
08095,38.5,4327,3349,9,869,1108,50076,1696,1152,544,1696,132600,2017
08097,43.3,17747,15212,214,1742,3637,67755,7340,4757,2583,7340,593600,2017
08099,37.4,12084,7254,48,4493,3344,41740,4913,3200,1713,4913,94400,2017
08101,38.8,163368,85660,2594,69809,40751,42386,63489,40106,23383,63489,148000,2017
08103,35.9,6557,5793,20,651,1624,57991,2417,1667,750,2417,201000,2017
08105,40.7,11430,5962,29,5096,3031,38534,4750,3143,1607,4750,143000,2017
08107,39.9,24359,21865,192,1682,5627,67472,9478,6471,3007,9478,460600,2017
08109,48.8,6338,3692,0,2348,1650,34765,2626,1855,771,2626,150100,2017
08111,46.9,569,490,0,76,117,46397,255,171,84,255,269400,2017
08113,42,7804,6783,14,771,1787,62243,3301,1974,1327,3301,485000,2017
08115,48.4,2357,1945,30,263,583,49583,998,710,288,998,91500,2017
08117,39.2,29722,24357,254,4158,5336,73538,9455,6287,3168,9455,547700,2017
08119,49.8,23769,21266,158,1469,7117,66809,10076,8134,1942,10076,261100,2017
08121,42.2,4809,4220,45,460,1413,51458,2012,1433,579,2012,120300,2017
08123,34.2,285729,189741,2956,82920,73071,66489,99817,71451,28366,99817,245000,2017
08125,35.8,10109,7649,46,2289,2500,44668,4053,2514,1539,4053,148800,2017
09001,40.2,947328,595323,98931,180379,236410,89773,337678,228666,109012,337678,417800,2017
09003,40.4,897417,560997,114711,154977,226604,69936,348871,225378,123493,348871,235300,2017
09005,46.9,184454,164992,2843,10510,49751,76438,74605,57330,17275,74605,250100,2017
09007,45.1,164110,138523,8046,9612,42571,81673,66599,49088,17511,66599,283700,2017
09009,40.1,862127,553000,105661,148446,205240,64872,327402,204037,123365,327402,244400,2017
09011,41,270772,206261,14093,27186,69729,69411,107193,71447,35746,107193,238900,2017
09013,37.9,151596,129519,4425,7860,35732,81312,54878,39710,15168,54878,247500,2017
09015,41,116674,97434,2110,12946,29630,62553,44529,31142,13387,44529,196800,2017
10001,37.3,173145,108627,41729,11820,44233,57647,63381,44132,19249,63381,205800,2017
10003,37.8,555036,324937,133538,53113,131765,68336,202654,138618,64036,202654,248100,2017
10005,48.3,215551,161347,26144,19860,59507,57901,86322,68348,17974,86322,242900,2017
11001,33.9,672391,241901,315159,71829,121411,77649,277985,115795,162190,277985,537400,2017
12001,31.2,259865,161138,51543,24059,50991,45478,97485,52252,45233,97485,167000,2017
12003,37.1,27537,22554,3790,648,6297,59506,8299,6439,1860,8299,121100,2017
12005,39.6,180117,139208,19358,10820,44548,50283,68667,42881,25786,68667,166400,2017
12007,40.9,26775,19953,5111,1021,5771,46106,8980,6381,2599,8980,90500,2017
12009,47.1,568183,427709,55543,55042,145167,51536,227223,163565,63658,227223,162400,2017
12011,40.1,1890416,721241,518277,535987,433887,54895,675828,420780,255048,675828,223400,2017
12013,40.3,14458,11114,1848,836,3026,36237,4581,3824,757,4581,80000,2017
12015,58.1,173236,146273,9483,11873,47776,46511,74884,58572,16312,74884,165200,2017
12017,55.9,141373,125288,3957,7528,39581,40574,62488,50556,11932,62488,117400,2017
12019,39.4,203291,150764,19541,18890,54577,61971,71939,53528,18411,71939,165300,2017
12021,49.7,356774,227002,24395,96948,93364,62407,138131,99624,38507,138131,316200,2017
12023,40.7,68484,50028,12068,3977,15565,43504,24722,18051,6671,24722,112500,2017
12027,40.7,35675,19782,4563,10887,8044,35435,11744,8090,3654,11744,83700,2017
12029,47.6,16323,13843,1154,632,4223,35910,6431,5031,1400,6431,71600,2017
12031,36,912043,493308,266817,81639,216247,51296,347783,200667,147116,347783,156200,2017
12033,37,309924,200963,66894,16935,69798,47361,117836,71791,46045,117836,126700,2017
12035,50.3,105015,78486,10491,10496,27473,51049,39433,30369,9064,39433,188400,2017
12037,44.3,11675,9132,1587,606,2774,41267,4327,3182,1145,4327,135300,2017
12039,40.7,46113,15027,25522,4630,11757,39830,17310,12159,5151,17310,101300,2017
12041,42.8,17191,14982,998,947,4378,42934,6399,5229,1170,6399,96700,2017
12043,45.8,13197,8005,1699,2745,2808,37385,4297,3223,1074,4297,80100,2017
12045,44.3,16018,11928,2694,762,3680,44647,5295,3953,1342,5295,151400,2017
12047,41.1,14238,7813,4858,1310,3202,36209,4551,3354,1197,4551,73500,2017
12049,34.9,27326,12944,2166,11801,5729,39063,7718,5288,2430,7718,81200,2017
12051,33.7,39064,13099,4276,20258,8369,37966,12098,7915,4183,12098,79700,2017
12053,48.9,179144,142067,8744,21865,48784,44324,72234,56187,16047,72234,120600,2017
12055,53.1,100177,68505,9268,18893,26519,36374,41350,30884,10466,41350,87900,2017
12057,36.8,1351087,679341,209695,370827,321144,53742,505845,293143,212702,505845,179500,2017
12059,42.2,19483,16971,1432,532,4632,37474,7019,5496,1523,7019,92400,2017
12061,52.2,147981,112347,13103,17872,36622,49009,57911,43914,13997,57911,172600,2017
12063,41.5,48571,31834,13018,2258,11202,36944,17041,11942,5099,17041,94900,2017
12065,46,14085,8200,4946,568,3770,47599,5702,4414,1288,5702,131700,2017
12067,39.2,8684,5933,1311,1238,1579,41512,2193,1781,412,2193,101400,2017
12069,46.6,326215,231923,32358,47009,86712,49734,127441,93644,33797,127441,155100,2017
12071,47.8,700165,479250,57549,141544,174256,52052,264325,184567,79758,264325,190200,2017
12073,30.5,285890,163461,87888,17506,61964,49941,112373,59141,53232,112373,187400,2017
12075,46.4,39713,31873,3437,3178,10315,36554,15806,11848,3958,15806,88700,2017
12077,36.9,8347,6249,1518,406,1618,36741,2325,1751,574,2325,62400,2017
12079,42.4,18518,10073,7180,936,4401,31816,6743,5106,1637,6743,87200,2017
12081,47.6,363542,261265,31285,57651,92321,53408,140255,100100,40155,140255,197200,2017
12083,48.5,343778,245045,42355,42467,87376,41964,134747,101514,33233,134747,119200,2017
12085,51.6,155719,123000,8443,20549,38713,55588,63497,48642,14855,63497,233000,2017
12086,39.5,2702602,371233,441604,1823038,585476,46338,858289,448011,410278,858289,242800,2017
12087,46.7,76745,51643,5152,18021,17358,63030,30198,17724,12474,30198,429000,2017
12089,44.9,78435,68631,4817,2979,22165,64294,30454,23688,6766,30454,203500,2017
12091,36.7,197591,147226,18755,17109,50053,59955,76574,48462,28112,76574,198700,2017
12093,41,40228,25751,3225,10052,9067,39059,13333,9630,3703,13333,89900,2017
12095,34.7,1290216,536856,256997,389005,294557,51586,451960,246375,205585,451960,192400,2017
12097,35.7,325168,111112,29879,167797,72448,47343,96250,58140,38110,96250,164500,2017
12099,44.4,1426772,799018,257856,304210,339462,57256,543591,372677,170914,543591,242500,2017
12101,44.5,498136,380701,24843,69864,129246,48289,195818,140827,54991,195818,134300,2017
12103,47.6,949842,709165,94991,86921,225686,48968,406871,265628,141243,406871,167100,2017
12105,40.4,652256,397742,95997,134399,155940,45988,226604,154703,71901,226604,121100,2017
12107,44.8,72435,51959,11729,7079,17148,33619,27951,20321,7630,27951,82800,2017
12109,43.1,226578,189412,11336,14484,60085,73640,83744,64505,19239,83744,274600,2017
12111,44.6,298763,175050,57459,54152,74384,47132,110043,79480,30563,110043,150700,2017
12113,39.5,166778,138198,9616,8736,44717,62731,60607,45036,15571,60607,170500,2017
12115,55.1,404839,338000,18043,35694,108183,55236,177998,130699,47299,177998,215300,2017
12117,39.1,449260,279744,47735,90119,106445,60739,161371,106116,55255,161371,201900,2017
12119,66.4,116754,98930,8545,6608,35920,54771,52360,47193,5167,52360,239800,2017
12121,41.7,43814,33187,5833,3866,10930,40600,15291,10820,4471,15291,92400,2017
12123,41.4,22350,16056,4773,915,5221,37188,7406,5869,1537,7406,84900,2017
12125,39.8,15300,10692,3350,831,2762,37460,3946,2673,1273,3946,89000,2017
12127,46.4,518660,378165,53152,66743,128435,43838,209885,145699,64186,209885,149900,2017
12129,40.7,31586,25054,4711,1136,7957,57866,11075,8903,2172,11075,133700,2017
12131,43.2,63457,53508,3095,3814,16778,50619,25449,18121,7328,25449,203100,2017
12133,41.9,24472,18997,3750,867,5923,36989,8558,6749,1809,8558,102700,2017
13001,39.3,18471,12865,3299,1798,4806,37089,6702,4816,1886,6702,72100,2017
13003,34.9,8313,4708,1482,2048,1902,33063,2835,2100,735,2835,62500,2017
13005,37.6,11279,8306,1642,957,2906,38824,3989,2821,1168,3989,73200,2017
13007,43.6,3251,1695,1342,174,839,43867,1321,916,405,1321,79500,2017
13009,35.1,45527,24064,18857,999,9550,37008,16330,9004,7326,16330,108800,2017
13011,40.3,18363,16225,462,1180,4862,42182,6489,4816,1673,6489,128900,2017
13013,35.1,75099,54809,8320,7524,18350,56119,24588,17930,6658,24588,134300,2017
13015,37.5,102623,80298,10773,8379,26667,52393,37120,24293,12827,37120,140500,2017
13017,39,17272,9760,6246,1044,4469,32344,6361,3861,2500,6361,81200,2017
13019,39.5,19014,15652,2058,927,5121,38297,7240,5017,2223,7240,86700,2017
13021,36,153923,60541,83045,4864,34583,38183,57319,30235,27084,57319,117300,2017
13023,37.4,12779,8798,3545,345,2754,40688,4155,2978,1177,4155,98800,2017
13025,40.3,18411,17057,572,389,4934,36812,6658,5212,1446,6658,68200,2017
13027,43.2,15629,8873,5252,875,4122,34890,6337,4661,1676,6337,92400,2017
13029,34.8,34883,25908,5097,2316,9731,68589,12366,8515,3851,12366,201700,2017
13031,28.1,73742,47177,21049,2737,16464,39305,26632,14157,12475,26632,131200,2017
13033,37.4,22645,10652,11115,699,6011,38707,8068,5587,2481,8068,86500,2017
13035,38.4,23556,15685,6644,725,5760,39655,8053,5628,2425,8053,121500,2017
13037,38.4,6503,2113,3933,312,1235,29617,1865,1257,608,1865,49000,2017
13039,31.6,52252,36635,9668,3326,14363,53687,18913,11358,7555,18913,154500,2017
13043,37.9,10894,6670,2561,1251,2921,33125,4061,2373,1688,4061,88600,2017
13045,34.4,114898,81705,21436,7678,28238,46844,41123,26355,14768,41123,119600,2017
13047,39.6,65870,60207,1487,1885,17992,54537,24719,18140,6579,24719,138800,2017
13049,41.4,12963,8042,3280,1084,2754,43257,3537,2566,971,3537,82200,2017
13051,34.9,285506,140127,112467,17845,66960,52215,107427,57915,49512,107427,177900,2017
13053,23.7,11096,6558,1986,1699,1832,46096,2505,675,1830,2505,81700,2017
13055,40.3,24880,20676,2550,1179,6140,35718,9253,6077,3176,9253,68500,2017
13057,38,235896,188379,14515,23664,61684,75477,83150,63549,19601,83150,220200,2017
13059,27.3,123554,68658,33669,13135,22143,34557,46291,17832,28459,46291,154600,2017
13061,44.6,3024,915,1944,143,702,23315,1154,747,407,1154,59900,2017
13063,32.4,274150,30835,185643,36168,61259,44106,91604,46220,45384,91604,89400,2017
13065,37.6,6788,4460,1857,333,1535,21838,2576,1840,736,2576,63100,2017
13067,36.4,739072,392231,194071,94405,187468,72004,274361,176516,97845,274361,219700,2017
13069,35.9,43048,25220,12029,4870,9632,36572,14329,9468,4861,14329,87600,2017
13071,36,45890,25929,10336,8683,11133,34503,15599,9277,6322,15599,84500,2017
13073,36.4,143723,100805,23446,8953,35456,74162,45823,35992,9831,45823,183800,2017
13075,37,17190,11162,4675,1003,4400,35539,6065,4185,1880,6065,87800,2017
13077,37.9,138015,98747,23981,9328,38162,67570,50531,36672,13859,50531,190700,2017
13079,44.2,12385,9103,2885,87,3310,41032,4715,3622,1093,4715,93300,2017
13081,38.3,23005,11643,9931,745,5718,33194,8312,4909,3403,8312,83900,2017
13083,41.8,16282,15274,84,355,4442,43163,6089,4584,1505,6089,122500,2017
13085,43.3,23397,21707,276,988,6421,62284,8557,6827,1730,8557,202300,2017
13087,37.9,27023,13743,11375,1564,6769,36934,10311,6157,4154,10311,109800,2017
13089,35.5,736066,213843,392421,63842,160589,55876,273614,147910,125704,273614,176000,2017
13091,41.2,21063,13748,5849,722,5254,35290,7858,5200,2658,7858,73400,2017
13093,43.5,14053,5981,6954,974,3446,33389,5171,3325,1846,5171,83200,2017
13095,35,91522,23976,62630,2419,21503,34541,34842,15728,19114,34842,102100,2017
13097,36.3,140152,60795,61725,12906,34797,59333,48426,31884,16542,48426,140100,2017
13099,40.5,10405,4792,5256,224,2673,29493,4032,2747,1285,4032,82700,2017
13101,38.1,4011,2608,108,1069,1085,34315,1502,932,570,1502,57000,2017
13103,36.2,57087,45248,7543,2228,14727,64279,19584,15028,4556,19584,155500,2017
13105,42.3,19288,12240,5891,1067,5096,35207,7730,5580,2150,7730,81800,2017
13107,37.2,22502,13377,7648,1008,5489,33089,8387,5719,2668,8387,78500,2017
13109,37.3,10757,6077,3250,1266,2885,38736,4023,2598,1425,4023,83600,2017
13111,50.8,24480,23327,52,528,6758,43344,10175,7817,2358,10175,171500,2017
13113,43.5,110306,70754,23263,7806,30530,84861,39604,32077,7527,39604,255300,2017
13115,38.3,96471,68872,13938,10224,24711,46096,35506,21371,14135,35506,126600,2017
13117,38.2,211300,158260,6056,20064,57777,96445,70468,59379,11089,70468,301100,2017
13119,41.1,22328,18743,2183,987,5816,39246,8322,5623,2699,8322,101600,2017
13121,35.2,1010420,403350,440568,74574,211714,61336,391850,201145,190705,391850,268900,2017
13123,46,29614,25331,179,3404,8214,46211,11468,8537,2931,11468,162400,2017
13125,42.9,3027,2645,267,47,698,45273,1083,855,228,1083,66600,2017
13127,40.8,83467,53220,21414,5607,21698,47546,33200,20351,12849,33200,161200,2017
13129,37,56424,44007,2228,8690,14993,43452,19959,12818,7141,19959,119500,2017
13131,39.7,25048,14615,7060,2771,6610,39462,9092,5548,3544,9092,110500,2017
13133,48.9,16732,9438,5995,1016,4598,45069,6793,4901,1892,6793,175800,2017
13135,34.9,889954,349434,230815,184621,215104,64496,283256,188529,94727,283256,185200,2017
13137,39.5,43878,33919,1372,6210,10410,44474,15106,11361,3745,15106,137200,2017
13139,36,192865,118722,14050,53644,46652,55622,63095,42572,20523,63095,171900,2017
13141,44.3,8667,2085,6321,156,1839,29268,2970,2331,639,2970,66100,2017
13143,40.7,28722,26195,1237,420,8043,43663,11033,7535,3498,11033,117000,2017
13145,43.2,33198,25606,5295,1098,9676,69539,12088,10240,1848,12088,194800,2017
13147,43,25535,19178,4846,947,7004,41216,9848,7357,2491,9848,131200,2017
13149,41.9,11607,9862,1162,78,3028,44897,4379,3046,1333,4379,100500,2017
13151,36.7,217506,101652,88487,14079,56318,64752,72697,52337,20360,72697,154900,2017
13153,35.1,150341,86402,44634,9895,39145,55965,55200,35396,19804,55200,135800,2017
13155,39.7,9278,6275,2597,116,2133,34677,3323,2507,816,3323,81200,2017
13157,38.7,63851,52583,4309,4516,16459,57999,21785,16780,5005,21785,163200,2017
13159,42.2,13732,10110,2858,533,3687,42067,5100,3747,1353,5100,119700,2017
13161,36.3,14999,10746,2487,1717,3919,37267,5210,3820,1390,5210,77900,2017
13163,38.6,15954,6655,8615,583,3664,29640,5797,3726,2071,5797,69200,2017
13165,40.6,8929,5022,3170,575,2105,27197,3375,2317,1058,3375,59100,2017
13167,41.6,9800,6139,3309,228,2149,36423,3277,2310,967,3277,64200,2017
13169,39.7,28540,20516,7037,418,7868,55110,10472,8437,2035,10472,124800,2017
13171,38.1,18282,11887,5293,415,3815,41157,6263,4339,1924,6263,132400,2017
13173,33.8,10388,7137,2499,567,2632,31109,3744,2306,1438,3744,102000,2017
13175,38.3,47451,27593,17430,1217,11469,35202,17437,10956,6481,17437,85000,2017
13177,36.9,29216,21268,5688,803,7982,65018,10292,7546,2746,10292,156800,2017
13179,27.9,62120,25011,24859,7734,16460,43493,23108,10356,12752,23108,120500,2017
13181,47.9,7768,5082,2503,119,2154,37711,3438,2496,942,3438,115600,2017
13183,31.6,17857,10449,4273,2032,3964,53083,5399,3708,1691,5399,117500,2017
13185,30.1,113941,62123,41124,6179,25440,39911,40318,21035,19283,40318,129700,2017
13187,37.3,31567,28653,677,1489,7453,43039,11412,7321,4091,11412,176300,2017
13189,37.8,21488,11641,8656,617,5765,40469,8156,5008,3148,8156,102500,2017
13191,49.2,14061,8679,4935,213,3858,43285,5730,4513,1217,5730,112700,2017
13193,40.6,13675,4461,8110,581,2956,30851,4618,2935,1683,4618,61300,2017
13195,41,28600,23712,2469,1395,7924,47653,10571,7833,2738,10571,121600,2017
13197,43.3,8558,5065,3052,144,2206,39015,3263,2366,897,3263,86300,2017
13199,42,21152,11912,8116,442,5643,36368,8108,5533,2575,8108,91300,2017
13201,43.1,5884,4023,1781,24,1621,37255,2326,1535,791,2326,88500,2017
13205,38.8,22574,10442,10722,999,5362,34122,7991,5267,2724,7991,82500,2017
13207,43.3,26795,19316,6311,631,6626,50666,9590,7398,2192,9590,159900,2017
13209,39.4,8962,5779,2331,587,2127,40308,3077,2261,816,3077,76500,2017
13211,44.2,18013,12903,4238,565,5212,59572,6698,5003,1695,6698,208200,2017
13213,37.6,39444,32865,380,5658,10646,41617,14176,9620,4556,14176,91700,2017
13215,33.7,198647,81594,89371,14881,45774,43239,73179,35455,37724,73179,140200,2017
13217,36.2,105042,51168,44742,5389,25936,52784,35823,24729,11094,35823,123300,2017
13219,40.1,35972,30524,1946,1714,10137,77388,12693,10432,2261,12693,252000,2017
13221,42.5,14654,11126,2632,607,3865,43938,5642,4387,1255,5642,111800,2017
13223,35.6,152399,111299,27271,8866,40428,63669,51397,39939,11458,51397,150400,2017
13225,35.8,27027,12425,11995,2029,6453,43645,10113,6639,3474,10113,126000,2017
13227,44.9,30343,28416,148,923,8533,61542,11379,8825,2554,11379,185700,2017
13229,39.4,19141,16093,1710,978,5429,39863,6975,5123,1852,6975,99000,2017
13231,40.5,17919,15536,1841,273,4451,52377,5963,4968,995,5963,162000,2017
13233,37.1,41444,29827,5253,5403,10346,40652,14949,9646,5303,14949,105600,2017
13235,43.1,11396,6843,3959,406,2519,38750,3893,2384,1509,3893,111100,2017
13237,45.6,21430,14011,5587,1406,6304,48340,8662,6490,2172,8662,168700,2017
13239,52.6,2140,897,1086,12,571,26750,978,725,253,978,67400,2017
13241,48.8,16354,14237,303,1320,4168,39297,6506,4824,1682,6506,157800,2017
13243,44.3,7206,2611,4305,120,1795,30640,2864,1732,1132,2864,67300,2017
13245,33.7,201568,71642,111302,9645,43382,39430,72361,38434,33927,72361,100200,2017
13247,37.3,88482,30593,45162,9030,21913,54175,29937,20520,9417,29937,148600,2017
13249,36.9,5168,3474,1420,258,1467,41267,1925,1268,657,1925,94800,2017
13251,41.2,14037,7652,5856,255,3454,36556,5268,3643,1625,5268,78900,2017
13253,44,8549,5267,2878,253,2327,33999,3353,2380,973,3353,77200,2017
13255,38.9,64192,38112,21402,2791,16119,42398,23475,14404,9071,23475,112400,2017
13257,42.3,25625,21224,3006,809,6496,39756,9427,6620,2807,9427,98500,2017
13259,37,5832,1506,2932,1182,1064,22413,1780,1211,569,1780,51800,2017
13261,35.2,30687,12210,16063,1626,7750,34219,11871,6626,5245,11871,82600,2017
13263,49.9,6423,2582,3622,150,1870,37226,2801,2262,539,2801,81200,2017
13265,43.3,1844,622,1135,78,441,30500,710,495,215,710,59100,2017
13267,36.9,25402,14836,7414,2734,5767,36355,8044,5487,2557,8044,88100,2017
13269,43.8,8267,4753,3340,79,2428,29875,3554,2471,1083,3554,65800,2017
13271,41,16339,8018,6334,1901,3395,28044,5167,3191,1976,5167,55600,2017
13273,40.7,8978,3188,5442,243,2229,32219,3290,1925,1365,3290,88600,2017
13275,39.6,44909,25898,16063,1570,11936,41336,17254,11116,6138,17254,131400,2017
13277,35.5,40531,22836,11892,4618,10681,38728,14999,8545,6454,14999,112200,2017
13279,36.1,27160,16434,6890,3140,6931,35750,10521,6371,4150,10521,97500,2017
13281,53.3,11173,10613,113,163,3039,41182,4588,3708,880,4588,197900,2017
13283,40.8,6752,4590,2000,143,1784,39375,2633,1870,763,2633,71000,2017
13285,36.2,69433,39751,24339,2563,16728,43597,24679,14074,10605,24679,125000,2017
13287,40.2,8036,4393,3172,368,2276,42622,3103,2169,934,3103,72700,2017
13289,46.3,8323,4572,3547,30,2004,30629,2943,2311,632,2943,57000,2017
13291,53.8,22262,20964,185,680,6205,42767,8788,7041,1747,8788,191800,2017
13293,41.5,26241,17733,7470,604,6218,35375,10263,6600,3663,10263,84900,2017
13295,41.4,68609,62705,2952,1364,18163,43581,25564,18475,7089,25564,111100,2017
13297,38.9,88695,67361,14619,3557,23807,55876,30488,22243,8245,30488,164700,2017
13299,38.9,35688,22771,10541,1425,9498,36962,13903,8777,5126,13903,78500,2017
13301,44.2,5410,2012,3278,31,1387,32860,2274,1526,748,2274,62300,2017
13303,40.3,20506,8864,10846,474,5220,38097,7384,5080,2304,7384,82400,2017
13305,38.2,29833,21243,5831,1857,7139,41534,10362,6537,3825,10362,107300,2017
13307,43.5,2627,1271,1283,54,735,36658,1091,851,240,1091,57200,2017
13309,38.2,7952,4465,3318,131,1336,28490,1972,1259,713,1972,46800,2017
13311,45.1,28509,26374,586,875,7988,43944,11250,8227,3023,11250,157900,2017
13313,35.4,103963,61859,4014,35516,25486,43871,35384,21835,13549,35384,124300,2017
13315,39.4,8896,5203,3141,386,1726,35457,2676,1956,720,2676,69800,2017
13317,45.5,9905,5064,4205,453,2456,34234,3971,2689,1282,3971,83400,2017
13319,42.5,9147,5198,3491,248,2215,38711,3288,2518,770,3288,69100,2017
13321,42.1,20809,14020,5870,418,5800,40369,7899,5343,2556,7899,85600,2017
15001,42.1,196325,59540,1105,24523,44937,56395,67054,44942,22112,67054,316000,2017
15003,37.6,990060,185366,21577,95070,219859,80078,311451,173242,138209,311451,626400,2017
15005,57.6,86,18,0,4,15,61750,53,2,51,53,NA,2017
15007,42.1,71093,21059,476,7654,15723,72330,22563,14213,8350,22563,520100,2017
15009,40.9,164094,50064,819,18130,37230,72762,54381,32223,22158,54381,569100,2017
16001,36.4,435117,370788,5412,34228,104954,60151,164389,112238,52151,164389,219900,2017
16003,52.8,3946,3656,13,131,1130,42727,1736,1386,350,1736,166500,2017
16005,33.2,84113,71102,511,6954,20461,47390,30790,21200,9590,30790,148300,2017
16007,39.3,5942,5565,48,245,1735,50603,2313,1817,496,2313,142100,2017
16009,46.5,9050,7667,22,311,2328,43472,3508,2596,912,3508,150800,2017
16011,33.3,45369,33576,132,8121,11146,51307,14903,11147,3756,14903,147400,2017
16013,42.8,21583,16511,64,4535,5159,58835,8273,5528,2745,8273,390300,2017
16015,53.2,6968,6394,14,286,2080,49964,3004,2490,514,3004,185100,2017
16017,47.7,41855,39157,51,1210,11558,45607,17563,12782,4781,17563,222700,2017
16019,32.6,110404,92311,550,13987,27737,54150,38400,27120,11280,38400,161000,2017
16021,43.7,11323,10294,25,526,2726,39512,4490,3317,1173,4490,181300,2017
16023,46.4,2613,2472,65,66,712,43207,1049,870,179,1049,110700,2017
16025,47,886,801,0,82,220,36667,370,272,98,370,173300,2017
16027,33.2,207027,146850,851,51487,48420,46426,69303,46834,22469,69303,144000,2017
16029,36.9,6862,6417,0,371,1858,58750,2533,2124,409,2533,130600,2017
16031,31.8,23472,16522,23,6337,6086,48162,7827,5455,2372,7827,136900,2017
16033,29.7,1055,542,2,443,244,31927,313,173,140,313,98700,2017
16035,50.3,8533,7763,19,332,2340,41122,3706,2848,858,3706,134400,2017
16037,53.4,4141,3818,1,164,1244,37976,1850,1410,440,1850,173300,2017
16039,31.4,26232,19240,750,4300,6980,45154,10062,5823,4239,10062,145200,2017
16041,32.6,13120,11981,33,881,3456,51583,4286,3449,837,4286,168200,2017
16043,36.7,12889,10970,26,1605,3429,51806,4383,3509,874,4383,157700,2017
16045,45.2,16850,14834,0,1398,4374,42888,6404,4788,1616,6404,148800,2017
16047,37.3,15110,10296,15,4354,3818,42626,5550,3764,1786,5550,134400,2017
16049,49.5,16275,14864,23,523,4318,40299,6480,5124,1356,6480,164600,2017
16051,31.3,27410,23866,19,2858,6816,58055,8470,6861,1609,8470,166200,2017
16053,32.6,23039,14539,18,7944,5783,46421,7741,4963,2778,7741,144400,2017
16055,39.7,150128,136632,532,6560,41022,53189,58873,41729,17144,58873,212900,2017
16057,28.3,38697,34601,276,1612,8503,43310,15448,8230,7218,15448,207200,2017
16059,52.9,7755,7238,15,250,2304,36031,3703,2611,1092,3703,173400,2017
16061,48.1,3824,3274,4,166,960,40313,1626,1201,425,1626,120000,2017
16063,33.1,5296,3563,0,1577,1157,46383,1609,1115,494,1609,127200,2017
16065,23.5,38241,34029,234,2722,8606,33620,10633,4930,5703,10633,190500,2017
16067,35.4,20448,12895,41,7029,5593,48021,7357,5227,2130,7357,121800,2017
16069,41.3,40014,34907,142,1486,10817,51804,16308,11555,4753,16308,172500,2017
16071,39.5,4284,4015,3,178,1143,43491,1581,1243,338,1581,151600,2017
16073,38.6,11384,7760,16,3023,2880,36092,4190,2865,1325,4190,125700,2017
16075,38.8,22839,18000,90,3885,5939,48447,8571,6342,2229,8571,138900,2017
16077,34.8,7667,4792,20,2523,1862,47602,2544,1784,760,2544,132600,2017
16079,47.2,12490,11467,36,430,3559,39835,5614,3933,1681,5614,117500,2017
16081,36.4,10776,8741,20,1832,2437,55986,3764,2742,1022,3764,291600,2017
16083,34.6,82248,65975,530,12863,21383,49118,30096,20461,9635,30096,154200,2017
16085,50.2,10104,9569,8,448,2365,54015,3532,2673,859,3532,258000,2017
16087,46.1,9996,7864,4,1715,2585,37521,3979,2910,1069,3979,149100,2017
17001,41.5,66787,61471,2635,988,17706,48454,27461,19373,8088,27461,120200,2017
17003,42.3,6776,4190,2343,68,1545,31014,2432,1714,718,2432,53200,2017
17005,40.4,17034,14961,1032,590,4070,54393,6132,4803,1329,6132,115200,2017
17007,38.3,53638,39692,1108,11283,13791,62701,18709,14820,3889,18709,145700,2017
17009,38.7,6791,4999,1446,245,1295,56289,2066,1628,438,2066,88600,2017
17011,43.7,33619,29723,257,2942,9596,54271,13816,10518,3298,13816,106800,2017
17013,46.5,4897,4735,15,55,1266,53641,1881,1546,335,1881,110900,2017
17015,47.4,14704,13734,183,526,4091,50555,6573,5048,1525,6573,99400,2017
17017,40.2,12880,9815,501,2417,3361,50156,5160,3786,1374,5160,76800,2017
17019,29.7,207946,142105,26935,11950,42681,49586,81418,44405,37013,81418,154800,2017
17021,42.7,33562,31953,553,523,8933,50668,13892,10449,3443,13892,87500,2017
17023,43,15924,15394,49,239,4720,52068,6809,5061,1748,6809,87400,2017
17025,44,13393,12908,90,189,3786,47427,5624,4447,1177,5624,77200,2017
17027,40.4,37640,34471,1336,1163,9603,64543,14183,11440,2743,14183,142900,2017
17029,34.3,52540,47789,1987,1267,12315,41907,21006,12996,8010,21006,93800,2017
17031,36.4,5238541,2235598,1226134,1312304,1182951,59426,1956561,1112383,844178,1956561,227400,2017
17033,42.5,19214,17487,794,557,4983,47468,7665,5979,1686,7665,82900,2017
17035,41.9,10899,10542,10,121,2922,50680,4287,3389,898,4287,94000,2017
17037,30.7,104473,81117,7414,11287,23088,58343,37420,21139,16281,37420,166800,2017
17039,42.8,16176,14409,68,414,4445,55411,6704,5220,1484,6704,98000,2017
17041,37.9,19830,17949,64,1427,5013,52261,7580,5495,2085,7580,102700,2017
17043,39.1,931826,632342,42462,131290,238768,84442,340669,249800,90869,340669,289900,2017
17045,44.5,17603,17103,100,193,5267,47873,7669,5678,1991,7669,80000,2017
17047,43.6,6570,6355,27,84,1855,49632,2810,2347,463,2810,73500,2017
17049,39.1,34164,32804,190,661,9120,54655,13450,10443,3007,13450,137300,2017
17051,41.4,21980,20175,1122,377,5259,44541,7659,6184,1475,7659,84000,2017
17053,43.2,13470,12707,122,407,3649,50851,5684,4035,1649,5684,100600,2017
17055,42.3,39302,37738,252,648,10157,39454,16346,11767,4579,16346,69900,2017
17057,42.5,35733,32860,1349,1029,9017,48599,14069,10906,3163,14069,84800,2017
17059,44.8,5226,5009,14,58,1481,42450,2272,1744,528,2272,71500,2017
17061,42.7,13311,12874,170,54,3477,44502,5087,3976,1111,5087,76900,2017
17063,37.5,50333,43855,658,4717,13822,71598,19006,13695,5311,19006,188300,2017
17065,43.6,8259,8170,49,23,2353,47293,3413,2689,724,3413,91500,2017
17067,46,18264,17594,121,262,5242,51460,7523,6068,1455,7523,85100,2017
17069,46.8,4161,3875,157,74,898,39524,1452,1165,287,1452,63200,2017
17071,49.2,6927,6670,10,107,1999,47428,3019,2397,622,3019,88100,2017
17073,42.7,49649,45101,870,2731,13716,55755,19991,15635,4356,19991,115800,2017
17075,44.3,28457,25709,326,1877,7903,48857,11845,8997,2848,11845,96800,2017
17077,31.1,59115,44012,8561,2518,12623,36008,23942,12706,11236,23942,108600,2017
17079,43,9608,9338,38,141,2566,56523,3723,3036,687,3723,99000,2017
17081,40.9,38358,32911,3255,928,9767,46109,15244,11179,4065,15244,92700,2017
17083,42.5,22215,21341,103,286,6207,56320,8831,7179,1652,8831,135400,2017
17085,49.4,22046,20927,86,648,6401,55532,9795,7677,2118,9795,143300,2017
17087,42.5,12899,10922,1429,430,3077,45743,4486,3655,831,4486,96600,2017
17089,36.6,529402,304696,28468,167287,130292,74862,175930,128974,46956,175930,223400,2017
17091,37.7,110801,79961,16681,11142,26994,56542,40239,27511,12728,40239,140100,2017
17093,34.5,122933,87482,7854,21617,31835,89860,39882,32645,7237,39882,214700,2017
17095,42.2,51374,42830,4327,2843,12048,41972,20981,13862,7119,20981,81700,2017
17097,38,704476,442289,46767,148894,179683,82613,244523,179525,64998,244523,251400,2017
17099,41.8,111151,95693,2730,10323,29605,54693,44448,32306,12142,44448,126100,2017
17101,41.2,16457,13920,1419,623,4206,44504,6271,4459,1812,6271,72400,2017
17103,42.7,34670,30073,1793,2041,8548,58319,13416,9905,3511,13416,116500,2017
17105,41.6,36812,32847,1468,1627,9515,54339,14379,10432,3947,14379,109500,2017
17107,40.6,29488,25504,1967,1002,7167,58271,11011,8016,2995,11011,101300,2017
17109,31.3,31597,27861,1502,851,6274,42911,11481,7659,3822,11481,94600,2017
17111,39.9,308043,252341,3848,38531,83007,82230,110860,88011,22849,110860,212600,2017
17113,32.7,173231,138256,13850,8216,40560,64573,66070,42861,23209,66070,163800,2017
17115,41,107587,82514,14906,2327,26993,49052,44310,30998,13312,44310,95900,2017
17117,43.1,45960,44261,358,510,12599,53890,18663,14310,4353,18663,98400,2017
17119,40,266153,227604,22485,8310,69651,56536,107241,75734,31507,107241,130200,2017
17121,41.8,38305,35058,1297,719,10461,44679,16001,11893,4108,16001,71900,2017
17123,46.3,11925,11311,53,365,3164,55173,4900,4071,829,4900,103300,2017
17125,45.5,13904,13445,85,142,3858,44695,6034,4662,1372,6034,81000,2017
17127,43.8,14594,12944,889,393,3854,42168,6084,4471,1613,6084,82500,2017
17129,42.3,12416,11896,63,179,3683,62368,5230,3974,1256,5230,132500,2017
17131,44.8,15794,15134,88,354,4510,55649,6620,5126,1494,6620,105100,2017
17133,42.3,33739,32575,141,508,10007,74410,13227,10852,2375,13227,195500,2017
17135,42.4,29173,26509,1756,502,7294,47807,11234,8767,2467,11234,81000,2017
17137,41.2,34442,30659,2105,803,8716,49353,13894,9578,4316,13894,103400,2017
17139,39.9,14711,14277,85,181,3960,53979,5856,4441,1415,5856,107500,2017
17141,41.9,51619,45065,550,5079,14236,57655,20830,15594,5236,20830,139900,2017
17143,37,186145,131028,32343,8545,45441,53063,74515,48422,26093,74515,128000,2017
17145,41.8,21467,18517,1868,651,5162,45864,8223,6137,2086,8223,80500,2017
17147,43,16433,15235,175,209,4857,67360,6676,5452,1224,6676,128100,2017
17149,42.4,15930,15214,261,202,4230,41387,6629,5137,1492,6629,74700,2017
17151,52.2,4360,3944,213,84,1047,41139,1639,1399,240,1639,84100,2017
17153,43.3,5691,3622,1737,119,1355,34655,2246,1656,590,2246,63500,2017
17155,47.5,5771,5335,17,308,1646,64741,2438,1945,493,2438,120800,2017
17157,41.5,32829,27908,3479,1003,7627,49717,12060,9126,2934,12060,99900,2017
17159,42.3,15953,15247,71,264,3924,46454,6460,4596,1864,6460,83200,2017
17161,40,146205,106163,14074,18361,37684,51426,60064,41434,18630,60064,115600,2017
17163,38,264433,164262,78667,10293,66928,51103,103125,67109,36016,103125,122600,2017
17165,42,24430,22375,841,423,6645,40722,9938,7208,2730,9938,70500,2017
17167,40.1,198134,160020,24947,4360,51362,58687,83673,58052,25621,83673,136100,2017
17169,46.6,7181,6709,398,18,1822,47321,2856,2277,579,2856,83400,2017
17171,43.7,5109,4965,6,60,1390,48542,2111,1597,514,2111,87500,2017
17173,44.6,21906,21335,146,220,6302,49807,9183,7415,1768,9183,86800,2017
17175,45,5551,5334,37,79,1565,52284,2330,1872,458,2330,85600,2017
17177,44.7,45839,38196,4371,1667,12634,46427,19604,13537,6067,19604,97700,2017
17179,40.8,134695,126850,1663,3018,37075,60874,54751,41725,13026,54751,137300,2017
17181,43.5,17267,15781,128,860,4758,46716,6686,5365,1321,6686,98600,2017
17183,40.2,79207,62383,10995,3836,19871,44930,31355,21928,9427,31355,75900,2017
17185,42.8,11568,10983,98,229,3214,49716,4915,3711,1204,4915,79000,2017
17187,39.1,17429,14705,481,1611,4507,47278,6802,5084,1718,6802,83900,2017
17189,43,14260,13719,75,200,3882,54520,5897,4631,1266,5897,108100,2017
17191,43.4,16569,15973,99,231,4673,46405,7117,5451,1666,7117,78600,2017
17193,43.8,14186,13705,61,198,3981,46279,6144,4752,1392,6144,69700,2017
17195,42.9,56823,48237,881,6691,15320,51969,23468,17671,5797,23468,102200,2017
17197,37.3,687727,445263,75873,115453,171194,80782,226668,184080,42588,226668,216400,2017
17199,40.9,67477,60823,2681,1701,17731,48600,26862,19396,7466,26862,106400,2017
17201,39.6,287512,201954,35522,35035,74501,51110,114491,75723,38768,114491,115900,2017
17203,39.9,38942,37260,230,674,10658,69507,14547,12020,2527,14547,160300,2017
18001,33.3,35018,32824,328,1554,8594,48290,12453,9491,2962,12453,118900,2017
18003,35.7,367747,274344,41406,26546,92542,51091,142696,97441,45255,142696,119400,2017
18005,38.1,81024,67429,1401,5253,21028,57331,31472,22345,9127,31472,139400,2017
18007,40.9,8685,8062,76,442,2227,49183,3397,2509,888,3397,84900,2017
18009,43.7,12214,11721,29,184,3474,40622,5199,3973,1226,5199,68500,2017
18011,38.4,63013,57739,1014,1729,17612,75591,24228,18367,5861,24228,207500,2017
18013,49.3,15007,14388,80,243,4315,59292,6011,5022,989,6011,174800,2017
18015,42.3,19994,18837,107,780,5498,56188,7819,6391,1428,7819,124100,2017
18017,40.5,38248,30972,520,5567,9665,45558,14840,10956,3884,14840,84100,2017
18019,38.8,114893,96387,7641,6039,28070,52834,43657,31157,12500,43657,131500,2017
18021,40.9,26375,25428,106,347,7520,50924,10680,8193,2487,10680,96000,2017
18023,38.2,32455,26937,185,4932,8372,51659,11961,8552,3409,11961,103700,2017
18025,43.7,10598,10214,21,154,2710,40067,4007,3334,673,4007,86700,2017
18027,34.6,32777,30252,540,1562,8221,48355,11482,8478,3004,11482,115400,2017
18029,42.7,49564,47751,403,594,13361,62905,18667,14770,3897,18667,160800,2017
18031,38.8,26480,25131,177,497,7050,52270,10354,7182,3172,10354,121800,2017
18033,39.1,42524,40454,74,1175,11088,51374,16317,12489,3828,16317,113600,2017
18035,35.4,115938,100956,8275,2661,27492,41208,46304,29732,16572,46304,88600,2017
18037,40.2,42379,38652,234,2996,11274,57307,16524,12719,3805,16524,146000,2017
18039,35.4,202924,152901,11044,31179,51567,52449,71733,49240,22493,71733,130800,2017
18041,42.4,23426,22449,589,240,6490,41476,9410,6473,2937,9410,81400,2017
18043,39.9,76481,67497,3954,2360,19703,59451,29046,20993,8053,29046,159700,2017
18045,43,16620,15882,60,402,4604,46669,6987,5173,1814,6987,93500,2017
18047,42.3,22835,22461,49,250,6796,55588,8843,7099,1744,8843,152200,2017
18049,41.9,20296,18728,212,1014,5011,47108,7934,6141,1793,7934,93600,2017
18051,40.5,33596,31660,688,505,9288,51149,13336,10312,3024,13336,105700,2017
18053,39.9,67615,57705,4827,2802,17148,42046,26122,17858,8264,26122,87600,2017
18055,42.8,32431,31399,73,426,8471,49648,12653,10086,2567,12653,95900,2017
18057,36.6,309687,261564,11141,11840,83805,90582,114282,89184,25098,114282,240000,2017
18059,40.2,72776,67711,1365,1593,20059,70973,27576,21358,6218,27576,161800,2017
18061,42.7,39450,37739,87,677,10436,53897,14693,12140,2553,14693,136400,2017
18063,37.6,158170,135680,9425,5737,42224,74245,57153,44977,12176,57153,171600,2017
18065,42.2,48649,45652,1109,813,12009,46131,18096,13227,4869,18096,94800,2017
18067,41.5,82457,70737,5791,2602,22187,47958,34538,23580,10958,34538,101300,2017
18069,40.3,36520,34756,291,800,10098,50063,14616,11159,3457,14616,102700,2017
18071,38.2,43779,39093,472,2819,11695,49080,16549,12027,4522,16549,114600,2017
18073,39,33448,30681,231,1989,8736,56574,12220,9337,2883,12220,153200,2017
18075,39.8,21107,20072,70,637,5383,42878,8195,6070,2125,8195,85000,2017
18077,40.6,32293,30028,662,846,8761,50722,12677,9093,3584,12677,120000,2017
18079,39.6,27840,26550,380,645,7229,48362,10753,7987,2766,10753,99900,2017
18081,37.3,149359,134849,3406,5175,39925,65272,54867,38974,15893,54867,149700,2017
18083,38.1,37763,35090,1176,685,9739,44837,14986,9596,5390,14986,87200,2017
18085,38,78720,69749,543,6201,21625,57190,30265,22632,7633,30265,142700,2017
18087,31.5,38720,36543,27,1510,9597,58336,12064,9898,2166,12064,172500,2017
18089,38.6,488694,266264,116903,89875,123584,52559,185524,128486,57038,185524,140100,2017
18091,40.2,110839,88538,12093,6935,28138,49921,42975,30717,12258,42975,126700,2017
18093,42.6,45669,43799,148,721,13148,49985,18432,14523,3909,18432,109200,2017
18095,40.2,129641,110647,9751,4968,33855,45432,51647,35694,15953,51647,91900,2017
18097,34.3,939964,532896,255912,94609,206566,44869,367215,198434,168781,367215,123500,2017
18099,39.8,46752,41121,270,4517,12022,51869,17249,13018,4231,17249,130100,2017
18101,42,10219,9932,56,37,2783,49372,4251,3422,829,4251,97900,2017
18103,39.9,36035,32176,1789,1066,9271,46666,13465,9459,4006,13465,85500,2017
18105,28.8,144436,121518,4395,4799,28541,45689,55014,29793,25221,55014,163900,2017
18107,40.5,38288,35308,308,1807,10259,53075,14993,10742,4251,14993,118400,2017
18109,41.5,69533,66975,252,1020,18461,60317,25805,19763,6042,25805,147200,2017
18111,42.5,14056,12865,18,859,3895,52193,5530,4149,1381,5530,112500,2017
18113,38.5,47421,41540,183,4825,12967,52393,18205,13543,4662,18205,114500,2017
18115,46.8,5911,5718,77,58,1732,58359,2479,1959,520,2479,142400,2017
18117,41.3,19623,18751,254,280,5187,42803,7830,5900,1930,7830,90400,2017
18119,44.6,20957,20212,94,244,5949,48315,8551,6762,1789,8551,110200,2017
18121,42.2,17062,16179,165,252,4307,44643,6112,4721,1391,6112,86700,2017
18123,41.9,19229,18138,511,250,5031,49689,7460,5765,1695,7460,103000,2017
18125,43.9,12471,12072,119,67,3423,50196,5096,4219,877,5096,89300,2017
18127,39.4,167391,140547,5475,16067,44394,65979,63251,47702,15549,63251,173100,2017
18129,42.5,25599,24616,390,284,7319,60992,10140,8422,1718,10140,138800,2017
18131,41.8,12761,12078,45,366,3589,47633,5296,4044,1252,5296,92600,2017
18133,37.8,37543,34487,1149,954,9249,55295,13162,9693,3469,13162,120300,2017
18135,42.1,25203,23659,164,821,6884,44985,10495,7964,2531,10495,79500,2017
18137,40.6,28372,27131,137,509,8001,53698,11150,8549,2601,11150,139500,2017
18139,41.6,16765,16111,229,254,4880,47955,6672,4842,1830,6672,100000,2017
18141,36.5,268613,197612,34353,22423,64202,48121,100694,68361,32333,100694,118600,2017
18143,40.7,23722,22736,68,495,6374,49243,8892,6668,2224,8892,98800,2017
18145,41.3,44339,41069,427,1786,11799,57216,17603,12925,4678,17603,125300,2017
18147,43.2,20610,19593,128,590,5774,55280,8101,6644,1457,8101,117900,2017
18149,41.7,22966,21702,72,812,6103,45526,8792,7050,1742,8792,101600,2017
18151,42.7,34459,32399,82,1196,9359,52749,13810,10743,3067,13810,136300,2017
18153,41.4,20900,19253,780,360,5286,45031,7601,5528,2073,7601,80900,2017
18155,40,10617,10157,87,148,2947,43468,4259,3005,1254,4259,114300,2017
18157,28.1,186081,143304,8679,15135,39085,50486,68771,37260,31511,68771,144300,2017
18159,44.5,15290,14578,29,398,4272,53931,6365,5071,1294,6365,110300,2017
18161,43.3,7225,6925,8,1,1730,45531,2860,2076,784,2860,109900,2017
18163,37.9,181831,152954,16539,4621,44688,44815,74923,47989,26934,74923,121200,2017
18165,43.2,15644,15147,66,178,4041,45440,6533,4902,1631,6533,74600,2017
18167,36.1,107723,92473,6625,2772,24901,42030,41164,24908,16256,41164,90700,2017
18169,42,31848,30107,279,807,8432,49052,12920,9567,3353,12920,96700,2017
18171,44.6,8269,7977,39,127,2494,58950,3395,2850,545,3395,112500,2017
18173,40.5,61581,57148,968,1090,17445,66080,23742,19118,4624,23742,158100,2017
18175,41.2,27807,26948,25,363,7674,46861,10570,8034,2536,10570,106200,2017
18177,41.1,66972,59273,3368,1892,17310,41813,26397,17791,8606,26397,96500,2017
18179,39.8,27832,26428,202,769,7740,53038,10944,8689,2255,10944,121000,2017
18181,42,24279,21810,103,1921,6748,51404,9723,7623,2100,9723,105800,2017
18183,41,33481,32058,146,638,9592,57041,13469,10711,2758,13469,131600,2017
19001,45.7,7192,6950,24,124,2099,49477,3210,2460,750,3210,93200,2017
19003,47.7,3785,3664,16,45,1083,49745,1654,1287,367,1654,84900,2017
19005,45,13940,12716,132,847,3869,47895,6037,4617,1420,6037,122800,2017
19007,45.1,12547,12009,74,227,3197,40377,5407,4111,1296,5407,78000,2017
19009,48.3,5711,5547,22,24,1628,48750,2679,2102,577,2679,68800,2017
19011,42.1,25646,24785,174,360,7101,64061,10187,8322,1865,10187,147800,2017
19013,34.9,132960,109247,11756,5603,31465,50916,52811,34857,17954,52811,139300,2017
19015,41.4,26381,24945,108,665,7050,57906,10998,8303,2695,10998,130500,2017
19017,39.2,24741,23582,234,353,6574,65440,9445,7690,1755,9445,155100,2017
19019,38.7,21101,20337,70,312,5508,59348,8212,6529,1683,8212,132500,2017
19021,35.1,20369,12516,532,5098,5129,52784,7561,5005,2556,7561,111100,2017
19023,43.7,14822,14349,36,191,4245,53937,6278,4947,1331,6278,112100,2017
19025,45.1,9814,9300,175,180,2714,46302,4229,3259,970,4229,77800,2017
19027,41.7,20428,19466,301,481,5463,54563,8675,6517,2158,8675,127400,2017
19029,44.6,13327,12763,38,322,3668,45637,6053,4198,1855,6053,93600,2017
19031,41.9,18368,17596,133,346,5049,62555,7546,5980,1566,7546,143800,2017
19033,44.5,43134,39352,721,1981,11435,50569,19201,13234,5967,19201,121500,2017
19035,46.3,11577,10881,110,393,3220,53998,5227,3981,1246,5227,89200,2017
19037,44.2,12140,11691,52,267,3372,50688,5298,4140,1158,5298,105100,2017
19039,40.7,9267,7842,10,1181,2599,49718,3870,2644,1226,3870,105000,2017
19041,42.2,16387,15401,36,542,4615,48978,7264,5027,2237,7264,115700,2017
19043,46.5,17711,17030,184,332,4857,51114,7625,5768,1857,7625,116500,2017
19045,42.2,47587,43521,1223,1448,12455,50295,19877,14759,5118,19877,112400,2017
19047,37.6,17131,11569,206,4687,4541,51091,6389,4613,1776,6389,93400,2017
19049,35.1,80864,69708,1077,4942,21776,82719,31363,23560,7803,31363,218000,2017
19051,37.5,8834,8573,11,115,2382,52390,3255,2644,611,3255,109100,2017
19053,36.5,8105,7550,135,217,1977,41042,3172,2106,1066,3172,76300,2017
19055,43.4,17326,16805,48,241,4890,60534,6926,5695,1231,6926,126000,2017
19057,42.5,39876,35101,2391,1168,10582,47524,16772,12095,4677,16772,101400,2017
19059,48.7,17000,16344,91,321,5074,59889,8039,6100,1939,8039,175900,2017
19061,38.6,96571,88280,2746,2228,25253,59150,38076,27476,10600,38076,157200,2017
19063,42.5,9661,8497,159,900,2620,47419,4133,3200,933,4133,85700,2017
19065,43.7,20139,18954,246,455,5396,48412,8315,6300,2015,8315,90800,2017
19067,44.6,15904,14761,301,399,4417,48607,6924,5016,1908,6924,102400,2017
19069,42.4,10326,8866,140,1247,2862,48172,4232,3074,1158,4232,87100,2017
19071,46,6985,6657,33,177,2013,54430,2997,2251,746,2997,100200,2017
19073,45.7,9046,8599,11,244,2601,52529,3912,2902,1010,3912,88900,2017
19075,42.4,12354,12000,84,148,3543,65170,5155,4143,1012,5155,129900,2017
19077,45.7,10664,10195,36,252,2946,56306,4393,3525,868,4393,112600,2017
19079,42.6,15201,13622,174,905,4220,55836,6367,4560,1807,6367,98900,2017
19081,44.5,10971,10290,69,432,3170,57840,4809,3757,1052,4809,97600,2017
19083,44.4,17239,15907,244,720,4489,52207,7183,5483,1700,7183,91300,2017
19085,44,14196,13701,28,229,3994,57558,6068,4669,1399,6068,107600,2017
19087,40.4,19865,17600,415,926,5247,52275,7772,5531,2241,7772,107900,2017
19089,41.8,9321,9010,66,144,2469,51422,3883,3105,778,3883,107700,2017
19091,43,9586,9014,18,381,2675,48847,4221,3121,1100,4221,93900,2017
19093,44.7,6965,6685,0,144,2004,51978,3043,2278,765,3043,91900,2017
19095,41.8,16231,15524,130,401,4766,58077,6766,5237,1529,6766,143900,2017
19097,44.6,19409,18577,108,269,5555,51806,8395,6502,1893,8395,117000,2017
19099,42.6,36789,34649,586,738,9822,56363,14533,10716,3817,14533,122800,2017
19101,40.9,17945,14469,1040,518,4089,44516,6872,4623,2249,6872,114300,2017
19103,29.9,144425,115025,9064,7874,31386,59965,57423,34032,23391,57423,210400,2017
19105,43.6,20468,19324,512,366,5608,58391,8264,6266,1998,8264,130700,2017
19107,44,10223,9897,14,154,2793,48399,4471,3443,1028,4471,83700,2017
19109,45.8,15166,14477,123,338,4390,54868,6674,5280,1394,6674,104300,2017
19111,43.3,34785,31645,872,1229,9407,48266,14204,10655,3549,14204,90200,2017
19113,37.4,220008,191432,10573,6790,56172,62702,89061,66089,22972,89061,150600,2017
19115,41,11238,8836,117,1774,2964,54393,4364,3383,981,4364,104200,2017
19117,44.8,8600,8525,9,10,2282,47325,3703,2852,851,3703,84900,2017
19119,38,11745,11283,8,295,3360,62012,4489,3807,682,4489,125200,2017
19121,40.8,15720,15082,36,288,4596,60077,6357,4875,1482,6357,160400,2017
19123,39.7,22301,20918,334,448,5948,50568,8955,6313,2642,8955,110100,2017
19125,39.5,33127,31398,188,614,8636,57917,13098,9313,3785,13098,146900,2017
19127,38.5,40476,29339,396,8395,10308,52752,15541,10902,4639,15541,104600,2017
19129,42.1,14933,14122,118,423,3956,67949,5601,4407,1194,5601,157000,2017
19131,43.7,10663,10323,14,142,2826,53675,4302,3602,700,4302,112300,2017
19133,46.7,8865,8436,10,71,2342,41598,4047,2833,1214,4047,84300,2017
19135,42.2,7912,7397,6,218,2215,50179,3347,2552,795,3347,99100,2017
19137,44.5,10239,9640,0,371,3080,43674,4614,3131,1483,4614,81800,2017
19139,38.1,42923,33383,836,7522,11349,56398,16414,11892,4522,16414,128100,2017
19141,43.3,13944,12990,102,622,3916,56314,6101,4334,1767,6101,108000,2017
19143,44,6149,5557,79,456,1682,53604,2617,1980,637,2617,89500,2017
19145,44.4,15393,14094,310,495,4040,46708,6405,4719,1686,6405,87600,2017
19147,42.3,9110,8595,173,217,2414,50470,3823,2869,954,3823,98100,2017
19149,40.5,25027,23222,102,1136,7175,61316,10083,7972,2111,10083,150200,2017
19151,47.2,6972,6525,120,243,1922,45969,3191,2402,789,3191,73400,2017
19153,35.2,467235,366946,29308,37937,114697,63530,181316,121656,59660,181316,165500,2017
19155,39.6,93287,82365,1303,6989,24222,56291,36926,25201,11725,36926,133500,2017
19157,40.7,18428,16955,355,568,4797,51456,7571,5287,2284,7571,131100,2017
19159,45,4986,4788,6,111,1388,50642,2063,1545,518,2063,79600,2017
19161,45.9,9936,9490,75,270,2904,53254,4372,3400,972,4372,88100,2017
19163,38.1,171493,138329,13494,11022,42328,57681,67100,46422,20678,67100,153200,2017
19165,46.9,11772,11187,54,330,3222,55638,5055,3996,1059,5055,111700,2017
19167,33.3,34692,30358,127,3539,9024,66022,12113,9688,2425,12113,153800,2017
19169,25.9,95888,81058,1789,3133,19093,52671,37106,19135,17971,37106,172900,2017
19171,43.2,17236,14172,105,1496,4603,56110,6675,5167,1508,6675,105300,2017
19173,43.3,6214,5638,20,469,1827,46825,2694,2050,644,2694,76100,2017
19175,40.1,12497,11806,149,347,3222,47597,5309,3751,1558,5309,94300,2017
19177,44,7308,7078,24,100,1947,47197,2877,2415,462,2877,82700,2017
19179,39.5,35321,29594,1039,3703,9425,43329,14531,10413,4118,14531,81000,2017
19181,38.2,48630,46055,112,1268,13463,71514,18621,14340,4281,18621,171400,2017
19183,40.8,22095,20217,189,1295,5921,59157,8669,6291,2378,8669,140400,2017
19185,43.3,6405,6178,43,35,1644,42434,2631,2122,509,2631,74700,2017
19187,39.6,36945,32548,1703,1667,8881,42148,15067,10195,4872,15067,95300,2017
19189,42.5,10545,9729,115,441,2894,50072,4590,3406,1184,4590,94400,2017
19191,41,20575,19593,214,446,5345,60788,8123,6345,1778,8123,161500,2017
19193,35.6,102397,76449,2960,16130,25658,51350,38962,25920,13042,38962,110700,2017
19195,44.4,7502,7102,79,212,2082,50880,3179,2564,615,3179,98000,2017
19197,44.3,12864,11155,61,1425,3454,48935,5579,4054,1525,5579,79200,2017
20001,41.6,12752,11565,185,427,3209,43031,5325,3834,1491,5325,78600,2017
20003,42.2,7840,7462,15,58,2060,40986,3206,2284,922,3206,88200,2017
20005,35.9,16466,14559,510,478,3688,46640,5967,4183,1784,5967,92900,2017
20007,43.4,4905,4531,33,155,1200,52075,1967,1366,601,1967,75600,2017
20009,39.6,27067,22199,285,3915,7459,46070,11288,7752,3536,11288,87600,2017
20011,39.3,14757,13354,478,366,3788,39379,5622,3963,1659,5622,82600,2017
20013,42.2,9736,8119,92,406,2664,46964,3993,2829,1164,3993,83900,2017
20015,38.1,66260,59287,1378,3016,17535,62324,24358,17906,6452,24358,142400,2017
20017,45,2665,2440,39,118,666,42772,1095,859,236,1095,85200,2017
20019,48.7,3425,2968,13,116,880,39531,1432,1114,318,1432,63300,2017
20021,41.4,20501,18160,83,492,5479,41101,7980,5975,2005,7980,78400,2017
20023,47.8,2677,2416,0,173,752,47167,1248,997,251,1248,86600,2017
20025,44.2,2089,1737,21,224,559,46094,912,632,280,912,76400,2017
20027,43,8203,7751,54,199,2424,55434,3406,2707,699,3406,100200,2017
20029,41.8,9191,8577,64,291,2415,44199,3896,2858,1038,3896,73200,2017
20031,44,8328,7800,63,211,2509,58662,3592,2734,858,3592,111000,2017
20033,49.5,1741,1581,0,147,478,51563,726,593,133,726,73200,2017
20035,38.2,35732,28652,934,3780,9087,46624,13688,9020,4668,13688,85700,2017
20037,32.5,39099,34157,957,2065,8894,38017,14974,8903,6071,14974,87300,2017
20039,51.3,2891,2738,5,75,772,41230,1439,1032,407,1439,63400,2017
20041,41.2,19162,17463,168,863,5199,49663,7781,5672,2109,7781,110700,2017
20043,39.4,7790,7030,292,213,2072,50300,3065,2206,859,3065,95300,2017
20045,29.2,117806,93227,4661,7109,24333,54370,44945,23201,21744,44945,188100,2017
20047,44.8,2946,2275,39,592,824,50229,1273,996,277,1273,61200,2017
20049,50.8,2581,2350,4,106,739,39405,1158,944,214,1158,48300,2017
20051,32,28877,26041,269,1609,6529,49562,11647,7214,4433,11647,159400,2017
20053,43.7,6331,5451,242,383,1585,48550,2500,1921,579,2500,88500,2017
20055,30.6,37097,15796,764,18160,9328,51703,12648,7855,4793,12648,126200,2017
20057,31.1,34658,14125,787,18673,8280,49890,11339,7093,4246,11339,108400,2017
20059,40,25599,23289,388,1044,6676,53167,9897,7137,2760,9897,121700,2017
20061,26.4,35796,20485,6019,5602,9380,46096,12923,5044,7879,12923,141900,2017
20063,48.5,2632,2490,3,70,828,50817,1193,922,271,1193,78900,2017
20065,50.8,2561,2275,104,82,735,43427,1239,1001,238,1239,69600,2017
20067,32.6,7716,3995,0,3612,1945,57474,2628,2066,562,2628,102800,2017
20069,35.9,6004,5061,0,900,1607,61220,2141,1626,515,2141,117900,2017
20071,48.7,1210,905,10,267,332,47045,494,320,174,494,86100,2017
20073,48.6,6227,5753,15,232,1789,41648,2772,2046,726,2772,61100,2017
20075,33.4,2621,1671,19,884,575,48160,864,593,271,864,86800,2017
20077,42.5,5746,5191,7,364,1521,48059,2357,1723,634,2357,66700,2017
20079,39.2,34683,28874,638,4052,9273,55687,13355,9445,3910,13355,120200,2017
20081,36.1,4081,2842,0,1200,1003,53780,1330,1009,321,1330,102600,2017
20083,46.8,1875,1649,0,144,566,55345,786,568,218,786,86700,2017
20085,41.4,13322,11228,87,587,3822,53592,5296,3959,1337,5296,128100,2017
20087,44,18856,17697,105,470,5505,58935,7681,6285,1396,7681,135800,2017
20089,51.9,2963,2831,11,72,831,43125,1388,1113,275,1388,53700,2017
20091,37.3,578797,466059,26035,43057,153483,81121,224248,154575,69673,224248,232500,2017
20093,34.8,3931,2591,21,1217,905,51439,1242,970,272,1242,98200,2017
20095,45.5,7576,7105,27,242,2050,57593,3148,2446,702,3148,92200,2017
20097,40.8,2524,2251,24,161,632,48226,1004,682,322,1004,133800,2017
20099,41,20553,17562,788,902,5570,45706,8098,5727,2371,8098,74900,2017
20101,41.5,1702,1539,1,113,484,51765,828,649,179,828,76400,2017
20103,37.3,79359,62814,6631,5393,19598,70022,27233,18532,8701,27233,171000,2017
20105,46.6,3121,2986,21,94,785,48693,1275,1031,244,1275,68900,2017
20107,43.6,9602,9014,71,247,2892,46576,4433,3385,1048,4433,89400,2017
20109,40.4,2790,2529,1,155,755,49926,1168,877,291,1168,83100,2017
20111,32.9,33302,23835,686,6953,8155,42992,13552,7795,5757,13552,98500,2017
20113,40.8,28792,26443,283,1157,8106,56946,12077,8662,3415,12077,140300,2017
20115,45,12087,11266,80,400,3313,50212,4857,3889,968,4857,81300,2017
20117,44,9859,9365,28,232,2775,50420,4209,3177,1032,4209,93400,2017
20119,37.7,4295,3446,24,715,1207,54167,1674,1203,471,1674,88700,2017
20121,41.7,32976,30692,497,992,8898,63501,12771,9962,2809,12771,181100,2017
20123,43.7,6230,5954,41,139,1613,44591,2725,1971,754,2725,85700,2017
20125,40.3,33463,26801,1766,2076,8865,43977,13619,9559,4060,13619,74000,2017
20127,47.9,5605,5175,3,252,1573,50338,2325,1809,516,2325,95100,2017
20129,39.5,2931,2123,24,662,738,43813,1115,765,350,1115,97700,2017
20131,40.4,10095,9649,55,177,2772,53368,4123,3069,1054,4123,116500,2017
20133,39.7,16209,14680,157,804,4370,44402,6521,4554,1967,6521,77300,2017
20135,47.2,3001,2655,7,321,902,48412,1327,1091,236,1327,70500,2017
20137,43.5,5527,4944,131,281,1333,50673,1906,1468,438,1906,73700,2017
20139,43.4,15894,14886,113,469,4545,54186,6604,4938,1666,6604,107200,2017
20141,47.4,3684,3490,17,73,979,42173,1713,1231,482,1713,61300,2017
20143,42.4,5957,5617,46,163,1684,51797,2437,2023,414,2437,98600,2017
20145,44.5,6776,5724,332,524,1608,46224,2590,1825,765,2590,75600,2017
20147,44.3,5446,5124,23,174,1495,46806,2326,1819,507,2326,76900,2017
20149,35.2,23188,20837,138,1234,6185,64410,8510,6668,1842,8510,169300,2017
20151,39.2,9670,8851,26,692,2370,53415,3742,2664,1078,3742,87600,2017
20153,50.3,2520,2311,10,151,751,50893,1170,869,301,1170,81700,2017
20155,40.1,63360,53681,1696,5736,16261,47897,25015,17186,7829,25015,96600,2017
20157,50.9,4705,4525,10,76,1308,43489,2307,1747,560,2307,60500,2017
20159,38.5,9868,8289,164,1109,2627,48333,3932,2856,1076,3932,74800,2017
20161,24.9,75696,58208,4731,6129,14559,48428,26686,11284,15402,26686,189200,2017
20163,43.6,5148,4866,36,129,1391,48352,2144,1714,430,2144,75400,2017
20165,47.9,3119,2940,1,96,850,43594,1432,1114,318,1432,69900,2017
20167,48.7,6987,6511,87,193,2026,48427,3161,2414,747,3161,90100,2017
20169,37.9,55334,44556,1711,6038,13963,49728,22294,14845,7449,22294,125400,2017
20171,40.5,4981,3962,0,887,1426,62198,2105,1568,537,2105,135900,2017
20173,35,510484,350354,44871,72080,125797,52841,195072,124608,70464,195072,130900,2017
20175,29.5,22948,7253,1032,13682,5474,47535,7573,4986,2587,7573,98500,2017
20177,38.9,178392,132874,13615,21329,44672,54667,71601,46411,25190,71601,127600,2017
20179,44.7,2497,2343,12,109,781,56607,1144,889,255,1144,101000,2017
20181,38.5,5999,5088,19,717,1766,52030,2729,1782,947,2729,86300,2017
20183,51.6,3693,3512,14,70,1063,45357,1662,1289,373,1662,66200,2017
20185,42.7,4251,3557,28,566,1230,47121,1804,1511,293,1804,61800,2017
20187,39.3,2107,1247,9,787,537,42222,798,623,175,798,71900,2017
20189,35.1,5741,3558,5,2023,1442,57500,1958,1421,537,1958,110000,2017
20191,40.7,23336,21001,221,1241,5947,52695,9188,6790,2398,9188,86800,2017
20193,36.3,7847,7157,109,433,2233,52465,3259,2425,834,3259,114000,2017
20195,49.4,2899,2741,4,36,871,55197,1389,1095,294,1389,84400,2017
20197,43.4,6918,6432,22,235,1932,58947,2732,2308,424,2732,111900,2017
20199,40.6,1591,1490,0,81,378,60000,594,464,130,594,88300,2017
20201,46.2,5572,5256,19,183,1549,47992,2339,1879,460,2339,75300,2017
20203,41.2,2157,1502,15,598,629,55109,890,627,263,890,84000,2017
20205,44,8858,8181,46,256,2444,44468,3873,2866,1007,3873,66700,2017
20207,48.6,3178,2959,35,26,864,36493,1523,1242,281,1523,53200,2017
20209,33.7,163227,67848,37030,45791,37900,42783,59355,34112,25243,59355,92800,2017
21001,40.8,19304,18037,693,356,4866,36575,7101,5400,1701,7101,85900,2017
21003,40.6,20628,19680,392,397,5693,40598,7705,5542,2163,7705,102500,2017
21005,40.5,22017,20746,518,366,5929,51681,8613,6580,2033,8613,138600,2017
21007,43.3,8152,7583,318,100,2149,42988,3225,2532,693,3225,102600,2017
21009,40.3,43418,39383,1674,1319,11585,39658,16927,11207,5720,16927,110400,2017
21011,39.9,12189,11629,126,186,3357,38763,4509,3298,1211,4509,77900,2017
21013,41.6,27469,25951,908,80,6982,23558,11063,7187,3876,11063,59400,2017
21015,37.1,127682,112914,3823,5201,34772,72731,46095,33885,12210,46095,183700,2017
21017,42.1,20017,17050,1445,1334,5417,47886,8116,5059,3057,8116,144900,2017
21019,41.9,48486,45216,1183,826,12904,45543,19119,13360,5759,19119,103900,2017
21021,40.2,29773,25581,2117,958,7113,43076,10875,7234,3641,10875,141100,2017
21023,40.7,8330,8033,2,134,2221,40458,3427,2482,945,3427,102300,2017
21025,41.2,13276,12878,133,123,3602,25861,5342,3904,1438,5342,50000,2017
21027,43.3,19991,18925,348,254,5042,44057,7467,5831,1636,7467,95200,2017
21029,39.8,78622,74629,481,1399,21292,59917,29014,23681,5333,29014,153100,2017
21031,41.2,12735,12107,47,399,3591,39362,5060,3685,1375,5060,90400,2017
21033,42.6,12747,11608,867,170,3812,46182,5309,3870,1439,5309,95300,2017
21035,34.7,38616,34657,1422,1004,8671,39269,14757,9383,5374,14757,130100,2017
21037,38,91804,84820,2904,1765,23011,57208,35870,24675,11195,35870,160700,2017
21039,42.2,4890,4614,78,112,1281,38860,1988,1569,419,1988,89200,2017
21041,37.2,10695,9525,271,705,2633,43345,3962,2625,1337,3962,103800,2017
21043,41.1,27385,26512,231,233,7412,35095,10460,8122,2338,10460,83300,2017
21045,43.1,15805,15019,102,446,4331,33031,6398,5120,1278,6398,77600,2017
21047,28.4,72438,48058,14774,5434,17039,41849,25275,12024,13251,25275,112200,2017
21049,42.3,35757,32346,1788,977,9726,51547,14216,9335,4881,14216,139200,2017
21051,39.2,20866,19329,695,530,5556,24596,7719,5505,2214,7719,55600,2017
21053,41.7,10208,9810,56,282,2679,31130,4025,2815,1210,4025,66100,2017
21055,43.2,9154,8820,123,89,2539,41114,3711,3015,696,3711,84600,2017
21057,45.1,6744,6269,200,27,1806,35449,2709,1902,807,2709,90300,2017
21059,39,99258,88196,4393,2830,26313,48371,39531,26700,12831,39531,123200,2017
21061,43.1,12063,11517,187,105,3569,41114,4880,3929,951,4880,87100,2017
21063,42,7533,7236,263,21,1926,29043,2635,2026,609,2635,72700,2017
21065,42.6,14382,14030,19,36,3819,30692,5638,3975,1663,5638,71000,2017
21067,34.3,315109,226106,45132,21943,73105,53013,127336,68819,58517,127336,175000,2017
21069,40.9,14515,13943,254,176,4317,41095,5849,4166,1683,5849,89900,2017
21071,41.4,37447,36423,323,280,10447,31196,15108,10631,4477,15108,72900,2017
21073,40.7,49969,40941,4881,1521,12697,53539,20786,13131,7655,20786,139300,2017
21075,43.1,6259,4456,1526,44,1502,28274,2463,1506,957,2463,63600,2017
21077,39,8652,7896,131,452,1933,50250,3007,2145,862,3007,109900,2017
21079,42.4,17226,16240,161,384,5030,47906,6925,5413,1512,6925,131000,2017
21081,36.5,24800,23282,214,658,6495,43881,8637,5801,2836,8637,119700,2017
21083,40.3,37259,32453,1661,2273,9460,40369,14299,10558,3741,14299,95600,2017
21085,40.2,26129,24910,346,349,6870,35944,9594,6902,2692,9594,102200,2017
21087,44.4,11044,10425,339,66,3046,37388,4467,3429,1038,4467,75800,2017
21089,43.3,36012,34688,283,375,10269,47517,14089,10740,3349,14089,103300,2017
21091,40.2,8700,8334,82,127,2534,49135,3375,2560,815,3375,109100,2017
21093,36.1,107699,82147,12189,6023,27550,51923,41051,25297,15754,41051,148000,2017
21095,41.4,27548,26224,706,238,7771,24451,11249,7694,3555,11249,53500,2017
21097,41.8,18630,17466,319,420,4923,44620,7107,4944,2163,7107,132900,2017
21099,40.6,18531,17002,801,321,5016,37315,7346,5456,1890,7346,90200,2017
21101,40.4,46252,40237,3294,1092,12317,43458,18719,11580,7139,18719,118000,2017
21103,41.3,15677,14386,555,504,4311,50787,6104,4140,1964,6104,126100,2017
21105,48.3,4625,4032,401,62,1124,38036,1877,1530,347,1877,70200,2017
21107,41.3,45985,40829,2869,895,12626,44048,18546,13078,5468,18546,96600,2017
21109,41,13369,13282,16,1,3883,32055,5435,4065,1370,5435,69900,2017
21111,38,764378,523981,160658,38156,184658,52237,309888,190584,119304,309888,159000,2017
21113,37.4,51667,46290,2027,1658,14131,55450,18537,11512,7025,18537,164300,2017
21115,41.9,23064,22487,116,86,6003,35629,8771,6342,2429,8771,90300,2017
21117,36.9,163987,145805,7121,4936,40781,58674,62929,41329,21600,62929,149700,2017
21119,41.4,15690,15255,64,146,4354,30503,6158,4727,1431,6158,52000,2017
21121,39.7,31424,30167,387,347,7797,26061,12264,7768,4496,12264,76900,2017
21123,40.8,14102,12924,511,452,3941,41720,5470,3951,1519,5470,107300,2017
21125,39.6,59901,57462,423,907,15846,37235,22976,15876,7100,22976,102000,2017
21127,40.9,15844,15405,59,141,4287,32703,6254,4782,1472,6254,80400,2017
21129,44.2,6717,6500,85,55,1606,23297,2843,2089,754,2843,64200,2017
21131,41.9,10648,10410,13,67,2907,27861,4292,3342,950,4292,48900,2017
21133,41.8,23011,22485,67,171,6950,30293,10065,7465,2600,10065,58500,2017
21135,42.1,13565,13279,54,22,3978,32054,5496,4113,1383,5496,68300,2017
21137,40.6,24413,23031,531,385,6785,37930,9786,7192,2594,9786,96100,2017
21139,45.8,9288,8897,14,155,2731,43472,4016,2982,1034,4016,90800,2017
21141,40.7,26847,23840,1685,725,6928,40982,10780,7265,3515,10780,105400,2017
21143,49.2,8268,7527,440,102,1990,50268,3376,2784,592,3376,122900,2017
21145,42.1,65285,54551,7247,1538,16240,42894,27557,18457,9100,27557,134100,2017
21147,39.2,17748,15925,951,600,4625,19264,6332,4483,1849,6332,61300,2017
21149,41.5,9361,9011,31,121,2723,44242,3826,3064,762,3826,96800,2017
21151,34,88376,79374,3826,2039,20737,46674,33036,19486,13550,33036,151000,2017
21153,42,12783,12651,3,125,3479,29578,5057,3475,1582,5057,63300,2017
21155,39.7,19335,16956,1638,493,4575,40005,7365,5440,1925,7365,100400,2017
21157,44.8,31177,30162,178,452,9214,49126,13117,10344,2773,13117,118100,2017
21159,39,12175,11250,575,226,2940,29239,4316,3114,1202,4316,65500,2017
21161,40.7,17167,15347,1003,126,4638,43082,6737,4571,2166,6737,111200,2017
21163,37.8,28452,25460,899,1084,7959,53732,10785,7722,3063,10785,140800,2017
21165,46.2,6381,6240,4,55,1802,39688,2537,2085,452,2537,77800,2017
21167,42.8,21378,19487,870,570,5985,47574,8645,6206,2439,8645,139900,2017
21169,43.1,9990,9505,71,148,2727,35594,3940,3005,935,3940,75200,2017
21171,41.8,10645,9959,264,318,2899,35665,4376,3176,1200,4376,74500,2017
21173,39,27550,25613,779,731,7286,42172,10404,6964,3440,10404,118200,2017
21175,41.3,13281,12378,438,160,3618,33523,4937,3682,1255,4937,77500,2017
21177,42,31153,28706,1516,463,8029,40037,11416,8885,2531,11416,82000,2017
21179,38.9,45131,40873,2371,929,12218,55182,17324,13579,3745,17324,144800,2017
21181,41.6,7061,6779,79,109,1937,38900,2760,1921,839,2760,82100,2017
21183,40.7,24062,22723,215,823,6413,41470,9055,6939,2116,9055,88300,2017
21185,39,64633,57190,2341,2465,16599,92237,20465,17431,3034,20465,259700,2017
21187,42.2,10686,10143,191,276,2773,44031,3944,2896,1048,3944,99100,2017
21189,41.8,4497,4238,184,23,1199,22736,1696,1252,444,1696,70000,2017
21191,41.2,14530,14034,128,93,3851,49706,5236,3965,1271,5236,106400,2017
21193,41.2,27329,26135,429,266,7605,31820,11037,8117,2920,11037,73300,2017
21195,41.9,61586,59725,507,552,17739,32972,25853,18853,7000,25853,75400,2017
21197,39,12349,11890,32,192,3317,34647,4878,3348,1530,4878,79800,2017
21199,42,63974,60267,583,1541,16800,35022,25810,17852,7958,25810,109100,2017
21201,47.1,2161,2045,40,48,549,30694,938,717,221,938,94500,2017
21203,42.2,16815,16394,34,142,4721,35888,6552,4975,1577,6552,80800,2017
21205,30.7,24392,23059,346,476,5111,36411,8774,5223,3551,8774,121100,2017
21207,43.4,17731,16667,91,635,4690,34660,7204,5338,1866,7204,87300,2017
21209,36.2,52322,45608,2469,2255,14471,65598,19706,13694,6012,19706,170800,2017
21211,38.8,45831,36847,3103,4173,11852,63171,16369,11348,5021,16369,184900,2017
21213,39.8,17881,15285,1702,399,4688,44989,6895,4342,2553,6895,130500,2017
21215,40.7,18012,17012,188,355,5505,68916,6678,5547,1131,6678,190900,2017
21217,38.4,25406,22814,1195,583,6407,36455,9669,6107,3562,9669,106700,2017
21219,36.8,12377,10642,961,472,3253,38248,4610,3284,1326,4610,94800,2017
21221,45.5,14286,12616,1252,285,4096,47259,5982,4942,1040,5982,119500,2017
21223,41.9,8697,8218,0,248,2400,50998,3603,2766,837,3603,110500,2017
21225,37.5,14915,12327,1958,280,3706,42139,5527,3755,1772,5527,83100,2017
21227,32.7,123824,98587,11429,6317,29995,49508,46443,27283,19160,46443,152300,2017
21229,41.2,11999,10528,627,516,3063,47843,4507,3451,1056,4507,105600,2017
21231,42,20692,19356,283,638,5075,33715,8011,5833,2178,8011,81400,2017
21233,41,13180,11683,517,681,3577,39273,5095,3708,1387,5095,80800,2017
21235,37,36027,34612,434,424,9305,34103,12583,8861,3722,12583,83800,2017
21237,41.8,7251,7122,24,20,1896,21999,2853,1851,1002,2853,65700,2017
21239,42.3,25817,22324,1147,1694,7093,60604,10063,7094,2969,10063,188200,2017
22001,35.8,62607,48541,11030,1500,15503,40492,22675,16177,6498,22675,97500,2017
22003,38.2,25667,18254,4872,1245,5136,42176,7834,5948,1886,7834,84800,2017
22005,35.3,119129,82617,25968,6261,31460,74748,41884,33582,8302,41884,179800,2017
22007,39.5,22881,15045,6798,634,5914,48656,8710,6895,1815,8710,114600,2017
22009,38.1,41095,26849,12368,754,10051,36763,14961,10431,4530,14961,90600,2017
22011,37.5,36598,29271,4634,1343,9305,47350,13327,10189,3138,13327,115200,2017
22013,42.3,13806,7495,5725,238,3820,34077,5840,4207,1633,5840,76000,2017
22015,34.9,125698,84978,27143,8204,32085,52145,48142,30303,17839,48142,164600,2017
22017,37.1,251069,114377,121254,6979,60021,40391,97283,58413,38870,97283,138200,2017
22019,36.1,198753,135549,48798,6395,50369,48219,77130,52140,24990,77130,138100,2017
22021,39.9,10000,7906,1676,313,2362,31933,3680,2712,968,3680,67800,2017
22023,43.2,6806,6216,189,377,2053,60194,2686,2414,272,2686,110900,2017
22025,38,10044,6625,3208,153,2586,34470,3747,2823,924,3747,78700,2017
22027,42.2,16296,7429,8339,234,3760,26877,5980,3974,2006,5980,74100,2017
22029,37.7,20211,11491,8310,266,4984,30028,7440,4722,2718,7440,78500,2017
22031,39.4,27164,15797,9982,756,7083,41443,10331,7531,2800,10331,110000,2017
22033,33.4,446167,201742,203276,17825,100463,51436,167188,98239,68949,167188,177800,2017
22035,33.8,7318,1999,5239,38,1460,20795,2417,1091,1326,2417,68200,2017
22037,42.4,19553,10351,8683,296,4865,46964,6817,5502,1315,6817,124100,2017
22039,35.4,33750,22601,9264,1162,7745,31745,11928,7929,3999,11928,90000,2017
22041,38,20388,13310,6803,41,5067,34722,7622,5184,2438,7622,83200,2017
22043,37.7,22305,17084,3397,1084,4678,40577,7271,4853,2418,7271,93600,2017
22045,36,73346,43435,22994,2961,18419,44504,26420,17736,8684,26420,106700,2017
22047,38.4,33122,15796,16126,837,7751,47128,11142,8445,2697,11142,127500,2017
22049,40.5,15952,10679,4796,251,4107,36394,6032,4259,1773,6032,84400,2017
22051,39,437038,233428,113952,62334,106845,50868,168786,104407,64379,168786,176000,2017
22053,38.1,31405,24669,5106,709,7764,40744,11435,8170,3265,11435,101800,2017
22055,34.5,238230,157459,61051,10872,56301,53950,89677,58780,30897,89677,172500,2017
22057,37.1,98112,75424,12800,4281,25496,52705,36153,27163,8990,36153,144300,2017
22059,38.2,14930,12379,1791,417,3598,34712,5044,3730,1314,5044,76700,2017
22061,27.6,47536,25302,19207,1386,10478,34424,17370,9465,7905,17370,145900,2017
22063,35.9,137096,121204,8111,4741,35778,60456,48675,39087,9588,48675,155800,2017
22065,35.1,11616,3966,7374,231,2399,29424,4073,2287,1786,4073,64100,2017
22067,39.6,26290,13021,12593,330,6366,31672,10077,6654,3423,10077,84900,2017
22069,33.6,39051,20564,15975,844,8103,29001,14549,7275,7274,14549,114100,2017
22071,35.9,388182,118660,229389,21448,75924,38721,154895,72892,82003,154895,205000,2017
22073,35.1,156433,91275,58451,3411,37153,40081,56799,33710,23089,56799,133400,2017
22075,35.9,23394,15245,4818,1562,6430,49635,8759,6046,2713,8759,165900,2017
22077,42.7,22271,13457,7885,550,5782,43964,8815,6715,2100,8815,124500,2017
22079,37.3,132080,81123,42109,3959,32111,42655,48032,29438,18594,48032,133800,2017
22081,39.9,8723,4974,3269,170,2116,41510,3374,2516,858,3374,85900,2017
22083,38.2,20619,12478,7391,427,5114,34745,7500,4752,2748,7500,86900,2017
22085,41.3,24145,16444,3992,921,6157,40695,9174,6803,2371,9174,84200,2017
22087,33.6,45067,28603,9935,4459,10468,45265,14791,10006,4785,14791,139200,2017
22089,37.2,52728,34529,13903,3062,14230,64707,18925,15206,3719,18925,185800,2017
22091,38.3,10509,4631,5671,24,2784,35254,3990,3303,687,3990,77400,2017
22093,38.9,21485,10317,10661,336,5538,52055,7887,6108,1779,7887,136400,2017
22095,36.5,43565,15838,24140,2524,11714,53628,15421,11728,3693,15421,152800,2017
22097,36.2,83580,45673,34254,1683,20398,32163,30467,21254,9213,30467,99200,2017
22099,37.1,53609,34512,15710,1504,13936,47279,19435,15501,3934,19435,114200,2017
22101,38,52578,29507,16250,3598,11565,41345,20032,12515,7517,20032,97000,2017
22103,39.8,249201,197138,28895,13500,65735,66539,91353,71409,19944,91353,206600,2017
22105,34.9,128850,81854,37900,5274,31920,45901,47598,32452,15146,47598,149300,2017
22107,44,4771,2019,2641,87,1105,21906,1930,1197,733,1930,62200,2017
22109,35.5,113067,75878,21736,5698,27382,47650,40177,28575,11602,40177,143700,2017
22111,41.7,22537,15466,5696,1050,5316,38916,7971,6506,1465,7971,88700,2017
22113,36.9,59841,46913,8507,1963,15025,49266,21721,16623,5098,21721,105700,2017
22115,30.1,51906,36384,7297,4857,12573,46620,17930,9399,8531,17930,116600,2017
22117,39.9,46449,30546,13970,969,11613,32962,17542,12545,4997,17542,84600,2017
22119,40.6,40043,24913,13676,733,9821,30891,15854,11102,4752,15854,81600,2017
22121,35.6,25518,14498,9812,768,6920,60902,9436,6928,2508,9436,177000,2017
22123,41,11274,8978,1789,365,2933,37304,4182,3105,1077,4182,79400,2017
22125,40.5,15376,8004,6902,233,2441,55647,3947,2903,1044,3947,209600,2017
22127,40.9,14631,9543,4569,281,3685,29472,5382,3508,1874,5382,72700,2017
23001,40.7,107317,97809,1703,1927,27608,49538,45263,28953,16310,45263,152000,2017
23003,47.2,68840,65024,620,767,18706,39021,29844,21394,8450,29844,97000,2017
23005,42.1,289173,262323,8098,5752,72612,65702,118807,81526,37281,118807,259400,2017
23007,45.4,30177,28908,93,390,7436,45541,11577,9237,2340,11577,136300,2017
23009,48.1,54468,51781,439,727,14914,51438,23674,17455,6219,23674,207300,2017
23011,44.2,121289,115092,996,1779,31954,50116,51055,35827,15228,51055,154500,2017
23013,47.8,39700,37968,251,498,10681,53117,17022,12983,4039,17022,199600,2017
23015,50.5,34021,32717,97,379,9621,54041,15241,11941,3300,15241,211900,2017
23017,46.3,57230,54715,164,709,13619,44582,20756,16593,4163,20756,137200,2017
23019,41.8,152284,143218,1149,1935,38388,47886,61848,43132,18716,61848,137900,2017
23021,50.7,16960,16178,65,230,4739,38797,7477,5699,1778,7477,116100,2017
23023,45.9,35149,33341,262,545,10095,60457,15810,11980,3830,15810,199400,2017
23025,45.8,50994,48948,205,514,13742,41549,21392,16288,5104,21392,108000,2017
23027,45.7,39280,37611,201,463,10993,50162,16954,13427,3527,16954,159800,2017
23029,47.6,31822,28659,134,610,8831,40328,14017,10604,3413,14017,110000,2017
23031,44.7,201454,190567,1588,3202,54376,62618,83324,62103,21221,83324,233000,2017
24001,41.5,72591,63403,5774,1257,17126,42771,27759,19110,8649,27759,119900,2017
24003,38.5,564600,393139,89635,41275,142696,94502,205395,152576,52819,205395,346000,2017
24005,39.2,828637,486692,228044,42438,204288,71810,312859,205962,106897,312859,249600,2017
24009,40.8,90824,71582,10591,3276,23759,100350,31462,26241,5221,31462,347200,2017
24011,40.1,32785,25022,4341,2247,8670,52469,11996,8540,3456,11996,201200,2017
24013,42.4,167319,150297,5455,5368,45399,90510,60432,49447,10985,60432,328100,2017
24015,40.3,102416,87889,6565,4231,26121,70516,37076,27110,9966,37076,238000,2017
24017,38.1,156021,67280,66761,8358,40303,93973,54988,42505,12483,54988,294000,2017
24019,44.4,32386,20676,8689,1615,8539,50532,12940,8518,4422,12940,179300,2017
24021,39.3,246105,184203,21635,21623,65073,88502,90022,67295,22727,90022,315400,2017
24023,45.4,29516,28520,170,316,8206,48174,11865,9199,2666,11865,167100,2017
24025,40.6,250132,192509,32691,10608,67167,83445,92895,73027,19868,92895,281400,2017
24027,38.7,312495,169069,56630,20343,82294,115576,111337,82082,29255,111337,439900,2017
24029,46.9,19666,15366,2912,851,4644,56638,7605,5332,2273,7605,237400,2017
24031,38.8,1039198,467734,182541,197242,257855,103178,369242,242295,126947,369242,467500,2017
24033,36.5,905161,120200,564173,157427,202472,78607,306694,189513,117181,306694,272900,2017
24035,44.1,49071,42489,3427,1805,12995,89241,17995,14587,3408,17995,343200,2017
24037,36.5,110979,83340,15760,5377,27646,86508,39276,28257,11019,39276,291500,2017
24039,37,25801,13280,10779,906,5258,39239,8362,5405,2957,8362,131000,2017
24041,49.7,37461,29076,4276,2427,10959,65595,16498,11599,4899,16498,326300,2017
24043,40.6,149546,120193,14968,6698,37413,58260,55999,36117,19882,55999,205300,2017
24045,35.8,102014,65154,25594,5145,24425,54493,37415,22709,14706,37415,171700,2017
24047,49.7,51559,41246,6901,1741,13493,59458,21190,15774,5416,21190,252100,2017
24510,35,619796,170916,385831,30729,123385,46641,239791,113558,126233,239791,153200,2017
25001,52.4,213900,192917,5699,5869,58437,68048,95011,74862,20149,95011,375000,2017
25003,46.5,127751,113686,3280,5461,32702,55190,55063,37987,17076,55063,203300,2017
25005,40.9,557016,461175,19353,40913,142267,62514,215903,135144,80759,215903,280400,2017
25007,45.9,17275,15021,645,280,3870,67535,6139,4770,1369,6139,674600,2017
25009,40.8,775860,558478,23782,152189,195222,73533,291659,186007,105652,291659,373400,2017
25011,45.9,70926,64668,879,2669,17919,57307,30512,21024,9488,30512,226600,2017
25013,38.7,469188,300617,36646,112302,115757,52205,178931,109475,69456,178931,198500,2017
25015,36.1,161197,135791,4465,8634,34930,64974,58782,38852,19930,58782,272700,2017
25017,38.5,1582857,1160650,76708,121171,385660,92878,593784,371697,222087,593784,453300,2017
25019,39.8,10912,8050,873,943,2298,91942,3761,2438,1323,3761,995900,2017
25021,41,694389,532276,43719,28900,173787,95668,262324,181881,80443,262324,433000,2017
25023,42.6,509114,416813,44804,18664,131072,82081,184195,139821,44374,184195,344400,2017
25025,32.6,780685,355132,157381,173707,151644,61242,303676,110361,193315,303676,430900,2017
25027,40.1,818249,637093,35449,88475,202054,69313,305975,198010,107965,305975,260800,2017
26001,57.9,10413,9996,33,147,3083,39424,4979,4391,588,4979,96000,2017
26003,49.3,9254,7788,665,131,2088,42647,3244,2809,435,3244,119000,2017
26005,39.7,114145,101281,1444,8225,30803,58487,42556,34873,7683,42556,150600,2017
26007,47.6,28730,27590,156,372,7908,40954,12789,9851,2938,12789,94000,2017
26009,50.4,23133,21981,70,484,6864,50988,9732,8243,1489,9732,151500,2017
26011,49.3,15238,14463,79,300,4333,39947,6663,5507,1156,6663,88900,2017
26013,43.4,8580,6271,1357,128,1900,42757,3009,2507,502,3009,93100,2017
26015,42.7,59607,56406,257,1612,16697,57312,23539,18902,4637,23539,146300,2017
26017,42.9,105350,95185,1624,5428,27943,45983,44070,34431,9639,44070,96800,2017
26019,48.9,17462,16402,60,417,4457,53185,6911,6079,832,6911,162200,2017
26021,42,154948,116416,22567,8080,40621,47132,63035,43694,19341,63035,140900,2017
26023,41.2,43543,39594,1010,1943,11057,48192,16415,12376,4039,16415,97700,2017
26025,39.9,134327,105142,14191,6709,33915,46213,53528,37346,16182,53528,102600,2017
26027,44.7,51397,44413,2476,1876,14351,50699,20686,16646,4040,20686,127600,2017
26029,47.7,26160,24589,95,469,7329,51567,11234,9112,2122,11234,158800,2017
26031,50.1,25475,23494,193,340,7413,42876,11348,9268,2080,11348,116900,2017
26033,39.7,38023,26662,2437,672,8560,44030,14004,9801,4203,14004,111100,2017
26035,46.9,30597,29087,168,572,8296,35913,12726,10371,2355,12726,85000,2017
26037,40.4,77321,69748,1277,3438,20434,64903,29163,23128,6035,29163,164700,2017
26039,50,13821,13128,94,254,3949,42666,6025,4856,1169,6025,91900,2017
26041,46.9,36395,33924,96,435,10022,44639,15920,12714,3206,15920,105900,2017
26043,46.4,25694,24562,153,364,7339,45681,11269,8776,2493,11269,92100,2017
26045,40.9,108586,90551,7022,5638,29021,59244,44323,31395,12928,44323,142300,2017
26047,45,32978,30138,170,515,9152,51475,14496,10648,3848,14496,171100,2017
26049,40.1,410881,297950,81431,13585,107172,45231,166838,117034,49804,166838,96500,2017
26051,49.5,25324,24372,90,373,7147,40871,10990,9184,1806,10990,100500,2017
26053,48.7,15577,13963,658,195,3851,36689,6660,5138,1522,6660,70100,2017
26055,42.8,91222,84495,1028,2484,23855,58229,36519,27991,8528,36519,183000,2017
26057,39,41319,35729,2302,2411,9766,42256,14736,10718,4018,14736,92100,2017
26059,42,45909,43637,321,1008,11946,46160,17896,13684,4212,17896,105600,2017
26061,32.9,36333,33578,262,543,7534,41379,13157,9013,4144,13157,102400,2017
26063,48.5,31750,30308,127,718,8940,45191,13880,11330,2550,13880,96200,2017
26065,31.7,286185,202042,30465,21738,60993,49109,111894,65175,46719,111894,123700,2017
26067,38.7,64147,56672,3034,3000,15815,51980,22625,17634,4991,22625,117000,2017
26069,52.6,25317,23872,166,514,7088,41414,11457,9179,2278,11457,89000,2017
26071,53.8,11291,10722,80,205,2865,36773,5315,4392,923,5315,76700,2017
26073,27.4,70572,60583,1788,2684,14028,42771,24898,15307,9591,24898,128400,2017
26075,41,158989,135108,13066,5404,40402,49715,61418,44932,16486,61418,120100,2017
26077,34.1,259830,202780,27499,12227,61146,51945,102362,65184,37178,102362,146100,2017
26079,44.6,17358,16436,122,313,4750,43431,7019,5652,1367,7019,105300,2017
26081,35,636376,473589,58992,65434,157244,57302,236929,163289,73640,236929,153500,2017
26083,55.1,2136,2082,32,14,630,41118,1013,872,141,1013,95800,2017
26085,52.1,11669,9898,885,303,2770,32309,4555,3844,711,4555,80800,2017
26087,43.6,88205,81163,1107,4035,24427,56186,33152,27348,5804,33152,151400,2017
26089,53.3,21564,19456,104,911,6253,62646,9022,7843,1179,9022,248900,2017
26091,41.6,98585,85780,2324,7660,25130,51339,38115,29599,8516,38115,124900,2017
26093,42.9,186946,176860,1035,4268,51974,78430,70831,60469,10362,70831,218700,2017
26095,44.2,6406,5012,411,204,1393,41221,2253,1741,512,2253,83200,2017
26097,51.8,10836,7997,252,174,3082,42559,5132,3798,1334,5132,125100,2017
26099,41,864019,693290,94596,21575,225398,58175,341532,248844,92688,341532,146700,2017
26101,48.7,24432,21851,675,707,6160,44882,9810,8069,1741,9810,116200,2017
26103,39.1,67145,62017,1045,964,15592,48491,26199,18328,7871,26199,142900,2017
26105,46,28800,26401,268,1286,7801,45524,12186,9398,2788,12186,126600,2017
26107,36.4,43181,39512,1083,924,9566,43470,15641,11567,4074,15641,114700,2017
26109,48,23389,21825,77,388,6433,44480,10593,8356,2237,10593,95900,2017
26111,41.5,83489,76534,1198,2157,23026,57117,33986,25791,8195,33986,133000,2017
26113,43.4,14982,14136,63,401,4069,42370,5941,4870,1071,5941,107100,2017
26115,42.2,149619,136961,3438,5162,40343,59479,58652,47019,11633,58652,149500,2017
26117,40.5,62956,57912,1235,2132,16081,44651,23556,18347,5209,23556,101000,2017
26119,55.3,9290,8940,22,117,2581,39152,4074,3597,477,4074,93800,2017
26121,39.1,172707,132180,23239,9412,43764,46077,65216,48466,16750,65216,105300,2017
26123,42.6,47899,43434,600,2762,12851,45645,18772,15511,3261,18772,104500,2017
26125,41,1241860,904862,169224,47941,323744,73369,499617,352687,146930,499617,209800,2017
26127,42.7,26317,21629,310,3821,7351,44382,10176,8206,1970,10176,106300,2017
26129,49.7,20979,19934,68,416,6114,38149,9325,7694,1631,9325,89600,2017
26131,57.1,6072,5781,19,82,1689,36073,2945,2598,347,2945,69500,2017
26133,43.5,23221,22032,226,399,6012,41099,9010,7312,1698,9010,91400,2017
26135,51.8,8304,7943,48,116,2262,36833,3728,3170,558,3728,83400,2017
26137,44.9,24247,22958,99,396,6875,50823,9880,7860,2020,9880,124100,2017
26139,34.9,280243,236327,3845,26437,72642,63962,99721,77206,22515,99721,168000,2017
26141,54.3,12854,12316,68,159,3906,43758,5929,5175,754,5929,97800,2017
26143,55.3,23934,22820,67,391,6917,37834,11131,9077,2054,11131,94000,2017
26145,40.8,193803,135088,35165,16052,49108,45034,78482,56305,22177,78482,94900,2017
26147,43.2,159761,145941,3269,5162,42785,53641,64387,49024,15363,64387,135000,2017
26149,39.4,60890,52871,1533,4564,16624,47856,23831,17639,6192,23831,111200,2017
26151,44.8,41535,39100,231,1518,11222,44417,17121,13676,3445,17121,101300,2017
26153,51.1,8114,6971,49,78,2064,37428,3282,2592,690,3282,105000,2017
26155,42,68617,64710,269,1956,19053,50967,27623,20898,6725,27623,111000,2017
26157,44.1,53569,50174,607,1740,14984,45495,21624,17727,3897,21624,98800,2017
26159,41.6,75190,61287,2323,8416,19579,49119,29151,22508,6643,29151,123100,2017
26161,33.4,361509,255347,42415,16405,79592,65618,138947,83645,55302,138947,231500,2017
26163,37.9,1763822,876195,686353,100977,416779,43702,673143,418914,254229,673143,92400,2017
26165,41.9,32915,31188,206,601,8907,42793,13105,10006,3099,13105,96500,2017
27001,54.5,15841,14903,74,202,5035,45860,7709,6364,1345,7709,169300,2017
27003,38.2,344861,285056,18860,14597,90711,76796,126072,100959,25113,126072,205000,2017
27005,41.8,33552,29056,173,635,9162,55884,13489,10538,2951,13489,182100,2017
27007,33.4,45847,33221,400,1018,10907,45923,17076,11648,5428,17076,153100,2017
27009,35.6,39360,36008,1104,852,10391,53574,16005,10998,5007,16005,162600,2017
27011,49,5039,4936,15,71,1454,48299,2264,1747,517,2264,97000,2017
27013,30.6,65767,58463,2152,2131,14657,53752,25558,15848,9710,25558,170800,2017
27015,42.5,25243,23702,71,1030,6978,55764,10668,8304,2364,10668,135300,2017
27017,40.7,35408,31256,555,601,9035,58874,13413,10687,2726,13413,162800,2017
27019,37.2,98799,88561,1449,4051,26537,93095,35342,28695,6647,35342,287200,2017
27021,48.7,28810,23988,108,570,8932,50162,12965,10464,2501,12965,178700,2017
27023,43,12040,10696,69,759,3285,57601,5019,3526,1493,5019,104500,2017
27025,40.9,54297,50953,729,1092,14421,76747,19871,16975,2896,19871,206400,2017
27027,32.6,62040,54901,1566,2688,14951,61409,23453,16114,7339,23453,173100,2017
27029,42.7,8824,7504,38,177,2223,45638,3428,2727,701,3428,122800,2017
27031,52.1,5270,4537,28,109,1707,51903,2700,2025,675,2700,241400,2017
27033,43.3,11437,9967,65,814,3137,50524,4837,3743,1094,4837,89400,2017
27035,44.1,63505,60405,405,918,17541,53121,26314,19920,6394,26314,188100,2017
27037,37.7,414655,330377,23183,28020,110265,79995,158777,118058,40719,158777,238000,2017
27039,38,20485,18947,61,1005,5614,71078,7690,6342,1348,7690,167900,2017
27041,44.3,36891,35473,236,570,10433,58667,16175,12149,4026,16175,197200,2017
27043,46.8,13966,12788,31,898,3943,50847,6245,4743,1502,6245,86500,2017
27045,42.5,20825,20150,99,298,5872,57093,8614,6873,1741,8614,148300,2017
27047,44.3,30619,26425,376,2908,8428,51174,12958,9958,3000,12958,105100,2017
27049,42.9,46138,42640,477,1479,13039,62431,19345,14435,4910,19345,191400,2017
27051,45.3,5923,5660,14,125,1746,53727,2536,2011,525,2536,104900,2017
27053,36.3,1224763,851532,153651,84059,286220,71154,499104,311517,187587,499104,245400,2017
27055,45.4,18709,18023,134,183,5543,56837,8114,6514,1600,8114,164200,2017
27057,48.6,20743,19322,138,413,6192,52941,8758,7212,1546,8758,182700,2017
27059,39.5,38584,36364,202,710,10062,67565,14571,11889,2682,14571,172900,2017
27061,45.9,45237,41652,181,598,12989,52050,19356,15559,3797,19356,156100,2017
27063,44,10104,9404,12,343,2856,55122,4350,3426,924,4350,114100,2017
27065,44.5,15948,15185,64,247,4334,50509,6353,5177,1176,6353,147200,2017
27067,39.5,42577,34829,1788,5061,11641,56604,16765,12381,4384,16765,167000,2017
27069,47.9,4384,4208,34,91,1150,52304,1891,1520,371,1891,71800,2017
27071,48.6,12776,11943,111,20,3606,47131,5629,4429,1200,5629,108300,2017
27073,50,6840,6536,79,144,2056,50195,3171,2552,619,3171,81100,2017
27075,50.3,10578,10131,110,153,3267,56078,5082,4259,823,5082,165800,2017
27077,51.1,3841,3590,1,67,976,46943,1533,1251,282,1533,128400,2017
27079,41.4,27810,25501,220,1597,7667,65500,10844,8878,1966,10844,190700,2017
27081,45.9,5724,5536,18,99,1557,51102,2484,1959,525,2484,95300,2017
27083,35.6,25789,22019,849,1604,6448,54181,10060,6862,3198,10060,135900,2017
27085,40.4,35816,32819,113,2060,9859,59869,14760,11558,3202,14760,150400,2017
27087,35.7,5500,2540,17,211,1286,42439,1947,1355,592,1947,97300,2017
27089,43.4,9397,8805,30,397,2625,57289,3953,3204,749,3953,104500,2017
27091,45.2,20084,18797,57,829,5501,53627,8685,6478,2207,8685,112400,2017
27093,42.2,23105,21793,133,867,6221,59611,9164,7211,1953,9164,161600,2017
27095,40.1,25635,22893,95,574,6867,53737,10116,7474,2642,10116,151400,2017
27097,41.7,32880,31542,202,518,9068,52855,13327,10571,2756,13327,159100,2017
27099,39.3,39386,31837,1351,4334,10214,53700,15524,11374,4150,15524,114700,2017
27101,48.1,8394,7871,53,301,2354,54211,3713,3020,693,3713,107700,2017
27103,36.3,33477,29994,989,1431,8459,62593,12662,9218,3444,12662,178000,2017
27105,36,21854,13292,948,5863,5498,53267,7917,5632,2285,7917,118300,2017
27107,44.3,6589,5909,58,328,1779,53034,2733,2212,521,2733,88500,2017
27109,37.1,151685,123059,8344,7242,40076,72337,59804,44164,15640,59804,188300,2017
27111,46.6,57790,53750,781,1870,16417,55181,24300,19152,5148,24300,170900,2017
27113,39.5,14197,12935,207,496,3595,53893,5883,4330,1553,5883,133300,2017
27115,44.5,29057,26024,550,814,6864,47285,10752,8434,2318,10752,151600,2017
27117,42.4,9229,8264,114,541,2592,48909,4019,3009,1010,4019,91200,2017
27119,38.7,31564,27748,556,1956,7908,55393,12609,9243,3366,12609,152600,2017
27121,45.9,10932,10544,51,141,3197,58198,4898,3881,1017,4898,163600,2017
27123,34.8,537893,339170,60445,39948,122042,60301,208504,123722,84782,208504,208700,2017
27125,42.2,4017,3720,12,140,1106,52500,1718,1409,309,1718,107300,2017
27127,43.5,15430,13514,116,480,4096,51871,6310,4871,1439,6310,97400,2017
27129,44.4,14798,13145,74,1182,3978,56721,6219,4944,1275,6219,100100,2017
27131,36.6,65251,54519,3052,5129,15655,63311,22899,17012,5887,22899,188400,2017
27133,40.9,9433,8875,95,266,2704,56753,3985,2967,1018,3985,133600,2017
27135,41.4,15537,14357,133,181,4151,56273,6123,4817,1306,6123,118500,2017
27137,41,200294,183032,3138,3124,48967,50936,85662,60738,24924,85662,146700,2017
27139,36,141463,116432,4772,6951,36833,93151,47864,39719,8145,47864,272000,2017
27141,35.9,92024,84546,2077,2297,24033,83895,31181,25920,5261,31181,204100,2017
27143,41.6,14888,13260,92,1276,4128,60848,5993,4688,1305,5993,142800,2017
27145,34.1,155300,136413,7834,4951,37525,59564,58657,40293,18364,58657,171300,2017
27147,39.3,36612,31924,1156,2733,9732,58882,14450,11050,3400,14450,154300,2017
27149,33.1,9759,8697,82,488,2186,57552,3630,2413,1217,3630,150800,2017
27151,44.1,9448,8735,201,428,2595,49556,4217,2917,1300,4217,102100,2017
27153,43.7,24423,22401,93,1347,6537,49213,9777,7996,1781,9777,141000,2017
27155,48.6,3357,3042,21,83,1028,48889,1576,1267,309,1576,79800,2017
27157,45,21490,20386,77,613,6143,61973,8867,7177,1690,8867,167300,2017
27159,41.7,13626,12909,151,241,3572,45018,5704,4427,1277,5704,118900,2017
27161,39.6,18898,16892,394,1085,4948,55189,7375,5738,1637,7375,147800,2017
27163,39.2,250979,210116,10209,9847,66885,89598,92005,74764,17241,92005,264300,2017
27165,39.9,10936,8091,59,2553,2752,50044,4327,3181,1146,4327,94500,2017
27167,44.3,6398,6016,35,45,1838,52917,2852,2168,684,2852,114400,2017
27169,34.5,50992,46658,749,1418,11460,53975,19228,13462,5766,19228,158400,2017
27171,36.2,131130,121903,1846,3632,35120,77953,46568,38387,8181,46568,211500,2017
27173,42.6,9930,8956,51,431,2819,54645,4157,3238,919,4157,99100,2017
28001,40.3,31583,11655,16678,2667,7437,30359,11509,7189,4320,11509,90800,2017
28003,40.1,37242,30972,4374,1124,9669,38919,14675,10303,4372,14675,86100,2017
28005,46.4,12574,7211,5277,29,3055,30129,4994,4287,707,4994,77500,2017
28007,39.9,18731,10124,7902,376,5029,33815,7174,5061,2113,7174,72700,2017
28009,42,8306,4999,3042,204,2126,40605,2960,2449,511,2960,70300,2017
28011,35,33121,10719,21248,696,7795,28468,12267,6800,5467,12267,89100,2017
28013,40.5,14617,9501,3981,829,3911,33370,5853,4167,1686,5853,66600,2017
28015,46,10221,6567,3422,50,2629,43068,3592,2926,666,3592,90900,2017
28017,37,17305,8737,7492,765,4450,33579,6454,4572,1882,6454,63800,2017
28019,44.3,8360,5649,2581,41,1969,34542,3198,2446,752,3198,77200,2017
28021,33.8,9106,1098,7915,33,1959,24601,3187,2190,997,3187,61000,2017
28023,41.8,16089,10197,5650,138,4319,37626,6365,5284,1081,6365,72000,2017
28025,39.4,19990,7831,11788,128,5451,34118,7681,5514,2167,7681,81200,2017
28027,34,24296,5244,18737,35,5977,28728,8969,4596,4373,8969,62400,2017
28029,38.2,28748,12768,14853,850,6848,38046,9778,7619,2159,9778,93800,2017
28031,37.5,19172,11637,6824,460,4948,36471,6919,5651,1268,6919,77600,2017
28033,36.6,173267,115476,43857,8253,44999,62595,61158,44744,16414,61158,158600,2017
28035,32,75835,43272,27911,2308,17588,39555,28063,15459,12604,28063,114700,2017
28037,42.5,7772,4910,2795,65,2309,42388,3097,2370,727,3097,74700,2017
28039,36.5,23545,20590,1818,636,5097,47640,7220,6155,1065,7220,98200,2017
28041,39,13801,9950,3531,156,2813,48029,4174,3655,519,4174,80700,2017
28043,40.3,21379,11775,9239,92,5048,34876,7889,5392,2497,7889,93200,2017
28045,43.2,46277,39296,4010,1740,12739,47518,19145,14076,5069,19145,132800,2017
28047,35.9,200491,129479,48160,10718,50893,44684,77630,43284,34346,77630,144300,2017
28049,34.2,243249,61616,174077,3642,57454,41011,89153,52834,36319,89153,109400,2017
28051,34.5,18267,2852,15189,50,4147,20330,6280,3828,2452,6280,50600,2017
28053,36.4,8678,1847,6549,248,1975,26188,3119,1815,1304,3119,64200,2017
28055,38.8,1296,440,841,15,287,25609,437,201,236,437,50200,2017
28057,39.8,23439,21222,1724,347,6207,38358,8813,6637,2176,8813,87000,2017
28059,38.3,141314,96478,30526,8342,33753,50274,50994,35803,15191,50994,125100,2017
28061,40.8,16547,7459,8947,0,5186,35271,6817,5736,1081,6817,67300,2017
28063,34.9,7463,974,6448,9,1582,21779,2453,1601,852,2453,57100,2017
28065,43.6,11639,4407,7175,39,3051,26736,4798,3592,1206,4798,80600,2017
28067,37.1,68328,44338,19798,2921,17218,38656,24663,17904,6759,24663,85600,2017
28069,41.7,10082,3446,6078,171,2259,27016,3695,2824,871,3695,70900,2017
28071,29.3,52744,36944,12561,1314,11323,45019,19767,11551,8216,19767,177300,2017
28073,34.7,60517,45199,12076,1543,15764,56129,22022,15007,7015,22022,169000,2017
28075,37.7,78221,41504,33465,1751,19466,41340,29892,19611,10281,29892,88500,2017
28077,40.4,12659,8283,4199,68,3385,40432,4822,3817,1005,4822,89100,2017
28079,35.8,22936,10869,9616,1015,5738,35578,8228,5922,2306,8228,80800,2017
28081,37,84840,56323,24499,2167,21994,45985,32485,21853,10632,32485,125600,2017
28083,33.1,30113,6892,22032,773,6397,25210,10477,5145,5332,10477,76100,2017
28085,37.8,34542,23226,10641,369,9030,37308,12806,9591,3215,12806,94800,2017
28087,36.6,59558,31093,25908,1201,15453,43198,22630,13872,8758,22630,123400,2017
28089,37,102212,56854,39031,2926,27918,68600,38405,27134,11271,38405,213400,2017
28091,39.9,25466,16551,8179,379,6611,30998,9667,7601,2066,9667,78500,2017
28093,39.9,35981,17180,17138,1256,8915,41134,13084,9928,3156,13084,94300,2017
28095,41,35967,24094,10839,421,9479,39444,14042,10522,3520,14042,87100,2017
28097,42.6,10309,5398,4332,235,3207,34983,4524,3350,1174,4524,77900,2017
28099,36.7,29437,17324,6146,573,7450,36755,10773,7917,2856,10773,80400,2017
28101,37.2,21437,13181,6426,387,5817,37643,8010,6219,1791,8010,80300,2017
28103,36,10942,2837,7887,148,2699,30808,4002,2960,1042,4002,57400,2017
28105,25.4,49392,28090,18304,813,8854,37348,17393,9256,8137,17393,146400,2017
28107,37,34229,16177,17163,599,8125,35891,12449,9061,3388,12449,73800,2017
28109,41,55049,45111,7087,1635,14909,44734,20710,15858,4852,20710,122900,2017
28111,40.7,12047,9319,2380,172,3079,35374,4476,3672,804,4476,81100,2017
28113,37,39763,17478,21101,622,9440,30949,14962,10232,4730,14962,87500,2017
28115,36.8,31075,23975,4610,1940,7705,41865,10845,7855,2990,10845,102100,2017
28117,39.5,25389,21098,3392,353,6536,32854,9533,6755,2778,9533,90500,2017
28119,37.9,7537,2051,5351,98,1886,25671,3072,2013,1059,3072,51400,2017
28121,37.2,149645,112015,29894,3965,39866,61605,55226,41552,13674,55226,158400,2017
28123,36.5,28399,14163,10927,3069,7008,33601,10096,7177,2919,10096,71500,2017
28125,39.6,4631,1245,3331,28,1086,30033,1809,1124,685,1809,51100,2017
28127,38.9,27215,16770,9944,137,6647,37591,9322,7360,1962,9322,86800,2017
28129,40.1,16114,11980,3809,265,4185,37697,5850,4738,1112,5850,79700,2017
28131,37.4,17981,13814,3458,345,4519,46283,5979,4690,1289,5979,113900,2017
28133,34.9,26915,6504,19825,434,5640,28556,8505,4784,3721,8505,71600,2017
28135,34.7,14552,5148,6863,2176,2779,30000,4296,3323,973,4296,63400,2017
28137,37.7,28333,18353,8511,715,7158,46233,10016,7632,2384,10016,107400,2017
28139,38.6,21993,17009,3641,1026,5977,39351,8204,6080,2124,8204,86000,2017
28141,42.6,19476,18193,488,571,5424,36672,7606,5771,1835,7606,82700,2017
28143,32.9,10276,2002,8066,77,2698,32052,3983,1494,2489,3983,96000,2017
28145,37.9,28202,22177,4170,1197,7054,40076,9927,7172,2755,9927,92500,2017
28147,40.3,14670,7736,6704,87,3631,31077,5903,5280,623,5903,101900,2017
28149,38.2,47510,22658,23842,282,12212,41635,18559,11817,6742,18559,114600,2017
28151,36.7,48002,12251,34422,697,11502,29387,18249,9945,8304,18249,74400,2017
28153,37.4,20458,11831,8289,131,5728,35215,7762,6275,1487,7762,80100,2017
28155,39.9,9868,7698,1893,145,2737,35634,3842,2863,979,3842,77400,2017
28157,37.3,9084,2537,6451,26,1760,23340,2882,2326,556,2882,60400,2017
28159,42,18482,9304,8690,215,5195,33313,7411,5341,2070,7411,77600,2017
28161,41.8,12426,7243,4932,187,3512,37647,5196,3886,1310,5196,75200,2017
28163,35.7,27496,9850,15508,1551,5707,28330,8642,5353,3289,8642,78700,2017
29001,27.3,25437,23030,617,596,5129,38750,9595,5690,3905,9595,117700,2017
29003,42.5,17358,16481,227,399,4908,56658,6874,5318,1556,6874,136400,2017
29005,47.8,5335,5155,20,66,1435,45259,2492,1761,731,2492,82000,2017
29007,39.6,25763,22427,1572,754,6062,44056,9457,6436,3021,9457,95800,2017
29009,43.2,35398,30616,112,3169,9393,40638,13091,9748,3343,13091,112600,2017
29011,40.6,11942,11066,28,300,3302,41184,4939,3418,1521,4939,97500,2017
29013,41.6,16405,15508,205,340,4565,45605,6704,4939,1765,6704,108300,2017
29015,53.2,18918,18033,67,358,5280,35097,7982,6495,1487,7982,114600,2017
29017,43.9,12347,11919,53,149,3424,40791,4805,3872,933,4805,97100,2017
29019,30.6,174589,138754,14852,5729,39527,52005,68898,37742,31156,68898,177800,2017
29021,37.1,89425,74906,4826,5706,20705,48652,33304,21046,12258,33304,114800,2017
29023,40.3,42826,38123,2305,860,11126,37878,16550,10479,6071,16550,104600,2017
29025,42.9,9046,8578,46,188,2463,44975,3741,2810,931,3741,103600,2017
29027,38.3,44793,40399,1937,894,10633,53180,16105,11563,4542,16105,132500,2017
29029,51,44855,42371,324,1212,11906,50496,16340,13034,3306,16340,176300,2017
29031,36.3,78013,67423,6142,1781,18634,49554,29613,19353,10260,29613,151900,2017
29033,42.8,8909,8451,77,134,2441,43583,3618,2663,955,3618,81800,2017
29035,41.3,6255,5918,1,142,1510,37875,2403,1746,657,2403,90400,2017
29037,39.5,101888,90204,3793,4302,28283,65352,38706,29212,9494,38706,165800,2017
29039,44,13862,13162,5,278,3720,35930,5879,4137,1742,5879,92700,2017
29041,45.7,7586,7229,165,66,1849,43186,2842,2186,656,2842,81300,2017
29043,37.6,83028,77763,474,2325,22778,55761,30774,22799,7975,30774,154400,2017
29045,43.8,6807,6616,18,35,1989,45216,2907,2183,724,2907,85000,2017
29047,36.8,236068,193763,13210,15590,60335,65675,89709,61967,27742,89709,160900,2017
29049,41.1,20495,19249,409,410,5907,57591,8185,6147,2038,8185,142000,2017
29051,38.2,76749,62535,8885,2118,18810,54216,29642,19907,9735,29642,154200,2017
29053,39.2,17620,15538,1139,314,4118,46547,6410,4567,1843,6410,128900,2017
29055,41.6,24387,23291,64,459,6136,37171,9286,6640,2646,9286,116100,2017
29057,46.7,7581,7124,30,151,2130,38880,3107,2444,663,3107,75700,2017
29059,43.5,16441,15595,5,319,4514,41441,6156,4506,1650,6156,107400,2017
29061,41.3,8300,7985,65,124,2075,45707,3083,2426,657,3083,101100,2017
29063,40.5,12564,10583,1231,282,2505,46517,3854,2562,1292,3854,111600,2017
29065,44.1,15566,14755,69,249,4109,38829,6087,4279,1808,6087,107300,2017
29067,47.3,13391,13122,14,185,3631,33003,5173,3964,1209,5173,101700,2017
29069,39.4,30905,25050,3003,1966,8153,32348,12760,8071,4689,12760,69500,2017
29071,40.7,102413,97576,840,1706,28659,53849,40612,30074,10538,40612,156800,2017
29073,45.9,14769,14214,84,192,4255,50687,6135,4689,1446,6135,123000,2017
29075,41.3,6688,6449,63,20,1766,43777,2662,1929,733,2662,85600,2017
29077,35.7,286759,252812,9268,10061,70573,43175,119989,69714,50275,119989,136300,2017
29079,40.9,10111,9570,34,210,2561,41092,4018,2706,1312,4018,85100,2017
29081,42.8,8615,8231,67,182,2409,42889,3528,2575,953,3528,72800,2017
29083,44,21834,20521,317,486,5785,41089,9294,6812,2482,9294,92200,2017
29085,54.8,9352,8913,6,144,2586,34746,3983,3267,716,3983,90200,2017
29087,48.4,4499,4336,14,16,1396,43981,2111,1511,600,2111,93700,2017
29089,38.9,10144,9206,514,147,2482,50356,3713,2817,896,3713,116300,2017
29091,40.2,40139,37931,130,823,10862,34984,16204,11208,4996,16204,102200,2017
29093,45.3,10286,9719,159,180,2696,36457,4062,2931,1131,4062,83100,2017
29095,36.6,688554,430411,161236,60846,163816,50652,280174,164551,115623,280174,131500,2017
29097,35.9,118522,100385,2447,9114,30088,45328,46009,29707,16302,46009,112700,2017
29099,38.8,222639,210764,2229,4108,61574,60765,83744,66900,16844,83744,154100,2017
29101,29.9,53941,46474,2445,2203,12828,50689,19918,11907,8011,19918,147000,2017
29103,43.7,3976,3836,16,39,1073,39674,1602,1265,337,1602,72400,2017
29105,40.1,35488,33297,188,819,9831,42646,13825,9350,4475,13825,112700,2017
29107,42.2,32655,30113,662,887,9277,52557,13224,9644,3580,13224,122600,2017
29109,39.7,38131,34205,222,2730,10226,41673,14636,10351,4285,14636,98000,2017
29111,40.1,10078,9349,297,176,2431,47148,3754,2735,1019,3754,85500,2017
29113,37.3,54800,51157,1022,1281,13733,58603,18698,14404,4294,18698,154100,2017
29115,42.5,12248,11644,48,254,3362,41652,4997,3650,1347,4997,80400,2017
29117,40.7,15025,13967,416,250,3712,45929,5813,3883,1930,5813,106000,2017
29119,38.3,22753,17838,418,2631,6068,41207,8137,5753,2384,8137,97000,2017
29121,43,15319,14397,346,196,3764,38903,6023,4466,1557,6023,89000,2017
29123,41.7,12226,11603,116,286,3272,37484,4867,3464,1403,4867,99800,2017
29125,44.4,8959,8580,34,226,2388,41715,3667,2678,989,3667,122800,2017
29127,39.2,28703,25891,1396,465,7367,44098,11311,7239,4072,11311,113500,2017
29129,43.6,3669,3516,15,63,914,43314,1390,1056,334,1390,82500,2017
29131,41.1,24947,23712,95,451,6375,41461,9514,7116,2398,9514,126500,2017
29133,39.4,13916,9986,3319,277,3635,32212,5128,3106,2022,5128,73400,2017
29135,38.6,15904,14259,545,729,3934,50897,5373,4125,1248,5373,118400,2017
29137,45.2,8676,8098,299,135,2340,42011,3615,2691,924,3615,103100,2017
29139,43.9,11618,10968,168,207,3212,43094,4844,3495,1349,4844,105300,2017
29141,46.4,20097,18977,168,429,4966,34776,7774,5859,1915,7774,115600,2017
29143,41.3,18030,14433,2884,317,4900,33846,7309,4573,2736,7309,74500,2017
29145,39.4,58237,50367,530,2994,15734,46723,22151,15867,6284,22151,118200,2017
29147,29,22744,21106,594,365,4958,41370,8493,4761,3732,8493,117800,2017
29149,46.3,10779,10164,19,176,2905,32070,4375,3381,994,4375,87200,2017
29151,40.1,13610,13275,89,106,3615,54503,5108,4217,891,5108,140500,2017
29153,51.1,9328,8923,4,160,2698,32021,4075,3193,882,4075,91800,2017
29155,37.7,17344,11948,4639,421,4342,32468,6875,3631,3244,6875,73300,2017
29157,40.5,19135,18295,58,407,5339,54935,7529,5758,1771,7529,131900,2017
29159,37.9,42309,36084,1203,3626,10706,43097,16031,10780,5251,16031,111400,2017
29161,34.8,44873,39974,1125,1086,10747,41681,17330,10547,6783,17330,126100,2017
29163,39.2,18517,16359,1098,407,4431,45112,6741,4804,1937,6741,106500,2017
29165,38.2,96899,79450,6347,5601,25406,74199,38147,24870,13277,38147,204900,2017
29167,37.5,31347,29441,197,726,7963,44805,11717,7806,3911,11717,122600,2017
29169,27.6,53132,36969,6241,5770,10275,51137,15375,7404,7971,15375,141700,2017
29171,46.7,4846,4672,22,53,1349,37028,1956,1423,533,1956,84500,2017
29173,44.7,10208,9775,128,127,2922,50161,3994,3289,705,3994,126000,2017
29175,39.2,24987,22243,1424,491,5642,44754,8348,6298,2050,8348,93800,2017
29177,41.8,22859,21478,351,534,6088,57270,8684,6730,1954,8684,129700,2017
29179,46,6361,6003,116,89,1891,40265,2628,2062,566,2628,90300,2017
29181,42.5,13807,13160,32,177,3641,33849,5397,4143,1254,5397,87800,2017
29183,38,385115,337826,16344,12163,103589,78380,142554,114273,28281,142554,198500,2017
29185,50,9396,8880,80,98,2648,35066,4135,3111,1024,4135,78500,2017
29186,43,17882,17112,456,194,5130,50959,7185,5544,1641,7185,148800,2017
29187,39.2,66248,60963,2873,993,16017,42873,24661,16921,7740,24661,110200,2017
29189,40.3,999539,668690,236515,27784,258913,62931,402307,279767,122540,402307,181100,2017
29195,37.9,23010,18652,1080,2231,5668,41567,8754,6006,2748,8754,96700,2017
29197,40.6,4450,4328,37,32,1116,38848,1669,1208,461,1669,72500,2017
29199,37.2,4883,4762,82,14,1247,42939,1870,1336,534,1870,82000,2017
29201,40,38858,32491,4441,838,10468,41628,15241,10497,4744,15241,103300,2017
29203,44.8,8273,7795,7,150,2041,31202,3158,2264,894,3158,101400,2017
29205,41.9,6084,5832,121,104,1635,42593,2446,1806,640,2446,70300,2017
29207,42.1,29634,28344,451,488,7537,40076,11773,8158,3615,11773,91300,2017
29209,52.7,31529,29988,50,662,9111,43292,12880,10302,2578,12880,160600,2017
29211,41.5,6382,4946,115,1180,1413,42034,2283,1686,597,2283,77700,2017
29213,41.9,54308,48539,548,3019,15277,39661,22142,13177,8965,22142,124400,2017
29215,42.3,25714,23452,511,525,6196,35571,9303,6891,2412,9303,105800,2017
29217,40.7,20665,19454,219,426,5552,41479,8170,5580,2590,8170,97100,2017
29219,40.9,33554,30873,779,1080,8939,56193,12032,9595,2437,12032,166100,2017
29221,40.6,24968,23571,594,320,6469,37810,9048,7408,1640,9048,90400,2017
29223,46.9,13369,12738,81,217,3692,35135,5482,4204,1278,5482,72700,2017
29225,37.4,37558,35505,452,733,9790,45185,13311,9684,3627,13311,122500,2017
29227,47.5,2053,1986,6,24,629,48214,888,671,217,888,60600,2017
29229,42,18304,17445,108,313,5010,31290,7488,5111,2377,7488,89500,2017
29510,35.2,314867,135150,149456,12280,64617,38664,139741,60850,78891,139741,123800,2017
30001,43,9360,8548,6,390,2268,43880,3978,2623,1355,3978,192600,2017
30003,29.9,13290,3676,14,743,2947,47276,3710,2273,1437,3710,100000,2017
30005,34,6646,3068,16,166,1560,35506,2314,1366,948,2314,85800,2017
30007,46.3,5755,5432,4,152,1552,55295,2405,2020,385,2405,195000,2017
30009,50,10466,9906,24,250,2865,56988,4565,3608,957,4565,227400,2017
30011,51.6,1320,1290,0,4,368,45347,565,469,96,565,97900,2017
30013,38.4,81816,70201,1046,3461,21495,46827,34383,22559,11824,34383,168100,2017
30015,40.9,5812,4448,4,132,1569,39577,2290,1432,858,2290,123000,2017
30017,41,11895,10994,60,376,3197,53050,4875,3426,1449,4875,157000,2017
30019,45.5,1788,1728,0,50,494,53591,876,673,203,876,123500,2017
30021,41.9,9324,8637,48,280,2752,59622,4045,2808,1237,4045,154300,2017
30023,47.4,9131,8261,34,299,2317,41235,3984,2791,1193,3984,116700,2017
30025,38.1,2925,2745,42,52,795,56806,1241,840,401,1241,154200,2017
30027,45.7,11327,10694,16,249,3099,47110,4953,3466,1487,4953,133700,2017
30029,42.3,96147,89590,244,2524,24854,51410,38006,27350,10656,38006,246500,2017
30031,33.4,100733,93009,317,3339,23821,59397,40723,25089,15634,40723,303700,2017
30033,43.8,1086,1084,0,2,326,47188,451,365,86,451,116300,2017
30035,31,13677,4248,39,387,2548,29201,4181,2468,1713,4181,105000,2017
30037,54,747,640,0,65,224,43854,325,234,91,325,98300,2017
30039,53.1,3206,3032,4,69,808,49063,1309,948,361,1309,218900,2017
30041,34.4,16468,11561,43,573,4033,45269,6208,3872,2336,6208,128000,2017
30043,47.9,11625,10810,6,268,3215,64911,4512,3840,672,4512,264000,2017
30045,51.7,1965,1878,0,46,603,43281,925,662,263,925,138500,2017
30047,41.8,29518,19329,67,1261,7731,42582,11796,8466,3330,11796,224100,2017
30049,41.1,66290,60810,207,2042,17205,60789,27534,18925,8609,27534,220600,2017
30051,48.4,2245,2213,0,21,551,46641,859,525,334,859,108000,2017
30053,52.1,19249,17946,15,525,4910,36934,8244,6550,1694,8244,175500,2017
30055,49.1,1728,1534,0,56,487,46193,720,581,139,720,111900,2017
30057,53,7902,7409,20,265,2037,47900,3487,2683,804,3487,252200,2017
30059,43.9,2000,1869,0,82,473,41343,777,547,230,777,136300,2017
30061,52.1,4194,4049,7,53,947,40117,1694,1198,496,1694,159800,2017
30063,35.4,114231,102616,417,3533,26829,49412,47963,28234,19729,47963,259600,2017
30065,49.1,4766,4428,39,115,1330,38156,2073,1453,620,2073,161400,2017
30067,46.4,16001,15026,46,436,4252,44920,7552,5355,2197,7552,235600,2017
30069,51.7,453,446,0,0,127,46429,206,134,72,206,112000,2017
30071,46.4,4139,3509,0,97,1079,42101,1791,1275,516,1791,117800,2017
30073,40.5,6081,4953,25,117,1415,44597,2218,1603,615,2218,122100,2017
30075,51.4,1610,1500,0,40,490,51136,764,488,276,764,110900,2017
30077,45.6,6852,6168,43,142,1618,44352,2400,1661,739,2400,141000,2017
30079,51,1325,1307,0,17,363,50850,549,487,62,549,100700,2017
30081,48.5,41387,38562,41,1383,11232,44733,16936,12532,4404,16936,246600,2017
30083,38,11405,10197,0,594,2991,66572,4523,2832,1691,4523,213000,2017
30085,30.2,11218,4003,21,367,2088,39219,3203,1852,1351,3203,116400,2017
30087,36.5,9292,5226,8,443,2238,54709,3205,2312,893,3205,118600,2017
30089,52.7,11414,10307,16,306,3334,36445,4994,3785,1209,4994,205000,2017
30091,46.9,3568,3242,5,91,996,51940,1661,1261,400,1661,146500,2017
30093,39.9,34514,31408,185,1448,8287,40480,15256,10138,5118,15256,133800,2017
30095,46.5,9342,8721,20,330,2736,61998,3797,2953,844,3797,225200,2017
30097,50.1,3646,3422,5,57,1014,49761,1531,1142,389,1531,225900,2017
30099,44.5,6040,5690,14,90,1543,51060,2413,1682,731,2413,156600,2017
30101,41.9,5031,4429,4,174,1197,46735,1871,1086,785,1871,125200,2017
30103,49.2,790,747,0,19,266,42454,365,253,112,365,105500,2017
30105,44.4,7561,6417,7,185,2185,55267,3432,2533,899,3432,135600,2017
30107,39.4,2108,1989,0,60,480,37222,820,529,291,820,89300,2017
30109,49.4,1121,1078,0,41,352,47132,497,394,103,497,110100,2017
30111,38.3,156332,135960,901,8359,40256,57955,64020,43537,20483,64020,210500,2017
31001,37.9,31564,27440,192,2972,7823,51721,12659,8645,4014,12659,115300,2017
31003,45.9,6406,6108,16,204,1920,46949,2748,2118,630,2748,78500,2017
31005,43.3,421,411,0,0,96,41250,177,112,65,177,101500,2017
31007,48.1,728,651,4,57,237,55000,300,205,95,300,137200,2017
31009,46.8,502,492,0,0,151,52000,232,141,91,232,85900,2017
31011,45,5357,5178,26,106,1508,53854,2277,1773,504,2277,105600,2017
31013,40.5,11200,9212,67,1354,3062,56328,4610,3305,1305,4610,105400,2017
31015,52.1,2049,1947,10,15,600,48750,905,740,165,905,63800,2017
31017,48.9,3058,2952,1,37,915,42773,1475,1075,400,1475,80200,2017
31019,32.9,48834,42678,534,4231,11693,55053,18923,11931,6992,18923,161200,2017
31021,46.6,6546,6124,41,178,1931,50174,2885,2187,698,2885,91600,2017
31023,43.5,8105,7702,43,246,2268,52448,3400,2718,682,3400,111500,2017
31025,41.9,25513,23994,81,787,6907,68284,9894,8093,1801,9894,166200,2017
31027,44.1,8561,8304,2,146,2382,57208,3508,2830,678,3508,113600,2017
31029,44.4,3803,3382,2,399,1098,54568,1671,1345,326,1671,109900,2017
31031,43.8,5792,5128,2,182,1725,53226,2652,1639,1013,2652,119800,2017
31033,40.7,10012,9001,41,669,2562,58770,4400,3109,1291,4400,114100,2017
31035,43.5,6264,5588,27,555,1770,54167,2616,2021,595,2616,85000,2017
31037,33.7,10616,5427,292,4754,2553,54876,3681,2519,1162,3681,94300,2017
31039,44,9039,7998,10,894,2485,50734,3790,2580,1210,3790,113200,2017
31041,43.5,10836,10295,86,315,3177,48836,4792,3447,1345,4792,92800,2017
31043,33.8,20529,10219,885,7889,5605,52401,7427,4891,2536,7427,116400,2017
31045,34,8972,7650,83,430,2140,46146,3557,2222,1335,3557,107500,2017
31047,35.8,23925,14366,1360,7927,6411,51238,8898,5947,2951,8898,101000,2017
31049,46.1,1901,1701,1,148,549,53438,833,626,207,833,76300,2017
31051,42.2,5765,4932,17,726,1606,57036,2307,1853,454,2307,87600,2017
31053,39.1,36576,31051,265,4300,9963,51748,15090,9647,5443,15090,119600,2017
31055,34.3,549706,386002,60164,67246,132033,58640,213689,130582,83107,213689,155100,2017
31057,43.6,2017,1710,3,295,546,44653,875,595,280,875,73900,2017
31059,47.5,5603,5266,32,216,1558,56750,2443,1831,612,2443,76100,2017
31061,50.7,3019,2903,14,62,905,49453,1367,1142,225,1367,62000,2017
31063,45.5,2624,2530,1,37,758,52090,1113,854,259,1113,98200,2017
31065,46.1,4814,4537,16,177,1287,43400,2172,1559,613,2172,65300,2017
31067,44.2,21632,20540,135,490,5926,52223,9255,6338,2917,9255,108800,2017
31069,51.7,1913,1803,3,74,544,48125,897,721,176,897,81800,2017
31071,51.4,1958,1892,4,41,600,46509,893,702,191,893,96100,2017
31073,49.5,2019,1943,0,41,605,61769,885,616,269,885,116300,2017
31075,48.6,682,656,6,13,192,45833,274,223,51,274,55300,2017
31077,45.9,2436,2344,15,49,671,47218,1015,817,198,1015,69400,2017
31079,35.8,61233,41644,1337,16384,15498,53807,22817,14078,8739,22817,136500,2017
31081,42.3,9149,8708,66,290,2727,61944,3722,3027,695,3722,136200,2017
31083,49.5,3469,3267,32,129,946,46750,1590,1226,364,1590,83200,2017
31085,42.7,957,898,0,56,296,44946,423,283,140,423,77500,2017
31087,47.1,2860,2828,3,22,753,41582,1273,936,337,1273,58400,2017
31089,44.1,10293,9676,15,440,2950,52050,4569,3288,1281,4569,102900,2017
31091,58,684,658,6,20,201,41607,316,236,80,316,85800,2017
31093,43.3,6385,6107,3,161,1754,53648,2656,2039,617,2656,119600,2017
31095,45.7,7276,6857,1,259,2005,46576,3308,2430,878,3308,75500,2017
31097,41.1,5200,4201,351,516,1255,49564,1869,1382,487,1869,82200,2017
31099,40.6,6547,6071,8,380,1741,53207,2745,1906,839,2745,128600,2017
31101,49.7,8129,7355,57,549,2503,45078,3989,2692,1297,3989,108400,2017
31103,50.2,720,704,1,8,228,48864,334,242,92,334,72000,2017
31105,46,3688,3251,5,324,1014,43017,1546,1031,515,1546,83200,2017
31107,47.2,8496,7327,20,219,2394,48072,3662,2691,971,3662,85100,2017
31109,33.2,306357,251487,11909,20625,72986,55747,120962,72645,48317,120962,162900,2017
31111,40.4,35569,31458,316,2934,9809,55875,15025,9654,5371,15025,130800,2017
31113,38.9,919,863,6,27,258,50278,366,253,113,366,110900,2017
31115,52.8,537,535,0,0,186,58625,245,200,45,245,159100,2017
31117,48.5,432,418,0,4,137,60714,192,128,64,192,137500,2017
31119,36.9,35062,28289,474,5097,9205,49865,14236,9313,4923,14236,126100,2017
31121,43.5,7829,7277,47,322,2163,53536,3251,2431,820,3251,90900,2017
31123,42.9,4903,4023,41,755,1248,44201,2017,1439,578,2017,87400,2017
31125,45.4,3569,3459,3,90,977,45428,1553,1219,334,1553,80400,2017
31127,38,7041,6640,99,183,1883,55536,2814,2023,791,2814,114600,2017
31129,49.4,4318,4125,11,112,1252,42055,1985,1500,485,1985,62300,2017
31131,41.7,15875,14207,34,1207,4302,54605,6439,4665,1774,6439,130700,2017
31133,50.1,2704,2580,0,49,789,42176,1238,994,244,1238,71100,2017
31135,43.3,2904,2772,4,111,845,58125,1247,983,264,1247,105600,2017
31137,42.1,9163,8491,13,499,2446,56408,3870,2726,1144,3870,120000,2017
31139,41.7,7175,6938,25,115,2018,55417,2985,2406,579,2985,102600,2017
31141,38.3,32875,26293,144,5784,8473,58679,12937,9207,3730,12937,136600,2017
31143,45.5,5244,4872,4,251,1468,63667,2038,1637,401,2038,100200,2017
31145,40.8,10870,10022,125,538,2789,42882,4598,3453,1145,4598,91500,2017
31147,47.6,8045,7439,17,154,2365,46839,3798,2938,860,3798,69300,2017
31149,51.9,1381,1348,4,13,409,52361,655,498,157,655,83700,2017
31151,36,14325,10132,105,3484,3438,50932,5073,3463,1610,5073,95000,2017
31153,34.2,175188,143350,6401,15294,46789,75752,63851,44463,19388,63851,173900,2017
31155,41,20953,20034,63,442,5658,65015,8150,6445,1705,8150,159400,2017
31157,39.5,36509,26517,225,8545,9395,47975,14425,9933,4492,14425,116600,2017
31159,38.3,17045,16196,83,422,4440,63095,6496,4605,1891,6496,159700,2017
31161,46.1,5241,4294,28,245,1432,41209,2306,1622,684,2306,70900,2017
31163,49.3,3048,2960,0,62,878,48704,1378,1124,254,1378,85400,2017
31165,51.6,1256,1130,5,48,378,45375,579,438,141,579,103200,2017
31167,41,6020,5552,77,318,1789,57534,2351,1960,391,2351,111900,2017
31169,48.2,5133,4903,13,117,1499,48151,2337,1814,523,2337,67500,2017
31171,42.1,643,626,0,4,190,53173,293,204,89,293,82300,2017
31173,28.1,7055,2592,16,361,1563,44701,2142,1284,858,2142,79100,2017
31175,46,4252,4069,17,119,1362,50270,1934,1385,549,1934,92700,2017
31177,41.2,20414,19339,194,576,5918,66485,8133,6223,1910,8133,182400,2017
31179,31.7,9409,8486,196,522,2353,58093,3602,2289,1313,3602,133000,2017
31181,46.1,3597,3313,8,168,915,43831,1499,1201,298,1499,75600,2017
31183,50.2,846,837,0,6,245,49706,378,265,113,378,104300,2017
31185,40.9,13832,12571,167,678,3664,59966,5623,3973,1650,5623,128400,2017
32001,38.9,24022,17746,585,3214,6225,46914,9734,6261,3473,9734,169100,2017
32003,36.9,2112436,931891,228127,648211,480487,54882,749858,395201,354657,749858,212300,2017
32005,50.8,47632,38648,278,5846,14272,61176,20376,14143,6233,20376,311400,2017
32007,34.1,52377,35183,442,12689,12769,76178,17882,12627,5255,17882,198100,2017
32009,48,1102,882,8,172,234,39405,494,269,225,494,73500,2017
32011,47.3,1728,1671,1,27,478,67159,765,528,237,765,83100,2017
32013,35.6,17088,11252,110,4520,4055,69324,6261,4812,1449,6261,163500,2017
32015,37.8,5887,3991,3,1577,1536,79865,2183,1776,407,2183,151900,2017
32017,41.6,5203,4356,135,453,1277,52971,1930,1336,594,1930,132900,2017
32019,43.8,52303,39790,485,8486,13324,50920,20127,14248,5879,20127,158000,2017
32021,46.7,4471,2598,34,495,1063,39375,1859,1210,649,1859,90900,2017
32023,51.6,43296,33425,1306,6139,11010,44225,18077,12529,5548,18077,125100,2017
32027,43.1,6661,4404,311,1586,1314,52308,2018,1415,603,2018,101100,2017
32029,54.7,3891,3375,28,261,1021,63607,1665,1380,285,1665,187100,2017
32031,38,445551,283988,9514,106453,106982,58595,173519,100137,73382,173519,268100,2017
32033,39.4,9858,7168,462,1511,2066,60358,3343,2551,792,3343,130600,2017
32510,43,54219,36904,853,12665,13336,49341,22158,12191,9967,22158,217400,2017
33001,46.7,60383,57523,285,951,16319,65834,24579,18619,5960,24579,220400,2017
33003,51.4,47524,45668,233,649,14061,58139,21203,16870,4333,21203,227600,2017
33005,42.5,76109,71930,506,1302,19198,60148,30529,21453,9076,30529,188700,2017
33007,48,32119,30058,739,549,8725,45386,13879,9882,3997,13879,123200,2017
33009,42.9,89280,81439,901,1984,21412,61036,34856,23802,11054,34856,215600,2017
33011,40.5,406371,348156,8555,25429,106062,75777,158139,104138,54001,158139,256300,2017
33013,42.8,147958,137801,1740,2936,38156,69856,57247,40616,16631,57247,226700,2017
33015,44.1,302479,281776,1983,8054,83861,85619,119955,92025,27930,119955,295900,2017
33017,37,126552,115654,1041,2792,31265,67805,48543,31845,16698,48543,220900,2017
33019,46.1,43073,41105,184,620,11599,59419,17780,13054,4726,17780,171100,2017
34001,41.1,272926,153899,38978,50510,67179,57514,100660,67845,32815,100660,219000,2017
34003,41.6,937920,542226,49842,176933,244327,91572,337819,218066,119753,337819,451200,2017
34005,41.4,449192,306647,70545,34356,115238,82839,164404,125557,38847,164404,245300,2017
34007,38.5,510996,293604,92554,82396,125854,65037,187012,125008,62004,187012,193500,2017
34009,48.7,94549,80953,4230,6954,25963,62332,39861,30900,8961,39861,295500,2017
34011,36.8,154952,73427,27464,45966,34759,50000,50596,32245,18351,50596,160500,2017
34013,37.3,800401,249087,310404,179661,181847,57365,280327,124852,155475,280327,362300,2017
34015,39.9,291372,230567,28834,16799,74980,81489,104810,83431,21379,104810,213800,2017
34017,34.9,679756,195557,73309,293465,156467,62681,252352,79116,173236,252352,349500,2017
34019,45.9,125717,108455,3135,7801,34274,110969,46822,39185,7637,46822,393800,2017
34021,38.6,373362,189649,73583,63157,87992,77027,129546,83188,46358,129546,281900,2017
34023,38.1,837288,371039,77992,170601,207105,83133,283794,180484,103310,283794,329000,2017
34025,42.8,627551,473037,42037,66481,161387,91807,232482,171560,60922,232482,396200,2017
34027,42.3,498847,359215,15142,64875,129765,107034,180124,135197,44927,180124,438100,2017
34029,42.9,589699,500671,16278,53261,149402,65771,223135,178570,44565,223135,267900,2017
34031,36.7,510563,214683,54255,206937,118717,63339,162440,86901,75539,162440,333200,2017
34033,41.9,63776,47874,8358,5276,16004,63934,24038,17153,6885,24038,185800,2017
34035,41.3,333316,192408,30152,47897,84124,106046,115970,88188,27782,115970,412800,2017
34037,44.1,143570,125183,2829,10778,38714,89238,53618,44342,9276,53618,264100,2017
34039,38.3,557320,226675,111889,171189,134815,73376,187916,110762,77154,187916,351800,2017
34041,43.5,107088,88750,4537,9227,28366,75500,41385,29523,11862,41385,256700,2017
35001,37.1,674855,266372,16914,334067,159035,50386,263551,165608,97943,263551,189700,2017
35003,60.2,3547,2953,9,559,866,42047,1433,1331,102,1433,164600,2017
35005,35.3,65454,26416,1008,36365,16125,42177,23343,15870,7473,23343,106400,2017
35006,36.4,27049,5412,271,10269,6142,36089,9068,6450,2618,9068,89800,2017
35007,48.8,12522,5906,70,6159,3185,33042,5591,3768,1823,5591,105900,2017
35009,30.8,50283,24704,2774,20602,12116,41941,18470,10664,7806,18470,131200,2017
35011,42.6,2016,1053,30,928,376,31439,666,443,223,666,67700,2017
35013,32.9,213849,59835,3413,144782,52433,39114,76740,48139,28601,76740,140700,2017
35015,35.9,56793,27545,802,26982,15027,60703,21273,15012,6261,21273,143100,2017
35017,45.9,28382,13184,192,14190,7255,40470,11879,8585,3294,11879,125300,2017
35019,41.7,4426,669,57,3633,603,26060,1253,833,420,1253,81100,2017
35021,58.4,546,340,0,204,115,35096,203,149,54,203,67800,2017
35023,42.6,4446,1814,30,2576,1163,31829,1761,1282,479,1761,81200,2017
35025,31.7,69505,25828,2517,39501,16410,59285,22029,14999,7030,22029,118500,2017
35027,50.9,19497,12354,110,6224,4999,42145,7902,6190,1712,7902,171900,2017
35028,43,18031,13143,55,3110,4969,110190,7525,5543,1982,7525,285300,2017
35029,39,24319,7529,299,16031,5349,27602,9088,5612,3476,9088,83800,2017
35031,31.6,72849,6620,369,10297,13710,30336,19764,14131,5633,19764,62800,2017
35033,47,4605,643,3,3639,828,26644,1513,1153,360,1513,109100,2017
35035,35.6,65130,32428,2015,24415,14997,43533,23657,15169,8488,23657,106300,2017
35037,46.1,8447,4260,133,3775,1592,26663,3085,2115,970,3085,72200,2017
35039,40.7,39455,5075,172,28175,7626,33422,12852,9848,3004,12852,167100,2017
35041,29.7,19313,10256,541,7917,4337,35928,7125,4358,2767,7125,114300,2017
35043,39.6,138815,61889,2553,52572,34569,60345,49265,39815,9450,49265,183300,2017
35045,34.6,128221,50290,653,25468,29653,49686,41999,30647,11352,41999,143300,2017
35047,42.9,28203,5107,280,21879,5693,29168,11041,7770,3271,11041,132900,2017
35049,45.3,147514,63298,944,75514,36733,57945,61651,43346,18305,61651,277700,2017
35051,55.9,11254,7399,62,3367,2784,29690,5400,4019,1381,5400,99600,2017
35053,40,17098,6002,12,8497,2528,34008,4698,3573,1125,4698,103000,2017
35055,47.7,32809,11616,66,18624,7221,35314,12603,9366,3237,12603,218400,2017
35057,44,15534,8116,268,6537,3498,35543,5598,4487,1111,5598,111700,2017
35059,40.2,4216,2192,55,1740,817,38240,1424,937,487,1424,89500,2017
35061,39,75845,25480,610,45505,18781,43428,26985,21718,5267,26985,133100,2017
36001,37.8,308580,225210,35996,17534,68180,62293,125376,71274,54102,125376,214400,2017
36003,38.6,47400,44785,652,732,11808,45359,18124,13463,4661,18124,73300,2017
36005,33.6,1455846,137674,427414,810549,326296,36593,495356,97658,397698,495356,371800,2017
36007,39.6,196124,164841,9933,7819,46737,49064,78821,51769,27052,78821,113100,2017
36009,41.7,78175,70996,1277,1576,19976,45571,31723,22617,9106,31723,86500,2017
36011,42.5,78319,70857,3054,2186,19844,54664,31428,22255,9173,31428,120000,2017
36013,42.3,130846,114862,3109,9427,32986,44304,52983,37098,15885,52983,85800,2017
36015,41.2,86883,75170,5018,2580,21665,51251,34664,23609,11055,34664,105500,2017
36017,44.4,48763,46262,418,1048,12717,48567,20373,15265,5108,20373,95900,2017
36019,39.4,81224,73034,3293,2277,20084,52759,31680,21542,10138,31680,129000,2017
36021,47.4,61481,53427,2618,2785,16008,61093,25470,18429,7041,25470,224600,2017
36023,36.2,48334,44820,800,1266,11002,52451,17925,11598,6327,17925,113900,2017
36025,47,45950,42498,782,1692,11766,47921,19098,14008,5090,19098,138000,2017
36027,41.8,295685,213506,28360,34662,72096,75585,107384,74264,33120,107384,275200,2017
36029,40.3,923995,701817,120267,48102,229623,54006,386371,251212,135159,386371,139900,2017
36031,46.7,38233,35087,1121,1227,9904,55294,15257,11600,3657,15257,146900,2017
36033,40.5,51054,41720,2971,1740,12092,50733,18956,13820,5136,18956,102200,2017
36035,43.4,53955,50273,974,1528,14438,48033,22535,16085,6450,22535,107600,2017
36037,43.2,58537,53120,1382,1818,15546,54033,23951,17369,6582,23951,111900,2017
36039,45.6,47791,40928,2874,2652,10591,53214,17106,12960,4146,17106,176100,2017
36041,53.7,4646,4438,36,69,723,55587,1095,927,168,1095,164000,2017
36043,43.7,62943,59667,651,1296,16193,49077,25187,18053,7134,25187,95800,2017
36045,31.9,116567,95658,6389,8465,29204,50322,43206,24012,19194,43206,149300,2017
36047,34.8,2635121,947519,805388,508365,585611,52782,944650,283752,660898,944650,623900,2017
36049,41.8,26845,25729,197,454,7183,51475,10236,7987,2249,10236,121700,2017
36051,40.4,64373,58548,1589,2212,15435,53654,24432,17888,6544,24432,125000,2017
36053,41.3,71760,67006,1290,1513,16869,58365,26307,19985,6322,26307,132800,2017
36055,38.6,748680,531332,108330,62493,182129,55272,300496,191781,108715,300496,142300,2017
36057,41.1,49500,40863,618,6510,12501,47449,19700,13565,6135,19700,99900,2017
36059,41.5,1363069,836384,150103,224195,340148,105744,444136,357982,86154,444136,460700,2017
36061,37.1,1653877,773377,206945,431249,320700,79781,758345,182453,575892,758345,915300,2017
36063,43,212675,182905,15152,5795,54627,51656,87978,62888,25090,87978,114800,2017
36065,41,232324,191852,13586,12527,56466,51316,90472,60271,30201,90472,120000,2017
36067,38.8,467669,360803,50207,21813,113541,57271,185840,120606,65234,185840,139400,2017
36069,43.4,109491,98850,2480,4857,28546,61710,44269,32389,11880,44269,156500,2017
36071,36.9,378174,247267,36590,74643,89112,75146,126460,86449,40011,126460,260300,2017
36073,42.8,41584,35981,2438,1971,10763,49223,16214,12166,4048,16214,93600,2017
36075,39.8,119833,113001,1002,2959,30730,51755,45881,33302,12579,45881,97800,2017
36077,42,60750,55584,1047,2146,15005,51254,23627,17553,6074,23627,141900,2017
36079,43.8,99464,79747,2204,13684,25824,99608,34316,28101,6215,34316,357700,2017
36081,38.3,2339280,593073,401543,654793,525106,62008,777904,346041,431863,777904,481300,2017
36083,39.9,159800,134012,9410,7394,39265,63166,64456,40878,23578,64456,183400,2017
36085,39.9,475948,295516,44600,86540,123292,76244,166150,115428,50722,166150,460200,2017
36087,36.2,325027,205500,37408,56251,74710,88571,99935,68822,31113,99935,425100,2017
36089,38,110817,102050,2471,2529,26325,48330,41638,30189,11449,41638,88000,2017
36091,42.3,226632,206071,3446,6752,61132,77548,93129,66624,26505,93129,243600,2017
36093,39.8,155239,114630,14923,10363,32886,61315,53825,36519,17306,53825,164100,2017
36095,44.1,31611,29572,467,956,7928,51842,12539,9471,3068,12539,143300,2017
36097,45.7,18112,17252,190,319,4768,47810,7444,5688,1756,7444,114700,2017
36099,42.2,34843,31132,1615,1139,8396,51601,13536,9912,3624,13536,98400,2017
36101,42.4,97539,91505,1550,1552,26077,50157,40351,28956,11395,40351,95300,2017
36103,41,1497595,1025705,108361,278954,359870,92838,489328,393065,96263,489328,379400,2017
36105,42.6,75783,54910,5826,11697,17467,53877,27679,18521,9158,27679,167900,2017
36107,44,49322,47002,281,879,13510,57153,19996,15422,4574,19996,113000,2017
36109,30.4,104415,80749,3725,5025,20429,56200,38986,21630,17356,38986,190100,2017
36111,43.6,180129,143781,9317,17714,43393,61652,69662,48343,21319,69662,221600,2017
36113,46.2,64701,60929,732,1529,16606,60222,27249,19605,7644,27249,192800,2017
36115,43.6,62183,57555,1792,1623,16195,52527,23988,17431,6557,23988,144900,2017
36117,43.6,91442,82523,2671,3851,24455,53693,36578,28109,8469,36578,118900,2017
36119,40.6,975321,530156,131769,234081,239896,89968,345885,212731,133154,345885,513300,2017
36121,41.8,40886,36737,1968,1339,10400,55459,15686,11897,3789,15686,108500,2017
36123,41.7,25083,23805,249,542,6255,51758,9338,7196,2142,9338,128900,2017
37001,39.7,157844,102558,29769,19453,41479,44281,63035,41213,21822,63035,145500,2017
37003,42.8,37159,32335,2178,1712,9706,44523,13744,10382,3362,13744,131800,2017
37005,49.2,10935,9549,266,1033,3429,38944,4742,3558,1184,4742,136000,2017
37007,40.4,25531,11463,12417,962,6166,38123,9647,6267,3380,9647,83700,2017
37009,47.2,26833,24810,210,1387,8450,40293,11995,8883,3112,11995,150300,2017
37011,44.5,17535,15605,728,895,4454,37109,6725,5176,1549,6725,138800,2017
37013,45.4,47316,31150,12102,3575,12456,41101,18978,13439,5539,18978,123600,2017
37015,45,19913,6834,12275,415,4913,31287,7988,5882,2106,7988,78900,2017
37017,42.8,34130,18504,11743,2576,9416,32396,14394,9913,4481,14394,89500,2017
37019,51.9,122586,100035,12875,5816,36616,51164,53104,40983,12121,53104,194700,2017
37021,41.9,252268,211110,15415,16254,61216,48464,105407,67120,38287,105407,209800,2017
37023,43.6,88898,73190,5265,5223,23058,40854,34568,24733,9835,34568,115400,2017
37025,37.9,196716,133776,32817,19669,51648,60716,70598,50009,20589,70598,180300,2017
37027,44.1,81805,71921,3980,4162,22292,40735,32150,23032,9118,32150,112400,2017
37029,40.8,10336,8306,1475,278,3106,68327,3796,3042,754,3796,222500,2017
37031,47.4,68699,59330,3882,2896,19282,51584,30000,21801,8199,30000,197700,2017
37033,45.4,22833,13961,7538,857,6369,39428,9160,6998,2162,9160,104700,2017
37035,41.2,156182,118877,12341,14564,41348,48649,60238,41741,18497,60238,139900,2017
37037,46.3,68364,48818,7970,8583,19413,59684,28148,21452,6696,28148,251600,2017
37039,50.8,27463,25125,377,813,7549,38115,11206,8965,2241,11206,145500,2017
37041,44.7,14370,8577,4850,521,4093,41979,5903,4310,1593,5903,128300,2017
37043,50.7,10753,10211,177,351,3323,37070,5049,3924,1125,5049,154600,2017
37045,41.7,97038,71232,20073,3216,25459,40002,37782,25455,12327,37782,110500,2017
37047,41.9,56589,33685,17208,2890,14705,36261,22462,15921,6541,22462,85200,2017
37049,36.2,103374,68269,21729,7366,27587,49391,40571,25669,14902,40571,156500,2017
37051,31,332766,148550,117984,37331,78900,44737,124500,63533,60967,124500,131200,2017
37053,42.9,25247,22094,1345,919,7211,65758,9766,8055,1711,9766,244500,2017
37055,46,35412,31005,643,2521,10171,55640,15264,10598,4666,15264,285000,2017
37057,42.1,164118,132614,14854,11280,45206,45806,64727,46332,18395,64727,134800,2017
37059,44.6,41766,35461,2554,2727,11340,53493,15895,12323,3572,15895,170000,2017
37061,40,59350,30743,14570,12901,14812,36679,21669,15099,6570,21669,88800,2017
37063,35,300865,126557,110911,40484,69980,56393,120936,64668,56268,120936,195900,2017
37065,40.3,54032,19732,30911,2338,14451,32929,21431,12674,8757,21431,84000,2017
37067,38.2,368362,211211,94503,46309,91413,48369,145102,90625,54477,145102,151400,2017
37069,40.9,63866,40528,16245,5164,17558,48344,24287,17744,6543,24287,140300,2017
37071,40.1,214049,157510,33189,14175,54107,46626,80682,52730,27952,80682,130700,2017
37073,45,11601,7254,3820,82,3123,52481,4439,3569,870,4439,142500,2017
37075,45,8607,7519,14,98,2254,36030,3303,2702,601,3303,124800,2017
37077,42.5,58503,34076,17881,4451,14863,52089,20945,15367,5578,20945,146100,2017
37079,40.4,21059,9881,7452,3134,4965,36989,7348,5094,2254,7348,85700,2017
37081,37.2,517197,265946,172214,39987,126502,49253,200998,118412,82586,200998,160200,2017
37083,42.7,52300,20220,27511,1435,13842,33573,21207,13388,7819,21207,86500,2017
37085,33.9,128753,79933,26528,15796,32013,50323,44657,29075,15582,44657,144700,2017
37087,47.5,59854,55704,615,2238,17211,45538,26288,18861,7427,26288,175900,2017
37089,46.9,112156,93642,3518,11156,30915,50454,47804,34555,13249,47804,193200,2017
37091,42.4,24262,8140,13935,889,5667,35806,8880,5967,2913,8880,86800,2017
37093,31.9,52571,21312,17098,6745,12637,45713,17373,11637,5736,17373,137700,2017
37095,42.7,5507,3294,1690,462,1350,40532,1835,1400,435,1835,81000,2017
37097,40.4,169798,129802,20811,12496,45639,55957,63447,45690,17757,63447,173600,2017
37099,37.2,41725,33803,893,2291,9748,45078,16218,10565,5653,16218,177200,2017
37101,37.9,186308,127945,28065,24829,48504,54610,65401,46877,18524,65401,150700,2017
37103,45.5,9776,6080,2971,439,2853,37256,4148,3009,1139,4148,92700,2017
37105,37.9,59805,34786,11275,11539,15052,49272,21691,14600,7091,21691,138400,2017
37107,41.9,57934,28788,22415,4364,15286,37515,23263,13992,9271,23263,93500,2017
37109,42.7,80504,68647,3969,5659,22912,50782,31250,23896,7354,31250,158700,2017
37111,43.3,45069,39510,1724,2716,12928,38776,17970,12804,5166,17970,110400,2017
37113,49.3,34160,30573,434,2328,9993,40659,15513,11440,4073,15513,162000,2017
37115,44.2,21347,20053,394,532,5500,40563,8346,6229,2117,8346,172200,2017
37117,46,23227,12103,9711,865,6422,35969,9624,6630,2994,9624,83100,2017
37119,34.9,1034290,495078,318010,132949,244302,61695,395503,224217,171286,395503,203900,2017
37121,47.1,15155,14051,46,757,4137,42534,6390,5079,1311,6390,140600,2017
37123,42.8,27445,17367,5110,4217,7241,38254,10855,7597,3258,10855,105900,2017
37125,44.7,94191,72695,11778,6040,25041,54468,38185,28402,9783,38185,207300,2017
37127,41.4,94125,47943,36893,6311,24318,46187,36878,24072,12806,36878,123100,2017
37129,38.7,219866,169063,30727,11879,52447,51457,91673,52611,39062,91673,225600,2017
37131,48.6,20426,7876,11622,433,5756,33508,8819,6106,2713,8819,81900,2017
37133,26,192685,128724,26342,23474,45009,48162,63093,33135,29958,63093,154400,2017
37135,34.2,141812,98474,16179,11811,31886,65522,52160,32250,19910,52160,283000,2017
37137,51,12803,9508,2331,462,3705,45211,5395,4040,1355,5395,150600,2017
37139,38.1,39546,21698,14310,1925,9813,47264,14629,8848,5781,14629,158900,2017
37141,42.6,57630,42945,9014,3895,13895,49357,21053,16658,4395,21053,167200,2017
37143,48.9,13506,9718,3161,340,4020,44039,5882,4280,1602,5882,165500,2017
37145,43,39240,26080,10553,1627,10665,44921,15772,11361,4411,15772,118500,2017
37147,32,176484,97236,60582,10671,41310,43526,68805,35957,32848,68805,138700,2017
37149,52.1,20434,17972,1042,1182,5681,48412,8913,6514,2399,8913,205500,2017
37151,41.5,142827,113899,8424,15796,38493,43598,55679,39823,15856,55679,119500,2017
37153,40.2,45447,26181,14126,2838,11903,33607,18371,12025,6346,18371,80000,2017
37155,35.9,134187,34477,32238,11438,31379,32407,46163,29859,16304,46163,72100,2017
37157,44.4,91566,66490,16920,5455,24476,41700,37162,25427,11735,37162,109600,2017
37159,40.1,138940,101045,22389,11553,35686,46978,51798,35274,16524,51798,130400,2017
37161,44.5,66523,55589,6668,2739,17276,38573,26497,18949,7548,26497,109000,2017
37163,40.2,63664,32872,15900,12013,15443,37765,23431,16302,7129,23431,87700,2017
37165,39.3,35445,15573,13697,1004,8933,32739,13273,8235,5038,13273,85200,2017
37167,42.4,60875,49402,6729,2440,16751,46017,23859,17293,6566,23859,133000,2017
37169,45.3,46124,42120,1826,1296,13366,44490,19273,14953,4320,19273,123900,2017
37171,43.4,72315,61034,2678,7354,20173,39071,29256,21363,7893,29256,120900,2017
37173,41.1,14208,8909,67,701,3466,35271,5464,3921,1543,5464,122300,2017
37175,50.6,33291,29762,1345,1060,9680,44559,14125,10726,3399,14125,202100,2017
37177,47.1,4090,2175,1451,310,1011,32411,1539,1163,376,1539,113100,2017
37179,38,222095,162137,25208,24278,58877,70858,73709,59339,14370,73709,215200,2017
37181,40.6,44420,18014,22124,3249,10717,35246,17029,9980,7049,17029,95500,2017
37183,35.8,1023811,620364,204690,102537,255026,73577,381971,244792,137179,381971,250700,2017
37185,47.2,20190,7738,10119,765,4920,35443,8157,5873,2284,8157,93900,2017
37187,43.5,12331,5535,5949,614,2980,34557,5223,3164,2059,5223,86000,2017
37189,30.6,53421,49106,819,1829,10920,41541,20331,11976,8355,20331,240700,2017
37191,37.3,124496,67352,37503,14009,31928,41766,47587,28964,18623,47587,117000,2017
37193,44.1,68525,60214,2820,4195,18924,37173,27765,20691,7074,27765,123700,2017
37195,40.4,81379,38490,32180,8196,21255,42095,32068,19391,12677,32068,119200,2017
37197,43.5,37825,31972,1268,4132,10744,41126,15521,11782,3739,15521,127300,2017
37199,46.8,17605,16335,149,871,5025,37610,7493,5496,1997,7493,139800,2017
38001,45.3,2368,2203,37,13,706,54700,1052,769,283,1052,144900,2017
38003,44.5,10971,10188,94,207,3053,56237,5113,3424,1689,5113,117200,2017
38005,30.7,6875,2838,0,62,1641,44500,2292,1439,853,2292,68900,2017
38007,44.4,983,928,9,40,291,91518,401,296,105,401,185300,2017
38009,45.2,6651,6119,55,144,1898,58767,3096,2345,751,3096,140500,2017
38011,42.2,3226,2987,4,165,930,65435,1432,1062,370,1432,149600,2017
38013,35.7,2253,2104,10,36,587,71667,950,707,243,950,115300,2017
38015,36.6,92372,83067,1560,2001,24134,67308,38901,26785,12116,38901,237000,2017
38017,32.2,170620,148543,7272,4190,40853,58026,73039,38149,34890,73039,198100,2017
38019,50.1,3817,3653,13,40,1116,65505,1787,1465,322,1787,95500,2017
38021,43.6,5041,4718,69,171,1428,58357,2192,1537,655,2192,110400,2017
38023,50.9,2378,2218,23,25,615,54223,1053,818,235,1053,150800,2017
38025,41.2,4349,3647,43,119,1149,68594,1601,1247,354,1601,168800,2017
38027,45.8,2321,2071,0,42,615,55294,1048,742,306,1048,74200,2017
38029,52.1,3389,3277,0,10,964,46581,1565,1322,243,1565,92200,2017
38031,46.4,3318,3183,5,44,1006,59500,1502,1116,386,1502,125600,2017
38033,42.4,1892,1776,0,32,426,44018,863,580,283,863,119900,2017
38035,29.5,70130,59602,2369,2796,16098,51410,29716,14592,15124,29716,181600,2017
38037,52.2,2387,2314,2,19,655,50875,1110,942,168,1110,79800,2017
38039,50.9,2276,2189,31,7,657,50272,1039,743,296,1039,91800,2017
38041,47.3,2601,2371,19,95,732,56118,1078,887,191,1078,108200,2017
38043,44.3,2457,2305,12,121,780,60225,1053,800,253,1053,104400,2017
38045,47.8,4106,3987,4,43,1180,57463,1811,1398,413,1811,91100,2017
38047,52.9,1932,1861,1,31,566,57379,879,749,130,879,79000,2017
38049,42.8,5951,5658,10,136,1671,61788,2663,2231,432,2663,116700,2017
38051,53.5,2680,2550,0,58,826,46012,1325,1039,286,1325,72300,2017
38053,30.8,11679,9104,65,821,2458,79316,3651,2131,1520,3651,213600,2017
38055,46.7,9607,8611,59,218,2865,63926,4313,3503,810,4313,159300,2017
38057,44.7,8637,8040,81,233,2584,80337,3649,3000,649,3649,166200,2017
38059,38.2,30059,27324,194,806,8190,65385,13246,9603,3643,13246,187600,2017
38061,34.2,9986,6280,109,695,2173,69622,3213,2238,975,3213,169800,2017
38063,52.5,2971,2874,0,75,858,52417,1492,1126,366,1492,78700,2017
38065,50.1,1822,1667,7,67,577,71500,788,686,102,788,171800,2017
38067,48.2,7050,6456,15,230,2051,61393,3218,2480,738,3218,85500,2017
38069,46.1,4272,4022,36,43,1135,45996,1995,1434,561,1995,110400,2017
38071,42.4,11574,9790,4,290,2820,55927,4931,2990,1941,4931,130400,2017
38073,44.4,5411,5140,38,86,1466,62524,2333,1628,705,2333,120600,2017
38075,39.3,2543,2343,13,137,664,66023,1011,802,209,1011,125900,2017
38077,37.8,16333,15016,76,446,4292,60551,6829,4849,1980,6829,116000,2017
38079,30.6,14657,2753,66,72,3236,36170,4740,3271,1469,4740,73700,2017
38081,46.3,3883,3620,38,115,1145,60824,1819,1353,466,1819,96400,2017
38083,52,1403,1368,0,12,440,49750,684,537,147,684,84900,2017
38085,26.9,4420,551,2,173,854,40795,1114,492,622,1114,76300,2017
38087,52,674,623,40,4,197,61250,309,246,63,309,89300,2017
38089,34.3,30316,26871,526,1533,7226,77328,11962,7950,4012,11962,228200,2017
38091,49.8,1915,1865,0,50,575,65437,916,775,141,916,72000,2017
38093,39.7,21058,19572,230,479,5253,56088,9199,5979,3220,9199,130900,2017
38095,49.4,2258,2042,0,36,657,54625,1033,813,220,1033,73000,2017
38097,41.4,8050,7460,79,273,2070,60952,3349,2463,886,3349,127200,2017
38099,44.6,10920,9271,38,1217,2993,50781,4838,3612,1226,4838,83700,2017
38101,31,69628,58563,2541,3929,16505,64159,27449,16371,11078,27449,211900,2017
38103,51.8,4089,3996,0,51,1224,54464,1988,1592,396,1988,84200,2017
38105,31.3,32916,27194,1115,2006,7972,89874,12895,7975,4920,12895,238900,2017
39001,42.2,27926,26982,124,267,7332,36320,10829,7405,3424,10829,98000,2017
39003,38.6,104157,84618,12231,2995,26509,47905,40319,26645,13674,40319,110900,2017
39005,40.4,53299,51161,418,671,13907,50893,20504,14890,5614,20504,122000,2017
39007,42.5,98622,88631,3378,3937,24991,43017,38381,26982,11399,38381,106300,2017
39009,28.6,65563,58834,1665,1211,12407,37191,22509,12783,9726,22509,116500,2017
39011,41.1,45778,43948,163,712,12790,59516,18342,13903,4439,18342,143100,2017
39013,44.2,68889,64047,2850,610,17575,46484,26910,20414,6496,26910,94800,2017
39015,41.6,43799,42321,371,384,12405,49188,17333,12880,4453,17333,118600,2017
39017,36.4,375702,308665,29253,16872,94185,62188,136416,93317,43099,136416,162300,2017
39019,45,27825,26822,257,351,7809,51748,10917,8739,2178,10917,116700,2017
39021,42.1,39005,36468,613,586,10752,54495,15274,11100,4174,15274,126700,2017
39023,41.2,135520,114419,10984,4300,35942,46275,54836,35995,18841,54836,107300,2017
39025,39.9,202166,189838,2887,3622,54336,64183,76143,56540,19603,76143,160600,2017
39027,39.8,41869,39108,889,664,11088,49997,16309,10617,5692,16309,123700,2017
39029,43.8,104584,98553,2249,1634,28511,45498,41582,30446,11136,41582,104300,2017
39031,41.4,36602,35164,396,361,9699,43251,14367,10812,3555,14367,95500,2017
39033,43,42231,40414,359,651,11580,41726,17833,12356,5477,17833,85600,2017
39035,40.4,1257401,750133,368171,70325,304670,46720,537621,316372,221249,537621,123900,2017
39037,41.8,51919,50029,407,762,14355,50064,20803,15073,5730,20803,113200,2017
39039,40,38311,33275,646,3694,10632,55295,15309,11663,3646,15309,112700,2017
39041,38.4,193024,166725,6529,4723,51699,100229,67701,54999,12702,67701,279800,2017
39043,44.6,75369,62984,6101,3147,19879,51033,31577,21850,9727,31577,132400,2017
39045,39.2,151526,132004,10685,3072,40142,63424,55549,39788,15761,55549,168500,2017
39047,41.1,28659,26612,567,566,8011,44289,11729,7284,4445,11729,108900,2017
39049,34,1253507,808258,271602,65494,291539,56319,496337,266046,230291,496337,158400,2017
39051,40.2,42296,37822,120,3571,12032,57774,16404,12671,3733,16404,134700,2017
39053,40.6,30203,28277,843,397,7873,42002,11520,8688,2832,11520,103200,2017
39055,44.4,93895,89908,1154,1279,26259,77104,35121,30129,4992,35121,228000,2017
39057,38.1,164825,138758,11175,4450,42558,65032,64702,43261,21441,64702,163500,2017
39059,42.4,39414,37346,481,441,10597,42744,16065,11505,4560,16065,103100,2017
39061,36.9,808703,533253,206653,24454,195770,52389,338267,195236,143031,338267,145800,2017
39063,38.9,75508,67671,1044,3894,19951,52831,32049,22201,9848,32049,132600,2017
39065,35.6,31576,30096,213,492,7588,46404,11430,8031,3399,11430,95400,2017
39067,46,15397,14660,309,138,4315,46223,6192,4897,1295,6192,88600,2017
39069,41.2,27463,24781,150,2048,7802,58070,11094,8697,2397,11094,116200,2017
39071,40.3,43031,41088,525,406,11117,42333,16731,11743,4988,16731,107800,2017
39073,42.7,28547,27573,295,166,7731,48073,11268,8412,2856,11268,118400,2017
39075,30.8,43808,42907,70,392,10207,58728,12520,9605,2915,12520,183800,2017
39077,39.2,58497,52999,757,3639,15692,49710,22876,15996,6880,22876,118800,2017
39079,40.2,32624,31369,249,331,8919,43397,12964,8883,4081,12964,93900,2017
39081,44.7,67349,60975,3736,903,17570,43161,27571,19037,8534,27571,88700,2017
39083,38.9,60945,58214,552,874,15253,51211,23229,16571,6658,23229,138900,2017
39085,43.5,229701,204657,8759,9302,61968,61137,95238,71096,24142,95238,150100,2017
39087,41.5,61057,57932,1179,565,15753,45466,23731,17036,6695,23731,101500,2017
39089,39.9,170678,155582,5952,2975,45132,59747,64434,46661,17773,64434,157800,2017
39091,41,45323,42454,740,659,12826,53051,18627,13754,4873,18627,127200,2017
39093,41.5,305405,240861,23670,29089,80152,54987,118594,84684,33910,118594,140300,2017
39095,37.9,433404,300571,81098,29559,107097,44820,178971,107321,71650,178971,109000,2017
39097,40.4,43732,38894,2529,812,10405,62897,14916,10637,4279,14916,156700,2017
39099,43.5,231857,177300,34194,12882,59900,43251,98035,67314,30721,98035,99300,2017
39101,40.8,65483,58085,3383,1638,16223,44708,24699,16884,7815,24699,93700,2017
39103,41.9,176362,166036,2604,3435,47971,71595,67192,53709,13483,67192,185800,2017
39105,42.8,23234,22494,270,146,6339,42105,9285,7251,2034,9285,87400,2017
39107,39.8,40723,39007,278,731,11319,57052,16142,12497,3645,16142,137900,2017
39109,41.5,104081,96634,2170,1625,27003,54568,40900,28515,12385,40900,138900,2017
39111,45.8,14239,14087,8,74,4222,43299,5984,4682,1302,5984,97400,2017
39113,39.3,531987,379728,109016,14451,135301,47045,223495,136713,86782,223495,112100,2017
39115,44.2,14773,13643,503,129,4288,40276,6116,4778,1338,6116,90500,2017
39117,41.8,34935,33575,260,490,9339,52767,12781,10522,2259,12781,139400,2017
39119,40.2,85933,78851,2638,881,22488,43325,34348,23107,11241,34348,112500,2017
39121,48.7,14498,13372,788,115,3394,42171,5012,4224,788,5012,91300,2017
39123,48.3,40769,37644,440,2006,11836,56193,17495,13686,3809,17495,145400,2017
39125,41.5,18951,17535,148,867,5242,49866,7589,5835,1754,7589,92500,2017
39127,39.9,35983,34861,119,289,10054,46477,13576,10004,3572,13576,102500,2017
39129,39.4,57075,53041,1823,769,14111,60314,19465,14374,5091,19465,152000,2017
39131,41,28291,27000,333,279,7500,43562,11033,7585,3448,11033,100100,2017
39133,37.8,162080,145941,6581,2744,39535,53816,62208,42710,19498,62208,152000,2017
39135,42.3,41328,39951,215,318,11447,52661,16126,12308,3818,16126,116900,2017
39137,39.6,34037,31430,144,2040,9812,61161,13159,10562,2597,13159,147200,2017
39139,41.4,121533,104284,9372,2151,30313,44138,47987,32498,15489,47987,103700,2017
39141,40.5,77125,69128,3954,906,20001,45792,28526,20075,8451,28526,114600,2017
39143,41.7,59559,50576,1632,5777,15737,50370,23721,16945,6776,23721,111900,2017
39145,39.8,76871,71838,2122,979,19022,38978,30204,20470,9734,30204,93000,2017
39147,39.5,55549,50177,1330,2719,14335,49153,21507,15534,5973,21507,98600,2017
39149,39.3,48902,45564,1384,729,13236,57673,18665,13209,5456,18665,137800,2017
39151,41.8,374273,324807,26499,7202,99828,50117,152037,103979,48058,152037,127100,2017
39153,40.8,541318,421165,77748,10574,138754,53291,223021,146403,76618,223021,137000,2017
39155,44,203341,177674,16600,3430,55323,45380,86709,61185,25524,86709,101600,2017
39157,40.9,92531,87899,731,2251,24502,49460,36548,25837,10711,36548,117100,2017
39159,38.3,54688,49456,1339,859,14200,78848,19038,14871,4167,19038,186000,2017
39161,41.4,28262,26669,339,856,8166,50974,11503,8604,2899,11503,99000,2017
39163,41.9,13142,12722,60,69,3433,41541,5053,3711,1342,5053,85700,2017
39165,39.1,223868,194949,7358,5778,60539,79397,80704,62593,18111,80704,200100,2017
39167,43.8,60871,58008,725,626,16559,46021,25378,18744,6634,25378,119400,2017
39169,38.7,115915,108910,1602,2152,30490,54037,43353,31629,11724,43353,140100,2017
39171,41.4,37061,34499,406,1545,9794,47593,15263,11666,3597,15263,94200,2017
39173,34.6,129504,114844,3472,6923,31468,58033,50187,32992,17195,50187,154700,2017
39175,41.3,22190,21142,72,608,6101,49767,9157,6617,2540,9157,110600,2017
40001,37.2,22136,9029,61,1407,5669,33366,7796,5438,2358,7796,81200,2017
40003,43.8,5877,4480,142,296,1369,57432,1978,1503,475,1978,74500,2017
40005,40.8,13899,9980,514,469,3646,37106,5284,3869,1415,5284,98400,2017
40007,40.5,5445,4162,4,1202,1562,52571,2103,1642,461,2103,106500,2017
40009,35.1,22971,17396,765,3272,5297,49625,7573,4971,2602,7573,117100,2017
40011,42.1,9680,7164,378,948,2501,46362,3819,2907,912,3819,83800,2017
40013,37.8,45068,32425,808,2543,10964,41197,16911,10658,6253,16911,98900,2017
40015,37.1,29437,16907,638,3563,6964,41626,10273,7232,3041,10273,81900,2017
40017,35.8,132922,102775,3138,10987,32379,69220,43878,33457,10421,43878,155400,2017
40019,38.1,48407,34255,3080,3306,12095,47754,18278,12649,5629,18278,109000,2017
40021,35,48404,23357,618,3322,10538,39187,16360,10874,5486,16360,111300,2017
40023,42.5,14979,9187,1702,600,3785,30298,5962,4091,1871,5962,88800,2017
40025,44.6,2221,1726,7,463,650,44667,990,722,268,990,57400,2017
40027,33.6,274024,199476,12598,22426,67723,60632,103028,66450,36578,103028,155500,2017
40029,41.8,5666,3939,9,250,1494,39931,2240,1610,630,2240,87800,2017
40031,32.6,123066,69916,20066,15608,27877,49569,42957,23051,19906,42957,125600,2017
40033,41.1,6000,4598,119,438,1617,49962,2265,1774,491,2265,77600,2017
40035,42.5,14563,9352,423,501,3669,40465,5413,3980,1433,5413,96100,2017
40037,40.3,70899,54421,1573,2758,18751,47147,26398,19555,6843,26398,112100,2017
40039,30.7,29169,20222,884,5095,7132,48520,10458,6204,4254,10458,127600,2017
40041,46.5,41878,26880,104,1526,11211,38234,16571,12598,3973,16571,110000,2017
40043,40.6,4904,4084,8,323,1193,52930,1727,1263,464,1727,86700,2017
40045,44.1,4102,3565,0,298,1059,50594,1625,1189,436,1625,83700,2017
40047,35.7,62421,47288,1892,7267,16225,50724,23798,15574,8224,23798,104000,2017
40049,39.2,27751,21189,643,2267,7052,42567,10473,7083,3390,10473,93400,2017
40051,38.6,54351,44567,1166,2997,14582,55527,19743,15270,4473,19743,117200,2017
40053,44,4458,3961,7,207,1247,54460,1883,1428,455,1883,76400,2017
40055,39.6,6018,4535,506,662,1307,35898,2152,1560,592,2152,65800,2017
40057,42.4,2758,1627,203,770,796,38264,1185,858,327,1185,49700,2017
40059,38.9,3843,2879,3,855,904,46915,1348,1086,262,1348,76300,2017
40061,40.3,12746,9071,92,530,3463,38017,4849,3619,1230,4849,87500,2017
40063,39.8,13519,8606,810,684,2928,38425,4258,3185,1073,4258,69400,2017
40065,34.2,25574,16210,1792,5962,6578,45189,9958,5710,4248,9958,97800,2017
40067,42.4,6270,4927,81,624,1566,35933,2392,1721,671,2392,59700,2017
40069,39.4,11039,7727,127,552,2833,38636,4256,3031,1225,4256,79500,2017
40071,38.6,45173,34067,895,3430,11215,44067,17890,12328,5562,17890,84100,2017
40073,36.6,15510,11986,166,2353,3959,62829,5691,4561,1130,5691,136200,2017
40075,43.1,9127,6840,296,1019,2461,38191,3839,2658,1181,3839,62500,2017
40077,40.8,10621,7025,114,360,2794,40539,4019,2737,1282,4019,81100,2017
40079,39.6,49860,35860,1125,3387,12977,39253,18354,13432,4922,18354,87200,2017
40081,41,34759,28785,631,1123,9091,47539,12923,10233,2690,12923,103400,2017
40083,37.8,45326,35247,3898,2598,11388,59133,15651,12439,3212,15651,153100,2017
40085,40,9843,7094,189,1468,2272,49409,3104,2434,670,3104,94600,2017
40087,38.3,37919,30206,398,2939,10438,62081,13838,10828,3010,13838,166400,2017
40089,39,33026,20850,2631,1878,8975,34250,12980,9050,3930,12980,78000,2017
40091,47,19874,13567,549,517,5623,38163,8349,6440,1909,8349,95300,2017
40093,41.7,7730,6611,25,714,2142,52056,3030,2358,672,3030,94000,2017
40095,43.2,16226,10766,256,2733,4320,45671,6241,4715,1526,6241,86600,2017
40097,40.3,40929,26770,204,1364,11169,45302,15730,11553,4177,15730,106700,2017
40099,42.2,13797,10102,230,827,3592,51844,5275,3574,1701,5275,107100,2017
40101,37.7,69471,39326,7443,4076,17528,41329,26097,17364,8733,26097,97700,2017
40103,41.5,11421,9353,97,398,3347,52372,4598,3376,1222,4598,94800,2017
40105,42.3,10448,7006,234,300,2846,41282,4064,3078,986,4064,81600,2017
40107,40,12160,7491,928,469,2767,38346,3987,2904,1083,3987,79100,2017
40109,34.4,774203,440041,114524,130090,184349,50762,296818,174898,121920,296818,142700,2017
40111,39.2,39121,24557,3344,1491,9548,39567,14852,10494,4358,14852,80300,2017
40113,42,47350,30177,5354,1616,12709,47683,18314,14119,4195,18314,110100,2017
40115,38.2,31725,20796,310,1716,8152,38472,12020,8245,3775,12020,84300,2017
40117,41.7,16448,12700,170,468,4496,46460,6211,4717,1494,6211,87500,2017
40119,27.2,80634,62363,3151,3699,16569,39149,30404,15050,15354,30404,147400,2017
40121,41,44673,31272,1408,2124,11758,44941,17828,12969,4859,17828,98400,2017
40123,35.5,38289,25384,796,1944,9459,46689,14512,9291,5221,14512,120300,2017
40125,37.6,71614,52257,2236,3527,17926,46159,25925,17840,8085,25925,108400,2017
40127,44.6,11132,8027,93,386,2937,35414,4550,3357,1193,4550,73400,2017
40129,41,3734,3145,5,255,880,51286,1350,968,382,1350,106100,2017
40131,38.7,90098,65224,922,3980,25556,61320,34109,26653,7456,34109,150900,2017
40133,39.2,25246,16439,1206,1207,6254,37741,9240,6475,2765,9240,71200,2017
40135,40.7,41364,26274,775,1621,11262,37455,15412,10967,4445,15412,92500,2017
40137,40.5,44293,35811,794,3208,11595,44805,17252,12320,4932,17252,104000,2017
40139,32.5,21409,9764,826,9649,4650,49469,6989,4529,2460,6989,109300,2017
40141,40.9,7591,4599,601,1956,2042,40728,3012,2317,695,3012,54100,2017
40143,35.4,637123,401597,62741,77359,158414,52017,250071,147675,102396,250071,145800,2017
40145,38.5,76830,55416,2640,4375,21171,59210,28309,22424,5885,28309,150400,2017
40147,40.1,51867,38159,1309,2971,13896,50388,20688,14454,6234,20688,112600,2017
40149,38.6,11550,9691,15,1113,3191,51909,4484,3269,1215,4484,80200,2017
40151,33.8,9132,7636,221,618,2084,57097,3413,2288,1125,3413,93100,2017
40153,36,21140,17046,176,2575,5264,57602,7366,5273,2093,7366,123000,2017
41001,47.9,15980,14561,150,631,4427,43765,7033,4806,2227,7033,145600,2017
41003,32.8,88249,71745,870,6307,19450,54682,34775,19787,14988,34775,288700,2017
41005,41.4,399962,330964,3538,33558,105356,72408,153822,107039,46783,153822,341600,2017
41007,44.1,38021,32710,282,3159,9683,49828,15976,9756,6220,15976,253900,2017
41009,43.3,50207,44725,242,2434,12952,57449,19213,14020,5193,19213,223300,2017
41011,48.3,62921,53829,360,3954,16539,40848,26473,17261,9212,26473,177300,2017
41013,48,21717,19193,35,1641,6076,41777,9330,6293,3037,9330,187200,2017
41015,55.6,22377,19423,74,1515,5795,42519,10382,7009,3373,10382,221300,2017
41017,42.1,175321,153774,935,13684,46895,59152,69631,45441,24190,69631,298200,2017
41019,47,107576,95104,450,5899,29363,44023,44828,30465,14363,44828,174200,2017
41021,47,1910,1643,0,154,512,39831,805,515,290,805,110900,2017
41023,53,7209,6618,32,257,2002,44826,3176,2323,853,3176,155400,2017
41025,46.2,7195,6246,61,359,2036,39504,3079,2152,927,3079,111900,2017
41027,39,22938,14736,27,7136,5527,57269,8543,5451,3092,8543,339400,2017
41029,43,212070,173230,1232,25928,54981,48688,86195,54232,31963,86195,240900,2017
41031,40.6,22707,13674,185,4495,5401,48464,7628,5243,2385,7628,178300,2017
41033,47.6,84514,73870,323,6031,22730,40705,35614,23631,11983,35614,235600,2017
41035,42.6,66018,51971,495,8126,17592,42531,27171,17659,9512,27171,156900,2017
41037,48.8,7807,6653,20,614,2132,32769,3522,2097,1425,3522,123100,2017
41039,39.4,363471,300329,3696,30653,87977,47710,148752,87539,61213,148752,232800,2017
41041,50.9,47307,39216,204,4188,12372,43291,20674,13145,7529,20674,227700,2017
41043,39.7,121074,103819,465,10483,31521,49515,46265,29649,16616,46265,184900,2017
41045,36.1,30421,18782,268,10078,6976,37112,10262,5953,4309,10262,127700,2017
41047,36.2,330453,219207,3420,85971,79138,53828,116077,69362,46715,116077,205600,2017
41049,39.2,11153,6768,29,3912,2962,54386,3936,2791,1145,3936,131600,2017
41051,36.8,788459,556207,41979,88966,174076,60369,318173,172892,145281,318173,330900,2017
41053,37.3,79666,62834,775,10673,19779,56032,29128,18806,10322,29128,224700,2017
41055,51.7,1635,1499,13,73,460,42074,779,497,282,779,144000,2017
41057,48,25840,21883,75,2663,6493,45061,10454,7235,3219,10454,233500,2017
41059,36.1,76736,51407,580,19939,18284,50071,26976,16967,10009,26976,147900,2017
41061,39.8,25810,23058,198,1182,6559,46228,10291,6512,3779,10291,172100,2017
41063,52.7,6864,6414,15,186,1958,44877,3126,2123,1003,3126,217600,2017
41065,40.9,25687,19362,94,4463,6583,48510,10135,6497,3638,10135,191400,2017
41067,36.4,572071,383804,10636,94012,144406,74033,212778,129376,83402,212778,331700,2017
41069,57.9,1415,1260,0,86,404,33563,677,501,176,677,138300,2017
41071,38.2,102366,79477,878,16097,25345,58392,35952,24428,11524,35952,254000,2017
42001,43.3,101589,90912,1399,6891,27769,62661,38818,30191,8627,38818,197400,2017
42003,40.9,1229605,972003,156289,24076,304668,56333,536439,348012,188427,536439,140600,2017
42005,46,66737,64902,637,472,19168,47527,28242,21421,6821,28242,98600,2017
42007,44.9,168161,150808,9933,2486,45668,53981,70384,51609,18775,70384,129200,2017
42009,45.9,48891,47372,203,557,13401,48703,19666,15642,4024,19666,126800,2017
42011,39.9,415500,304286,17000,81398,106020,59580,153876,111104,42772,153876,170900,2017
42013,43.1,124736,118267,1840,1467,32825,45664,51638,36185,15453,51638,117300,2017
42015,44.4,61546,59141,353,881,16827,50900,24851,18595,6256,24851,145600,2017
42017,43.6,626486,531406,23975,31398,167411,82031,235909,180670,55239,235909,315700,2017
42019,43.1,185984,176705,1670,2593,51256,66037,75596,57630,17966,75596,190000,2017
42021,45,135871,126378,4281,2096,36239,44943,57154,42455,14699,57154,88900,2017
42023,50.8,4754,4590,51,39,1237,40402,2196,1583,613,2196,73800,2017
42025,45.7,63987,59136,1097,2727,17046,51236,25978,20092,5886,25978,141200,2017
42027,31.3,160646,137817,5839,4559,32917,56466,57710,35427,22283,57710,212300,2017
42029,40.3,514652,412914,29271,37264,132897,92417,188613,141800,46813,188613,338200,2017
42031,41.3,38747,37295,395,311,9968,44373,15925,11058,4867,15925,109900,2017
42033,44.2,80539,75006,2005,2330,20690,45188,31152,23969,7183,31152,90300,2017
42035,38.5,39321,37473,541,560,9683,47990,14675,10378,4297,14675,124700,2017
42037,40.5,66615,62230,1173,1722,16911,48395,26564,18336,8228,26564,143300,2017
42039,42.8,86847,82555,1622,1046,23458,47179,35102,25551,9551,35102,108200,2017
42041,40.5,245801,213538,8656,8698,62855,65544,97919,69237,28682,97919,194100,2017
42043,39.6,273329,183372,48258,23315,69881,57071,111489,70837,40652,111489,163300,2017
42045,39,563384,382859,116489,20099,137459,69839,204870,142566,62304,204870,235200,2017
42047,46.7,30781,30029,154,233,8602,49876,13447,10598,2849,13447,97100,2017
42049,39,277794,235528,18859,11152,69234,48192,110377,72959,37418,110377,124100,2017
42051,44.6,133160,122632,5226,1442,34054,41632,54043,39459,14584,54043,94600,2017
42053,39.2,7388,4407,2277,516,866,37106,1473,1258,215,1473,91000,2017
42055,41.3,153003,135632,5830,8063,41038,58267,60102,42413,17689,60102,175800,2017
42057,44.6,14631,14087,214,174,4077,50007,5947,4670,1277,5947,156000,2017
42059,42,37338,34945,1172,551,9615,50972,14484,10670,3814,14484,108600,2017
42061,42.9,45686,41544,2297,849,11616,46765,16935,12724,4211,16935,121900,2017
42063,39.7,86551,81298,1873,1098,21340,46306,34030,23857,10173,34030,111200,2017
42065,43.9,44258,43075,244,368,12221,45342,18452,13813,4639,18452,96700,2017
42067,42.8,24448,23182,266,794,6558,50571,9361,7082,2279,9361,143600,2017
42069,42.2,211960,183656,5586,14176,52136,48380,85907,56356,29551,85907,149100,2017
42071,38.5,536494,443708,19261,53792,139173,61492,198565,135368,63197,198565,193200,2017
42073,44.9,88231,81198,3106,1151,24456,47188,36742,27219,9523,36742,102300,2017
42075,41.2,137616,114705,2512,16795,36740,57698,52792,36703,16089,52792,166600,2017
42077,39.4,360774,239931,19488,82105,92116,60116,137239,89550,47689,137239,196000,2017
42079,43,318222,266682,11071,32188,81903,49290,128247,87714,40533,128247,124100,2017
42081,41,115398,104712,5558,2204,29787,50634,45991,32145,13846,45991,147400,2017
42083,42.5,42070,39347,1035,883,10948,45866,17199,12696,4503,17199,77100,2017
42085,44.4,113623,102613,6494,1583,29858,47340,45805,33516,12289,45805,114100,2017
42087,43.6,46452,44652,300,670,12807,46286,18939,13299,5640,18939,103700,2017
42089,42.6,167306,113048,21807,24980,41181,61430,57526,44987,12539,57526,167200,2017
42091,41.2,818677,626927,72124,39971,214517,84791,312805,225724,87081,312805,299300,2017
42093,43,18302,16857,326,465,4545,56250,7423,5293,2130,7423,173800,2017
42095,42,300941,234541,14093,37343,78385,65390,113827,81540,32287,113827,209800,2017
42097,44.3,93038,86519,2283,2940,24967,44534,39281,28000,11281,39281,112300,2017
42099,43,45878,43934,398,809,12641,60847,17936,14372,3564,17936,164000,2017
42101,34.1,1569657,548312,648846,221777,311734,40649,591280,308695,282585,591280,151500,2017
42103,47,55687,45178,3158,5757,15296,63417,21379,17981,3398,21379,183400,2017
42105,46.7,17070,16512,63,211,4269,41406,6536,5045,1491,6536,103700,2017
42107,44.2,144287,132324,3764,5536,38216,47642,58758,43942,14816,58758,96200,2017
42109,39.7,40570,38611,326,884,10516,54182,14576,10594,3982,14576,154800,2017
42111,45.9,75619,71527,1993,1077,20481,46132,29918,23296,6622,29918,103100,2017
42113,53.1,6192,5762,152,110,1547,45519,2648,2159,489,2648,148500,2017
42115,47.8,41716,40214,248,696,11809,52014,17404,13413,3991,17404,159100,2017
42117,44,41550,40007,238,517,10917,50017,16121,11918,4203,16121,139400,2017
42119,39.4,45056,38039,2792,2561,9922,53768,14702,10404,4298,14702,172200,2017
42121,46,52880,50808,454,574,14862,46487,21925,16403,5522,21925,85000,2017
42123,46.7,40345,39131,184,408,10971,45781,17095,13026,4069,17095,92200,2017
42125,44.4,207661,192166,6122,3258,55834,59309,83897,63420,20477,83897,158600,2017
42127,47.7,51656,46992,1595,2144,12882,52161,19202,15214,3988,19202,174600,2017
42129,46.6,356835,335912,8249,3903,100971,56702,151892,117800,34092,151892,144900,2017
42131,44,27760,26585,187,497,7277,55965,10801,8415,2386,10801,163500,2017
42133,41,442216,372701,23061,30643,117907,61707,169667,126302,43365,169667,170300,2017
44001,44.1,49028,45446,617,1336,12410,74630,19521,13466,6055,19521,341300,2017
44003,43.7,164012,146824,2191,7165,43150,69047,69013,48648,20365,69013,212600,2017
44005,44.6,83204,71549,2596,4623,21983,75463,35421,21973,13448,35421,362800,2017
44007,37.3,633704,394363,50835,137017,148061,52530,238465,126847,111618,238465,214400,2017
44009,44.1,126190,115206,1621,3769,32696,77862,49608,36357,13251,49608,320600,2017
45001,43.7,24788,17076,6844,332,6137,35254,9392,7236,2156,9392,92600,2017
45003,41,165707,110445,40529,9116,44740,47713,65703,47484,18219,65703,135900,2017
45005,40.6,9402,2115,6912,288,1942,23331,3285,2173,1112,3285,52100,2017
45007,40.5,194174,150741,31052,6823,52403,45551,76234,53847,22387,76234,133900,2017
45009,41.8,14842,5280,9134,288,3604,32330,5587,4244,1343,5587,65800,2017
45011,40.6,21788,11146,9826,502,5581,34035,8426,5826,2600,8426,76200,2017
45013,44,179316,120827,32543,20187,46694,60603,68790,48493,20297,68790,283800,2017
45015,35.8,204632,130979,48887,12850,51970,56697,73168,51215,21953,73168,164900,2017
45017,45.9,14808,7938,6158,530,3863,44010,6150,4878,1272,6150,103900,2017
45019,37.2,387847,247681,107017,19510,90251,57882,154049,93308,60741,154049,273100,2017
45021,38.9,56549,41330,11241,2323,12208,35286,20480,14446,6034,20480,94300,2017
45023,41.8,32424,19091,11792,619,7872,37421,12384,9291,3093,12384,88900,2017
45025,41.9,46127,28026,14766,1935,12984,38469,18303,13143,5160,18303,81200,2017
45027,43.6,34156,16182,16504,1024,9008,35838,13573,10160,3413,13573,89900,2017
45029,42.2,37581,21158,14294,1156,10068,34996,15134,11016,4118,15134,84600,2017
45031,41.2,67572,37174,27512,1297,17548,36217,26861,18431,8430,26861,84800,2017
45033,37.4,31073,14324,14431,830,7263,30866,10945,7226,3719,10945,67200,2017
45035,36.2,151716,98031,38414,7651,37435,58685,54028,38389,15639,54028,177500,2017
45037,42.6,26620,15040,9696,1505,6488,47500,9054,6770,2284,9054,123000,2017
45039,45.4,22868,8552,12557,457,5598,35551,8878,6607,2271,8878,101100,2017
45041,38.8,138537,72820,58405,3442,35217,43310,52092,34284,17808,52092,128400,2017
45043,48.5,61065,38666,19114,1838,17550,46967,24840,18992,5848,24840,178600,2017
45045,38,490332,338103,88189,43348,123867,53739,185837,122809,63028,185837,165600,2017
45047,39.3,69981,42039,21811,4084,17819,39196,27022,17365,9657,27022,116300,2017
45049,39.9,20066,8209,10640,799,4371,32147,7129,5399,1730,7129,75400,2017
45051,44.4,310186,239238,41901,18578,81822,46475,125168,87486,37682,125168,166500,2017
45053,38.1,27465,11418,11905,3637,6964,39740,9715,6737,2978,9715,130700,2017
45055,41.8,63734,44041,15263,2599,17211,46565,24711,20109,4602,24711,121200,2017
45057,42,86544,60704,18783,4360,21725,50557,31445,24814,6631,31445,169000,2017
45059,40.8,66508,45291,16634,2982,17636,40580,25543,18244,7299,25543,87400,2017
45061,41.7,17897,5841,11206,418,4249,31963,6501,4864,1637,6501,69800,2017
45063,38.9,281870,212989,40626,16394,74380,57482,109251,80472,28779,109251,148400,2017
45065,52.8,9694,4771,4605,85,2706,40622,4077,3103,974,4077,116600,2017
45067,40,31765,12312,17969,859,7780,31129,11911,8208,3703,11911,75800,2017
45069,39.9,27505,10784,13805,909,6507,33921,9703,6429,3274,9703,60500,2017
45071,41.5,37914,22674,11972,2773,10328,39600,14893,10844,4049,14893,99700,2017
45073,45,75926,64366,5394,3905,21225,43978,31354,22872,8482,31354,153300,2017
45075,39.5,89116,29650,54943,1869,20005,34943,33029,22673,10356,33029,92700,2017
45077,36.2,121449,104578,7896,4264,29609,45332,46428,31576,14852,46428,132300,2017
45079,33,404869,175125,186882,20423,89549,52082,149161,87981,61180,149161,154100,2017
45081,40.6,20228,11709,5153,3116,5157,41885,7052,5070,1982,7052,93100,2017
45083,38.3,297732,204830,60568,19315,77247,47575,113191,78103,35088,113191,128000,2017
45085,36,107379,49068,50329,4091,28144,41946,41417,26860,14557,41417,113200,2017
45087,43.7,27772,18088,8585,376,7715,37493,11564,8123,3441,11564,75600,2017
45089,41.7,32256,10055,20938,751,8303,30976,12310,9069,3241,12310,68400,2017
45091,38.3,251664,179171,47594,12960,67618,59394,95539,67863,27676,95539,173600,2017
46003,39.9,2739,2432,45,183,723,57257,1179,915,264,1179,72300,2017
46005,37.9,18163,14445,71,1644,4653,48995,7651,5129,2522,7651,104800,2017
46007,28.8,3440,1066,8,250,711,45725,955,581,374,955,69000,2017
46009,43.5,6972,6095,94,207,1590,52923,2554,1925,629,2554,80400,2017
46011,26.7,33697,30648,479,876,6915,53473,12602,7512,5090,12602,165100,2017
46013,37.3,38637,34229,629,952,10054,53807,16328,10765,5563,16328,152900,2017
46015,40.5,5280,4476,0,134,1494,50870,2170,1476,694,2170,117100,2017
46017,25.3,2048,242,8,49,416,30500,530,222,308,530,51400,2017
46019,40.1,10194,9359,64,357,2685,44786,4172,3110,1062,4172,123900,2017
46021,51.7,1443,1403,0,2,388,51548,690,588,102,690,65900,2017
46023,36,9319,5897,5,286,2045,44104,3184,2162,1022,3184,89900,2017
46025,41.3,3642,3451,0,66,888,47500,1510,1175,335,1510,81100,2017
46027,25,13907,12268,203,381,2599,41773,5302,2735,2567,5302,146400,2017
46029,38.3,27963,26073,133,588,7378,52025,12011,7824,4187,12011,166500,2017
46031,28.8,4177,1225,19,31,917,32260,1239,662,577,1239,53300,2017
46033,53.8,8519,7722,17,259,2758,56449,3901,3231,670,3901,202600,2017
46035,38.2,19753,18105,118,484,5256,48665,8696,5283,3413,8696,141000,2017
46037,48.4,5524,4768,0,111,1689,43902,2567,1873,694,2567,86000,2017
46039,44.7,4282,4146,0,118,1196,57969,1835,1508,327,1835,112700,2017
46041,28,5709,1162,7,75,1131,41190,1648,963,685,1648,65700,2017
46043,47.5,2940,2790,0,17,874,52543,1271,978,293,1271,80800,2017
46045,44.4,3971,3867,2,68,1118,65380,1579,1325,254,1579,114000,2017
46047,50.9,6783,5779,47,268,1895,48862,3115,2264,851,3115,116700,2017
46049,48.1,2327,2203,1,27,537,46750,944,728,216,944,85700,2017
46051,43.7,7133,6695,0,130,2197,56276,3203,2681,522,3203,115800,2017
46053,45.8,4209,3719,0,62,1225,42679,1943,1354,589,1943,68600,2017
46055,45.3,2084,1849,1,11,623,38873,893,701,192,893,78100,2017
46057,35.2,5911,5583,10,217,1620,61784,2193,1786,407,2193,117400,2017
46059,47.4,3303,3234,1,24,931,50720,1498,1041,457,1498,115100,2017
46061,36.2,3404,3196,157,0,792,62448,1061,937,124,1061,121300,2017
46063,39.8,1281,1202,17,23,338,55972,533,379,154,533,82300,2017
46065,38.3,17572,14611,86,518,4100,59741,7391,4780,2611,7391,173400,2017
46067,44.3,7277,6924,32,137,1943,49583,2881,2200,681,2881,81300,2017
46069,50,1373,1175,0,11,366,53696,582,470,112,582,88100,2017
46071,31.6,3275,1404,7,23,688,38041,984,618,366,984,55800,2017
46073,48.6,2034,1958,0,45,552,49882,911,671,240,911,77700,2017
46075,53,740,740,0,0,218,39432,405,307,98,405,77700,2017
46077,46.8,5000,4753,0,107,1511,58794,2327,1855,472,2327,105900,2017
46079,42,12350,11584,68,287,3178,58467,4817,3590,1227,4817,155200,2017
46081,41.4,25018,22854,236,790,6274,49275,10902,6996,3906,10902,189200,2017
46083,34.4,53147,49754,554,1000,13917,81849,18736,14780,3956,18736,209700,2017
46085,36,3882,2188,2,85,967,47113,1383,967,416,1383,81700,2017
46087,40.7,5515,5219,45,174,1552,60808,2182,1637,545,2182,120700,2017
46089,50.5,2366,2125,3,51,606,41674,1019,809,210,1019,54500,2017
46091,41.3,4759,3987,23,352,1151,60948,1813,1302,511,1813,106700,2017
46093,36.1,27066,23817,484,1104,7756,54286,11022,8117,2905,11022,168400,2017
46095,32.8,2062,847,0,107,484,31165,683,462,221,683,45300,2017
46097,42,2255,2146,23,47,643,50658,990,777,213,990,82000,2017
46099,34.7,183660,153510,8719,8558,45632,57322,73762,46899,26863,73762,166600,2017
46101,40.3,6496,5044,36,237,1806,56233,2664,2020,644,2664,118900,2017
46102,25.2,14291,593,14,532,2371,27804,2920,1536,1384,2920,18700,2017
46103,37.8,108126,87068,1160,5200,27277,52245,43110,29196,13914,43110,172400,2017
46105,47,2964,2807,3,47,837,50450,1311,971,340,1311,74300,2017
46107,52.6,2318,2157,0,53,614,51597,1025,847,178,1025,81600,2017
46109,38.2,10250,5914,49,287,2583,51228,3756,2552,1204,3756,95700,2017
46111,45.3,2366,2253,0,70,737,54677,1050,774,276,1050,72800,2017
46115,44.1,6478,6151,8,120,1663,52000,2626,1929,697,2626,77300,2017
46117,43.4,2994,2628,0,32,996,63233,1309,1032,277,1309,158300,2017
46119,44.9,1390,1327,0,13,388,60694,601,462,139,601,122300,2017
46121,24.4,10016,850,32,423,1997,26285,2768,1152,1616,2768,38500,2017
46123,46.5,5480,4500,0,18,1473,48409,2424,1677,747,2424,85800,2017
46125,43.7,8242,7888,30,172,2390,54294,3523,2753,770,3523,110400,2017
46127,41.1,14929,13853,105,441,4176,65434,6285,4601,1684,6285,161300,2017
46129,44.4,5502,4393,26,108,1288,46623,2292,1633,659,2292,82400,2017
46135,42.1,22660,20267,411,841,5785,50029,9283,6064,3219,9283,140400,2017
46137,30.5,2837,664,0,11,599,35000,764,408,356,764,57100,2017
47001,43.3,75538,67664,2592,2012,20083,47206,30518,20584,9934,30518,134100,2017
47003,37.2,46854,36430,3087,5528,12574,47117,17058,11631,5427,17058,129700,2017
47005,46.5,16154,15048,556,356,4007,33702,6693,5066,1627,6693,88700,2017
47007,44.5,14413,12856,582,308,3471,40450,4664,3533,1131,4664,129600,2017
47009,43.2,127135,116204,3193,3977,34014,51172,49939,37372,12567,49939,169500,2017
47011,39.2,103666,89698,5068,6029,27334,46381,39615,26120,13495,39615,150100,2017
47013,43.5,39824,38488,216,486,11070,35377,15843,10980,4863,15843,92700,2017
47015,41.7,13839,13072,201,273,3809,47457,5456,4015,1441,5456,151800,2017
47017,43,28137,23876,2766,683,7584,38201,11321,8204,3117,11321,86800,2017
47019,44.4,56500,53753,785,971,15731,34625,23798,16656,7142,23798,114600,2017
47021,40.5,39713,37087,516,1083,10631,56150,14671,11599,3072,14671,170500,2017
47023,36.2,17097,14702,1650,413,4545,43740,5998,4500,1498,5998,113800,2017
47025,42.7,31566,30170,314,376,8822,35428,12996,9234,3762,12996,102700,2017
47027,47.6,7684,7284,165,120,2168,30801,3171,2359,812,3171,90300,2017
47029,44.7,35262,32994,564,776,9383,32027,14592,9964,4628,14592,107200,2017
47031,40.2,54074,48255,1142,2209,14508,46614,21576,14625,6951,21576,118000,2017
47033,40,14554,10872,1920,1473,3436,39692,5400,3770,1630,5400,96700,2017
47035,50.5,58178,55107,383,1640,17418,40994,25114,19627,5487,25114,140800,2017
47037,34.3,678322,382565,184942,68326,153909,53419,273497,148731,124766,273497,194800,2017
47039,45.7,11681,10708,341,373,3247,36427,4721,3473,1248,4721,91800,2017
47041,40.9,19380,17225,243,1470,5080,40690,7362,4896,2466,7362,131100,2017
47043,39.5,51341,46156,2017,1699,13099,47398,19032,13571,5461,19032,146300,2017
47045,40.5,37751,30301,5065,1234,10679,44386,15327,9428,5899,15327,98100,2017
47047,44.8,39336,26852,10898,974,11239,57919,15084,12028,3056,15084,185000,2017
47049,44.8,17940,17356,32,255,5081,32616,7385,5580,1805,7385,103700,2017
47051,41.5,41397,36761,2010,1312,11118,46882,16325,12015,4310,16325,120600,2017
47053,40.3,49222,37789,8719,1260,13177,41315,19280,13438,5842,19280,94800,2017
47055,43.1,29024,24617,2837,577,7955,43925,11599,8086,3513,11599,120400,2017
47057,44.2,22942,21761,87,697,6599,40088,9112,7061,2051,9112,110600,2017
47059,44.3,68520,63943,1487,1856,18198,38266,27319,19864,7455,27319,114600,2017
47061,43,13359,10848,64,156,3472,31919,4894,3670,1224,4894,82400,2017
47063,40.3,63465,51951,2164,7269,16792,42042,24343,16081,8262,24343,131200,2017
47065,39.5,354589,253156,68496,18703,85872,50273,139037,89631,49406,139037,166100,2017
47067,44.6,6605,6412,31,59,1770,29619,2704,2094,610,2704,83500,2017
47069,40.5,25784,14108,10702,435,5896,36686,8680,6039,2641,8680,85400,2017
47071,45.3,25813,23752,943,595,7099,39092,10118,7596,2522,10118,107400,2017
47073,44.2,56402,53766,755,788,15761,38728,23375,17302,6073,23375,115400,2017
47075,40,17944,7967,8966,768,4660,36118,7104,4258,2846,7104,104300,2017
47077,41.2,27889,24442,2227,619,7347,42711,10827,7831,2996,10827,92700,2017
47079,45.3,32263,28234,2889,754,9059,40415,13483,10173,3310,13483,97000,2017
47081,40.9,24502,22195,1214,562,5983,39333,8930,6998,1932,8930,104800,2017
47083,43.6,8188,7551,331,62,2061,41820,2999,2315,684,2999,94900,2017
47085,42.1,18281,16982,649,418,4487,40998,7064,5432,1632,7064,103000,2017
47087,46.9,11573,11081,72,220,3052,33933,4566,3470,1096,4566,107700,2017
47089,43.2,52887,48914,951,1836,14324,45641,20088,14751,5337,20088,136700,2017
47091,45.7,17846,16449,680,336,4653,32994,6936,5305,1631,6936,114100,2017
47093,37.3,452286,374054,39739,18014,113197,52458,182315,116893,65422,182315,169400,2017
47095,40.2,7588,5088,2211,164,1433,31993,2164,1284,880,2164,75100,2017
47097,38,26497,16139,8913,629,6782,35551,9725,5590,4135,9725,81000,2017
47099,39.6,42591,40035,816,848,11519,41522,16101,11887,4214,16101,98800,2017
47101,44.7,11944,11173,143,263,3270,37092,4663,3674,989,4663,88300,2017
47103,43.3,33543,29310,2296,1067,9271,42153,13653,9904,3749,13653,117500,2017
47105,47.1,51024,45126,656,4170,14800,55431,20090,15282,4808,20090,193000,2017
47107,42.6,52569,47134,1875,1935,13451,39990,20352,15115,5237,20352,123700,2017
47109,42.7,25945,23386,1485,514,6691,34353,10095,7428,2667,10095,87500,2017
47111,38.6,23239,21405,100,1187,6356,35533,9158,6723,2435,9158,111700,2017
47113,37.9,97887,55328,36315,3576,24768,44496,37110,23511,13599,37110,126100,2017
47115,43.2,28355,26104,534,486,8303,45366,11393,8511,2882,11393,121200,2017
47117,39.3,31753,27110,2408,1568,8431,46837,12008,8608,3400,12008,119300,2017
47119,38.9,87606,69899,10126,4749,23502,52080,33332,22891,10441,33332,156000,2017
47121,44.4,11830,11176,161,177,3416,39786,4818,3816,1002,4818,118400,2017
47123,43,45698,41646,877,1925,12779,36931,17416,13198,4218,17416,115200,2017
47125,30.5,192120,124059,35821,18665,49394,53737,68904,40631,28273,68904,153700,2017
47127,45.1,6302,5881,110,11,1935,51671,2613,2195,418,2613,166000,2017
47129,41.2,21639,20198,1080,264,5512,40707,7384,5994,1390,7384,91600,2017
47131,42.6,30659,25572,3144,1214,8785,38063,12795,8631,4164,12795,87600,2017
47133,42.6,21995,21193,146,284,6109,36052,8937,7028,1909,8937,114700,2017
47135,43.5,7882,7296,261,180,2418,31503,3295,2700,595,3295,84200,2017
47137,49.8,5071,4910,41,44,1662,39313,2180,1771,409,2180,129700,2017
47139,44.9,16722,15947,44,311,5103,42307,7023,5355,1668,7023,110900,2017
47141,36,75565,67103,1728,4542,19019,37802,30624,18527,12097,30624,152800,2017
47143,40.7,32478,29552,715,1501,8312,39368,12607,8882,3725,12607,114200,2017
47145,46.5,52926,49282,1251,898,14232,45407,21619,16274,5345,21619,135900,2017
47147,38.7,68575,57589,4898,4401,19015,57424,25065,18748,6317,25065,163100,2017
47149,33.1,298456,216513,41481,22213,74794,62149,106673,69934,36739,106673,174200,2017
47151,38.7,21949,21411,117,176,5743,31875,8519,5941,2578,8519,86700,2017
47153,43,14654,12590,26,515,4256,51312,5505,4153,1352,5505,138100,2017
47155,42.4,95523,86562,639,5399,25688,44473,36901,24861,12040,36901,164000,2017
47157,35.3,937847,341880,498510,57198,219970,48415,349207,195204,154003,349207,135700,2017
47159,41.2,19279,17969,416,486,5397,44275,7535,5633,1902,7535,120700,2017
47161,43.6,13248,12189,145,342,3690,44090,5315,3769,1546,5315,130400,2017
47163,44.7,156519,146608,2902,2776,43733,42251,66388,48178,18210,66388,130300,2017
47165,39.6,175730,149787,12027,7957,47158,61584,64600,47485,17115,64600,194900,2017
47167,37.3,61434,46710,10999,1631,16481,57212,21445,14831,6614,21445,142400,2017
47169,37.5,8773,7445,999,98,1904,41776,2944,2101,843,2944,128000,2017
47171,45.9,17830,16714,86,787,4841,36576,7613,5513,2100,7613,121200,2017
47173,42,19176,18518,84,290,5434,40132,7268,5492,1776,7268,114200,2017
47175,47.2,5675,5464,17,53,1608,43631,2156,1888,268,2156,95000,2017
47177,40.1,40210,34547,505,3508,10306,36765,15755,10794,4961,15755,108600,2017
47179,39.8,126437,112755,4840,4132,33021,44180,52684,34063,18621,52684,152800,2017
47181,41.9,16713,15086,942,320,4217,34299,5860,4715,1145,5860,96400,2017
47183,38.1,33776,29403,2933,770,8597,36550,13607,9060,4547,13607,94300,2017
47185,43.4,26394,24764,433,609,6853,37654,9793,7673,2120,9793,97700,2017
47187,39,212161,181074,8825,9937,58821,103543,73160,58932,14228,73160,388400,2017
47189,40.2,128874,110802,8786,4953,35249,66123,47213,36338,10875,47213,227100,2017
48001,39.1,57747,34468,12075,9981,11611,42313,16567,11748,4819,16567,91800,2017
48003,31.6,17577,7229,265,9737,4157,70753,5413,3981,1432,5413,126000,2017
48005,36.8,87700,53704,12878,18871,22400,46472,30931,20424,10507,30931,97300,2017
48007,49.6,24832,16803,390,6714,6277,44601,9529,7039,2490,9529,158900,2017
48009,44.8,8793,7787,74,731,2391,63192,3351,2752,599,3351,125600,2017
48011,45.9,1929,1671,24,192,540,68750,702,569,133,702,128600,2017
48013,35.4,48139,16480,353,30585,11819,55194,15509,11537,3972,15509,96100,2017
48015,40.9,29292,18533,2601,7598,8131,62614,11021,8175,2846,11021,175200,2017
48017,35.2,7098,2459,108,4447,1700,43523,2230,1609,621,2230,68000,2017
48019,52,21316,16788,213,3836,5694,56413,8278,7007,1271,8278,165900,2017
48021,38.8,80306,43147,6219,28883,18997,59185,26015,19911,6104,26015,150300,2017
48023,48.1,3602,3020,116,365,971,36157,1644,1273,371,1644,67200,2017
48025,35.2,32729,10555,2697,19058,6121,45415,8531,5375,3156,8531,78500,2017
48027,30.6,336506,158932,70588,80846,82041,52583,116397,63767,52630,116397,137100,2017
48029,33.3,1892004,537451,133212,1130949,423390,53999,627889,368817,259072,627889,142300,2017
48031,49.5,11089,8601,1,2119,3068,58500,4230,3240,990,4230,230800,2017
48033,42.1,602,556,0,46,179,77708,248,183,65,248,106900,2017
48035,46.5,17955,14127,246,3154,5204,48677,7027,5435,1592,7027,106700,2017
48037,38.2,93635,60361,22371,6932,22847,46283,33171,21583,11588,33171,109400,2017
48039,35.6,345995,169835,44790,102715,87576,76426,117088,84216,32872,117088,164300,2017
48041,25.8,214231,121439,21819,53696,43236,43907,77480,35247,42233,77480,170500,2017
48043,43.1,9220,4768,13,4079,2146,38906,3932,2155,1777,3932,113400,2017
48045,46.4,1591,964,27,513,435,42500,664,504,160,664,65700,2017
48047,31.8,7251,417,5,6824,1443,24794,2022,1243,779,2022,61900,2017
48049,41,37787,27465,1369,8119,9417,43062,13835,10038,3797,13835,95100,2017
48051,42.9,17596,11561,2169,3537,4597,52510,6565,5126,1439,6565,99500,2017
48053,44,45017,33365,696,9857,12077,57173,16545,12610,3935,16545,171100,2017
48055,35.8,40544,16661,2458,20537,8975,51346,12894,8672,4222,12894,124300,2017
48057,37.7,21821,9426,567,10503,5412,58788,7733,5458,2275,7733,114900,2017
48059,43.3,13660,11862,201,1249,3269,40945,5291,4352,939,5291,76500,2017
48061,31.4,420201,39240,1560,375256,96308,36095,122188,82068,40120,122188,82500,2017
48063,36.8,12670,7168,2140,3034,3378,41811,4730,3345,1385,4730,83600,2017
48065,41.1,6033,5215,39,586,1612,67010,2292,1948,344,2292,107800,2017
48067,42.9,30118,23015,5106,1306,8240,41432,11811,9196,2615,11811,86200,2017
48069,34.4,7891,2595,54,5039,1779,44643,2462,1584,878,2462,80300,2017
48071,35.4,39283,26720,3154,8396,10432,74368,13320,11023,2297,13320,171500,2017
48073,38,51594,31603,6991,11605,13197,44294,17885,13172,4713,17885,98200,2017
48075,32.8,7064,4525,512,1536,1473,40432,2282,1254,1028,2282,81000,2017
48077,46,10369,9370,56,587,2873,46863,4076,3479,597,4076,87200,2017
48079,33.5,2932,1104,77,1672,718,37500,1000,761,239,1000,33300,2017
48081,49.1,3238,2490,21,682,967,42500,1574,1121,453,1574,81800,2017
48083,46.6,8422,6512,231,1465,2383,40804,3470,2467,1003,3470,65900,2017
48085,36.5,914075,540387,84259,137871,240307,90124,323905,212556,111349,323905,265300,2017
48087,39.8,3026,1824,105,946,802,46348,1099,883,216,1099,55800,2017
48089,43.4,20913,11918,2727,6045,5342,50241,7603,6240,1363,7603,116700,2017
48091,42.2,129100,88661,2547,34565,35407,73655,47253,35605,11648,47253,244100,2017
48093,44.4,13492,9504,90,3677,3508,42419,5107,4002,1105,5107,89600,2017
48095,41.9,3858,1731,26,2046,554,46696,791,564,227,791,109800,2017
48097,40.5,39064,29844,976,6774,10951,60027,15185,10456,4729,15185,144700,2017
48099,31.2,75818,45085,10391,13459,16295,50865,22424,12916,9508,22424,107700,2017
48101,47.6,1498,803,153,490,462,33534,664,434,230,664,44700,2017
48103,32.1,4836,1591,201,3036,1092,63935,1479,1158,321,1479,81500,2017
48105,35.5,3836,1264,35,2537,1050,52310,1411,1027,384,1411,80600,2017
48107,37.7,5895,2358,218,3266,1472,38674,2064,1415,649,2064,57500,2017
48109,41.2,2257,392,8,1821,507,33125,735,490,245,735,57000,2017
48111,32.1,7207,3692,124,3157,1776,45580,2432,1450,982,2432,77000,2017
48113,33.3,2552213,771258,563220,1011374,590475,53626,906179,457251,448928,906179,148300,2017
48115,33.1,13095,4752,740,7390,2958,43201,4339,3085,1254,4339,66400,2017
48117,31.8,18947,4914,148,13574,4355,51543,6118,3978,2140,6118,88000,2017
48119,43.7,5172,4214,411,357,1414,42642,2035,1571,464,2035,73100,2017
48121,34.9,781321,475452,70796,149286,195602,80290,275164,177522,97642,275164,232000,2017
48123,41.2,20474,11383,1852,7062,5251,50960,7260,5465,1795,7260,100000,2017
48125,43.2,2224,1528,69,614,541,43088,832,595,237,832,54200,2017
48127,33.5,10822,1429,6,9362,2294,31384,3476,2448,1028,3476,65200,2017
48129,41.9,3433,2809,126,365,789,44429,1230,915,315,1230,65100,2017
48131,36.8,11434,1025,165,10211,2731,35443,3845,2584,1261,3845,48500,2017
48133,43,18278,14595,411,2923,3672,32135,6437,4817,1620,6437,59800,2017
48135,30.3,155744,53705,6451,91475,36252,59528,51475,33994,17481,51475,120800,2017
48137,49.1,2111,909,0,1201,404,48462,634,551,83,634,72800,2017
48139,36,164092,102697,14640,41791,43047,67371,54725,39978,14747,54725,158200,2017
48141,31.9,834825,103880,25333,686173,195606,43244,263200,162108,101092,263200,116600,2017
48143,30,41016,30923,673,8439,8905,47013,13827,8803,5024,13827,128300,2017
48145,39.2,17289,8909,4196,3939,3554,38834,5405,3931,1474,5405,63000,2017
48147,41.9,33787,26834,2189,3580,8519,47875,12027,8977,3050,12027,98200,2017
48149,47.2,24963,17951,1489,5098,6721,56941,9298,7552,1746,9298,158700,2017
48151,44,3875,2575,111,1156,1043,45294,1696,1227,469,1696,60500,2017
48153,37.1,5953,2258,149,3440,1724,48767,2320,1687,633,2320,60500,2017
48155,48.6,1414,1077,31,306,364,50000,562,451,111,562,47400,2017
48157,35.8,711421,244432,143866,171949,182543,93645,222331,173534,48797,222331,233300,2017
48159,42.9,10639,8468,481,1479,2748,43967,3931,2929,1002,3931,130300,2017
48161,40.6,19646,13269,3164,2891,5324,45890,7232,5409,1823,7232,86100,2017
48163,31.3,19110,3140,679,15006,3366,37382,4530,3174,1356,4530,75900,2017
48165,28.1,19889,11198,452,8066,4436,58167,5716,4364,1352,5716,111000,2017
48167,37.6,321184,186380,40304,76806,81866,65702,117455,77873,39582,117455,171600,2017
48169,40.1,6739,2726,300,3639,1417,53832,1715,1115,600,1715,77500,2017
48171,50.2,25939,19614,20,5849,7558,56267,10795,8234,2561,10795,269900,2017
48173,38.3,1420,844,0,576,416,64886,475,341,134,475,193600,2017
48175,46.4,7510,4401,400,2675,2107,56737,2755,2256,499,2755,130900,2017
48177,36.9,20558,8703,1369,10293,5054,47516,7018,4822,2196,7018,92900,2017
48179,36.7,22962,14807,981,6412,5229,48314,7971,5995,1976,7971,71700,2017
48181,40.2,126146,96360,6995,15999,32831,52683,47550,31863,15687,47550,116600,2017
48183,35.4,123402,71967,24790,22449,30446,47970,45615,26844,18771,45615,130000,2017
48185,40.4,27358,16051,4259,6468,6253,49745,8980,6983,1997,8980,110100,2017
48187,36.7,150889,77499,10668,56319,39413,66187,51990,39219,12771,51990,175000,2017
48189,33,34527,11938,1522,20291,8070,46012,11217,6774,4443,11217,80200,2017
48191,43.2,3102,1760,231,1060,824,31324,1244,779,465,1244,48700,2017
48193,46.4,8220,6994,55,987,2215,46611,3157,2389,768,3157,108500,2017
48195,34.9,5532,2950,4,2569,1430,40678,1924,1404,520,1924,93500,2017
48197,43.6,3990,2738,277,850,1002,37995,1533,1150,383,1533,38400,2017
48199,39.3,55993,48723,3151,3003,15129,56131,20739,16757,3982,20739,113100,2017
48201,33.1,4525519,1386576,838285,1910535,1066649,57791,1562813,855629,707184,1562813,154100,2017
48203,37.7,66606,42506,14192,8467,17101,48644,23363,17328,6035,23363,115100,2017
48205,39.8,5821,3467,490,1527,1288,64427,1754,1067,687,1754,146900,2017
48207,43.4,5806,3822,182,1605,1435,43529,2128,1655,473,2128,49200,2017
48209,31.3,194843,107718,6784,73608,44204,62815,68045,42242,25803,68045,204700,2017
48211,35.1,4152,2568,31,1461,1078,68679,1358,929,429,1358,130700,2017
48213,43.8,79687,62894,5224,9668,21718,44888,30459,22968,7491,30459,99000,2017
48215,28.9,839539,55339,3522,770794,190585,37097,232523,156949,75574,232523,82400,2017
48217,42.5,35098,25038,2210,7017,8955,45970,12674,9350,3324,12674,93700,2017
48219,33.4,23273,11112,849,10921,5757,49184,8065,5533,2532,8065,82300,2017
48221,46.8,55418,46999,384,6641,14935,60275,21527,16373,5154,21527,170800,2017
48223,39.6,35929,26577,2390,5859,9828,47832,13287,9209,4078,13287,97200,2017
48225,44.6,22849,14155,5694,2439,5445,33552,8328,5721,2607,8328,80200,2017
48227,36.7,36491,18262,1891,15030,7370,50855,11032,7508,3524,11032,85700,2017
48229,38.8,3702,684,55,2901,655,26346,890,665,225,890,44100,2017
48231,37.9,90322,65807,7044,13837,21940,49319,31781,22146,9635,31781,105000,2017
48233,36.9,21704,15474,431,4887,5170,50035,7799,6202,1597,7799,75500,2017
48235,45.5,1592,1153,51,364,478,63021,648,514,134,648,146400,2017
48237,40.6,8839,6889,395,1439,2175,52829,3075,2524,551,3075,81400,2017
48239,39.2,14756,8765,1049,4760,3667,58504,5232,3650,1582,5232,96700,2017
48241,40.4,35444,26482,5929,2294,8165,41960,11974,8997,2977,11974,97400,2017
48243,55.3,2236,1361,15,810,593,46534,1007,809,198,1007,111300,2017
48245,36,254574,106135,85901,49725,59674,46315,94020,58181,35839,94020,101300,2017
48247,35.4,5262,309,0,4938,1130,31403,1587,1205,382,1587,61800,2017
48249,34.5,41318,7556,214,33151,10080,41103,13614,9447,4167,13614,73800,2017
48251,36.9,160173,117957,4506,32475,42181,60458,55467,40981,14486,55467,132000,2017
48253,38.6,19969,10940,2892,5424,3968,48601,5635,4162,1473,5635,73100,2017
48255,35.3,15051,5684,1316,7965,2919,53051,4303,3200,1103,4303,94100,2017
48257,35.7,114852,76486,11926,22817,28264,63926,36525,28175,8350,36525,154000,2017
48259,42.4,40306,29661,278,9285,10265,81023,13691,9975,3716,13691,297700,2017
48261,29.8,564,64,0,499,106,24800,152,43,109,152,21300,2017
48263,46.7,680,524,5,147,162,52250,275,202,73,275,70500,2017
48265,47.8,50761,35478,719,13263,13712,48698,20580,14660,5920,20580,164000,2017
48267,52.6,4432,3295,1,1049,1352,41095,1941,1458,483,1941,107200,2017
48269,32.7,289,212,0,77,62,56964,101,20,81,101,38800,2017
48271,41.1,3631,1382,4,2245,680,34926,1200,928,272,1200,64200,2017
48273,27.9,31540,6618,1098,22819,6829,41700,10958,5808,5150,10958,86800,2017
48275,40.6,3753,2228,225,1255,980,46319,1376,1110,266,1376,44400,2017
48277,40.4,49401,37039,6093,3689,13127,42198,19085,12273,6812,19085,88100,2017
48279,35.6,13368,5319,484,7347,3346,43712,4790,3399,1391,4790,62700,2017
48281,41.8,20473,14916,621,3935,5731,54467,7748,5758,1990,7748,136800,2017
48283,33.9,7418,1308,92,5928,1470,44601,2286,1607,679,2286,70800,2017
48285,43.9,19859,14750,1312,3593,5540,51708,7684,5801,1883,7684,143300,2017
48287,41.3,16850,10731,1853,3916,4513,55741,6118,4739,1379,6118,138300,2017
48289,44.7,16966,12986,1218,2405,4372,44875,6245,4897,1348,6245,102300,2017
48291,35.8,79884,52576,7972,17488,18902,48344,25974,19440,6534,25974,93200,2017
48293,39.5,23480,13905,4140,4994,5661,40356,8100,6109,1991,8100,84800,2017
48295,35,3495,2308,13,1046,902,59583,1276,935,341,1276,92400,2017
48297,42.3,12043,6941,293,4669,2379,51480,3586,2959,627,3586,84900,2017
48299,57.1,20195,17593,150,1983,5885,50524,8681,6647,2034,8681,184500,2017
48301,57.5,74,55,0,12,19,80938,31,16,15,31,NA,2017
48303,30.7,298042,162449,20465,102770,68845,49078,110275,61694,48581,110275,122700,2017
48305,38.1,5785,2853,77,2728,1637,44922,2147,1475,672,2147,76800,2017
48307,43.5,8145,5067,161,2571,2164,42367,3143,2398,745,3143,82000,2017
48309,33.2,245720,139446,34865,63010,58634,46262,88208,51140,37068,88208,125200,2017
48311,42,600,292,0,303,153,71389,194,143,51,194,74700,2017
48313,35.2,13979,7794,2428,3134,2834,44004,4174,3069,1105,4174,101700,2017
48315,49.8,10140,7187,2402,394,2761,36938,4457,3528,929,4457,88600,2017
48317,31.7,5547,2977,36,2500,1241,71115,1635,1261,374,1635,120500,2017
48319,48.9,4122,2962,1,1001,1027,40949,1622,1185,437,1622,156400,2017
48321,37.2,36744,16503,3741,15230,9143,44896,13811,9359,4452,13811,102200,2017
48323,29.6,57471,1521,129,54767,13297,37734,16416,11170,5246,16416,95100,2017
48325,38.8,48548,21624,1140,24884,11151,59305,15154,12448,2706,15154,134400,2017
48327,49.1,2123,1252,13,792,582,37917,964,643,321,964,60800,2017
48329,31.8,159883,75630,9374,69124,38371,75815,55045,36750,18295,55045,187400,2017
48331,41.5,24479,15408,2063,6306,6239,41768,9437,6444,2993,9437,88500,2017
48333,47.3,4887,3971,11,892,1199,46318,1833,1553,280,1833,111200,2017
48335,34.6,8774,4270,902,3446,1899,52194,2639,2005,634,2639,65700,2017
48337,44,19406,16748,41,2072,5435,46592,8044,5784,2260,8044,107100,2017
48339,36.7,535187,363190,23915,122934,139465,74323,186861,133082,53779,186861,206400,2017
48341,30.5,22016,7410,700,11920,5110,52469,6725,4294,2431,6725,106400,2017
48343,42.9,12530,8159,2953,1148,3621,40227,5024,3732,1292,5024,82300,2017
48345,37.6,1114,852,39,182,308,40598,469,336,133,469,57300,2017
48347,30.6,65411,39199,11221,12372,15329,41482,23825,13308,10517,23825,117700,2017
48349,38.9,48239,27631,6323,12647,12931,45103,17326,11889,5437,17326,88900,2017
48351,43.5,14187,10442,3024,490,3158,40180,4781,3957,824,4781,73300,2017
48353,38.8,14990,8548,733,5456,3802,42019,5552,3845,1707,5552,66100,2017
48355,35.1,358484,108703,12915,225811,87821,53317,128857,74465,54392,128857,122400,2017
48357,31.7,10484,4662,18,5553,2752,50120,3549,2562,987,3549,102400,2017
48359,29.9,2083,1579,117,322,421,62426,581,429,152,581,87000,2017
48361,37.7,83909,68273,6928,5946,22834,53667,32272,24309,7963,32272,104700,2017
48363,41,28109,21203,681,5539,7192,45067,10441,7331,3110,10441,88600,2017
48365,38.7,23574,17311,3844,2017,6358,49704,9032,6995,2037,9032,97200,2017
48367,39.6,125963,106370,1642,14461,33503,70608,43942,34062,9880,43942,180900,2017
48369,34.1,9871,3468,161,6161,2499,50410,3222,2221,1001,3222,86200,2017
48371,36.2,15804,4094,654,10822,2983,50543,4420,3075,1345,4420,68600,2017
48373,43.4,46974,33325,4895,6946,12291,43267,17632,13523,4109,17632,84900,2017
48375,33.6,121230,54757,11301,45560,28289,41852,43453,24906,18547,43453,89000,2017
48377,41.4,7191,979,0,5854,1708,26486,2589,1543,1046,2589,50700,2017
48379,47.6,11246,9653,172,973,3061,48308,4333,3346,987,4333,114000,2017
48381,35.6,130552,95851,3596,26314,34000,65564,49118,34303,14815,49118,157600,2017
48383,33,3735,1078,27,2620,897,59760,1171,823,348,1171,88400,2017
48385,54.3,3358,2685,7,664,693,36493,1123,862,261,1123,105100,2017
48387,45.6,12353,9035,2176,897,3334,35356,5218,3956,1262,5218,65200,2017
48389,35.4,14791,2693,661,11096,2589,49390,3731,2674,1057,3731,52900,2017
48391,42.3,7293,3084,363,3626,1856,50338,2694,1947,747,2694,80800,2017
48393,37.8,889,805,0,66,251,79167,326,242,84,326,135700,2017
48395,41.4,16727,9682,3299,3382,4416,52189,6298,4691,1607,6298,93900,2017
48397,37.2,90414,65357,5437,15419,24526,93269,30365,24414,5951,30365,225400,2017
48399,41.1,10266,6394,134,3474,2699,41226,3781,2714,1067,3781,76500,2017
48401,38.5,53026,34304,9029,8559,13096,49270,17982,13677,4305,17982,111200,2017
48403,52.1,10429,8977,789,422,2516,33561,3811,3353,458,3811,92100,2017
48405,48.9,8403,5783,1746,584,2138,32394,3202,2537,665,3202,81900,2017
48407,44.2,27436,20537,2932,3433,6588,43421,9414,7812,1602,9414,95900,2017
48409,35.1,66867,26351,992,38004,17294,53332,23246,15546,7700,23246,105400,2017
48411,40.9,5851,3823,161,1739,1255,40301,2135,1438,697,2135,97000,2017
48413,35.2,3122,1489,9,1618,808,63432,1102,847,255,1102,72900,2017
48415,35.6,17346,9306,784,6891,3910,54565,5838,4327,1511,5838,89800,2017
48417,42,3348,2867,6,391,847,46685,1257,992,265,1257,78900,2017
48419,37.4,25689,15961,4837,4580,6369,38121,9218,6580,2638,9218,73100,2017
48421,39.8,3067,1712,8,1327,817,54961,1063,860,203,1063,86800,2017
48423,36.6,222277,134122,38746,42128,53391,50742,77801,51275,26526,77801,144800,2017
48425,40.6,8650,6804,51,1648,2446,52346,3234,2391,843,3234,172200,2017
48427,28.8,63420,403,24,62903,13314,27133,16320,12136,4184,16320,67200,2017
48429,39.2,9365,6756,204,2176,2318,45862,3361,2653,708,3361,73400,2017
48431,42.4,1139,654,3,465,334,50000,462,393,69,462,66100,2017
48433,51.9,1084,787,38,246,276,46786,458,348,110,458,53700,2017
48435,40.2,3894,1528,3,2314,1153,60996,1573,1073,500,1573,95500,2017
48437,35.6,7541,3584,429,3253,1925,37883,2602,1814,788,2602,70800,2017
48439,34.2,1983675,959103,308577,559025,481588,62532,689921,418852,271069,689921,158200,2017
48441,32.2,135371,87366,10018,32219,32712,49161,49443,29152,20291,49443,112400,2017
48443,47.3,721,239,23,406,182,26063,343,263,80,343,66600,2017
48445,34.6,12755,5203,592,6858,2987,42441,4142,2894,1248,4142,68000,2017
48447,48.2,1541,1271,2,244,464,37279,712,520,192,712,68600,2017
48449,34,32664,15121,2970,13749,8310,46980,10675,7163,3512,10675,96300,2017
48451,34,116906,63505,4682,45407,27150,49662,43081,27169,15912,43081,122600,2017
48453,33.6,1176584,580292,92653,398398,254476,68350,447561,234225,213336,447561,275800,2017
48455,48.5,14481,11454,1382,1347,3947,37398,5934,4616,1318,5934,75300,2017
48457,43,21456,17081,2313,1564,5224,44396,7312,6163,1149,7312,81500,2017
48459,40.7,40506,32704,3611,3263,9904,48796,14061,10823,3238,14061,111600,2017
48461,33.7,3575,1537,238,1778,865,52750,1308,954,354,1308,62900,2017
48463,33.8,27015,7325,40,19158,5860,40781,8624,6284,2340,8624,77800,2017
48465,31.7,48976,7811,534,39855,11541,44609,15189,9592,5597,15189,94500,2017
48467,43.3,53607,45206,1406,5510,13726,50061,19354,14926,4428,19354,112600,2017
48469,35.7,91518,41590,5331,42139,22989,55740,32734,21458,11276,32734,129100,2017
48471,35.2,70818,40319,16198,12584,12366,41456,21294,11241,10053,21294,132200,2017
48473,28.8,48443,20853,12041,14230,10755,53506,14698,10084,4614,14698,157600,2017
48475,33.6,11498,4758,553,6001,2671,63333,3954,2767,1187,3954,85600,2017
48477,42,34667,22344,5882,5372,8442,55793,12205,9398,2807,12205,163400,2017
48479,28.4,269624,9382,736,257482,58364,40442,72379,45601,26778,72379,115500,2017
48481,37.3,41430,18756,5725,16682,10735,50145,15224,10269,4955,15224,115700,2017
48483,39.4,5599,3825,150,1485,1548,50910,2287,1461,826,2287,86500,2017
48485,34.2,131778,87142,13018,24423,30787,45776,48528,29759,18769,48528,93200,2017
48487,37.2,12972,7708,1034,3710,3320,43913,5155,3343,1812,5155,69900,2017
48489,33.4,21839,2415,142,19208,4689,29104,5737,4465,1272,5737,49100,2017
48491,35.8,508313,309652,30364,122387,122968,79123,170051,117210,52841,170051,227100,2017
48493,40.4,47205,27225,634,18488,12365,71942,15755,13157,2598,15755,170600,2017
48495,32.6,7777,2870,181,4619,1772,55000,2524,1974,550,2524,58200,2017
48497,38.5,63247,49012,752,11859,16280,59081,21691,16642,5049,21691,141700,2017
48499,48.1,43315,36029,2389,4167,11660,48038,16122,12965,3157,16122,117000,2017
48501,31.7,8481,2813,0,5516,2037,62500,2652,2054,598,2652,81900,2017
48503,41.5,18166,14306,271,3283,5239,46351,7066,5530,1536,7066,87500,2017
48505,29.4,14415,753,0,13560,3400,34550,4457,3222,1235,4457,60700,2017
48507,30.8,12152,660,61,11374,2570,25988,3536,2452,1084,3536,39900,2017
49001,33.3,6414,5687,0,700,1603,47878,2313,1643,670,2313,147300,2017
49003,32.3,52182,45542,255,4761,13513,58835,17035,12987,4048,17035,179600,2017
49005,25,120288,100797,840,12656,27394,53812,36829,23228,13601,36829,202400,2017
49007,36.4,20512,17079,136,2708,5096,46994,7841,5712,2129,7841,129900,2017
49009,47.3,702,666,1,23,139,85000,168,157,11,168,202900,2017
49011,30.6,334977,282951,4145,30912,82775,75961,101422,78443,22979,101422,246500,2017
49013,30.3,20259,17292,28,1644,5259,63000,6650,4941,1709,6650,178100,2017
49015,35,10410,9513,13,647,2764,51852,3564,2848,716,3564,136200,2017
49017,41.2,5020,4495,1,282,1293,51700,1756,1405,351,1756,166300,2017
49019,39.8,9544,8407,23,955,2625,46658,3873,2710,1163,3873,230900,2017
49021,29.1,48504,41863,244,4102,11246,45422,15575,10023,5552,15575,183100,2017
49023,30.7,10694,9883,24,487,2645,57590,3287,2657,630,3287,175800,2017
49025,42.2,7246,6648,9,327,1495,50266,2514,2036,478,2514,190200,2017
49027,35.5,12651,10534,39,1643,3377,59312,4235,3328,907,4235,150300,2017
49029,32.4,11014,10498,39,290,2903,86071,3236,2736,500,3236,311000,2017
49031,40.6,1860,1781,3,67,381,41750,516,455,61,516,143800,2017
49033,34.3,2307,2050,2,206,466,52917,601,461,140,601,160400,2017
49035,32.4,1106700,797514,18343,198222,255828,67922,363058,241328,121730,363058,260700,2017
49037,31.6,15193,6688,26,809,3036,42581,4019,3235,784,4019,136600,2017
49039,31.7,28892,24863,268,2757,6541,50928,8366,6193,2173,8366,169400,2017
49041,34.9,20961,19298,83,1039,5493,50850,7171,5503,1668,7171,152800,2017
49043,38.8,39731,33700,265,4522,10917,94952,14781,10899,3882,14781,558300,2017
49045,31.1,63357,52863,310,7622,15643,66542,19562,15499,4063,19562,196300,2017
49047,30.1,36343,29768,165,2998,7714,67012,10616,8104,2512,10616,194800,2017
49049,24.5,576496,478514,2995,65539,127466,67042,155664,104703,50961,155664,256900,2017
49051,33.3,29306,24496,26,3960,7098,74552,9040,6309,2731,9040,357300,2017
49053,35.9,155577,132089,979,15655,39432,55175,52385,36722,15663,52385,240300,2017
49055,40.4,2700,2479,4,145,670,42444,990,758,232,990,175800,2017
49057,32.3,244101,187247,2448,43633,59438,62036,81298,58406,22892,81298,183100,2017
50001,43.4,36825,34245,337,795,9418,61875,14701,10648,4053,14701,237000,2017
50003,46.6,36054,34160,289,632,9764,52251,15280,11139,4141,15280,208600,2017
50005,43.7,30576,29070,272,460,7331,47371,12094,8850,3244,12094,164500,2017
50007,36.6,160985,143657,4091,3542,37357,66906,64906,40980,23926,64906,280000,2017
50009,50,6203,5929,64,83,1726,38767,2720,2148,572,2720,128900,2017
50011,39.9,48816,45986,302,701,12788,62214,18649,13848,4801,18649,209100,2017
50013,48.1,6950,6479,13,124,2092,66111,2952,2362,590,2952,274700,2017
50015,40.5,25191,23895,214,408,6315,54899,10401,7427,2974,10401,225200,2017
50017,45.7,28901,27649,188,386,7969,56584,12275,9911,2364,12275,188300,2017
50019,45.4,26951,25734,115,367,7360,45664,11498,8948,2550,11498,161100,2017
50021,46.4,59676,57018,445,817,15099,52635,25160,18141,7019,25160,177600,2017
50023,43.5,58691,55387,468,1087,15279,60602,24719,17709,7010,24719,217200,2017
50025,46.8,43332,40499,343,948,11151,50831,19059,12906,6153,19059,212000,2017
50027,47.4,55485,52696,393,833,14918,56828,24121,17304,6817,24121,216300,2017
51001,46,32840,19815,9308,2901,8955,42260,13528,9466,4062,13528,157200,2017
51003,38.6,105105,81167,9987,5991,25494,72265,40015,25459,14556,40015,329600,2017
51005,46.9,15489,14230,846,221,4324,46020,6866,5225,1641,6866,113600,2017
51007,46.5,12802,9265,3037,142,3409,58535,4699,3928,771,4699,185100,2017
51009,43.9,31819,24028,5587,720,8317,49677,12110,9313,2797,12110,151500,2017
51011,43.5,15462,11862,3103,196,4480,54875,5948,4817,1131,5948,151700,2017
51013,34.4,229534,142962,19591,35687,47715,112138,102310,45525,56785,102310,643300,2017
51015,44.6,74390,68003,2967,1886,20640,59544,28790,22774,6016,28790,206300,2017
51017,47.3,4458,3802,119,252,1137,44483,1847,1365,482,1847,151100,2017
51019,45.9,77319,68163,5397,1582,22524,59405,30927,25167,5760,30927,198100,2017
51021,45.3,6524,6151,312,33,1840,46927,2561,2116,445,2561,109300,2017
51023,47.2,33149,30837,999,521,9600,64733,13238,11274,1964,13238,220000,2017
51025,43.4,16435,6752,8888,345,3802,40871,6048,4472,1576,6048,110900,2017
51027,46.3,22611,21563,635,61,6146,30828,9022,7116,1906,9022,71900,2017
51029,42.7,17048,10420,5855,401,3791,46610,5705,4298,1407,5705,132500,2017
51031,42.8,55158,44288,7713,1183,15479,48823,22608,16947,5661,22608,154300,2017
51033,40.2,29889,19001,8411,1288,7730,60925,10815,8668,2147,10815,193200,2017
51035,47,29767,28289,64,912,8263,41145,12517,9760,2757,12517,107300,2017
51036,49.8,7022,2915,3224,126,1890,55069,2899,2415,484,2899,163000,2017
51037,45.2,12176,8213,3609,250,2829,38350,4493,3198,1295,4493,107500,2017
51041,38.8,335594,210795,75068,27684,87344,76969,120907,91047,29860,120907,224200,2017
51043,46,14331,12453,703,685,3743,72129,5568,4176,1392,5568,333100,2017
51045,47.5,5131,5102,7,1,1384,53526,2344,1734,610,2344,164800,2017
51047,38.8,49795,35424,6774,4826,12540,69693,16837,12272,4565,16837,266400,2017
51049,44.5,9797,6185,3181,14,2684,43020,3972,2870,1102,3972,146600,2017
51051,43.9,15181,14852,125,125,4187,29916,6096,4630,1466,6096,77500,2017
51053,42.9,28033,17422,8912,893,7232,54640,10347,7982,2365,10347,160100,2017
51057,44.8,11083,6083,4192,378,2845,50629,4470,3153,1317,4470,177200,2017
51059,37.9,1142004,590582,106546,184595,281196,117515,393380,266707,126673,393380,534800,2017
51061,41.6,68406,55319,5113,5141,17777,94775,23981,18803,5178,23981,370000,2017
51063,46,15594,14607,390,440,4458,48396,6434,5196,1238,6434,153800,2017
51065,42.6,26109,20537,3533,854,7118,67964,9794,7911,1883,9794,228100,2017
51067,46,56277,49016,4456,1514,16278,51208,23203,18393,4810,23203,176900,2017
51069,40.5,83784,70803,3337,6522,22650,71037,30495,23620,6875,30495,239100,2017
51071,44.4,16867,16039,402,271,4646,49734,7088,5300,1788,7088,114500,2017
51073,44.6,37035,31508,3020,1215,10322,63881,14746,11378,3368,14746,224100,2017
51075,48.4,22148,17186,3642,568,6382,86652,8257,7186,1071,8257,327700,2017
51077,47.4,15708,14267,590,480,4211,32048,6653,5238,1415,6653,95700,2017
51079,39.6,19213,15995,1136,1092,5266,62952,7260,5852,1408,7260,242500,2017
51081,41.1,11606,4305,6679,456,2445,42121,3649,2754,895,3649,89400,2017
51083,45.9,35030,20959,12512,696,9258,39233,14084,10220,3864,14084,110800,2017
51085,42.6,103218,87131,9331,2886,28949,84955,38208,31070,7138,38208,267600,2017
51087,38.3,324073,175647,95051,17556,80370,66447,126115,79311,46804,126115,223900,2017
51089,46.8,51956,36506,11283,2709,14785,36779,22161,16220,5941,22161,94300,2017
51091,60.5,2213,2200,0,0,692,45094,1163,994,169,1163,184000,2017
51093,44.4,36090,25551,8035,1013,10204,67767,14157,10939,3218,14157,249100,2017
51095,45.9,73028,55458,9450,3976,20141,80772,28410,21117,7293,28410,328700,2017
51097,45.1,7052,4658,1820,225,1862,51495,2811,2213,598,2811,170000,2017
51099,37.1,25564,18864,4188,1188,6713,84770,8972,6780,2192,8972,294300,2017
51101,41.3,16329,12438,2971,129,4839,67423,6079,5233,846,6079,199700,2017
51103,56.3,10848,7401,3040,188,3051,51495,5081,3719,1362,5081,226900,2017
51105,43.8,24428,22681,1069,492,6315,32590,9278,6671,2607,9278,81700,2017
51107,35.8,374558,216051,26940,50426,94277,129588,121299,94437,26862,121299,475500,2017
51109,44.5,34813,26947,5262,921,9553,56946,13451,10721,2730,13451,212900,2017
51111,45.4,12369,7415,3806,529,3036,39537,4480,3227,1253,4480,108400,2017
51113,45.2,13108,11147,880,315,3662,52287,5107,3749,1358,5107,256500,2017
51115,52.6,8830,7573,927,60,2540,63622,3766,3248,518,3766,227200,2017
51117,47.9,30959,18623,11040,829,7483,41126,11785,8503,3282,11785,125300,2017
51119,53.5,10710,8318,1977,55,2925,50483,4522,3659,863,4522,248400,2017
51121,28.2,97692,81970,4172,2983,19389,53424,35577,19520,16057,35577,213300,2017
51125,49.7,14863,12132,1873,581,4337,53834,6523,4685,1838,6523,231400,2017
51127,44,20523,16326,2336,598,5942,78429,7555,6182,1373,7555,256600,2017
51131,48.4,11998,6485,4183,1008,3322,41468,5177,3344,1833,5177,165800,2017
51133,56.5,12254,8568,3491,59,3986,56677,5774,4917,857,5774,277900,2017
51135,41.3,15537,8484,6142,633,3751,38410,5633,3318,2315,5633,134800,2017
51137,41.9,35265,27817,4341,1605,9658,67196,13470,10406,3064,13470,235200,2017
51139,45,23694,22383,345,443,6508,46140,9467,6525,2942,9467,172200,2017
51141,49.2,17958,16144,994,502,5181,37757,7713,5942,1771,7713,116000,2017
51143,46.4,61970,45982,13045,1542,18358,44356,26687,20068,6619,26687,113800,2017
51145,44.6,28364,23989,3135,574,7966,80441,9974,8954,1020,9974,264300,2017
51147,30.8,22903,14184,7160,862,4533,44147,7281,4722,2559,7281,154800,2017
51149,37.1,37704,20978,11766,2852,8715,68461,11298,7710,3588,11298,212100,2017
51153,34.7,450763,201113,91160,101042,107839,101059,139306,100948,38358,139306,358300,2017
51155,46.2,34330,31221,1600,555,9838,49691,14577,10615,3962,14577,139600,2017
51157,49.5,7359,6566,280,261,2154,62541,3131,2354,777,3131,358600,2017
51159,44,8873,5406,2281,589,2183,47341,3250,2338,912,3250,163200,2017
51161,43.7,93419,80819,5419,2656,26035,62134,38434,28751,9683,38434,192100,2017
51163,48.6,22440,20846,676,367,6084,53918,9160,7040,2120,9160,197200,2017
51165,41.8,78653,70410,1534,5099,21838,57651,30503,22351,8152,30503,206700,2017
51167,44.8,27725,26845,261,352,7365,40083,11102,8643,2459,11102,94900,2017
51169,46.3,22290,21591,185,287,6020,38725,8976,6931,2045,8976,90500,2017
51171,44.2,42854,37891,735,2970,11693,53934,17262,12035,5227,17262,204000,2017
51173,44.6,31298,29513,718,622,8499,40544,12829,9015,3814,12829,89600,2017
51175,45.8,18089,10986,5985,271,4928,53681,6664,4773,1891,6664,172800,2017
51177,37.7,130159,90467,20106,11706,33291,81434,43279,33482,9797,43279,265600,2017
51179,35.2,141159,89967,23125,16515,36991,103005,45345,34377,10968,45345,327600,2017
51181,49.3,6670,3474,3043,55,2077,54656,2773,2110,663,2773,172700,2017
51183,40.4,11595,4415,6503,331,2142,44608,3388,2395,993,3388,121600,2017
51185,44.3,42689,40125,1279,392,11532,40309,17330,13304,4026,17330,96500,2017
51187,40.6,38991,34156,1407,1622,10025,65353,14190,10887,3303,14190,231000,2017
51191,45.5,54457,51925,765,806,15019,44844,22388,16926,5462,22388,137200,2017
51193,47.6,17596,11234,4683,1086,4532,55688,7412,5695,1717,7412,203100,2017
51195,40.3,39539,36259,2082,482,10261,38255,15104,10455,4649,15104,84500,2017
51197,44.4,29048,27295,924,332,7829,46119,11892,9036,2856,11892,127400,2017
51199,39.6,67196,48357,8502,4016,19179,86781,24333,17547,6786,24333,315400,2017
51510,36.4,154710,80143,33557,25900,33164,93370,68663,29576,39087,68663,537900,2017
51520,42.3,17077,15005,1319,93,4666,37844,7418,4372,3046,7418,114100,2017
51530,36.4,6495,5738,165,46,1782,33672,2606,1623,983,2606,111700,2017
51540,30.9,46487,30526,8704,2431,8433,54739,18408,8116,10292,18408,277800,2017
51550,36.6,235410,137401,68775,13209,62298,72214,83031,58843,24188,83031,260900,2017
51570,40.1,17582,13068,2312,971,4464,50952,7092,4471,2621,7092,163300,2017
51580,44.2,5675,4626,736,116,1431,35546,2399,1805,594,2399,72200,2017
51590,40.6,41911,18316,20412,1625,10761,34951,18517,9844,8673,18517,90900,2017
51595,35.9,5495,1623,3531,311,1461,27426,2119,902,1217,2119,115700,2017
51600,39,23580,13652,1145,3985,5680,106870,8499,5949,2550,8499,501900,2017
51610,39.7,13843,9968,625,1474,3459,114795,5308,3178,2130,5308,742000,2017
51620,38.7,8334,3112,4907,59,2267,38760,3470,1726,1744,3470,186100,2017
51630,29.9,28135,16882,5985,3007,5701,57258,10419,3746,6673,10419,341200,2017
51640,46.6,6788,5184,490,997,1809,31311,2837,1674,1163,2837,105500,2017
51650,35.8,136255,53475,66977,7389,32352,52021,53555,30471,23084,53555,186600,2017
51660,24.8,53064,35728,3379,9922,8836,43009,16848,6445,10403,16848,196200,2017
51670,36.5,22353,10905,8940,1636,5577,40712,9123,4653,4470,9123,122400,2017
51678,21.6,7113,5677,621,343,786,37309,1935,1147,788,1935,252500,2017
51680,28.3,79237,49653,22449,2901,16422,41971,28150,13978,14172,28150,153800,2017
51683,33.5,41379,17644,5295,14477,9507,77551,12540,7979,4561,12540,307000,2017
51685,34.1,16117,5800,2065,6085,3495,79131,4778,3224,1554,4778,263300,2017
51690,41.5,13256,6042,6198,670,3302,33545,5740,3165,2575,5740,90100,2017
51700,33.2,180775,79598,71872,15615,42285,51082,68665,34345,34320,68665,189300,2017
51710,30.4,245752,107229,101370,18715,50157,47137,87249,37854,49395,87249,194800,2017
51720,37.2,4043,3637,155,35,990,26971,1786,868,918,1786,92500,2017
51730,38.3,32037,4806,24223,1492,7162,33939,13262,5532,7730,13262,112900,2017
51735,42.2,12022,11095,124,287,3363,88328,4583,3659,924,4583,316800,2017
51740,35.2,95536,36631,49817,3891,22176,48727,36616,19936,16680,36616,169400,2017
51750,22.7,17380,14480,1619,501,2415,36082,5503,2559,2944,5503,160600,2017
51760,33.5,220892,88320,105878,14343,40367,42356,89238,37190,52048,89238,209200,2017
51770,38.4,99572,59263,27865,6012,23106,41483,42333,21977,20356,42333,133700,2017
51775,41.1,25521,21897,1840,815,6313,53990,9997,6551,3446,9997,174000,2017
51790,42,24273,19768,2683,692,5881,46435,10477,6026,4451,10477,162500,2017
51800,38.1,88057,43750,36310,3527,23737,68089,32331,22380,9951,32331,238200,2017
51810,35.6,450057,281070,82987,35255,116008,70500,167731,107096,60635,167731,267300,2017
51820,40,21620,16649,2647,1547,5432,42112,9128,5376,3752,9128,161600,2017
51830,24.5,14817,10062,2152,1136,2127,54606,4649,2198,2451,4649,307000,2017
51840,37.6,27516,18447,2676,4647,6181,49330,10520,4802,5718,10520,226200,2017
53001,28.4,19261,6784,50,11992,4427,48131,5824,3745,2079,5824,150300,2017
53003,44.7,22259,20310,98,812,5804,47483,9235,6531,2704,9235,176700,2017
53005,35.6,190529,136348,2762,39718,48526,63001,70363,47936,22427,70363,198600,2017
53007,39.9,75138,51355,278,20688,18208,54975,27383,18007,9376,27383,256400,2017
53009,50.5,73439,61144,783,4419,19472,48002,32280,22480,9800,32280,227400,2017
53011,38,457474,363383,8025,41165,117089,67832,167717,110347,57370,167717,272400,2017
53013,50,3999,3461,21,297,1088,46250,1759,1249,510,1759,161700,2017
53015,41.4,103590,87327,691,8936,26811,49804,40668,26975,13693,40668,186600,2017
53017,37.3,40585,26332,75,12548,10805,55805,14706,10337,4369,14706,229100,2017
53019,49,7568,5572,6,325,1970,41081,3056,2152,904,3056,165900,2017
53021,29.9,89124,36673,1765,46775,19875,60275,25835,17835,8000,25835,177400,2017
53023,46.7,2226,2043,0,53,653,51399,1007,695,312,1007,143800,2017
53025,32.6,93420,51309,623,38023,22127,52382,30512,18928,11584,30512,161700,2017
53027,43.5,71454,57064,686,6978,17782,45483,28070,18547,9523,28070,161800,2017
53029,44.1,80323,64343,2505,5733,23094,61516,34027,23180,10847,34027,311400,2017
53031,57.1,30524,27075,159,1062,8624,51842,13903,10211,3692,13903,304000,2017
53033,37.2,2118119,1300694,127179,200545,512299,83571,851077,488554,362523,851077,446600,2017
53035,39.1,258903,200498,6407,18954,67889,68336,100484,67077,33407,100484,277500,2017
53037,33.3,43726,36885,451,3778,9555,53163,17648,10172,7476,17648,256700,2017
53039,45.9,21172,17405,58,2565,5366,51258,8247,5572,2675,8247,219200,2017
53041,42.8,76012,63980,413,7460,19977,46387,30036,20666,9370,30036,176000,2017
53043,48.6,10344,9501,57,323,3018,49460,4416,3487,929,4416,150500,2017
53045,45.9,61569,50093,585,5694,15196,53087,23034,17785,5249,23034,206700,2017
53047,43.1,41377,27227,181,8008,11522,42598,17075,11502,5573,17075,169100,2017
53049,52.7,20940,17262,70,1927,5446,39895,8786,6701,2085,8786,163400,2017
53051,50.2,13066,11612,29,467,3845,49184,5637,4388,1249,5637,186000,2017
53053,36,845193,574507,54780,87702,208065,63881,312839,191613,121226,312839,255800,2017
53055,55.7,16221,14438,104,973,4692,60271,7718,5718,2000,7718,452300,2017
53057,41.4,121725,91371,888,21851,31961,59263,47341,32080,15261,47341,269100,2017
53059,46,11498,10139,105,685,3116,53606,4713,3265,1448,4713,248500,2017
53061,37.8,771904,549547,20409,75763,194472,78020,284477,189431,95046,284477,338400,2017
53063,37.4,490764,418428,7958,26375,123597,52159,194995,121774,73221,194995,195500,2017
53065,46.4,43858,38106,201,1552,12128,47272,17534,13526,4008,17534,184600,2017
53067,38.9,269885,204684,7601,22980,70386,66113,106229,67862,38367,106229,255500,2017
53069,53.3,4105,3634,8,237,1284,49508,1823,1477,346,1823,202600,2017
53071,37.3,59862,43269,837,12631,14374,52630,22391,14453,7938,22391,196300,2017
53073,36.9,212738,169696,1987,19198,50745,56419,83475,51560,31915,83475,299800,2017
53075,24.5,47794,38009,950,2836,8528,41574,17657,7856,9801,17657,199400,2017
53077,32.7,248279,109974,1818,120080,58723,47470,81720,51225,30495,81720,163500,2017
54001,40.9,16790,16076,154,149,4222,37516,6293,4508,1785,6293,101200,2017
54003,38.8,111610,94395,7997,4486,29598,59480,42456,31348,11108,42456,168200,2017
54005,42.5,23236,22733,184,133,6530,37955,9298,7148,2150,9298,71800,2017
54007,44.9,14345,13934,50,144,4110,41266,5498,4267,1231,5498,91100,2017
54009,46.2,23067,22087,394,205,6382,48835,9961,7440,2521,9961,91000,2017
54011,38.3,96100,86577,4718,1325,22702,37816,40239,24523,15716,40239,119800,2017
54013,47.9,7450,7250,2,94,1950,36279,2808,2355,453,2808,79900,2017
54015,43.6,8901,8694,2,24,2289,34242,3365,2739,626,3365,79100,2017
54017,44.5,8570,8200,118,37,1817,44437,2662,2237,425,2662,105900,2017
54019,43.3,44602,41255,2297,482,12196,39297,17697,13889,3808,17697,86400,2017
54021,38,8305,6711,901,344,1746,37175,2703,2008,695,2703,91600,2017
54023,46.3,11673,11304,188,113,2895,40093,4372,3486,886,4372,144600,2017
54025,45.4,35523,32933,917,616,9622,40483,15255,11077,4178,15255,115400,2017
54027,45.4,23412,22461,257,311,5552,36575,9676,6244,3432,9676,136700,2017
54029,46.1,29921,28141,626,428,8132,43634,12760,9149,3611,12760,89800,2017
54031,44.9,13812,12540,457,587,4070,42573,5561,4051,1510,5561,121900,2017
54033,42,68438,64635,1130,1063,18027,48315,27542,20513,7029,27542,110000,2017
54035,43,29123,28290,27,125,7715,41731,11149,8643,2506,11149,113300,2017
54037,40.2,55673,46666,3630,2972,14643,72526,20808,15420,5388,20808,227300,2017
54039,43.1,187827,164970,12962,1982,50303,46859,80267,55469,24798,80267,111200,2017
54041,42.8,16371,15808,36,208,4532,39793,6586,4634,1952,6586,98600,2017
54043,42.7,21241,20817,116,129,5564,37075,8046,6221,1825,8046,82000,2017
54045,43,34428,33039,558,289,9586,37859,13978,10337,3641,13978,85800,2017
54047,44,19707,17486,1617,308,5168,25595,7702,6117,1585,7702,34800,2017
54049,41.3,56575,52548,2011,680,14789,48158,22718,17074,5644,22718,110100,2017
54051,44.9,32006,30985,305,317,8497,42473,12695,9924,2771,12695,99800,2017
54053,44,27000,26148,86,175,7698,38977,11079,8586,2493,11079,78300,2017
54055,42.7,60963,55122,3689,645,16507,37763,25019,17959,7060,25019,89400,2017
54057,43.5,27421,25828,918,238,7287,40749,11274,7530,3744,11274,129800,2017
54059,42.1,25150,24161,478,5,7412,31227,10910,8055,2855,10910,71000,2017
54061,30.9,103715,91607,3821,2161,20431,49624,38410,22149,16261,38410,178200,2017
54063,47.7,13517,13018,87,169,4003,36684,5815,4672,1143,5815,105700,2017
54065,47,17510,16754,119,250,4518,46346,7118,5776,1342,7118,170600,2017
54067,44.9,25496,24811,122,146,7361,39037,10671,8474,2197,10671,88900,2017
54069,43.5,42906,39622,1715,447,10441,45777,17846,12382,5464,17846,114800,2017
54071,49.9,7138,6763,238,78,2036,39554,3032,2421,611,3032,107900,2017
54073,43.4,7527,7381,4,56,2151,45152,2868,2340,528,2868,104700,2017
54075,48.6,8574,8199,79,133,2189,37111,3647,2980,667,3647,117200,2017
54077,42.6,33760,31037,1480,725,8627,46673,12420,10160,2260,12420,106600,2017
54079,41.6,56644,54072,694,629,15415,59113,21734,17667,4067,21734,157500,2017
54081,42,77097,67043,5998,1210,21230,42386,31069,22736,8333,31069,105700,2017
54083,43.1,29152,28008,559,252,7377,40094,11391,8235,3156,11391,99800,2017
54085,45.8,10005,9862,5,34,2543,41497,3825,3007,818,3825,82100,2017
54087,44.8,14348,13915,7,142,3972,37931,5815,4618,1197,5815,92700,2017
54089,47.3,13210,12125,648,165,3614,35218,5482,4055,1427,5482,95100,2017
54091,43.2,16977,16308,218,76,4272,45916,6616,5197,1419,6616,100200,2017
54093,48.1,7035,6863,16,48,1897,43294,2951,2388,563,2951,104300,2017
54095,46.5,8949,8766,16,23,2340,40902,3563,2765,798,3563,92400,2017
54097,41.8,24604,23694,316,307,6172,39434,9341,6962,2379,9341,111900,2017
54099,43.3,41063,40050,114,258,11088,38905,16305,12182,4123,16305,90600,2017
54101,46.2,8637,8606,3,0,2481,33390,3690,2633,1057,3690,68400,2017
54103,45.9,15793,15397,91,77,3858,40694,5979,4716,1263,5979,90700,2017
54105,43.4,5800,5640,55,52,1577,38936,2427,2025,402,2427,81400,2017
54107,43,86016,82004,993,913,23362,45537,36110,25687,10423,36110,115100,2017
54109,43.8,22130,21548,191,56,6528,37644,9169,7477,1692,9169,67900,2017
55001,52.6,20111,18240,549,772,5281,44003,8163,6916,1247,8163,127800,2017
55003,41.7,15779,13049,69,417,3880,41505,6504,4455,2049,6504,107400,2017
55005,44.2,45358,42563,540,1092,12507,49257,19133,14247,4886,19133,145500,2017
55007,51.6,15004,12755,91,261,4412,50110,6859,5726,1133,6859,163400,2017
55009,37,258004,210468,5557,21472,66762,56775,103267,67264,36003,103267,163200,2017
55011,45.7,13243,12701,65,289,3901,54753,5723,4308,1415,5723,150400,2017
55013,52.1,15239,13803,80,255,4727,45891,7284,5884,1400,7284,150800,2017
55015,39.8,49737,45439,392,2022,14327,70662,19345,15628,3717,19345,168400,2017
55017,41.2,63445,59545,807,1055,17015,55240,25247,18230,7017,25247,154900,2017
55019,37.5,34513,32258,151,1514,8794,49131,12755,9921,2834,12755,117400,2017
55021,42.4,56790,52863,759,1771,15787,63293,23317,17241,6076,23317,180100,2017
55023,45.7,16313,15479,276,213,4107,47331,6610,5033,1577,6610,127000,2017
55025,34.8,522837,419230,26167,32985,124351,67631,216930,126397,90533,216930,242700,2017
55027,42.4,87833,79317,2117,4049,22428,56038,33987,23913,10074,33987,156200,2017
55029,52.3,27443,25879,148,785,8807,56494,13159,10301,2858,13159,204700,2017
55031,41.3,43503,40000,527,657,11356,50730,18717,12579,6138,18717,140400,2017
55033,34.2,44260,41192,227,801,10457,54605,16652,11405,5247,16652,156700,2017
55035,34.3,102388,92796,805,2389,23755,52178,40528,25473,15055,40528,156200,2017
55037,51.9,4354,4289,12,38,1311,47827,1979,1712,267,1979,132600,2017
55039,41.2,102082,92193,1224,5072,27505,57798,41387,29466,11921,41387,149400,2017
55041,46.2,9035,7204,80,196,2615,43356,4040,3025,1015,4040,131400,2017
55043,35.6,51742,49292,653,791,11968,50522,19444,13448,5996,19444,137200,2017
55045,42.8,36869,34855,143,1112,10054,60609,14957,11027,3930,14957,163600,2017
55047,45.5,18745,17423,120,866,5146,50276,7932,5884,2048,7932,139300,2017
55049,42.5,23576,22547,163,403,6633,60017,9799,7270,2529,9799,171700,2017
55051,53.8,5748,5514,36,68,1757,39855,2948,2246,702,2948,107200,2017
55053,42.1,20531,17742,456,662,5326,51108,8154,6074,2080,8154,129400,2017
55055,40.1,84586,76065,672,5891,22329,59215,32739,22806,9933,32739,177500,2017
55057,45.2,26427,24277,595,782,6372,48817,10149,7819,2330,10149,120100,2017
55059,37.9,167886,128171,12087,21354,41335,57269,63286,41539,21747,63286,164100,2017
55061,43.9,20378,19349,93,560,5673,60320,8234,6437,1797,8234,155900,2017
55063,35.5,117582,106164,1557,2101,28130,54127,46966,29983,16983,46966,161300,2017
55065,41.6,16755,15842,70,605,4626,55859,6714,5085,1629,6714,126600,2017
55067,47.6,19190,18131,184,357,5325,44122,8646,6632,2014,8646,106200,2017
55069,46.9,27994,26784,150,404,8311,54203,12560,9732,2828,12560,135500,2017
55071,44.5,79680,72693,562,2945,21633,51053,34119,25605,8514,34119,126200,2017
55073,40.7,135293,120585,914,3624,36597,56509,54820,39911,14909,54820,147600,2017
55075,47.7,40712,38925,263,631,11408,44958,18548,13801,4747,18548,116600,2017
55077,49.4,15164,14200,93,478,4024,49052,6389,5171,1218,6389,144000,2017
55078,31.4,4506,396,22,270,977,38080,1354,898,456,1354,85400,2017
55079,34.6,956586,499245,249356,139469,216055,46784,382027,189686,192341,382027,150300,2017
55081,39.5,45303,41327,671,1881,11697,56479,17832,12472,5360,17832,144100,2017
55083,46.3,37465,35697,150,639,10859,55762,15634,13027,2607,15634,156700,2017
55085,50.6,35352,33636,258,504,9735,52945,14994,12547,2447,14994,165000,2017
55087,37.9,183288,161409,2215,7663,48272,61523,72288,50989,21299,72288,160100,2017
55089,43.9,87817,80867,1194,2429,24944,80526,35044,26368,8676,35044,262100,2017
55091,45.8,7282,7038,30,125,2025,51470,3005,2440,565,3005,143800,2017
55093,36.6,41226,38997,227,794,10246,66772,15302,11141,4161,15302,193300,2017
55095,44.8,43328,41280,132,810,12265,53551,18189,14256,3933,18189,158300,2017
55097,36.6,70371,64533,489,2142,17130,54620,28072,19271,8801,28072,158800,2017
55099,51.3,13566,12834,97,221,4127,45680,6567,5138,1429,6567,120000,2017
55101,40.1,195101,141849,20797,24763,51497,58334,75640,52188,23452,75640,165200,2017
55103,44.8,17626,16782,128,385,4937,48234,7564,5614,1950,7564,134400,2017
55105,39.3,161226,134345,7017,13573,42303,53410,64482,44273,20209,64482,135000,2017
55107,48.6,14211,13523,146,252,4118,41930,6294,4877,1417,6294,106300,2017
55109,38.3,87142,82112,745,1972,24349,77768,33389,25266,8123,33389,223000,2017
55111,41.3,63340,57848,444,3060,17016,54447,25678,17642,8036,25678,172500,2017
55113,49.7,16384,12602,109,405,4935,43565,7573,5528,2045,7573,161700,2017
55115,44.9,41136,35840,119,1079,11249,51751,17024,12997,4027,17024,135800,2017
55117,41.3,115094,97959,1794,7085,31169,56114,47532,33085,14447,47532,149800,2017
55119,43.4,20344,19612,94,368,5811,49821,8769,6738,2031,8769,129300,2017
55121,40.5,29510,26682,143,2247,7726,54009,11892,8578,3314,11892,147000,2017
55123,42.3,30378,29260,135,476,8241,49996,12095,9332,2763,12095,148900,2017
55125,53.4,21465,18239,26,474,6734,42720,10758,8225,2533,10758,206500,2017
55127,39.4,102917,87992,1071,11373,26760,58401,40246,27537,12709,40246,192500,2017
55129,50.4,15638,14788,76,267,4608,46592,7142,5602,1540,7142,147000,2017
55131,42.6,133967,124930,1502,4127,38239,73021,53756,41682,12074,53756,219600,2017
55133,43.1,396731,353698,5843,18194,109855,81140,156996,119721,37275,156996,262700,2017
55135,44.9,51651,48874,197,1548,14042,54071,21793,16047,5746,21793,142300,2017
55137,48.8,24170,21647,396,1548,6552,48412,9851,8030,1821,9851,140500,2017
55139,38,169540,151374,3533,6654,42113,55128,69759,45027,24732,69759,147300,2017
55141,43.8,73427,68092,484,2054,20208,51603,32223,23492,8731,32223,127700,2017
56001,27.1,37944,31452,494,3528,7732,45816,16009,7940,8069,16009,223000,2017
56003,41.2,11920,10509,72,1045,2887,51716,4481,3255,1226,4481,151900,2017
56005,33.2,48116,42182,142,4052,12289,80178,17588,12575,5013,17588,213900,2017
56007,38.2,15689,12192,195,2811,4144,57644,6205,4390,1815,6205,158600,2017
56009,40,14166,12928,1,1108,3922,62776,5630,4123,1507,5630,197200,2017
56011,42.2,7347,6941,15,172,2141,66944,3010,2388,622,3010,219000,2017
56013,38.3,40354,28295,217,2736,9893,55013,15167,10699,4468,15167,189700,2017
56015,43.7,13479,11622,9,1424,3595,48422,5328,4050,1278,5328,154900,2017
56017,49.7,4741,4478,0,92,1352,48403,2246,1727,519,2246,147700,2017
56019,45,8562,7854,122,182,2447,52415,3778,2718,1060,3778,255200,2017
56021,36.8,97031,76743,2523,13839,25526,62879,38447,26650,11797,38447,202800,2017
56023,39.1,18791,17390,56,842,4919,63756,7063,5539,1524,7063,205900,2017
56025,36.3,81023,70488,978,6666,20480,59400,32984,21976,11008,32984,198600,2017
56027,40.4,2479,2207,3,107,527,36793,982,703,279,982,152500,2017
56029,44.2,29276,26545,156,1679,8096,60828,11811,8534,3277,11811,236200,2017
56031,46.7,8703,7761,3,678,2410,47380,3740,2856,884,3740,169900,2017
56033,42.1,29964,27441,267,1262,8214,56455,13130,9001,4129,13130,240900,2017
56035,37.5,10037,8956,0,731,2175,84911,3197,2419,778,3197,264800,2017
56037,34,44527,35460,344,7127,11224,71083,16269,12001,4268,16269,201000,2017
56039,39,22923,18681,107,3439,5231,80049,8795,5142,3653,8795,739100,2017
56041,35.1,20758,18196,29,1883,5472,54672,7705,5556,2149,7705,178400,2017
56043,43.4,8253,6783,25,1175,2333,51362,3490,2657,833,3490,165500,2017
56045,42.2,7117,6522,33,103,2088,59605,3182,2437,745,3182,180100,2017
72001,39.5,18525,59,0,18459,4428,11680,6166,3364,2802,6166,81700,2017
72003,41,39470,1616,23,36984,9507,16199,12824,9572,3252,12824,87500,2017
72005,40.6,55722,570,161,54216,14953,16821,21322,12961,8361,21322,119700,2017
72007,40.4,26855,157,0,26698,6285,16733,8594,5710,2884,8594,115000,2017
72009,40.7,24008,84,8,23881,6380,18387,8573,6870,1703,8573,109300,2017
72011,41.3,27892,570,15,27152,6644,18765,9255,7207,2048,9255,91200,2017
72013,41.4,89550,371,10,89124,22704,17289,32308,21953,10355,32308,96600,2017
72015,38.7,18504,33,0,18471,4451,15689,6127,4838,1289,6127,87700,2017
72017,38.7,24583,28,0,24529,5921,17113,8090,5983,2107,8090,101900,2017
72019,35.5,29237,0,3,29234,6958,15694,9109,7042,2067,9109,90600,2017
72021,40.4,188614,1173,153,186957,48914,25528,69318,47815,21503,69318,138200,2017
72023,42.3,49726,122,0,49604,11106,16461,16495,9641,6854,16495,114100,2017
72025,39.7,134269,1120,92,132912,34734,24229,49386,33729,15657,49386,133300,2017
72027,40.1,32936,258,17,32661,8741,17579,11571,8029,3542,11571,108300,2017
72029,39,46779,51,11,46665,10850,19986,14603,11256,3347,14603,115900,2017
72031,41.1,161684,1264,227,159708,43449,29082,64056,44416,19640,64056,146400,2017
72033,39.1,25595,114,0,25413,6604,18663,9068,5472,3596,9068,125000,2017
72035,41,45431,220,0,45210,11668,20442,16459,10808,5651,16459,119500,2017
72037,40.9,12238,100,0,12108,3117,18998,4532,3379,1153,4532,94000,2017
72039,40.5,17325,90,0,17235,4358,14432,5949,3959,1990,5949,93400,2017
72041,38.7,41181,109,12,41006,9837,20389,12998,9170,3828,12998,117500,2017
72043,39.4,39796,182,8,39599,9751,19110,13783,10507,3276,13783,88300,2017
72045,38.1,19914,78,0,19816,4329,13523,6075,3824,2251,6075,87800,2017
72047,38.1,34933,301,0,34597,8781,14752,11026,8779,2247,11026,88900,2017
72049,39.3,1494,115,0,1368,291,23355,520,349,171,520,89600,2017
72051,39.5,37722,479,0,37209,9276,29354,12029,9281,2748,12029,143300,2017
72053,40.7,33075,253,69,32651,8461,18941,12436,8113,4323,12436,102300,2017
72054,38.2,12140,123,0,12017,3323,16919,4300,3246,1054,4300,94500,2017
72055,41.4,17327,88,0,17239,3697,12653,5528,4083,1445,5528,87700,2017
72057,37.5,42623,342,68,42143,9852,15296,14989,10901,4088,14989,90800,2017
72059,40.3,19578,70,0,19485,4702,14988,6575,4577,1998,6575,82100,2017
72061,42.7,90773,1256,26,89320,21859,34060,32913,24237,8676,32913,191200,2017
72063,38.3,47074,534,113,46356,11286,32625,15223,12540,2683,15223,147500,2017
72065,40.7,40978,71,0,40907,10466,17770,14443,10722,3721,14443,97500,2017
72067,45.1,16474,43,18,16413,4172,19674,6271,4646,1625,6271,104700,2017
72069,41.3,54736,592,20,53941,13034,18735,18378,13424,4954,18378,97300,2017
72071,40.8,43314,402,102,42689,11100,16333,15230,9674,5556,15230,103100,2017
72073,36.3,15297,19,0,15278,3700,15615,4818,3019,1799,4818,90700,2017
72075,37.5,47952,153,12,47758,12040,20228,15964,11903,4061,15964,93300,2017
72077,37.6,39704,240,0,39464,8958,18533,12627,8927,3700,12627,112800,2017
72079,43.4,23893,29,0,23864,5620,13896,8059,4566,3493,8059,91400,2017
72081,41.1,27321,82,7,27196,7447,12820,10051,5669,4382,10051,86400,2017
72083,40.1,8874,103,0,8771,2195,14404,3033,2104,929,3033,73100,2017
72085,38.1,38253,56,76,38095,9504,20587,12534,9327,3207,12534,115600,2017
72087,37.5,27242,7,6,27187,6505,17273,8919,6394,2525,8919,105200,2017
72089,39.8,18952,260,10,18608,4785,19377,6636,4677,1959,6636,109200,2017
72091,40.9,40705,363,155,40131,11270,18191,15703,11582,4121,15703,106600,2017
72093,42.7,6180,12,0,6168,1374,13462,1914,1414,500,1914,92900,2017
72095,43.5,11297,128,0,11169,2762,17636,3976,3038,938,3976,91000,2017
72097,39.9,79615,395,29,79076,18443,14642,29769,17440,12329,29769,99800,2017
72099,38.6,37676,145,0,37355,9494,13413,12975,8656,4319,12975,97300,2017
72101,37,31785,30,0,31710,7765,18739,10129,7130,2999,10129,98000,2017
72103,37,26584,54,0,26464,5760,18976,8346,6618,1728,8346,91900,2017
72105,38.7,29112,37,0,29024,6520,18069,8696,6855,1841,8696,94500,2017
72107,37.9,21906,65,0,21841,5153,14296,6797,4667,2130,6797,89300,2017
72109,43.3,17769,34,0,17723,4090,14512,6501,4588,1913,6501,94800,2017
72111,36.4,21661,30,0,21603,5488,16868,7132,5354,1778,7132,76600,2017
72113,39.5,148863,852,114,147786,36710,16561,53341,34646,18695,53341,98600,2017
72115,39.3,24548,137,93,24294,6215,16082,8491,5294,3197,8491,109600,2017
72117,44.6,14526,958,0,13103,3167,18292,5079,3706,1373,5079,122200,2017
72119,40.2,51768,259,0,51489,11725,22584,15938,12163,3775,15938,114300,2017
72121,40.9,23610,52,0,23558,5265,15736,7568,5677,1891,7568,95800,2017
72123,38.4,29239,16,0,29107,7625,16246,10718,8679,2039,10718,85900,2017
72125,42.7,32937,128,20,32769,7762,15036,11922,8586,3336,11922,94800,2017
72127,41.8,355181,4398,781,348910,84529,21677,145321,78271,67050,145321,158000,2017
72129,40.2,38689,0,0,38658,9728,18589,13670,10413,3257,13670,111000,2017
72131,42,38970,346,0,38593,10674,14275,14278,8948,5330,14278,99900,2017
72133,37.2,22475,81,0,22394,5375,16816,7759,5679,2080,7759,92800,2017
72135,37.1,74169,330,40,73520,17919,29672,22205,18509,3696,22205,142800,2017
72137,38.9,81905,444,97,81299,19387,24583,27802,20475,7327,27802,131000,2017
72139,39.3,69478,441,15,68984,17893,31202,24357,16311,8046,24357,152400,2017
72141,41.7,30209,135,27,30047,7193,15931,9727,6273,3454,9727,93500,2017
72143,37.8,38589,351,19,38054,9281,18053,12529,8683,3846,12529,118500,2017
72145,40.1,54754,1709,45,52956,12918,18900,17746,14853,2893,17746,115100,2017
72147,41.4,8931,357,0,8546,1414,16261,2555,1999,556,2555,108100,2017
72149,37.6,23659,37,18,23593,5934,19893,7761,5569,2192,7761,93800,2017
72151,41.6,35025,25,0,34989,8053,15586,11989,8595,3394,11989,87800,2017
72153,42.1,37585,80,0,37500,7036,14451,10749,8195,2554,10749,91500,2017
01001,37.8,55200,41412,10475,1528,15161,58786,21115,15814,5301,21115,147900,2018
01003,42.8,208107,172768,19529,9353,51359,55962,78622,57881,20741,78622,189800,2018
01005,39.9,25782,11898,12199,1106,6030,34186,9186,5640,3546,9186,92900,2018
01007,39.9,22527,16801,4974,547,4947,45340,6840,5135,1705,6840,96500,2018
01009,40.8,57645,50232,820,5261,15104,48695,20600,16197,4403,20600,124700,2018
01011,39.6,10352,2228,7893,51,2481,32152,3609,2726,883,3609,77500,2018
01013,40.7,20025,10384,9027,67,4429,39109,6708,4692,2016,6708,88300,2018
01015,39.7,115098,83423,23618,4203,30833,45197,45033,31286,13747,45033,113800,2018
01017,43,33826,18872,13319,768,8659,39872,13516,9159,4357,13516,88400,2018
01019,45.9,25853,23730,1267,398,7332,41014,10606,8374,2232,10606,123100,2018
01021,38.6,43930,35205,4112,3416,11926,45182,16751,12538,4213,16751,102200,2018
01023,46.1,13075,7370,5570,73,3510,34884,5350,4263,1087,5350,75200,2018
01025,42.3,24387,12895,11173,48,6034,36127,9358,6314,3044,9358,100800,2018
01027,43.7,13378,10740,1971,415,3643,41225,5236,3789,1447,5236,102200,2018
01029,42.5,14938,13839,393,362,3860,40188,5726,4332,1394,5726,112000,2018
01031,39.3,51288,36223,8746,3549,13583,53155,19789,12822,6967,19789,149100,2018
01033,42.7,54495,42865,8561,1349,14768,47558,21799,15849,5950,21799,113500,2018
01035,44.8,12514,6274,5961,105,2887,33177,4574,3504,1070,4574,76600,2018
01037,46.9,10855,7084,3713,50,2664,38301,4103,3364,739,4103,87900,2018
01039,43.9,37351,31146,4790,604,10124,40601,15008,11110,3898,15008,95500,2018
01041,41.5,13865,9869,3147,275,3424,39812,5025,3709,1316,5025,79500,2018
01043,40.6,82313,75826,954,3543,21303,42558,30730,22919,7811,30730,124100,2018
01045,37.5,49255,34005,9611,3070,12586,45960,18670,11239,7431,18670,110100,2018
01047,39.5,40029,11024,28119,412,10564,31602,16336,9767,6569,16336,82600,2018
01049,39.3,71200,57441,979,10220,18413,39233,26132,18604,7528,26132,102700,2018
01051,38.6,81212,59471,17148,2347,20959,59347,29143,21480,7663,29143,161100,2018
01053,39.7,37328,22480,11912,838,8213,35000,13428,9237,4191,13428,98200,2018
01055,41.3,102939,80374,15816,3880,26139,44023,38777,27882,10895,38777,109900,2018
01057,43.8,16585,14042,1858,285,4812,37458,6947,5412,1535,6947,83800,2018
01059,37.6,31542,24313,1338,5333,7702,40459,11210,7910,3300,11210,87800,2018
01061,42.4,26491,22235,2468,1027,7220,38142,10479,7420,3059,10479,92300,2018
01063,42.5,8426,1445,6707,143,1630,21804,2955,2031,924,2955,66400,2018
01065,39.2,14887,5898,8743,130,3560,30571,5658,4044,1614,5658,92700,2018
01067,44.1,17124,11805,4727,448,4477,48610,6669,5522,1147,6669,115100,2018
01069,39.8,104352,69826,27887,3437,25733,45496,39253,25741,13512,39253,130500,2018
01071,43.3,52094,46537,1799,1505,14410,39816,20626,15282,5344,20626,105300,2018
01073,37.7,659892,330862,280748,25048,164836,51979,260924,163858,97066,260924,154400,2018
01075,44.5,13933,11981,1558,218,4052,36756,5974,4567,1407,5974,77200,2018
01077,41.4,92585,78501,9183,2412,24868,46265,38514,26376,12138,38514,136400,2018
01079,42.2,33171,25390,3615,707,9325,44515,12811,10133,2678,12811,107200,2018
01081,31.4,159287,107395,36389,5865,37391,48056,59373,35821,23552,59373,165000,2018
01083,39.5,93052,71554,12405,5479,22767,56460,32126,25064,7062,32126,152900,2018
01085,41.6,10236,2505,7586,70,2865,30833,4180,3079,1101,4180,66300,2018
01087,38,19054,2972,15583,328,4379,32074,7637,5021,2616,7637,79500,2018
01089,38.5,357560,232115,85293,17294,93386,63417,145256,97650,47606,145256,180600,2018
01091,42.7,19538,8791,10518,115,4148,32809,7768,5533,2235,7768,90000,2018
01093,44.3,29965,27559,1047,752,8419,35392,12212,9203,3009,12212,86500,2018
01095,38.7,95145,77297,2456,12961,23910,42490,34896,24555,10341,34896,122500,2018
01097,37.6,414659,236987,146600,11973,101776,46166,155831,101120,54711,155831,126600,2018
01099,42.3,21512,11689,8774,302,4994,30141,8149,4962,3187,8149,103000,2018
01101,36.2,226941,78393,130513,7749,56034,47990,89835,52626,37209,89835,127500,2018
01103,40.4,119122,90497,15141,9691,31202,49751,45646,32928,12718,45646,131000,2018
01105,37.7,9486,2798,6569,89,1588,23561,3079,2240,839,3079,65900,2018
01107,42.4,20298,10925,8148,932,4935,37458,7530,5569,1961,7530,97500,2018
01109,30.8,33403,18765,12661,263,6509,34678,11547,6845,4702,11547,117400,2018
01111,42.7,22574,16991,4413,665,5870,41449,8643,6345,2298,8643,88700,2018
01113,35.9,58213,27354,24787,3120,14510,40978,22740,13601,9139,22740,118600,2018
01115,40.3,87306,75109,8212,2089,23270,54887,32172,25397,6775,32172,148200,2018
01117,38.9,211261,165058,25166,12125,56022,75761,78328,62406,15922,78328,204500,2018
01119,35.8,12985,3201,9345,13,2680,23132,5047,3278,1769,5047,74600,2018
01121,41.1,80565,50655,25992,1818,20921,41012,31407,22392,9015,31407,101800,2018
01123,43.7,40636,28000,11012,954,11339,43361,16448,11982,4466,16448,107800,2018
01125,32.7,206213,127767,65058,7437,47281,52221,72379,45708,26671,72379,166000,2018
01127,42.4,64493,57475,3954,1545,17379,41748,25036,19045,5991,25036,93100,2018
01129,43.6,16643,10835,4086,182,4220,40794,6007,5034,973,6007,85200,2018
01131,40.8,10809,2901,7511,70,2246,27237,3804,2471,1333,3804,82200,2018
01133,44.9,23875,22428,90,734,6304,38504,9403,7426,1977,9403,87800,2018
02013,42.7,3425,515,117,346,538,69706,860,532,328,860,123000,2018
02016,37.6,5750,1389,246,798,716,85517,1176,331,845,1176,247900,2018
02020,33.2,296112,173209,15671,26847,70176,83280,106524,64827,41697,106524,308000,2018
02050,27.1,18040,1794,119,429,3478,54212,4558,2784,1774,4558,110200,2018
02060,41.8,890,480,4,32,209,84688,333,176,157,333,179500,2018
02068,43.1,2232,1810,18,9,316,84196,639,499,140,639,203500,2018
02070,30.3,4975,789,67,173,1017,58750,1420,856,564,1420,183200,2018
02090,31.1,99653,70188,4250,7951,24057,77095,36513,21363,15150,36513,236800,2018
02100,44.9,2518,1959,1,97,612,64342,1026,692,334,1026,258100,2018
02105,50.2,2132,921,65,142,517,63603,799,590,209,799,228500,2018
02110,38.1,32330,21023,321,2123,7610,88213,12521,8014,4507,12521,344000,2018
02122,40.8,58220,46954,317,2375,13666,66684,21741,15932,5809,21741,239800,2018
02130,39.6,13804,8838,103,701,3397,70356,5327,3240,2087,5327,272300,2018
02150,33.5,13649,6753,27,1219,3000,78281,4373,2405,1968,4373,275000,2018
02158,23.8,8198,298,23,81,1415,35539,1692,1257,435,1692,76000,2018
02164,33.5,1375,305,9,19,285,46406,425,294,131,425,120200,2018
02170,35,103464,82220,1022,4944,21695,75905,30879,23744,7135,30879,243000,2018
02180,28.1,9925,1464,83,253,2175,58987,2875,1734,1141,2875,149600,2018
02185,34.8,9797,3043,75,207,1472,75431,1966,988,978,1966,143000,2018
02188,27.2,7734,842,77,89,1394,62949,1860,1034,826,1860,131400,2018
02195,41,3255,2050,23,337,763,66907,1170,799,371,1170,213100,2018
02198,41,6474,2936,24,244,1515,54191,2356,1716,640,2356,172700,2018
02220,38.8,8738,5409,88,566,2129,71534,3561,2062,1499,3561,349300,2018
02230,38.5,1061,887,7,55,201,72237,400,206,194,400,314500,2018
02240,36.3,6876,5106,24,381,1476,71541,2163,1591,572,2163,184000,2018
02261,39,9301,6478,25,466,1867,82306,3093,2261,832,3093,229800,2018
02275,49.5,2484,1642,2,121,650,57583,1074,734,340,1074,212600,2018
02282,36.4,689,292,2,50,136,65833,232,145,87,232,169300,2018
02290,35.3,5415,1160,7,131,1151,40000,1906,1366,540,1906,77700,2018
04001,34.7,71522,13102,513,4445,13759,32963,20395,15988,4407,20395,62300,2018
04003,40.6,126279,69712,4455,44598,32319,48649,49250,34066,15184,49250,143800,2018
04005,30.6,140217,75820,1704,19666,29278,57616,47276,28637,18639,47276,261300,2018
04007,49.7,53400,33335,305,9992,13715,42092,21708,16033,5675,21708,157600,2018
04009,33.3,37879,19286,683,12453,7604,51352,10782,7467,3315,10782,127000,2018
04011,34.2,9504,4474,203,4414,2379,60962,3225,1586,1639,3225,82400,2018
04012,56,20701,11973,168,5614,5303,33333,8912,6620,2292,8912,77600,2018
04013,36.1,4253913,2368876,220519,1311091,996345,61606,1520767,933112,587655,1520767,242700,2018
04015,50.9,206064,159907,2030,33481,54107,43266,85485,58675,26810,85485,151100,2018
04017,36.4,108705,45073,788,12329,23917,40054,34407,23761,10646,34407,118800,2018
04019,38.3,1019722,531149,32824,376826,246861,51037,400907,250126,150781,400907,173500,2018
04021,38.9,419721,239869,17529,125373,95847,55550,137286,102115,35171,137286,169800,2018
04023,36.6,46584,6928,100,38899,11626,40467,15430,10212,5218,15430,148500,2018
04025,52.9,224645,181227,1224,32461,60712,50180,96007,69055,26952,96007,231600,2018
04027,34.3,207829,65155,3569,131670,54354,44058,72463,48612,23851,72463,122000,2018
05001,41.4,18124,12695,4677,554,4727,39466,7682,4894,2788,7682,83600,2018
05003,41.7,20537,13976,5250,1097,5432,39635,7915,5831,2084,7915,71500,2018
05005,52.1,41219,39112,74,927,12104,41481,18370,13929,4441,18370,128800,2018
05007,35.3,258980,190853,4236,42577,68778,64141,94333,62618,31715,94333,172000,2018
05009,42.4,37288,35060,156,899,10351,43262,14870,10638,4232,14870,124900,2018
05011,40.2,10948,6094,3168,1654,2909,39510,4537,2836,1701,4537,77800,2018
05013,45.5,5202,3775,1107,206,1364,44022,1936,1618,318,1936,69400,2018
05015,44.8,27887,22317,171,4182,7337,43505,11161,8480,2681,11161,126800,2018
05017,42.7,10826,4222,5856,580,2836,33051,4308,2769,1539,4308,63000,2018
05019,34.1,22385,15419,5367,1050,5359,39752,8505,5331,3174,8505,100900,2018
05021,43,15061,14385,93,300,4099,33935,6441,4474,1967,6441,72400,2018
05023,49.4,25230,23903,140,618,7266,43391,10731,8003,2728,10731,132400,2018
05025,42.7,8226,6959,924,154,2294,42460,3292,2482,810,3292,83000,2018
05027,36,23892,14151,8291,650,5759,36148,8962,6161,2801,8962,82800,2018
05029,41.7,20906,17069,2255,812,5649,41196,8475,5786,2689,8475,101400,2018
05031,34.1,105701,81089,14567,5253,26481,45868,40800,23445,17355,40800,138500,2018
05033,38.7,62472,52838,867,4715,17328,46619,23701,18182,5519,23701,116900,2018
05035,35.1,49013,20905,23706,1210,12027,39002,18756,10871,7885,18756,110500,2018
05037,41.2,16998,12384,3308,330,4679,43838,6694,4514,2180,6694,83600,2018
05039,43.7,7432,3957,3088,229,1913,36628,3033,2060,973,3033,66600,2018
05041,39.1,11887,5410,5596,698,3339,30234,5111,3035,2076,5111,62800,2018
05043,37,18502,12336,5321,609,4474,43014,7018,4790,2228,7018,97600,2018
05045,32.5,122416,98294,13872,4956,28494,51930,44095,27615,16480,44095,157600,2018
05047,41.3,17780,16374,169,545,4699,39463,6800,4928,1872,6800,94200,2018
05049,48.1,12139,11564,71,183,3520,36184,5000,3909,1091,5000,93500,2018
05051,44.9,98296,80889,7989,5434,25362,43146,39894,26955,12939,39894,138400,2018
05053,40.4,18086,16772,528,481,5094,51920,6780,5417,1363,6780,127100,2018
05055,37.9,44623,41684,717,1244,12104,47497,16879,11434,5445,16879,113100,2018
05057,39.9,22018,12082,6655,2786,5543,41355,7971,5473,2498,7971,79400,2018
05059,41.3,33520,27684,4032,1148,8874,41262,12377,9369,3008,12377,91900,2018
05061,38.8,13389,8653,2761,1631,3393,35900,5096,3492,1604,5096,92500,2018
05063,39.4,37264,33154,670,2305,9977,43523,14268,10291,3977,14268,105200,2018
05065,48,13559,12639,254,302,3398,40218,5049,3994,1055,5049,81500,2018
05067,39.9,17225,13257,2131,485,3622,33174,6095,4227,1868,6095,66900,2018
05069,38.8,70424,27631,39852,1432,16316,38289,26977,16847,10130,26977,83800,2018
05071,38,26291,20979,397,3627,6821,37170,9800,7016,2784,9800,98900,2018
05073,46.3,6915,4075,2516,172,1816,32412,2859,2191,668,2859,63300,2018
05075,41.1,16669,15914,173,240,4463,38528,6531,4359,2172,6531,75700,2018
05077,41.8,9398,3845,5294,167,2111,28367,3352,1934,1418,3352,72700,2018
05079,38.6,13695,8809,4268,516,2806,45166,3795,2831,964,3795,74400,2018
05081,42.6,12417,9072,2762,107,3290,45388,5440,3934,1506,5440,72200,2018
05083,41.5,21757,19721,293,642,6137,39748,8464,6075,2389,8464,90200,2018
05085,36.1,72206,62192,4372,3196,20173,57509,26868,18506,8362,26868,136200,2018
05087,42.6,16076,14399,11,896,4501,43891,6195,4855,1340,6195,107200,2018
05089,51.7,16438,15507,145,366,4427,35518,6669,5260,1409,6669,119000,2018
05091,38.9,43759,30189,10772,1405,11163,41903,16748,10671,6077,16748,106500,2018
05093,36.2,42831,25054,15066,1728,11153,37237,16888,9525,7363,16888,82700,2018
05095,47,7249,3928,2897,199,1975,35190,3326,1994,1332,3326,64300,2018
05097,50,8993,8126,20,383,2648,37855,3761,3108,653,3761,106700,2018
05099,44.8,8440,5324,2927,24,2174,37635,3303,2248,1055,3303,64500,2018
05101,49.1,7848,7382,2,73,1934,39896,2899,2557,342,2899,105100,2018
05103,42.3,24106,13322,9830,546,6319,34887,10055,6854,3201,10055,72200,2018
05105,43.5,10322,9513,186,297,2745,46071,3708,2970,738,3708,95400,2018
05107,38.5,19034,6585,11921,343,4706,29263,7498,3614,3884,7498,68200,2018
05109,42.8,10808,9458,355,703,2938,37406,4299,3318,981,4299,82300,2018
05111,39.7,24054,20944,1141,707,6811,39277,9437,5990,3447,9437,75500,2018
05113,43.7,20163,17684,91,1319,5516,37035,8204,6217,1987,8204,90100,2018
05115,35,63644,53695,1862,5563,14892,41914,22628,15477,7151,22628,125000,2018
05117,46.2,8244,6998,1073,61,2489,41846,3826,2755,1071,3826,68000,2018
05119,36.9,393463,207385,142917,24078,95287,50093,157083,91808,65275,157083,153700,2018
05121,41.5,17603,16638,201,344,5033,36870,7455,5371,2084,7455,82400,2018
05123,38.9,26294,10552,14575,708,5726,35356,9319,5321,3998,9319,63300,2018
05125,39.2,118009,100522,8277,5451,31386,62152,43604,34167,9437,43604,151700,2018
05127,41,10442,8806,28,792,2539,35509,3855,2865,990,3855,72800,2018
05129,47.6,7923,7389,54,183,2178,36390,3271,2539,732,3271,98000,2018
05131,37.5,127461,89178,8789,17860,32833,43240,50670,30268,20402,50670,119900,2018
05133,34.9,17193,9939,868,5703,4298,46667,5854,4384,1470,5854,79200,2018
05135,47.4,17043,15968,103,373,4435,33708,7354,5573,1781,7354,81000,2018
05137,49.8,12446,11798,9,236,3387,36162,4954,3603,1351,4954,113900,2018
05139,40.1,39732,24178,12968,1540,10699,44000,15904,11888,4016,15904,82800,2018
05141,47.9,16684,15613,65,508,4711,36897,6852,5259,1593,6852,101600,2018
05143,31.8,228529,163162,7970,38052,53496,49629,85891,45769,40122,85891,167600,2018
05145,36.6,78804,69514,3140,3382,20476,43822,29263,19474,9789,29263,121300,2018
05147,45.6,6660,4621,1845,12,1815,31023,2890,1922,968,2890,66200,2018
05149,39.3,21573,16285,434,4314,5608,42361,7491,5263,2228,7491,110500,2018
06001,37.4,1643700,523391,172329,369061,383468,92574,572870,305134,267736,572870,707800,2018
06003,44.3,1146,678,9,105,177,64688,299,251,48,299,349000,2018
06005,50.5,37829,29763,749,5132,9446,61198,14090,10798,3292,14090,296400,2018
06007,37.1,227075,164390,3303,36358,51436,48443,86797,51358,35439,86797,248100,2018
06009,52.1,45235,36905,299,5297,11776,58151,17417,13526,3891,17417,297700,2018
06011,35.1,21464,7672,277,12655,5466,56704,7113,4371,2742,7113,249800,2018
06013,39.4,1133247,502951,93683,288101,282085,93712,392277,257528,134749,392277,582400,2018
06015,38.6,27424,17172,758,5340,6039,45258,9799,6115,3684,9799,204000,2018
06017,45.8,186661,145990,1432,23631,48535,80582,69172,52990,16182,69172,437200,2018
06019,32,978130,291455,44474,515907,221080,51261,304624,160944,143680,304624,237500,2018
06021,36.6,27897,14507,223,11504,7390,47395,10017,5981,4036,10017,222000,2018
06023,38,135768,101305,1342,15360,30101,45528,54267,30853,23414,54267,296600,2018
06025,32.4,180216,19773,3906,151019,33880,45834,44057,25717,18340,44057,177100,2018
06027,45.7,18085,11389,160,3927,4300,52874,8083,5110,2973,8083,262400,2018
06029,31.5,883053,307030,45053,465842,200379,52479,267913,155395,112518,267913,205200,2018
06031,31.7,150075,49058,8784,81154,32786,53865,42735,22114,20621,42735,202800,2018
06033,45.6,64148,45623,1426,12830,15359,42475,25966,17157,8809,25966,195400,2018
06035,36,31185,20528,2695,5834,6141,56362,9493,6445,3048,9493,184200,2018
06037,36.2,10098052,2659052,795505,4893603,2207265,64251,3306109,1514629,1791480,3306109,543400,2018
06039,33.9,155013,53531,4835,88806,34804,52884,44759,28627,16132,44759,235200,2018
06041,46.5,260295,185809,5597,41335,65685,110217,105258,67200,38058,105258,959200,2018
06043,51.4,17540,14125,166,1909,5019,51199,7700,5310,2390,7700,269500,2018
06045,42.8,87422,57314,511,21679,20783,49233,34090,20173,13917,34090,356800,2018
06047,30.9,269075,76008,8038,158494,60642,50129,79606,41378,38228,79606,229500,2018
06049,47.7,8938,6962,149,1292,2173,45149,3660,2803,857,3660,133300,2018
06051,38.3,14174,9234,40,3866,2524,63018,4847,3014,1833,4847,326400,2018
06053,34.1,433212,131238,10606,252588,91714,66676,126052,64362,61690,126052,477200,2018
06055,41.1,140530,74159,2764,47687,33730,84753,49032,31256,17776,49032,603700,2018
06057,50.1,99092,84470,601,9281,26483,63240,40904,30406,10498,40904,400000,2018
06059,37.8,3164182,1296036,50412,1080195,741721,85398,1032373,592269,440104,1032373,652900,2018
06061,41.9,380077,278380,5868,52498,98332,84357,140661,100700,39961,140661,443700,2018
06063,52.2,18699,15571,194,1629,4859,53270,8047,5868,2179,8047,234900,2018
06065,35.3,2383286,856468,144503,1154517,524557,63948,718349,472401,245948,718349,330600,2018
06067,36,1510023,682500,144003,347025,355363,63902,536029,300082,235947,536029,330100,2018
06069,35.5,59416,20780,434,35248,14175,81977,17740,11264,6476,17740,496200,2018
06071,33.1,2135413,623262,168864,1127813,481066,60164,630633,373740,256893,630633,305400,2018
06073,35.6,3302833,1515380,155536,1106925,753761,74855,1118980,593890,525090,1118980,526300,2018
06075,38.2,870044,353670,43619,132651,172190,104552,359673,135275,224398,359673,1009500,2018
06077,34.1,732212,237887,49926,301256,168502,61145,226727,126097,100630,226727,313800,2018
06079,39.1,281455,194574,4912,63002,66580,70699,105317,63986,41331,105317,537900,2018
06081,39.6,765935,303047,16838,189002,183144,113776,261969,156864,105105,261969,994100,2018
06083,33.7,443738,199356,7881,200060,95270,71657,144962,75640,69322,144962,549900,2018
06085,37,1922200,615912,45379,495455,456440,116178,635525,360658,274867,635525,913000,2018
06087,37.4,273765,157540,2359,91676,61058,78041,95756,56873,38883,95756,711000,2018
06089,41.8,179085,143575,2140,17605,46145,50905,70473,44721,25752,70473,242500,2018
06091,55.5,2930,2567,6,324,720,48125,1241,1010,231,1241,173200,2018
06093,48,43540,33390,619,5336,11671,44200,19257,12633,6624,19257,186300,2018
06095,37.9,438530,168870,59500,114406,107267,77609,149067,90420,58647,149067,377500,2018
06097,41.7,501317,318237,7192,132985,120415,76753,189339,115093,74246,189339,568700,2018
06099,34,539301,229796,14338,245973,127767,57387,172682,99079,73603,172682,272400,2018
06101,35.7,95872,44769,1793,29354,23697,56955,32360,18560,13800,32360,260300,2018
06103,40.9,63373,43539,420,15623,16004,42899,24025,15575,8450,24025,203400,2018
06105,51.8,12862,10607,87,930,3477,38497,5796,3868,1928,5796,284600,2018
06107,30.8,460477,133617,5870,295149,104650,47518,136106,77314,58792,136106,191200,2018
06109,48.4,53932,43364,880,6527,13770,56493,22427,15656,6771,22427,278900,2018
06111,37.9,848112,388301,13677,360017,197226,84017,271226,171554,99672,271226,559700,2018
06113,31,214977,101274,5215,67809,46152,65923,73510,38013,35497,73510,395500,2018
06115,32.5,75493,42085,2340,20990,18583,52624,26179,15387,10792,26179,231900,2018
08001,33.6,497115,251342,15509,197279,116273,67575,164353,107175,57178,164353,273000,2018
08003,30.4,16444,7940,134,7542,3474,39191,6153,3428,2725,6153,157500,2018
08005,36.5,636671,386645,65578,121355,157078,73925,237559,149832,87727,237559,327800,2018
08007,50.6,12908,9890,214,2371,3710,50753,5670,4228,1442,5670,295500,2018
08009,47.7,3563,3038,35,381,1038,37500,1642,1178,464,1642,82200,2018
08011,41,5809,3682,202,1858,1171,34392,1744,1119,625,1744,80600,2018
08013,36.2,321030,249803,2613,44266,73589,78642,125894,78093,47801,125894,462200,2018
08014,37.7,66120,50996,735,8069,17498,89624,26721,17722,8999,26721,382800,2018
08015,49.1,19164,16276,366,1935,5259,54580,7958,6103,1855,7958,335900,2018
08017,35.9,2039,1579,2,347,484,55227,742,550,192,742,104000,2018
08019,47.8,9379,8367,103,618,2869,69936,4640,3548,1092,4640,357000,2018
08021,39.4,8142,3584,36,4315,1994,34746,3068,2445,623,3068,117600,2018
08023,51.3,3687,1217,17,2307,1019,30593,1687,1189,498,1687,113200,2018
08025,35.6,5630,3517,206,1747,805,37586,1194,865,329,1194,71700,2018
08027,58.4,4640,3946,119,444,1416,44644,2083,1777,306,2083,262200,2018
08029,47.6,30346,24709,157,4595,7805,44512,11882,8441,3441,11882,219000,2018
08031,34.4,693417,372710,62617,209859,143098,63793,294358,146083,148275,294358,357300,2018
08033,51.8,1841,1674,0,108,513,41714,740,600,140,740,115900,2018
08035,38.4,328614,271949,4116,27998,91322,115314,117426,92775,24651,117426,441100,2018
08037,36.5,54357,36501,474,16140,12035,84685,17750,12531,5219,17750,538600,2018
08039,46.1,25162,22374,115,1693,7123,96658,9046,8116,930,9046,425500,2018
08041,34.1,688153,477996,40940,115664,173199,65334,253379,161564,91815,253379,254300,2018
08043,44.9,47002,37224,1888,6186,11451,46296,17163,12876,4287,17163,163300,2018
08045,36.3,58538,40078,228,16487,15165,72898,21138,14136,7002,21138,337900,2018
08047,45.7,5924,5123,15,548,1602,75120,2653,2147,506,2653,337400,2018
08049,43.5,15066,13198,122,1273,3610,70469,5823,4009,1814,5823,295800,2018
08051,34.5,16537,14418,65,1532,3602,54979,6643,4058,2585,6643,339400,2018
08053,57.5,878,792,0,51,271,52188,387,277,110,387,331100,2018
08055,55.1,6583,4186,20,2274,1868,36705,3282,2352,930,3282,157200,2018
08057,50.9,1296,1037,0,254,367,48828,575,410,165,575,195400,2018
08059,40.4,570427,446868,5977,87153,147643,78943,230153,162035,68118,230153,366800,2018
08061,40.4,1449,1260,17,78,367,39784,593,443,150,593,80100,2018
08063,38.5,7635,5852,195,1466,2078,51046,2977,2049,928,2977,140800,2018
08065,37.8,7585,4997,8,2346,2013,46918,3353,2085,1268,3353,214000,2018
08067,39.9,55101,43382,238,7028,12918,64372,21793,15377,6416,21793,375400,2018
08069,35.9,338161,280122,3035,38323,82842,67664,133527,86247,47280,133527,336200,2018
08071,46.1,14179,7471,104,5963,3903,41945,6477,4466,2011,6477,147100,2018
08073,37.9,5548,3668,524,1203,979,49423,1520,1040,480,1520,135700,2018
08075,38.4,21689,16870,198,3443,4948,48922,8183,5054,3129,8183,154500,2018
08077,39.1,149998,122306,931,21629,38356,53683,61033,41030,20003,61033,214400,2018
08079,58.6,823,714,16,79,269,61058,375,333,42,375,293600,2018
08081,37.8,13060,10597,131,1983,3478,52807,5210,3544,1666,5210,170700,2018
08083,44.4,25909,18827,44,3222,6861,46797,10615,7546,3069,10615,208300,2018
08085,45.1,41268,31394,146,8476,11656,48739,17125,12111,5014,17125,212900,2018
08087,36.3,28257,16593,905,10147,7555,51626,10785,6935,3850,10785,183900,2018
08089,40.2,18325,9864,248,7637,4879,34136,7691,4784,2907,7691,91900,2018
08091,53,4722,4401,0,201,1348,62230,2194,1500,694,2194,419900,2018
08093,50.6,17392,15507,24,1051,4589,66861,7119,5961,1158,7119,284800,2018
08095,39,4318,3267,8,944,1084,50724,1668,1173,495,1668,155500,2018
08097,42,17909,15317,266,1777,3439,71244,7018,4528,2490,7018,623400,2018
08099,38,12052,7172,134,4532,3233,40097,4963,3167,1796,4963,94100,2018
08101,38.9,164685,86059,2795,70637,40874,44634,63762,41006,22756,63762,155400,2018
08103,35.9,6465,5482,25,650,1582,55543,2403,1681,722,2403,203100,2018
08105,41.5,11351,5920,45,5046,2789,38639,4504,2982,1522,4504,161300,2018
08107,39.8,24874,22270,193,1740,5894,74273,9552,6729,2823,9552,510600,2018
08109,49.1,6468,3785,0,2366,1584,34410,2645,1982,663,2645,149500,2018
08111,52.1,544,489,0,48,119,46563,266,178,88,266,286700,2018
08113,41.5,7968,6885,16,820,1897,64478,3441,2081,1360,3441,491100,2018
08115,49.1,2350,1934,30,319,592,45188,1017,728,289,1017,87300,2018
08117,39.1,30429,25032,261,4352,5397,77589,9707,6416,3291,9707,563000,2018
08119,49.9,24113,21495,191,1532,7070,65382,10183,8242,1941,10183,279100,2018
08121,41.6,4840,4229,53,474,1397,49375,2030,1380,650,2030,138700,2018
08123,34.3,295123,194813,3259,86322,74632,70908,102101,74144,27957,102101,269400,2018
08125,38.4,10069,7579,89,2311,2710,48394,4051,2561,1490,4051,171600,2018
09001,40.3,944348,588974,99412,182653,237215,92969,340491,229169,111322,340491,422300,2018
09003,40.4,894730,553425,114565,157785,225023,72321,349064,225112,123952,349064,237700,2018
09005,47.2,183031,162898,2863,10941,48844,78314,73987,57079,16908,73987,251500,2018
09007,45.4,163368,137696,8050,9835,42841,84761,66892,49262,17630,66892,284900,2018
09009,40.1,859339,546120,106325,151361,204804,67128,329857,204295,125562,329857,246700,2018
09011,41.4,268881,204185,14219,27762,69306,71368,107402,71459,35943,107402,239000,2018
09013,37.5,151269,128603,4299,8086,35464,84916,55232,39798,15434,55232,251300,2018
09015,41.3,116538,96795,2084,13368,29443,64774,44449,30960,13489,44449,198000,2018
10001,37.6,174822,108687,42782,12180,44677,58775,64545,44554,19991,64545,213900,2018
10003,38.1,555133,322261,135169,54071,131858,70996,203855,138662,65193,203855,254500,2018
10005,49,219540,164675,26714,20064,61366,60853,89365,71092,18273,89365,248900,2018
11001,33.9,684498,248057,315281,74776,121788,82604,281322,117571,163751,281322,568400,2018
12001,31.3,263148,161957,51979,25229,50396,49078,97048,53194,43854,97048,173900,2018
12003,37.6,27785,22640,3770,674,6600,61769,8625,6524,2101,8625,120900,2018
12005,39.4,182482,139651,19650,11453,45243,51829,70199,44545,25654,70199,172600,2018
12007,40.1,26979,19990,5326,1068,5921,46197,8993,6168,2825,8993,97200,2018
12009,47.2,576808,431690,55699,57695,145729,54359,228888,166825,62063,228888,177400,2018
12011,40.1,1909151,710438,524739,554609,436468,57333,682088,423316,258772,682088,243100,2018
12013,40.2,14444,11119,1775,837,2873,38609,4556,3754,802,4556,81300,2018
12015,58.6,176954,148899,9374,12443,48430,49225,76150,60547,15603,76150,176500,2018
12017,56.2,143087,126367,3894,7873,38892,41424,62762,51119,11643,62762,123800,2018
12019,39.5,207291,152228,20242,20037,55688,62653,73398,54104,19294,73398,174400,2018
12021,50.3,363922,230233,24703,100061,95659,65675,140942,102429,38513,140942,340100,2018
12023,40.7,69105,50262,12099,4120,15579,44491,24985,18328,6657,24985,117800,2018
12027,40.6,36399,20017,4402,11352,8200,35057,11996,8383,3613,11996,84400,2018
12029,47.3,16437,13878,1334,647,4252,38237,6520,5031,1489,6520,74500,2018
12031,36.1,924229,494360,269513,86184,221153,53473,354387,200888,153499,354387,166900,2018
12033,37.2,311522,201285,67770,17293,70350,49286,118740,72598,46142,118740,133600,2018
12035,50.9,107139,80249,11094,10828,28547,53872,40629,30796,9833,40629,200000,2018
12037,45,11736,9030,1577,639,2639,42855,4297,3251,1046,4297,139500,2018
12039,40.7,46017,14961,25464,4659,11474,40922,17080,12134,4946,17080,99000,2018
12041,42.5,17615,15232,1079,998,4487,42357,6511,5441,1070,6511,97800,2018
12043,47.2,13363,8053,1762,2790,2995,39879,4433,3522,911,4433,76400,2018
12045,44.3,16055,12001,2850,760,3668,44291,5359,4037,1322,5359,150300,2018
12047,41.5,14269,7832,4836,1332,3210,34583,4485,3140,1345,4485,71100,2018
12049,35.1,27228,12865,2082,11834,5576,37594,7772,5143,2629,7772,81800,2018
12051,33.9,40127,13127,4407,21219,8771,40728,12027,7963,4064,12027,82000,2018
12053,48.9,182696,143190,8689,23507,49475,46030,73541,57201,16340,73541,130300,2018
12055,53.4,102101,69021,9162,20005,26755,37314,41026,30913,10113,41026,93800,2018
12057,36.9,1378883,682935,213409,386478,326368,56137,516478,299839,216639,516478,198000,2018
12059,42.5,19430,16894,1315,533,4883,38608,7016,5367,1649,7016,93200,2018
12061,52.9,150984,114195,13317,18512,35755,52336,57403,44838,12565,57403,185800,2018
12063,41.6,48472,31672,13007,2314,11198,39002,16894,12047,4847,16894,98800,2018
12065,47.2,14105,8383,4847,565,3947,48173,5771,4486,1285,5771,117900,2018
12067,39.1,8744,5806,1339,1263,1565,39543,2095,1653,442,2095,105900,2018
12069,46.8,335362,236868,33118,50061,88728,51884,130190,96761,33429,130190,167200,2018
12071,48.1,718679,487378,58965,149116,178334,54691,271861,191954,79907,271861,207700,2018
12073,30.7,288102,163785,88415,18050,61395,51201,112918,59910,53008,112918,195000,2018
12075,46.8,39961,31997,3414,3269,10304,37634,16433,12685,3748,16433,99400,2018
12077,40.3,8365,6363,1215,484,1635,37363,2381,1793,588,2381,66600,2018
12079,42.9,18474,10057,7081,966,4356,35509,6682,5138,1544,6682,87400,2018
12081,48,373853,267310,31631,60515,94718,56036,143652,102843,40809,143652,218900,2018
12083,48.6,348371,246731,42216,44391,88139,43361,136514,103534,32980,136514,127100,2018
12085,51.9,157581,123852,8564,21094,38818,57959,63865,49903,13962,63865,255000,2018
12086,39.7,2715516,365131,436864,1845646,595092,48982,870051,449056,420995,870051,268200,2018
12087,47.3,76325,51024,5024,18206,18053,67023,30982,18465,12517,30982,468200,2018
12089,45,80578,70385,4816,3257,22708,66297,31241,24517,6724,31241,218100,2018
12091,36.8,200737,148420,18978,18118,50129,62048,77403,48766,28637,77403,207600,2018
12093,41.1,40572,25805,3337,10217,9464,40367,13759,9874,3885,13759,89800,2018
12095,34.9,1321194,539349,262987,408324,299990,54335,458613,250719,207894,458613,216000,2018
12097,35.8,338619,111250,31734,179388,73233,50063,99158,60600,38558,99158,179800,2018
12099,44.6,1446277,799770,262376,316016,341581,59943,548216,376139,172077,548216,264400,2018
12101,44.6,510593,385808,26225,74279,131238,50417,199227,143456,55771,199227,149000,2018
12103,47.8,957875,711722,95859,90359,227414,51454,407720,268015,139705,407720,183000,2018
12105,40.3,668671,401087,98050,143958,159863,48500,231260,158475,72785,231260,135400,2018
12107,45,72766,52092,11591,7187,17362,35649,28264,20641,7623,28264,84500,2018
12109,43.4,235503,195806,12445,15749,62079,77323,86268,67717,18551,86268,287700,2018
12111,44.8,305591,177179,59731,56661,76444,49373,112872,82616,30256,112872,165700,2018
12113,39.7,170442,140846,10062,9199,45866,66242,61345,46265,15080,61345,184400,2018
12115,55.5,412144,343573,18214,36988,110416,58644,180551,133220,47331,180551,234800,2018
12117,39.2,455086,279063,48821,94168,111371,63760,167304,109069,58235,167304,224000,2018
12119,67,120999,102747,8684,6841,36291,55228,54636,49041,5595,54636,246500,2018
12121,42.5,43924,33222,5704,3962,10735,42686,15083,10841,4242,15083,95200,2018
12123,41.7,22098,15917,4826,937,5168,36934,7356,5995,1361,7356,82900,2018
12125,39.5,15239,10628,3302,840,2698,41770,3892,2690,1202,3892,104400,2018
12127,46.5,527634,381288,54722,70582,130030,46760,212985,149330,63655,212985,164200,2018
12129,40.7,31877,25350,4703,1165,8047,62778,11068,8927,2141,11068,144700,2018
12131,43.7,65858,55560,3085,4029,17621,53785,26432,19551,6881,26432,222700,2018
12133,41.8,24566,19034,3747,887,5775,37188,8484,6571,1913,8484,109800,2018
13001,39,18454,12816,3363,1803,4934,39561,6682,4881,1801,6682,75900,2018
13003,35.5,8265,4692,1471,2031,1881,34877,2785,2093,692,2785,60100,2018
13005,37,11228,8252,1714,940,2865,36964,3966,2711,1255,3966,73000,2018
13007,47,3189,1705,1228,134,828,37188,1385,939,446,1385,75500,2018
13009,35.3,45286,23815,19015,997,9295,39426,16122,9006,7116,16122,112500,2018
13011,41.1,18510,16289,500,1236,4954,45373,6603,5006,1597,6603,142800,2018
13013,35.4,76887,55541,8685,8012,19262,57348,25319,18407,6912,25319,146500,2018
13015,37.9,103620,80701,10962,8631,27206,55452,37351,24656,12695,37351,151700,2018
13017,39.7,17154,9656,6286,1042,4375,32705,6569,3905,2664,6569,80100,2018
13019,39.7,19025,15637,2103,925,4983,37163,7322,4896,2426,7322,85300,2018
13021,36.2,153490,59497,82816,4923,34799,39931,58010,30512,27498,58010,116500,2018
13023,36.8,12775,8789,3570,360,2657,45029,4168,2984,1184,4168,97900,2018
13025,40.9,18561,17162,569,392,4601,37031,6564,5271,1293,6564,68200,2018
13027,43,15622,8856,5323,896,4014,34322,6350,4748,1602,6350,96900,2018
13029,34.6,35885,26467,5080,2454,9901,71322,12636,8826,3810,12636,211800,2018
13031,28.5,74782,47666,20984,2894,16727,41789,26955,14413,12542,26955,135200,2018
13033,37.5,22550,10618,10952,703,6035,42773,8184,5774,2410,8184,87900,2018
13035,38.5,23750,15844,6817,751,5933,41845,8157,5841,2316,8157,121800,2018
13037,38.8,6428,2097,3908,299,1187,31725,1853,1226,627,1853,49000,2018
13039,32.3,52714,36858,9816,3466,14298,56397,19327,11997,7330,19327,159800,2018
13043,37.8,10827,6571,2546,1252,2830,32937,3965,2378,1587,3965,91200,2018
13045,34.5,116022,81950,21696,7843,28747,49608,41150,26850,14300,41150,130200,2018
13047,39.9,66299,60449,1432,1942,17442,55125,24636,18480,6156,24636,140000,2018
13049,41.7,12983,7983,3309,1103,2552,40283,3559,2604,955,3559,82600,2018
13051,35.2,287049,140243,112859,18007,66668,54911,108151,58545,49606,108151,184900,2018
13053,23.7,10767,6308,2111,1653,1898,46453,2550,663,1887,2550,69000,2018
13055,39.5,24817,20575,2489,1230,5892,36107,9098,6080,3018,9098,69600,2018
13057,38.3,241910,192110,15268,24977,64450,79670,85825,65701,20124,85825,234300,2018
13059,27.7,124602,68849,34090,13272,23331,36889,47224,18420,28804,47224,163700,2018
13061,45.1,3001,902,2036,0,692,25000,1202,769,433,1202,65900,2018
13063,32.4,278666,29732,189835,36703,62196,45778,92845,46949,45896,92845,97800,2018
13065,37.7,6743,4407,1862,345,1593,25236,2502,1804,698,2502,57100,2018
13067,36.5,745057,391088,197992,95619,189546,75153,277222,178162,99060,277222,237800,2018
13069,36.2,42961,25053,12028,4926,9756,38266,14298,9422,4876,14298,92600,2018
13071,36.4,45606,25653,10416,8662,10702,35472,15374,9416,5958,15374,83200,2018
13073,36.6,147295,102337,24274,9481,35527,76938,46840,37026,9814,46840,192200,2018
13075,37.4,17184,11148,4711,988,4386,38408,6233,4190,2043,6233,88100,2018
13077,38.5,140516,100370,24512,9562,38004,70717,51308,37015,14293,51308,201500,2018
13079,44.4,12344,9068,2978,160,3332,43257,4637,3597,1040,4637,92900,2018
13081,38.8,22846,11474,9974,749,5646,35096,8329,4790,3539,8329,85200,2018
13083,42.2,16227,15216,72,360,4578,44471,6070,4510,1560,6070,126700,2018
13085,43.4,23861,22085,230,1042,6374,65805,8711,7117,1594,8711,215500,2018
13087,38.1,26833,13555,11160,1577,6781,39148,10153,5761,4392,10153,109700,2018
13089,35.6,743187,216221,396854,63736,162716,59280,277757,150840,126917,277757,192400,2018
13091,41.6,20919,13660,5868,724,5230,35757,7694,5091,2603,7694,75800,2018
13093,43.7,13905,5929,6824,958,3285,35629,4861,3393,1468,4861,83700,2018
13095,35.1,91049,23379,62701,2487,21261,37633,34780,15797,18983,34780,103900,2018
13097,36.4,141840,59484,63998,13371,35050,62147,48968,31527,17441,48968,153100,2018
13099,40.7,10348,4720,5266,229,2757,31567,4082,2688,1394,4082,81700,2018
13101,40.9,3994,2687,143,984,1079,34447,1559,1089,470,1559,58900,2018
13103,36.1,58689,46190,7839,2483,14996,65153,20489,15535,4954,20489,159100,2018
13105,42.6,19212,12188,5854,1075,4908,37943,7491,5466,2025,7491,80600,2018
13107,36.8,22499,13355,7694,1003,5648,34946,8392,5507,2885,8392,74100,2018
13109,37.7,10727,6044,3256,1256,2819,39701,4006,2670,1336,4006,86200,2018
13111,51.4,24925,23700,79,565,6987,45647,10461,8175,2286,10461,185600,2018
13113,43.5,111369,70248,24241,7981,30563,87272,39753,32372,7381,39753,269900,2018
13115,38.5,96824,68897,13781,10422,24857,46367,35633,21469,14164,35633,129600,2018
13117,38.3,219880,161162,6915,20875,60229,101743,73675,61629,12046,73675,321000,2018
13119,41,22514,18844,2150,1003,5932,40198,8305,5462,2843,8305,106200,2018
13121,35.4,1021902,406755,445992,74328,216890,64787,400016,206043,193973,400016,290400,2018
13123,46.9,29922,25753,90,3429,8002,49389,11645,8715,2930,11645,171000,2018
13125,43.2,3009,2628,275,49,728,41686,1105,840,265,1105,63800,2018
13127,41,83974,53454,21778,5578,22088,50672,33777,21005,12772,33777,168700,2018
13129,37.8,56790,44167,2219,8864,15096,44313,20294,12987,7307,20294,127400,2018
13131,39.7,24926,14507,7039,2774,6441,42348,9037,5925,3112,9037,112500,2018
13133,49.4,16976,9676,6001,1018,4828,49755,7004,4995,2009,7004,207700,2018
13135,35.1,902298,345876,239090,188608,217852,67769,288724,191178,97546,288724,200400,2018
13137,39.5,44289,34298,1351,6401,10364,49140,15195,11667,3528,15195,146000,2018
13139,36.3,195961,119773,14079,55153,47761,59898,63931,43871,20060,63931,183200,2018
13141,46.5,8535,2068,6170,164,1736,31984,2991,2188,803,2991,79800,2018
13143,40.8,28956,26366,1347,455,8059,46353,11128,7605,3523,11128,116900,2018
13145,43.1,33590,25875,5404,1155,9667,74261,12158,10457,1701,12158,210100,2018
13147,43.8,25631,19200,4723,952,6950,41358,10019,7633,2386,10019,126900,2018
13149,41.5,11677,9910,1085,312,3177,48094,4489,3132,1357,4489,96900,2018
13151,36.9,221307,99804,92650,14739,57307,68609,73826,52832,20994,73826,165900,2018
13153,35.3,151682,86237,45872,9976,40223,58770,56146,36156,19990,56146,138600,2018
13155,39.9,9268,6234,2734,135,2070,32339,3291,2442,849,3291,74300,2018
13157,38.5,65755,53913,4274,4850,16840,62495,22034,17085,4949,22034,174000,2018
13159,42.4,13784,10184,2881,539,3734,43284,5087,3798,1289,5087,122300,2018
13161,36.7,14991,10705,2444,1754,3906,36531,5270,3592,1678,5270,76500,2018
13163,39.3,15772,6613,8485,576,3575,34300,5609,3699,1910,5609,74300,2018
13165,43.7,8827,4945,2937,747,2093,27311,3409,2394,1015,3409,66500,2018
13167,41,9730,6087,3256,229,2282,39813,3361,2293,1068,3361,66700,2018
13169,40.1,28548,20450,7000,445,7723,53155,10510,8420,2090,10510,123400,2018
13171,37.5,18513,12028,5392,438,3844,41464,6368,4424,1944,6368,134500,2018
13173,35.4,10366,7119,2507,574,2571,39104,3724,2382,1342,3724,105000,2018
13175,38.3,47418,27348,17584,1241,11374,37369,17183,10772,6411,17183,88800,2018
13177,37.2,29348,21178,5921,839,8044,65420,10354,7493,2861,10354,153000,2018
13179,28.1,62108,24605,24775,7845,16618,45959,23232,10332,12900,23232,121500,2018
13181,47.3,7799,5134,2462,129,2111,41014,3424,2477,947,3424,117500,2018
13183,32.7,18156,10596,4259,2043,4090,55439,5601,3898,1703,5601,116700,2018
13185,30.2,114582,62197,41486,6345,25370,41390,40472,21160,19312,40472,135100,2018
13187,37.2,31951,28963,584,1530,7710,47488,11649,7912,3737,11649,181600,2018
13189,37.6,21498,11562,8655,637,5605,39199,8103,4930,3173,8103,105300,2018
13191,49.7,14120,8737,4822,139,4221,47114,6033,4691,1342,6033,120300,2018
13193,40.2,13480,4389,8168,569,3019,31999,4673,3037,1636,4673,63700,2018
13195,41.2,28900,23814,2534,1495,8140,51701,10712,8129,2583,10712,126800,2018
13197,45.2,8484,5029,2563,603,2318,44309,3331,2457,874,3331,89500,2018
13199,41.6,21113,11892,8136,449,5542,36351,8151,5470,2681,8151,98000,2018
13201,43.8,5836,3981,1769,34,1595,42927,2300,1543,757,2300,93300,2018
13205,38.9,22432,10328,10438,1016,5363,37027,7889,4976,2913,7889,86200,2018
13207,43.1,27010,19396,6302,631,6498,54050,9803,7763,2040,9803,163800,2018
13209,40,9036,5833,2342,589,2108,40728,3039,2197,842,3039,79400,2018
13211,44.5,18235,13054,4251,587,5057,62530,6656,4974,1682,6656,224800,2018
13213,38.2,39557,32787,424,5837,10513,45238,14081,9743,4338,14081,100200,2018
13215,33.9,196670,80045,88840,14858,45097,45389,72924,35016,37908,72924,141700,2018
13217,36.2,106497,50708,46165,5733,26098,53309,36626,24795,11831,36626,139900,2018
13219,40.4,37017,31307,2005,1804,10503,88308,13093,10827,2266,13093,268100,2018
13221,42.1,14784,11198,2623,647,3878,44927,5621,4431,1190,5621,117000,2018
13223,35.8,155840,112322,28348,9491,40722,66467,52389,40013,12376,52389,161400,2018
13225,36.9,26966,12387,12015,2018,6471,42802,10103,6387,3716,10103,128600,2018
13227,45.1,30832,26906,409,945,8820,64512,11841,8987,2854,11841,185700,2018
13229,39.4,19164,16113,1832,966,5404,44167,7072,5388,1684,7072,98800,2018
13231,40.7,18082,15695,1808,279,4490,58765,6106,5057,1049,6106,165800,2018
13233,37.1,41621,29970,5082,5463,10290,43491,15011,9760,5251,15011,105400,2018
13235,43,11295,6721,3908,463,2607,38770,3817,2401,1416,3817,113500,2018
13237,46,21503,14084,5626,1381,6132,51245,8660,6747,1913,8660,165300,2018
13239,48.4,2276,876,1192,6,602,30000,934,642,292,934,65900,2018
13241,48.8,16457,14315,280,1331,4144,40902,6563,4910,1653,6563,164900,2018
13243,40,7087,2474,4406,96,1655,30914,2616,1502,1114,2616,77300,2018
13245,33.9,201463,70649,112216,9759,43129,40644,72165,38442,33723,72165,104700,2018
13247,37.7,89011,29491,46459,9038,22412,57049,30521,20785,9736,30521,157100,2018
13249,37.8,5211,3380,1545,268,1452,41276,1877,1309,568,1877,111600,2018
13251,41.5,13990,7624,5868,276,3458,37588,5257,3778,1479,5257,77000,2018
13253,44,8437,5196,2779,260,2284,34338,3325,2276,1049,3325,89500,2018
13255,39.1,64719,38210,21697,2860,16513,42671,24137,14523,9614,24137,122300,2018
13257,41.5,25676,21210,2876,843,6668,43416,9468,6607,2861,9468,94300,2018
13259,36.4,6042,1488,3269,1040,1107,25385,1826,1291,535,1826,50900,2018
13261,35.5,30352,12001,15936,1644,7391,36205,11758,6561,5197,11758,90300,2018
13263,49.2,6378,2583,3687,48,1804,36213,2766,2175,591,2766,80000,2018
13265,46.3,1665,549,1078,26,409,31797,612,423,189,612,67100,2018
13267,37.4,25353,14750,7375,2779,5830,38034,8237,5428,2809,8237,88500,2018
13269,44.4,8193,4692,3150,208,2265,33442,3437,2450,987,3437,82700,2018
13271,41,16115,7922,6188,1893,3294,30288,4931,3039,1892,4931,64000,2018
13273,40.9,8859,3149,5195,242,2300,38015,3247,1841,1406,3247,103300,2018
13275,40.3,44730,25758,16234,1651,11735,40112,17352,10963,6389,17352,133800,2018
13277,35.5,40510,22753,12154,4661,10322,42790,15058,8883,6175,15058,118900,2018
13279,36.4,27048,16321,6918,3133,6716,36575,10403,6115,4288,10403,95500,2018
13281,53.7,11417,10805,135,140,3142,43927,4777,3860,917,4777,205600,2018
13283,39.7,6777,4806,1833,122,1772,37606,2641,1873,768,2641,70900,2018
13285,36.3,69774,39555,24770,2563,16947,43850,24843,14232,10611,24843,129200,2018
13287,38.8,7962,4312,3401,131,2215,38341,3023,2041,982,3023,74000,2018
13289,46.2,8284,4565,3510,40,1925,33037,3031,2405,626,3031,63200,2018
13291,53.9,22775,21394,148,728,6425,44978,9070,7069,2001,9070,197200,2018
13293,41.7,26216,17662,7284,600,6304,36529,10204,6715,3489,10204,87200,2018
13295,41.4,68824,62690,2817,1439,18448,43650,25709,18493,7216,25709,114000,2018
13297,38.7,90132,67893,15269,3784,24158,58370,31133,22822,8311,31133,175500,2018
13299,38.4,35599,22616,10528,1460,9254,39887,13901,9037,4864,13901,82000,2018
13301,45.2,5346,1996,3267,23,1440,34730,2332,1578,754,2332,61300,2018
13303,40.6,20461,8774,10806,496,5172,38092,7359,4907,2452,7359,83300,2018
13305,38.2,29767,21206,5798,1853,7110,44869,10353,6614,3739,10353,107900,2018
13307,45,2613,1294,1045,250,721,35755,1101,871,230,1101,60800,2018
13309,38.2,7939,4451,3343,101,1172,27626,1937,1190,747,1937,63300,2018
13311,46.1,28928,26729,417,909,8398,46288,11588,8713,2875,11588,166100,2018
13313,36,103849,61352,4054,35864,25806,46970,36043,22741,13302,36043,126900,2018
13315,39.5,8846,5168,3122,399,1730,36077,2606,1980,626,2606,68200,2018
13317,46.1,9884,5037,4198,475,2416,35106,3879,2548,1331,3879,81200,2018
13319,41.8,9078,5149,3567,251,2156,37583,3237,2438,799,3237,70300,2018
13321,41.1,20656,13900,5833,431,5977,46076,8038,5339,2699,8038,85600,2018
15001,42.3,197658,60006,1229,25014,45716,59297,68412,45767,22645,68412,333600,2018
15003,37.6,987638,183137,21921,96562,219572,82906,311525,173697,137828,311525,649800,2018
15005,57.1,75,16,2,2,8,61875,47,2,45,47,NA,2018
15007,42.4,71377,21150,466,7802,15711,78482,22524,14211,8313,22524,546000,2018
15009,41.1,165281,50227,854,18582,38062,77117,54274,32685,21589,54274,599500,2018
16001,36.7,446052,378831,5682,35838,106718,63137,168741,115369,53372,168741,242300,2018
16003,54.2,4019,3715,11,141,1115,45319,1675,1350,325,1675,173100,2018
16005,33.3,85065,71479,546,7191,20369,49739,30841,21044,9797,30841,152500,2018
16007,39.3,5962,5577,21,249,1762,54265,2350,1803,547,2350,147600,2018
16009,46.1,9086,7698,6,321,2213,46507,3346,2447,899,3346,154000,2018
16011,33.5,45551,33606,113,8186,10920,51288,14772,11174,3598,14772,152600,2018
16013,43.2,21994,16603,81,4798,4994,51968,8190,5709,2481,8190,395800,2018
16015,53,7163,6549,16,310,2176,53942,3110,2608,502,3110,199300,2018
16017,47.8,42711,39866,88,1282,11880,48710,17584,13077,4507,17584,233900,2018
16019,32.7,112397,93545,574,14482,28273,56609,39000,27291,11709,39000,168100,2018
16021,43.5,11549,10455,33,567,2850,43507,4605,3456,1149,4605,179100,2018
16023,48.1,2602,2526,4,71,705,42250,1050,884,166,1050,117600,2018
16025,46.3,886,876,0,8,213,38393,357,268,89,357,174200,2018
16027,33.4,212230,149835,712,53357,49562,49143,70847,48290,22557,70847,159600,2018
16029,36.9,6918,6357,0,387,1879,59611,2618,2087,531,2618,137200,2018
16031,32.2,23615,16532,46,6417,6142,50918,7904,5508,2396,7904,151800,2018
16033,29.6,1077,465,7,505,240,35341,305,190,115,305,92900,2018
16035,50.2,8640,7825,33,356,2287,42348,3707,2826,881,3707,142300,2018
16037,53.3,4141,3749,4,184,1140,39957,1761,1317,444,1761,177300,2018
16039,31.9,26433,19292,669,4406,7054,46715,10285,5972,4313,10285,145600,2018
16041,33.4,13279,12111,32,891,3498,56613,4294,3470,824,4294,198000,2018
16043,36.8,12965,11003,37,1628,3484,53311,4309,3503,806,4309,162400,2018
16045,45.1,17052,14983,0,1418,4441,43001,6583,4836,1747,6583,159300,2018
16047,37.8,15169,10295,15,4413,3851,48638,5419,3699,1720,5419,143600,2018
16049,50,16337,14880,33,540,4244,39113,6466,5040,1426,6466,166100,2018
16051,31.2,27969,24282,24,2941,7003,60162,8647,6889,1758,8647,184100,2018
16053,32.7,23431,14566,24,8299,5852,49306,7828,5003,2825,7828,154600,2018
16055,40.2,153605,139458,482,6918,41702,54457,60497,42635,17862,60497,237400,2018
16057,28.3,39239,34874,382,1690,8457,45466,15530,8232,7298,15530,213600,2018
16059,52.3,7798,7265,3,261,2165,37921,3549,2677,872,3549,171000,2018
16061,48.3,3845,3239,9,171,919,41326,1632,1167,465,1632,123000,2018
16063,35,5321,3552,0,1607,1232,48222,1687,1166,521,1687,137000,2018
16065,23.4,38705,34254,106,2902,8863,36031,10625,4925,5700,10625,207500,2018
16067,35.2,20615,12825,27,7226,5527,50663,7279,5218,2061,7279,136800,2018
16069,40.9,40155,34947,94,1547,10657,54174,16302,11498,4804,16302,181200,2018
16071,37.9,4326,4042,4,192,1137,51058,1585,1279,306,1585,155800,2018
16073,38.4,11455,7810,50,3048,3041,40430,4250,3000,1250,4250,130300,2018
16075,39.9,23041,18109,78,3963,5905,50289,8768,6368,2400,8768,148400,2018
16077,37.7,7713,4749,4,2618,1714,49985,2581,1779,802,2581,139800,2018
16079,47.4,12526,11458,55,439,3465,39091,5540,3883,1657,5540,124600,2018
16081,36.6,11080,8972,17,1895,2456,68818,3736,2763,973,3736,317700,2018
16083,34.7,83666,66586,591,13502,21574,50778,30697,21051,9646,30697,160200,2018
16085,48.7,10401,10101,9,190,2370,55299,3461,2725,736,3461,283000,2018
16087,45.4,10025,7912,17,1718,2639,37206,4018,2824,1194,4018,152200,2018
17001,41.3,66427,61009,2676,1021,17646,51398,27300,19566,7734,27300,126100,2018
17003,42.8,6532,4063,2169,73,1487,34709,2323,1656,667,2323,53500,2018
17005,41.3,16712,14705,1043,578,4114,58097,6218,4818,1400,6218,122500,2018
17007,38.4,53606,39370,1084,11459,13937,66898,18731,14947,3784,18731,152600,2018
17009,39,6675,4933,1343,286,1286,58762,2087,1584,503,2087,89600,2018
17011,44,33381,29382,304,2995,9490,55940,13805,10539,3266,13805,109700,2018
17013,46.7,4858,4711,17,57,1212,54392,1805,1516,289,1805,114300,2018
17015,47.9,14562,13579,163,523,4097,51228,6476,4937,1539,6476,101600,2018
17017,39.7,12665,9622,505,2374,3386,51997,5024,3751,1273,5024,78100,2018
17019,29.9,209448,141757,27617,12239,42535,51692,82499,44247,38252,82499,157800,2018
17021,43.2,33231,31605,417,533,8909,52415,13939,10386,3553,13939,90000,2018
17023,43,15836,15294,46,247,4719,54158,6774,5007,1767,6774,87800,2018
17025,42.7,13338,12833,61,196,3704,48691,5638,4342,1296,5638,81700,2018
17027,40.2,37628,34442,1308,1166,9418,65010,14190,11195,2995,14190,148100,2018
17029,35.2,51736,47080,1897,1288,12253,44071,21139,13023,8116,21139,97600,2018
17031,36.6,5223719,2217734,1213706,1314232,1183806,62088,1963070,1116759,846311,1963070,237200,2018
17033,42,19088,16821,1083,668,5086,49233,7653,5984,1669,7653,87000,2018
17035,42.6,10865,10508,9,114,2934,53376,4322,3423,899,4322,100700,2018
17037,31,104200,80438,7749,11422,22925,61086,37703,21478,16225,37703,169800,2018
17039,43.1,16042,15194,76,430,4398,55591,6663,5288,1375,6663,100900,2018
17041,37.9,19714,17823,105,1424,5066,54218,7618,5461,2157,7618,106500,2018
17043,39.1,931743,627050,43312,132004,239066,88711,341823,250135,91688,341823,299000,2018
17045,44.6,17539,17010,61,201,5185,51109,7590,5742,1848,7590,80100,2018
17047,43.3,6507,6285,41,90,1871,49766,2776,2288,488,2776,76500,2018
17049,39.1,34174,32780,155,684,9009,56293,13555,10526,3029,13555,140300,2018
17051,41.5,21724,20008,1043,408,5264,44432,7616,6133,1483,7616,84700,2018
17053,43,13398,12573,147,427,3627,51120,5779,4079,1700,5779,98400,2018
17055,42.3,39127,37527,280,657,10002,41414,16135,11910,4225,16135,74500,2018
17057,43,35418,32549,1315,1043,8939,50180,14090,10825,3265,14090,86700,2018
17059,45.3,5157,4936,12,75,1578,42500,2314,1738,576,2314,75300,2018
17061,42.9,13218,12746,194,86,3322,46052,5005,3958,1047,5005,77400,2018
17063,37.6,50509,43702,611,4877,13923,74140,19398,13799,5599,19398,191300,2018
17065,44.1,8221,7920,31,198,2373,56862,3376,2721,655,3376,98100,2018
17067,46,18112,17435,148,268,5064,51549,7420,6047,1373,7420,86700,2018
17069,46.2,4009,3793,112,69,907,43081,1438,1155,283,1438,71500,2018
17071,49.7,6884,6620,5,117,2002,52712,2990,2433,557,2990,91300,2018
17073,43.1,49464,44823,848,2773,13635,57250,20023,15574,4449,20023,118800,2018
17075,44.5,28169,25375,282,1914,7936,51825,11779,9053,2726,11779,99500,2018
17077,31.6,58551,43423,8604,2530,12477,37802,23728,12324,11404,23728,106400,2018
17079,42.8,9598,9326,97,24,2458,54951,3656,3013,643,3656,99400,2018
17081,41,38169,32703,3193,969,9816,47617,15223,11065,4158,15223,94400,2018
17083,42.7,22069,21162,105,302,5921,56747,8665,6992,1673,8665,144800,2018
17085,49.7,21834,20695,110,648,6223,57083,9758,7626,2132,9758,144600,2018
17087,43.2,12602,10647,1462,403,3058,50923,4342,3653,689,4342,99400,2018
17089,37,530839,304340,27979,168385,131854,76912,178050,130827,47223,178050,232000,2018
17091,37.6,111061,80148,16543,11317,26471,57981,40050,27319,12731,40050,144200,2018
17093,34.9,124626,87623,8184,22616,31947,91764,40407,33555,6852,40407,224200,2018
17095,42.1,50999,42325,4349,2875,11860,43709,20830,13627,7203,20830,83100,2018
17097,38.2,703619,437597,46334,150590,179569,86244,244672,179473,65199,244672,259900,2018
17099,41.8,110401,94724,2678,10473,29552,56243,44644,32348,12296,44644,126000,2018
17101,41,16189,13711,1440,616,4114,45654,6144,4367,1777,6144,73800,2018
17103,43.4,34527,29847,1754,2077,8491,57901,13699,9975,3724,13699,117600,2018
17105,42,36324,32418,1420,1627,9483,56200,14320,10320,4000,14320,109700,2018
17107,40.4,29207,25266,1833,1000,6821,57899,10872,7909,2963,10872,102900,2018
17109,32.1,30875,27213,1431,835,6120,43724,11292,7535,3757,11292,94200,2018
17111,40.2,307789,250987,4160,39326,83541,84803,111812,88631,23181,111812,219600,2018
17113,32.9,173219,137682,14200,8340,40460,65813,66159,42440,23719,66159,166700,2018
17115,41.3,106512,81459,15185,2366,26739,50444,44113,30676,13437,44113,96800,2018
17117,43.6,45719,43966,422,536,12711,53778,18772,14321,4451,18772,99600,2018
17119,40.1,265670,226512,22318,8485,69285,57890,107413,76007,31406,107413,132300,2018
17121,42.1,38084,34772,1328,748,10170,46102,15913,11676,4237,15913,74900,2018
17123,46.3,11794,11177,46,360,3112,55901,4893,4017,876,4893,104800,2018
17125,45.3,13778,13308,130,147,3823,45596,6027,4701,1326,6027,79600,2018
17127,43.8,14430,12765,901,404,3892,42604,6011,4527,1484,6011,83700,2018
17129,42.9,12367,11832,58,185,3661,69102,5198,4012,1186,5198,137400,2018
17131,44.8,15693,14993,92,364,4499,58011,6624,5157,1467,6624,106000,2018
17133,42.6,33936,32722,76,514,10037,81268,13349,11277,2072,13349,209100,2018
17135,43.1,29009,26693,1458,504,7370,50304,11339,8742,2597,11339,82200,2018
17137,41.5,34426,30467,2267,816,8556,48508,13864,9405,4459,13864,104800,2018
17139,40.3,14703,14243,78,197,3950,59623,5910,4586,1324,5910,109000,2018
17141,42.4,51328,44681,497,5108,14335,59707,20901,15449,5452,20901,143100,2018
17143,37.2,184463,129321,32208,8681,44659,54770,73629,47914,25715,73629,129900,2018
17145,41.7,21384,18359,1918,657,5420,48298,8323,6238,2085,8323,85400,2018
17147,43,16427,15826,90,213,4775,69271,6700,5478,1222,6700,130300,2018
17149,42.3,15754,15097,234,195,4232,42664,6527,5106,1421,6527,78800,2018
17151,53.7,4249,3865,223,79,1033,40671,1644,1399,245,1644,87200,2018
17153,44.1,5611,3571,1680,124,1317,33799,2173,1626,547,2173,63600,2018
17155,47.9,5746,5300,24,308,1651,65034,2395,1929,466,2395,124500,2018
17157,42,32546,27666,3305,996,7734,52107,11873,8987,2886,11873,104700,2018
17159,41.9,15881,15153,141,264,4025,48724,6482,4649,1833,6482,87700,2018
17161,40.1,145275,104633,14107,18459,37533,52630,60294,41392,18902,60294,117000,2018
17163,38.3,263463,162966,79040,10507,65340,53681,103063,66915,36148,103063,124700,2018
17165,42,24231,22175,683,430,6668,41167,10002,7240,2762,10002,73100,2018
17167,40,197661,159026,24901,4449,50630,60466,83661,57651,26010,83661,138100,2018
17169,45.8,7064,6400,518,29,1737,46151,2836,2169,667,2836,85900,2018
17171,44.1,5047,4899,8,62,1354,53973,1959,1532,427,1959,85000,2018
17173,44.8,21832,21249,202,226,6282,51157,9203,7384,1819,9203,90100,2018
17175,45.1,5500,5267,38,88,1485,52260,2294,1841,453,2294,85400,2018
17177,45.1,45433,37665,4469,1725,12749,48016,19609,13468,6141,19609,97000,2018
17179,40.9,133852,125950,1747,3019,36888,62342,54613,41756,12857,54613,139700,2018
17181,43.7,17127,15591,237,876,4679,49182,6669,5176,1493,6669,101500,2018
17183,40.3,78407,61549,10885,3877,19598,45384,31180,21563,9617,31180,78900,2018
17185,43.6,11573,10918,93,271,3279,51432,4896,3737,1159,4896,80500,2018
17187,39.3,17338,14455,449,1631,4508,49607,6690,5053,1637,6690,84300,2018
17189,43.4,14155,13607,117,201,4038,59469,5975,4700,1275,5975,109400,2018
17191,43.3,16487,15872,290,81,4522,49764,7075,5400,1675,7075,82000,2018
17193,44.1,14025,13537,101,198,3913,47773,6082,4738,1344,6082,69700,2018
17195,43.2,56396,47787,900,6687,15278,53828,23346,17553,5793,23346,103400,2018
17197,37.6,688697,442248,75872,117522,171789,83504,227848,184653,43195,227848,224800,2018
17199,40.9,67299,60494,2759,1749,17327,49053,27089,18929,8160,27089,111800,2018
17201,39.6,286174,199283,35871,35640,73716,52743,114608,75348,39260,114608,117000,2018
17203,40,38817,37095,240,695,10687,71867,14566,11936,2630,14566,162700,2018
18001,33.4,35195,32917,392,1588,8692,51713,12476,9634,2842,12476,122400,2018
18003,35.8,370016,274671,41308,27170,93312,53402,143500,97949,45551,143500,123800,2018
18005,37.7,81893,67423,1419,5423,20938,59045,31669,22587,9082,31669,143800,2018
18007,40.5,8667,8032,49,445,2229,46188,3403,2453,950,3403,87900,2018
18009,44.3,12129,11615,17,191,3428,42217,5225,3962,1263,5225,71300,2018
18011,38,64321,58620,1024,1842,18124,80567,24645,18905,5740,24645,222500,2018
18013,49.2,15034,14392,157,249,4430,61455,6093,5091,1002,6093,186000,2018
18015,42.8,19994,18811,88,787,5468,56429,7880,6371,1509,7880,131600,2018
18017,40.8,38084,30638,451,5667,9606,47545,14666,10902,3764,14666,85500,2018
18019,38.9,115702,96633,7941,6147,28584,54240,44275,31193,13082,44275,137800,2018
18021,40.9,26268,25283,202,98,7487,53021,10510,8083,2427,10510,102000,2018
18023,38.2,32301,26671,201,5028,8131,52488,12007,8601,3406,12007,104000,2018
18025,43.6,10581,10188,33,151,2641,43875,3915,3241,674,3915,89700,2018
18027,34.7,32937,30289,561,1583,8187,51032,11417,8381,3036,11417,121500,2018
18029,42.7,49501,47648,419,614,13427,65096,18648,14706,3942,18648,165400,2018
18031,38.9,26552,25203,167,515,7028,54622,10425,7199,3226,10425,124700,2018
18033,39.1,42704,40599,71,1188,11431,53808,16789,12860,3929,16789,118100,2018
18035,35.4,115616,100534,8254,2751,27362,42705,46028,29688,16340,46028,90900,2018
18037,40.4,42418,38517,181,3115,11219,58994,16550,12920,3630,16550,149500,2018
18039,35.5,203604,152835,10694,31761,52027,55399,72329,49784,22545,72329,137900,2018
18041,42.6,23259,22252,569,267,6451,43317,9568,6653,2915,9568,82400,2018
18043,39.9,76809,67656,4002,2421,19655,61754,29356,21265,8091,29356,165700,2018
18045,43.1,16486,15732,60,406,4698,49887,7015,5338,1677,7015,94900,2018
18047,42,22842,22704,25,25,6894,58382,8744,7092,1652,8744,151900,2018
18049,41.3,20212,18601,204,1029,5108,49333,7884,6045,1839,7884,97200,2018
18051,40.3,33596,31602,658,523,9277,52620,13244,10228,3016,13244,110300,2018
18053,40.3,66944,56999,4890,2814,17301,42593,26121,18079,8042,26121,89500,2018
18055,42.9,32295,31235,111,446,8495,49177,12790,10228,2562,12790,95600,2018
18057,36.9,316095,266078,11649,12280,86746,94644,116982,90394,26588,116982,249400,2018
18059,39.9,73830,68493,1549,1674,20149,73142,28215,21890,6325,28215,165200,2018
18061,42.5,39712,37888,309,730,10274,57132,14584,12037,2547,14584,143500,2018
18063,37.7,160940,136697,10167,6016,42939,78355,58078,45575,12503,58078,179600,2018
18065,42.2,48483,45405,1184,843,12343,48235,18408,13543,4865,18408,96200,2018
18067,41.7,82387,70322,5740,2691,22575,50869,34550,23617,10933,34550,106300,2018
18069,40.7,36378,34551,333,847,10159,52208,14754,11193,3561,14754,105000,2018
18071,38.7,43938,38994,471,2903,11820,49506,16746,12158,4588,16746,116700,2018
18073,39.9,33449,30653,254,1999,8784,59574,12539,9486,3053,12539,158300,2018
18075,40,20993,19944,90,640,5391,44772,8149,5950,2199,8149,85400,2018
18077,40.5,32237,29926,704,876,8741,51119,12759,9177,3582,12759,123700,2018
18079,39.7,27727,26400,314,663,7126,49801,10659,8025,2634,10659,103900,2018
18081,37.4,151564,135959,3611,5286,40352,68712,55777,40050,15727,55777,158200,2018
18083,38,37409,34727,1070,717,9752,46457,14955,9722,5233,14955,88700,2018
18085,38,78806,69436,547,6245,21685,58402,30676,22563,8113,30676,146000,2018
18087,31.4,38942,36716,31,1544,9446,60675,12079,9988,2091,12079,179200,2018
18089,38.7,486849,264358,115090,90954,122498,54249,185437,129102,56335,185437,143500,2018
18091,40.4,110552,87918,12154,7136,28028,51101,42904,30824,12080,42904,127700,2018
18093,42.8,45619,43677,163,743,12943,52092,18487,14344,4143,18487,115700,2018
18095,40.3,129505,110235,9989,5074,33990,47436,51422,35935,15487,51422,93700,2018
18097,34.4,944523,528704,259571,96260,204538,46692,369033,199179,169854,369033,129200,2018
18099,40.1,46595,40816,374,4585,11921,54229,17245,12969,4276,17245,134500,2018
18101,42.7,10210,9913,80,107,2682,51224,4198,3323,875,4198,111100,2018
18103,40,35901,31959,1841,1109,9318,47460,13707,9759,3948,13707,87200,2018
18105,29.3,145403,121893,4227,4895,29135,47075,55537,30431,25106,55537,167900,2018
18107,40.5,38276,35246,303,1827,10315,53610,15271,10821,4450,15271,120500,2018
18109,41.4,69727,67069,212,1053,18650,62462,25926,19750,6176,25926,154300,2018
18111,42.9,14018,13069,37,868,3836,53146,5562,4391,1171,5562,115300,2018
18113,38.7,47451,41384,243,4858,12754,55033,18090,13749,4341,18090,118100,2018
18115,47.5,5887,5693,68,64,1756,61148,2513,1970,543,2513,148100,2018
18117,42.1,19547,18641,260,301,5293,45341,7881,5885,1996,7881,92200,2018
18119,44.9,20878,20097,100,259,5888,48667,8695,6849,1846,8695,113500,2018
18121,41.8,16996,16085,67,262,4442,48788,6145,4737,1408,6145,91300,2018
18123,42.2,19141,18035,546,260,4928,51064,7465,5781,1684,7465,108800,2018
18125,43.7,12411,11977,125,101,3352,52527,5129,4253,876,5129,96700,2018
18127,39.5,168041,140490,5620,16449,44440,68044,63969,48269,15700,63969,178100,2018
18129,42.3,25589,24570,377,296,7281,62583,10175,8249,1926,10175,141000,2018
18131,41.2,12660,11962,43,372,3409,48370,5200,4004,1196,5200,98700,2018
18133,37.9,37559,34494,1001,716,9337,56169,13439,9648,3791,13439,121300,2018
18135,42.4,25076,23428,170,845,6663,45601,10477,8058,2419,10477,79600,2018
18137,40.8,28425,27146,144,512,7846,56295,11165,8612,2553,11165,149800,2018
18139,41.6,16704,16006,257,266,4741,50535,6725,4798,1927,6725,104300,2018
18141,36.5,269240,196732,34488,22901,64343,50938,101241,68675,32566,101241,123900,2018
18143,40.7,23743,22689,60,521,6411,47123,9004,6550,2454,9004,99600,2018
18145,41,44399,41011,481,1844,11921,59214,17725,12989,4736,17725,130100,2018
18147,43.6,20526,19495,149,589,5803,56998,8109,6567,1542,8109,121000,2018
18149,41.6,22941,21655,84,835,6089,48895,8735,6901,1834,8735,108000,2018
18151,43.2,34474,32389,93,1206,9512,56101,14156,10969,3187,14156,140600,2018
18153,41,20792,19135,799,357,5237,46517,7707,5663,2044,7707,85500,2018
18155,40.1,10628,10157,99,208,2962,47929,4297,3163,1134,4297,110800,2018
18157,28,189294,144589,9445,15486,38701,51844,69112,37571,31541,69112,148800,2018
18159,44.9,15218,14472,25,412,4239,55479,6295,5075,1220,6295,106200,2018
18161,43.8,7153,6838,5,128,1822,48227,2846,2022,824,2846,112100,2018
18163,38.1,181313,152149,16961,4685,44263,46943,75197,48379,26818,75197,126400,2018
18165,43.1,15560,15025,217,57,4299,48377,6616,4821,1795,6616,77400,2018
18167,36.2,107693,92262,7013,2826,24940,43859,41874,25671,16203,41874,92400,2018
18169,42.2,31631,29889,304,805,8507,50637,12875,9425,3450,12875,97200,2018
18171,44.5,8247,7935,53,137,2507,61148,3384,2838,546,3384,115400,2018
18173,40.9,61928,57318,1072,1122,17654,70648,24267,19278,4989,24267,162700,2018
18175,41.5,27827,26938,24,369,7787,47078,10721,8165,2556,10721,113200,2018
18177,40.9,66613,58859,3300,1949,17375,44228,26611,17985,8626,26611,97400,2018
18179,39.8,27947,26450,202,812,7614,56265,10874,8648,2226,10874,120700,2018
18181,41.9,24217,21683,97,1973,6836,55086,9745,7615,2130,9745,110300,2018
18183,40.8,33649,32138,139,675,9675,61153,13548,11266,2282,13548,138700,2018
19001,45.4,7124,6867,27,135,2054,51859,3136,2404,732,3136,100100,2018
19003,47.3,3726,3643,16,47,1060,49229,1641,1269,372,1641,86100,2018
19005,44.8,13880,12602,174,884,3793,51057,5957,4630,1327,5957,124900,2018
19007,45.4,12510,11938,74,239,3188,41111,5416,3971,1445,5416,78000,2018
19009,49,5637,5461,2,37,1617,50397,2677,2080,597,2677,71100,2018
19011,42.6,25626,24730,155,371,7293,65475,10224,8418,1806,10224,157800,2018
19013,34.9,133009,108350,12031,5738,31653,52688,52976,34803,18173,52976,143100,2018
19015,41.8,26399,24924,135,685,7187,61111,10940,8407,2533,10940,131900,2018
19017,39.7,24782,23602,247,380,6607,68023,9585,7858,1727,9585,162100,2018
19019,38.7,21125,20334,22,321,5503,61409,8046,6302,1744,8046,138000,2018
19021,35.2,20260,12226,551,5107,5082,54556,7550,5025,2525,7550,112700,2018
19023,44.1,14735,14243,81,194,4213,55999,6251,4945,1306,6251,115800,2018
19025,45.1,9780,9241,121,182,2722,50800,4191,3263,928,4191,80000,2018
19027,41.7,20344,20043,35,147,5498,57674,8674,6674,2000,8674,132700,2018
19029,44.9,13191,12615,40,326,3535,48178,5964,4136,1828,5964,97800,2018
19031,42,18445,17643,136,358,4913,65791,7546,6076,1470,7546,150700,2018
19033,44.5,42984,39094,745,2034,11691,52902,19213,13284,5929,19213,124400,2018
19035,46.8,11468,10741,269,147,3085,54658,5337,3956,1381,5337,95200,2018
19037,44.3,12099,11609,51,295,3278,55385,5191,4163,1028,5191,112000,2018
19039,39.5,9282,7972,6,1227,2564,51571,3854,2728,1126,3854,104700,2018
19041,42.7,16313,15249,44,567,4583,47874,7343,5051,2292,7343,120600,2018
19043,47.1,17672,16965,181,339,4841,52828,7652,5738,1914,7652,121000,2018
19045,42.2,47218,43145,1262,1443,12377,50156,19689,14607,5082,19689,114900,2018
19047,37.8,17132,11401,428,4758,4532,53609,6435,4698,1737,6435,90700,2018
19049,35.3,84002,72040,1361,5120,22640,84790,32886,24456,8430,32886,231000,2018
19051,37,8885,8609,5,124,2322,58464,3215,2665,550,3215,114000,2018
19053,36.4,8044,7476,127,227,1996,42614,3213,2124,1089,3213,76800,2018
19055,43.6,17258,16698,48,254,4824,61179,6939,5754,1185,6939,134200,2018
19057,42.6,39600,34741,2328,1193,10459,49977,16840,12205,4635,16840,103600,2018
19059,48.4,17056,16354,111,333,5162,58099,8069,6372,1697,8069,179300,2018
19061,38.5,96802,88171,3263,2315,25272,61321,38330,27736,10594,38330,160900,2018
19063,42.4,9551,8363,168,913,2592,48542,4110,3168,942,4110,86400,2018
19065,43.6,19929,18717,379,462,5384,50015,8315,6269,2046,8315,94800,2018
19067,43.9,15858,14593,274,467,4248,48110,6759,4881,1878,6759,104700,2018
19069,42.4,10245,8747,142,1271,2966,53742,4200,3121,1079,4200,88500,2018
19071,45.8,6968,6619,32,184,1974,54281,2990,2217,773,2990,102700,2018
19073,44.5,9003,8542,25,252,2525,54050,3889,2887,1002,3889,94300,2018
19075,42.5,12341,11976,69,155,3537,66965,5137,4085,1052,5137,131200,2018
19077,45.6,10674,10162,3,286,2957,57075,4397,3493,904,4397,115900,2018
19079,42.4,15110,13495,206,901,4128,56273,6315,4601,1714,6315,101600,2018
19081,44.5,10888,10179,70,453,3248,61167,4766,3715,1051,4766,102900,2018
19083,44.7,17127,15764,217,735,4452,53872,7175,5529,1646,7175,92900,2018
19085,44.1,14143,13628,31,233,4046,60063,6076,4547,1529,6076,115200,2018
19087,40,19926,17585,449,948,5283,52428,7714,5475,2239,7714,108700,2018
19089,42.2,9264,8953,29,146,2415,52742,3868,3058,810,3868,107600,2018
19091,43,9566,8961,25,407,2687,52219,4221,3133,1088,4221,102300,2018
19093,44.5,6916,6621,0,152,1942,55969,3010,2281,729,3010,96200,2018
19095,42.1,16207,15450,148,430,4620,58570,6791,5304,1487,6791,146400,2018
19097,44.7,19395,18537,99,276,5414,54070,8236,6502,1734,8236,123500,2018
19099,42.3,36891,34614,704,792,9935,55727,14548,10758,3790,14548,128000,2018
19101,43,18077,14591,310,529,4094,43378,6831,4582,2249,6831,109400,2018
19103,30,147001,115842,9822,8184,31796,61640,58163,34716,23447,58163,216900,2018
19105,43.4,20568,19304,504,390,5425,56012,8204,6206,1998,8204,133000,2018
19107,43.9,10200,9855,39,166,2804,51043,4384,3370,1014,4384,88800,2018
19109,45.5,15075,14339,166,362,4213,54146,6666,5082,1584,6666,103600,2018
19111,43.2,34541,31395,883,1232,9348,48571,14177,10536,3641,14177,93300,2018
19113,37.5,222121,191906,11539,7084,56326,64862,89807,66812,22995,89807,153700,2018
19115,41.2,11223,8771,125,1768,2950,53943,4343,3332,1011,4343,108500,2018
19117,44.6,8597,8408,13,153,2359,50206,3642,2813,829,3642,87600,2018
19119,38.1,11769,11277,7,304,3297,64352,4549,3794,755,4549,132400,2018
19121,40.1,15890,15174,37,331,4660,64512,6309,4953,1356,6309,166500,2018
19123,39.7,22208,20757,339,475,5832,52950,8829,6284,2545,8829,114000,2018
19125,39.2,33207,31445,197,629,8898,58492,13314,9390,3924,13314,152400,2018
19127,39.1,40271,28874,357,8581,10013,54027,15338,10922,4416,15338,105500,2018
19129,42.1,14957,14105,130,448,3939,69177,5587,4357,1230,5587,165200,2018
19131,43.8,10631,10280,9,146,2853,55553,4397,3635,762,4397,114400,2018
19133,46.5,8796,8346,24,170,2431,45252,4053,2880,1173,4053,86700,2018
19135,41.8,7863,7352,5,201,2135,49549,3329,2598,731,3329,92500,2018
19137,44,10155,9533,0,384,2946,47648,4587,3148,1439,4587,83400,2018
19139,38.1,42950,33158,971,7641,11115,57348,16536,12053,4483,16536,127100,2018
19141,42.4,13911,12907,125,651,3791,53045,6031,4337,1694,6031,111400,2018
19143,43.8,6115,5477,77,479,1648,58125,2611,1980,631,2611,91900,2018
19145,44,15363,14020,260,512,3907,49974,6323,4582,1741,6323,91400,2018
19147,41.8,9055,8494,197,241,2459,52462,3812,2832,980,3812,100000,2018
19149,39.9,25039,23090,159,1244,7158,64296,10115,7959,2156,10115,155900,2018
19151,47.9,6898,6429,44,253,1939,49877,3205,2479,726,3205,75400,2018
19153,35.3,474274,370282,30183,39086,115653,66044,183753,123431,60322,183753,171800,2018
19155,39.5,93503,82251,1335,7122,24133,57467,36881,25155,11726,36881,136900,2018
19157,40.7,18605,17040,345,597,4802,53520,7681,5323,2358,7681,140200,2018
19159,44.9,4984,4767,3,119,1293,52005,1997,1543,454,1997,89100,2018
19161,46.2,9868,9399,64,283,2930,54958,4367,3454,913,4367,90500,2018
19163,38.3,172288,138243,12815,11370,42130,58803,67025,46559,20466,67025,158200,2018
19165,46.1,11694,11089,96,332,3177,55489,5046,3911,1135,5046,117000,2018
19167,33.2,34825,30340,124,3655,8916,67178,12166,9705,2461,12166,159400,2018
19169,26.3,96922,81476,1772,3259,19171,54554,37219,19638,17581,37219,180400,2018
19171,42.8,17136,13960,143,1581,4496,55898,6755,5153,1602,6755,107800,2018
19173,42.8,6201,5596,15,492,1710,48717,2650,2028,622,2650,79500,2018
19175,39.9,12453,11730,63,365,3164,47518,5194,3676,1518,5194,99800,2018
19177,44.3,7223,6976,35,107,1908,47083,2863,2342,521,2863,90900,2018
19179,39.3,35315,29257,1122,3763,9371,45233,14418,10421,3997,14418,82000,2018
19181,38.3,49361,46635,192,1333,13329,74383,18959,14765,4194,18959,176600,2018
19183,40.8,22143,20198,191,1336,6072,61769,8720,6174,2546,8720,148700,2018
19185,43,6413,6171,67,55,1636,45017,2669,2178,491,2669,77600,2018
19187,39.1,36757,32224,1719,1743,9079,44261,15208,10260,4948,15208,96600,2018
19189,42.6,10571,9708,136,464,2809,51002,4605,3386,1219,4605,94100,2018
19191,41.3,20401,19415,193,446,5332,62820,8205,6494,1711,8205,167800,2018
19193,35.7,102398,75673,3193,16541,25575,55483,38975,25582,13393,38975,117700,2018
19195,44,7489,7070,92,218,2109,54329,3170,2450,720,3170,104300,2018
19197,43.4,12804,11026,88,1481,3482,50198,5690,4070,1620,5690,85300,2018
20001,41.8,12630,11431,188,438,3120,42679,5289,3761,1528,5289,78700,2018
20003,41.5,7852,7462,45,142,2024,46274,3069,2277,792,3069,93400,2018
20005,36.1,16363,14456,373,487,3829,48667,5980,4090,1890,5980,101600,2018
20007,43.8,4733,4332,28,191,1158,50613,1960,1388,572,1960,66400,2018
20009,40,26791,21895,326,3935,7230,50198,10892,7599,3293,10892,92300,2018
20011,39.3,14702,13254,473,390,3841,40733,5722,3997,1725,5722,83300,2018
20013,42.2,9664,8055,105,415,2666,48547,3904,2849,1055,3904,88700,2018
20015,38.4,66468,59255,1481,3142,17622,63272,24473,18034,6439,24473,147100,2018
20017,44.4,2645,2416,46,122,652,46295,1029,815,214,1029,96200,2018
20019,48.8,3367,2905,20,36,897,38690,1450,1139,311,1450,62500,2018
20021,41.9,20331,17952,125,512,5492,41103,8037,5955,2082,8037,80300,2018
20023,45.7,2677,2471,0,174,709,46833,1228,973,255,1228,84000,2018
20025,44.3,2053,1764,10,172,549,50368,893,638,255,893,77700,2018
20027,43,8142,7674,45,201,2294,56186,3402,2609,793,3402,97300,2018
20029,41,9060,8429,161,289,2386,44143,3858,2735,1123,3858,73900,2018
20031,44,8296,7750,51,219,2474,58636,3548,2736,812,3548,117700,2018
20033,47.5,1780,1632,0,123,484,56912,744,600,144,744,78800,2018
20035,38.8,35591,28384,963,3836,9021,48087,13566,9028,4538,13566,87300,2018
20037,32.5,39108,33979,842,2146,8988,40174,15053,8795,6258,15053,91000,2018
20039,49.5,2881,2744,4,81,784,44104,1486,1070,416,1486,64700,2018
20041,41.5,19004,17297,254,876,4992,48167,7801,5442,2359,7801,109500,2018
20043,41.3,7736,6986,422,215,1926,49338,3024,2207,817,3024,101000,2018
20045,29.5,119319,93868,4841,7356,25119,55832,46294,24001,22293,46294,192800,2018
20047,44.7,2925,2247,17,595,809,49293,1302,1024,278,1302,60600,2018
20049,51.7,2562,2318,6,111,701,38494,1117,892,225,1117,50400,2018
20051,32.6,28878,25914,399,1640,6435,52700,11581,7095,4486,11581,164500,2018
20053,42.3,6293,5399,287,380,1518,48188,2462,1849,613,2462,94200,2018
20055,30.5,36957,15476,904,18286,8972,56573,12509,7820,4689,12509,140500,2018
20057,31.9,34484,13856,668,18809,8296,53072,11274,7030,4244,11274,109900,2018
20059,39.1,25563,23263,271,1062,6757,55486,9982,7106,2876,9982,125600,2018
20061,26.1,34895,19844,5914,5571,8922,49185,12754,4756,7998,12754,142200,2018
20063,48.1,2619,2434,3,91,804,48894,1211,934,277,1211,80600,2018
20065,51.9,2545,2250,100,77,705,40769,1216,965,251,1216,70100,2018
20067,32.6,7616,3939,0,3598,1915,55455,2592,2023,569,2592,109000,2018
20069,36.2,6037,4961,0,950,1605,64426,2179,1646,533,2179,131300,2018
20071,36.5,1200,899,8,276,326,51250,494,307,187,494,97900,2018
20073,48.7,6156,5673,19,233,1785,42595,2758,2033,725,2758,63500,2018
20075,32.2,2616,1603,25,937,557,45000,852,589,263,852,84600,2018
20077,42.3,5673,5117,10,355,1500,49455,2274,1631,643,2274,72300,2018
20079,39.5,34555,28673,573,4078,9131,56051,13383,9605,3778,13383,123100,2018
20081,36.6,4047,2724,0,1219,1038,53527,1329,1011,318,1329,104700,2018
20083,49.1,1842,1625,0,158,521,53854,761,586,175,761,81700,2018
20085,41.6,13318,11198,86,600,3774,55904,5392,4075,1317,5392,132500,2018
20087,44.2,18888,17698,128,494,5452,61793,7600,6230,1370,7600,145000,2018
20089,52.6,2916,2783,18,68,818,42552,1380,1129,251,1380,52800,2018
20091,37.5,585502,469810,26671,44056,154742,84915,226242,156387,69855,226242,244100,2018
20093,34.4,3932,2608,21,1232,950,51314,1261,962,299,1261,109500,2018
20095,45.5,7470,6984,21,254,2124,58483,3091,2434,657,3091,94200,2018
20097,40.3,2526,2240,16,164,633,51336,981,699,282,981,119900,2018
20099,40.6,20367,17409,852,908,5577,47668,8033,5656,2377,8033,78800,2018
20101,41.2,1642,1508,1,97,441,51719,787,607,180,787,76700,2018
20103,37.6,80042,63297,6482,5498,19457,71184,27060,18251,8809,27060,173900,2018
20105,46.4,3097,2928,23,98,757,46196,1264,1016,248,1264,73200,2018
20107,43.9,9635,9029,30,252,2835,43699,4348,3375,973,4348,99800,2018
20109,40,2810,2537,1,163,746,51597,1137,811,326,1137,87200,2018
20111,33.4,33299,23742,746,6998,7960,44191,13584,8000,5584,13584,104100,2018
20113,41.1,28630,26281,313,1176,7968,57765,12298,8602,3696,12298,146600,2018
20115,44.7,12032,11172,59,430,3238,51262,4789,3808,981,4789,86800,2018
20117,44,9798,9287,50,239,2651,50234,4112,3166,946,4112,94900,2018
20119,37.3,4261,3325,21,785,1140,55568,1675,1163,512,1675,92700,2018
20121,41.9,33127,30774,456,1031,8974,69150,12727,9997,2730,12727,191100,2018
20123,43.5,6222,5919,48,147,1545,45221,2616,1943,673,2616,85300,2018
20125,40.5,32970,26324,1656,2135,8760,45173,13538,9330,4208,13538,75000,2018
20127,47.7,5566,5117,2,263,1554,50352,2247,1762,485,2247,101200,2018
20129,43.1,2838,2039,26,654,684,43925,1117,781,336,1117,94700,2018
20131,39.9,10104,9631,56,204,2732,58644,4020,2975,1045,4020,123500,2018
20133,40.1,16125,14579,157,811,4305,44294,6681,4707,1974,6681,81200,2018
20135,48.7,2955,2609,21,300,873,51033,1313,1122,191,1313,73400,2018
20137,43.2,5486,4895,148,282,1304,49891,1930,1430,500,1930,75100,2018
20139,43.6,15882,14833,95,496,4484,55036,6554,4878,1676,6554,110700,2018
20141,46.7,3603,3405,14,74,958,48355,1691,1273,418,1691,68500,2018
20143,42.6,5902,5555,53,163,1680,51971,2420,1964,456,2420,98800,2018
20145,45.7,6709,5651,331,524,1436,42853,2502,1703,799,2502,75300,2018
20147,44.6,5408,5074,32,183,1532,48272,2363,1825,538,2363,80000,2018
20149,35.1,23545,21158,155,1238,6335,64657,8695,6681,2014,8695,181200,2018
20151,38.5,9582,8469,225,688,2365,54029,3684,2522,1162,3684,93200,2018
20153,49.2,2509,2274,10,170,712,48125,1168,886,282,1168,95000,2018
20155,40.4,63101,53154,1668,5888,15903,49174,25052,17207,7845,25052,98100,2018
20157,51.1,4686,4489,16,87,1318,48022,2248,1673,575,2248,62800,2018
20159,39.1,9762,8181,164,1101,2571,50764,3863,2874,989,3863,74700,2018
20161,25.1,75296,57609,4658,6232,14214,49910,26648,11310,15338,26648,194800,2018
20163,43.8,5118,4819,44,131,1340,50511,2100,1659,441,2100,78000,2018
20165,47.6,3102,2903,5,83,771,40598,1403,1080,323,1403,72300,2018
20167,49.1,6977,6468,107,217,1947,52806,2979,2404,575,2979,89300,2018
20169,38.5,54977,44169,1507,6078,13703,50515,22210,15000,7210,22210,128500,2018
20171,39.4,4949,3932,0,885,1362,71394,2025,1504,521,2025,134200,2018
20173,35.2,512064,349985,44285,73527,124872,54974,195779,124574,71205,195779,135600,2018
20175,29.4,22692,6980,1132,13627,5186,47025,7315,5008,2307,7315,98200,2018
20177,38.9,178284,132198,14183,21736,44298,55199,72017,46668,25349,72017,130500,2018
20179,44.3,2506,2361,11,120,727,56071,1134,836,298,1134,106900,2018
20181,38.8,5966,5011,43,723,1739,52847,2649,1703,946,2649,92700,2018
20183,51.6,3663,3477,8,76,1112,43438,1681,1315,366,1681,66900,2018
20185,44.4,4214,3523,25,560,1251,48563,1811,1484,327,1811,62200,2018
20187,39.6,2063,1253,1,744,549,46726,807,659,148,807,79700,2018
20189,34.7,5686,3471,37,2049,1443,56507,1911,1314,597,1911,111900,2018
20191,41.1,23208,20839,245,1245,6064,54915,9321,6849,2472,9321,87400,2018
20193,36.1,7824,7092,132,471,2306,57478,3301,2385,916,3301,120800,2018
20195,49.2,2858,2699,3,58,892,56810,1380,1062,318,1380,90100,2018
20197,43.8,6888,6374,32,247,1873,60450,2749,2346,403,2749,129100,2018
20199,43.1,1575,1453,4,83,423,58875,633,492,141,633,99300,2018
20201,46.5,5525,5197,14,189,1524,48889,2344,1843,501,2344,78200,2018
20203,45,2143,1450,19,625,615,57566,903,664,239,903,88900,2018
20205,43.9,8780,8094,49,267,2430,46208,3795,2732,1063,3795,67400,2018
20207,48.3,3170,2945,34,30,810,34621,1476,1145,331,1476,59800,2018
20209,33.7,164345,67669,36256,46738,38364,44873,59983,34265,25718,59983,95600,2018
21001,41.5,19241,17965,623,363,4879,39346,7020,5353,1667,7020,89600,2018
21003,40,20794,19793,311,428,5516,40893,7697,5557,2140,7697,112300,2018
21005,41,22214,20895,566,383,5960,54160,8627,6704,1923,8627,142200,2018
21007,43.3,8090,7507,336,103,2105,44350,3085,2462,623,3085,99800,2018
21009,40.3,43680,39524,1611,1362,11325,40216,16965,11328,5637,16965,116500,2018
21011,40.4,12268,11678,141,195,3386,40837,4624,3288,1336,4624,88200,2018
21013,41.6,27188,25651,780,279,7076,24628,10940,7060,3880,10940,59900,2018
21015,37.3,129095,113728,3873,5339,34312,75043,46404,34370,12034,46404,186500,2018
21017,42.1,20144,17124,1435,1382,5403,51462,8128,5260,2868,8128,142000,2018
21019,41.9,48091,44813,1202,850,12578,46165,18798,13048,5750,18798,110000,2018
21021,40.3,29913,25616,2095,987,7267,43274,10984,7287,3697,10984,142100,2018
21023,40.7,8306,7985,3,148,2150,45827,3377,2521,856,3377,102000,2018
21025,41.6,13116,12689,146,140,3679,26376,5322,3822,1500,5322,50800,2018
21027,42.9,20080,18972,369,289,5261,48189,7675,6024,1651,7675,99600,2018
21029,40.1,79466,75197,562,1479,21590,60534,29374,23683,5691,29374,157900,2018
21031,41,12745,12094,34,408,3537,40061,4996,3656,1340,4996,90100,2018
21033,43.5,12727,11574,840,221,3523,44940,5176,3887,1289,5176,89100,2018
21035,35.3,38776,34788,1314,1036,8701,40219,14641,9216,5425,14641,137200,2018
21037,38.1,92267,85196,2938,1852,23188,59782,36308,25018,11290,36308,168300,2018
21039,42.9,4841,4546,65,105,1296,39664,2020,1599,421,2020,93500,2018
21041,38.1,10711,9503,279,733,2627,43258,3981,2572,1409,3981,111200,2018
21043,41,27290,26396,267,251,6838,33067,9972,7672,2300,9972,88400,2018
21045,42.9,15796,14974,112,459,4177,34457,6330,4945,1385,6330,80700,2018
21047,28.4,72263,47586,14939,5600,17415,41235,25682,12047,13635,25682,113900,2018
21049,42.2,35872,32355,1634,1029,9748,52938,14427,9654,4773,14427,141600,2018
21051,39.7,20621,19093,613,559,5599,26250,7625,5175,2450,7625,58300,2018
21053,41.7,10211,9826,43,289,2439,31115,3835,2693,1142,3835,65400,2018
21055,43.6,9083,8737,109,104,2453,43169,3645,2960,685,3645,89800,2018
21057,46.1,6713,6208,262,59,1778,32906,2769,2014,755,2769,91400,2018
21059,38.7,99937,88308,4233,3009,26543,49836,39808,26597,13211,39808,130800,2018
21061,43.8,12122,11548,185,94,3385,41360,4886,3917,969,4886,90800,2018
21063,41.9,7517,7222,252,22,1968,33377,2576,1909,667,2576,75400,2018
21065,43.7,14313,13934,24,47,3719,31337,5503,3985,1518,5503,75300,2018
21067,34.4,318734,227283,45335,22854,74297,54918,128806,70172,58634,128806,180700,2018
21069,40.9,14479,13890,235,186,4283,42213,5888,4126,1762,5888,92300,2018
21071,41.9,36926,35861,385,295,10438,31267,15163,10680,4483,15163,72700,2018
21073,40.5,50296,41108,4764,1618,12784,55068,20875,13068,7807,20875,142100,2018
21075,43.1,6210,4412,1550,117,1530,28559,2524,1504,1020,2524,63100,2018
21077,38.9,8703,7926,158,467,1952,50204,3073,2198,875,3073,111900,2018
21079,42.7,17328,16329,192,390,5033,49888,6823,5508,1315,6823,139100,2018
21081,36,24915,23346,190,673,6610,45610,8849,6027,2822,8849,129000,2018
21083,40.3,37294,32361,1555,2402,9367,41615,14484,10623,3861,14484,98800,2018
21085,40.5,26178,24907,273,374,6814,37906,9771,6974,2797,9771,107000,2018
21087,44.6,11023,10415,143,52,2973,37374,4466,3368,1098,4466,77500,2018
21089,43.4,35765,34424,298,379,10084,49343,14057,10832,3225,14057,109100,2018
21091,39.4,8719,8336,81,130,2482,52019,3301,2588,713,3301,110300,2018
21093,36.3,108095,82252,12083,6154,27952,53168,41111,25498,15613,41111,153900,2018
21095,41.2,27134,25802,683,247,7707,26324,11213,7642,3571,11213,58500,2018
21097,42.1,18668,17460,361,445,4970,49696,7149,4951,2198,7149,137200,2018
21099,40.2,18627,17052,776,343,4821,37795,7311,5372,1939,7311,92500,2018
21101,40.8,46137,39882,3345,1152,12251,45389,18480,11257,7223,18480,127200,2018
21103,41.3,15814,14489,456,511,4278,51447,5999,4170,1829,5999,129000,2018
21105,46.6,4568,3966,431,53,1087,40463,1855,1501,354,1855,79100,2018
21107,41.9,45664,40471,2901,932,12593,45738,18560,12819,5741,18560,105900,2018
21109,41,13373,13306,13,13,3967,32143,5455,4005,1450,5455,78200,2018
21111,38.1,767154,521137,162652,40117,185093,54357,310318,191339,118979,310318,164400,2018
21113,37.9,52422,46748,2121,1759,14074,56728,18773,11818,6955,18773,168100,2018
21115,41.8,22843,22236,112,89,6031,37559,8737,6319,2418,8737,96300,2018
21117,37,164688,146065,7289,5159,40640,61606,63529,41781,21748,63529,155200,2018
21119,42.6,15513,15062,95,152,4397,29326,6348,4792,1556,6348,51200,2018
21121,40,31467,30176,392,367,7958,28790,12270,7836,4434,12270,82400,2018
21123,40.8,14156,12961,507,459,3873,41779,5654,4157,1497,5654,107500,2018
21125,39.6,60180,57659,560,926,15592,39230,22735,15854,6881,22735,107500,2018
21127,41.1,15783,15287,87,169,4139,31813,5956,4480,1476,5956,82300,2018
21129,44.1,6751,6505,57,40,1527,23972,2864,2005,859,2864,65000,2018
21131,41.8,10472,10229,6,73,2883,30798,4223,3394,829,4223,62000,2018
21133,42.2,22676,22116,88,175,6693,29856,9892,7472,2420,9892,58500,2018
21135,42.9,13490,13196,62,0,3725,31096,5435,4082,1353,5435,67400,2018
21137,40.5,24458,23051,500,389,6535,39833,9706,7478,2228,9706,100500,2018
21139,45.7,9263,8863,64,165,2622,46076,3967,3052,915,3967,104900,2018
21141,40.8,26849,23794,1668,753,6962,43842,10565,7166,3399,10565,108900,2018
21143,48.9,8186,7430,364,240,1961,50097,3258,2650,608,3258,134100,2018
21145,42.1,65284,54451,7148,1594,16142,44486,27841,18354,9487,27841,138900,2018
21147,40,17635,15787,997,438,4361,23273,6203,4366,1837,6203,64400,2018
21149,41.3,9331,8987,47,128,2723,50445,3818,2999,819,3818,98500,2018
21151,34,89700,80410,3818,2138,20726,48687,33229,19396,13833,33229,155000,2018
21153,42.1,12666,12611,5,46,3509,29516,5084,3620,1464,5084,72300,2018
21155,39.7,19232,16871,1417,519,4547,38544,7453,5422,2031,7453,103100,2018
21157,44.8,31166,30078,197,488,9246,50731,13390,10539,2851,13390,123000,2018
21159,39.3,11919,11030,597,198,2870,35125,4112,2971,1141,4112,67500,2018
21161,40.7,17153,15284,934,315,4453,41415,6711,4371,2340,6711,119500,2018
21163,38.5,28326,25320,922,1068,7836,57963,10638,7686,2952,10638,150700,2018
21165,46.2,6405,6369,4,0,1729,39905,2593,2143,450,2593,78600,2018
21167,42.2,21516,19548,838,634,5835,50475,8571,6108,2463,8571,144200,2018
21169,43.4,10004,9506,110,130,2783,35809,3998,3087,911,3998,78300,2018
21171,41.6,10634,9931,293,331,2816,34167,4414,3140,1274,4414,74600,2018
21173,39.1,27759,25776,804,752,7476,41974,10472,6953,3519,10472,117200,2018
21175,41.3,13285,12352,443,126,3518,34419,4958,3634,1324,4958,75000,2018
21177,42.4,31081,28632,1443,465,8018,43110,11317,8910,2407,11317,85700,2018
21179,39.5,45388,41049,2239,953,12013,57469,17491,13405,4086,17491,149500,2018
21181,41.5,7100,6803,76,121,1950,41354,2694,1925,769,2694,84600,2018
21183,40.6,24071,22724,225,816,6470,42826,9076,6866,2210,9076,91300,2018
21185,39,65374,57779,2386,2564,16934,97597,20733,17597,3136,20733,271900,2018
21187,41.2,10741,10180,174,291,2737,45338,3921,2866,1055,3921,99400,2018
21189,42.5,4463,4366,62,16,1158,25530,1664,1161,503,1664,71900,2018
21191,41.1,14520,13987,116,189,3869,52620,5260,3926,1334,5260,104900,2018
21193,41.2,26917,25710,306,271,7656,31046,11172,8340,2832,11172,73800,2018
21195,42.1,60483,58657,533,553,17695,34081,25768,18714,7054,25768,78400,2018
21197,39.2,12321,11840,29,197,3395,36958,4831,3387,1444,4831,79600,2018
21199,41.9,64145,60369,624,1592,16819,37921,25663,17710,7953,25663,110500,2018
21201,44.1,2143,2110,16,13,560,38864,902,711,191,902,100100,2018
21203,42.5,16827,16381,25,148,4626,36468,6525,4999,1526,6525,80800,2018
21205,30.4,24499,23164,432,406,5240,37639,8505,5077,3428,8505,125800,2018
21207,43.1,17760,16650,136,657,4562,36159,7027,5199,1828,7027,85700,2018
21209,36.2,53517,46567,2558,2341,14802,66966,20206,13934,6272,20206,178400,2018
21211,39.1,46786,37485,2853,4468,11673,64240,16569,11552,5017,16569,187200,2018
21213,39.5,18063,15411,1775,426,4988,48311,6914,4494,2420,6914,131600,2018
21215,41.6,18246,17228,220,375,5469,77738,6709,5704,1005,6709,201300,2018
21217,37.9,25500,22859,999,607,6470,39055,9596,6028,3568,9596,117200,2018
21219,37.6,12350,10601,976,478,3437,41865,4663,3226,1437,4663,102900,2018
21221,45.8,14344,12662,1253,303,4154,52279,5970,4922,1048,5970,124400,2018
21223,43,8637,8140,0,256,2360,47470,3604,2715,889,3604,118100,2018
21225,37.6,14802,12208,1899,284,3590,42844,5465,3786,1679,5465,86500,2018
21227,32.8,126427,99738,11308,6667,30339,52007,47142,27454,19688,47142,160600,2018
21229,40.7,12019,10514,624,539,3101,50794,4667,3527,1140,4667,113700,2018
21231,42.6,20609,19246,471,483,4933,34039,8019,5735,2284,8019,81200,2018
21233,41.1,13155,11622,513,719,3400,40947,4975,3630,1345,4975,81300,2018
21235,36.8,36089,34645,360,442,9181,36897,12490,8661,3829,12490,87700,2018
21237,41.6,7223,7118,8,23,1819,22458,2817,1773,1044,2817,63600,2018
21239,42.4,26097,22508,1166,1753,7322,62629,10198,7067,3131,10198,196700,2018
22001,36.2,62568,48422,11109,1560,15390,41177,22564,15966,6598,22564,107700,2018
22003,38.3,25661,18219,4786,1503,5324,41009,7920,5868,2052,7920,93000,2018
22005,35.4,121176,83388,26335,6603,31854,76589,42649,34160,8489,42649,191300,2018
22007,40.5,22714,14908,6783,659,5744,44744,8802,6811,1991,8802,113100,2018
22009,37.9,40882,26652,11713,762,9963,38077,15085,10612,4473,15085,97400,2018
22011,37.6,36769,29435,4575,1363,9133,50738,13219,10277,2942,13219,116600,2018
22013,41.6,13668,7436,5884,26,3717,30300,5892,4308,1584,5892,72300,2018
22015,35.1,126131,84691,27941,8262,32964,53806,48947,30551,18396,48947,168300,2018
22017,37.4,248361,112210,120802,6956,59481,40866,96360,57166,39194,96360,144400,2018
22019,36,200182,135842,49675,6763,50374,49452,77295,51864,25431,77295,149400,2018
22021,40.1,9996,7913,1671,317,2433,32174,3667,2724,943,3667,74100,2018
22023,44.5,6868,6094,289,403,2078,55000,2718,2364,354,2718,113900,2018
22025,38.1,9893,6521,3158,163,2539,38854,3595,2798,797,3595,82100,2018
22027,42.2,16153,7314,8377,236,3776,27303,5891,3875,2016,5891,76800,2018
22029,37.8,20021,11402,8230,280,4819,31813,7371,4838,2533,7371,84000,2018
22031,39.7,27216,15893,9713,777,7168,44230,10523,7747,2776,10523,110900,2018
22033,33.7,444094,199629,203285,17912,98543,52719,165939,97722,68217,165939,186100,2018
22035,33,7225,2089,5051,27,1291,21161,2153,1050,1103,2153,75600,2018
22037,43,19499,10360,8522,313,4935,48129,6759,5521,1238,6759,120200,2018
22039,35.4,33636,22422,9124,1183,7625,32180,12051,7925,4126,12051,92200,2018
22041,38.5,20322,13237,6701,106,5181,35466,7629,5387,2242,7629,86000,2018
22043,38.3,22348,17078,3684,1116,4534,40792,6989,4656,2333,6989,105700,2018
22045,36.5,72691,42862,22917,3051,17941,45274,26063,17336,8727,26063,112000,2018
22047,38.3,32956,15704,15852,838,7494,47797,10918,8090,2828,10918,143800,2018
22049,40.3,15926,10720,4771,257,4053,38523,5976,4240,1736,5976,87200,2018
22051,39.2,435300,231084,114087,62522,106956,52558,168895,103853,65042,168895,180500,2018
22053,37.7,31467,24646,5199,741,7818,39653,11501,8233,3268,11501,111600,2018
22055,34.9,240091,158194,61883,11038,56628,54726,90606,59041,31565,90606,177500,2018
22057,37.5,98214,75453,13040,4291,25374,53089,36449,27521,8928,36449,151600,2018
22059,38,14949,12381,1818,422,3672,36868,5018,3765,1253,5018,80000,2018
22061,27.8,47356,25243,19191,1437,10263,34154,17551,9055,8496,17551,150600,2018
22063,36.3,138111,121694,8252,4948,35772,63159,48859,39622,9237,48859,159900,2018
22065,35.1,11472,3890,7301,237,2432,27810,3943,2227,1716,3943,65500,2018
22067,39.6,25992,12829,12784,102,6140,33333,9758,6538,3220,9758,90900,2018
22069,33.7,38963,20403,15756,876,7722,27795,14630,6584,8046,14630,122600,2018
22071,36.3,389648,119323,229914,21403,73443,39576,154036,73037,80999,154036,219600,2018
22073,35.4,156075,90924,58313,3429,36610,41314,56686,33422,23264,56686,140900,2018
22075,36.2,23373,15072,4728,1652,6714,52386,8817,5940,2877,8817,173200,2018
22077,42.9,22158,13334,7874,577,5678,44269,8961,6816,2145,8961,131700,2018
22079,37.3,131546,80675,41699,4063,32525,44852,48000,29270,18730,48000,138600,2018
22081,38.7,8618,4907,3364,186,2088,33446,3334,2491,843,3334,80800,2018
22083,38.5,20474,12393,7249,439,5097,34422,7391,4772,2619,7391,87200,2018
22085,40.9,24088,16344,3926,933,5921,39465,9185,6282,2903,9185,92300,2018
22087,33.7,45694,28728,10214,4575,10392,46011,15029,10198,4831,15029,142400,2018
22089,37.6,52724,34433,13818,3162,14099,66620,18762,15093,3669,18762,189300,2018
22091,38.9,10411,4582,5626,36,2762,39895,3871,3210,661,3871,86900,2018
22093,39.9,21357,10245,10592,343,5694,50661,7906,6114,1792,7906,152500,2018
22095,36.6,43446,15285,24066,2554,11400,54821,15418,11750,3668,15418,152600,2018
22097,36.3,83449,45485,34275,1762,19879,33288,30094,20974,9120,30094,104200,2018
22099,37.1,53752,34548,15676,1579,13781,47974,19556,15249,4307,19556,121500,2018
22101,39.1,51734,29021,16058,3583,11374,40485,19740,12034,7706,19740,106200,2018
22103,40.1,252093,198839,29523,13857,65583,67706,91975,72223,19752,91975,212700,2018
22105,35.1,130504,82624,38555,5483,31606,46297,47527,32447,15080,47527,154000,2018
22107,43.5,4666,1976,2539,121,1056,23870,1825,1207,618,1825,68600,2018
22109,35.8,112587,75270,21513,5765,27041,48866,40014,28392,11622,40014,148800,2018
22111,41.7,22475,15454,5584,1047,5084,43083,7724,6366,1358,7724,99000,2018
22113,37.4,59867,46904,8811,2060,14923,50690,21632,16766,4866,21632,114300,2018
22115,30.1,51007,35699,7236,4790,12375,47772,17801,9381,8420,17801,118900,2018
22117,39.5,46457,30469,13951,1022,11530,34985,17337,11991,5346,17337,88500,2018
22119,40.8,39631,24590,13522,739,10156,30358,16230,10939,5291,16230,83300,2018
22121,36.2,25860,14566,10164,786,7089,60908,9599,6908,2691,9599,191400,2018
22123,39.8,11180,8846,1800,394,2768,36528,4041,3024,1017,4041,87100,2018
22125,40.6,15377,8039,6807,238,2549,55510,3908,2794,1114,3908,204500,2018
22127,40.8,14494,9432,4574,292,3603,35398,5437,3699,1738,5437,78300,2018
23001,40.7,107444,97551,2013,1980,27667,51412,45491,29272,16219,45491,153500,2018
23003,47.6,68269,64368,623,801,18519,39824,29645,21263,8382,29645,98000,2018
23005,42.1,290944,263312,8305,5959,72193,69708,119717,82295,37422,119717,269200,2018
23007,46,30019,28747,84,386,7471,48053,11817,9356,2461,11817,138800,2018
23009,48.5,54541,51768,465,759,14893,53068,23579,17773,5806,23579,211700,2018
23011,44.3,121545,115152,955,1828,31910,52929,51542,36443,15099,51542,155000,2018
23013,48.4,39823,37942,204,592,10705,55402,17156,13189,3967,17156,206800,2018
23015,50.7,34067,32711,160,400,9851,55180,15372,12000,3372,15372,213300,2018
23017,46.6,57325,54714,250,750,13815,47275,20814,16757,4057,20814,142200,2018
23019,42.1,151748,142493,1325,2006,37841,49374,61578,42921,18657,61578,140800,2018
23021,51,16887,16082,74,242,4558,39470,7357,5561,1796,7357,113800,2018
23023,46.9,35277,33389,265,577,10293,62131,15833,11987,3846,15833,200500,2018
23025,46.3,50710,48602,266,530,13759,42491,21533,16318,5215,21533,112400,2018
23027,46.2,39418,37670,186,528,11011,51564,17067,13583,3484,17067,160900,2018
23029,48,31694,28410,141,705,8612,41384,13806,10552,3254,13806,110500,2018
23031,44.9,203102,191614,1674,3378,54861,65538,84648,62849,21799,84648,241200,2018
24001,41.7,71977,62694,5924,1261,17108,44065,27837,19102,8735,27837,119200,2018
24003,38.4,567696,391578,91488,42640,144902,97810,207599,154340,53259,207599,355200,2018
24005,39.3,827625,480515,231318,43484,204006,74127,312913,205641,107272,312913,255400,2018
24009,40.8,91082,71450,10481,3427,23947,104301,31726,26367,5359,31726,349200,2018
24011,40.2,32875,24975,4511,2304,8755,54956,12081,8748,3333,12081,199600,2018
24013,42.4,167522,149855,5560,5632,45150,93363,60450,49668,10782,60450,333500,2018
24015,40.4,102517,87577,6556,4386,26001,72845,36930,26874,10056,36930,237300,2018
24017,38.3,157671,65671,69462,8757,41332,95924,55903,42764,13139,55903,302800,2018
24019,44.5,32261,20437,8639,1715,8778,52145,13264,8944,4320,13264,179300,2018
24021,39.2,248472,184545,22685,22855,65287,91999,91405,68379,23026,91405,323600,2018
24023,45.6,29376,28349,228,331,8173,49619,12073,9419,2654,12073,169700,2018
24025,40.8,251025,191937,33181,11069,67286,85942,93286,73203,20083,93286,286700,2018
24027,38.7,315327,167312,57522,21200,83037,117730,112966,82648,30318,112966,448000,2018
24029,47.5,19593,15248,2804,848,4832,56009,7910,5478,2432,7910,244200,2018
24031,39,1040133,462418,183962,200307,258811,106287,370227,242263,127964,370227,476500,2018
24033,36.8,906202,117501,562046,162372,203228,81969,308849,191562,117287,308849,287800,2018
24035,44.3,49355,42725,3333,1871,13354,92167,18148,14844,3304,18148,348000,2018
24037,36.5,111531,83197,15952,5521,28405,90438,40332,28565,11767,40332,295000,2018
24039,36.6,25737,13253,10793,899,5514,42165,8383,5446,2937,8383,140300,2018
24041,50.2,37211,28934,4006,2412,11106,67204,16627,11588,5039,16627,331500,2018
24043,40.5,149811,119338,15460,7155,37402,59719,55864,36550,19314,55864,208200,2018
24045,35.8,102172,64782,26199,5198,24546,56608,37637,22271,15366,37637,171700,2018
24047,50.1,51564,41292,6692,1765,13636,61145,21672,16380,5292,21672,255400,2018
24510,35.1,614700,169285,380636,31503,121958,48840,238436,112897,125539,238436,156400,2018
25001,52.9,213690,191771,6130,6228,58164,70621,94292,74991,19301,94292,384100,2018
25003,46.7,127328,112631,3489,5839,32401,56674,55167,37994,17173,55167,208500,2018
25005,41,558905,457855,20746,43042,142967,66157,216618,135377,81241,216618,290100,2018
25007,46.1,17313,14898,615,606,3924,71224,6367,4930,1437,6367,667400,2018
25009,40.8,781024,554743,23933,158974,195563,75878,292659,187549,105110,292659,389900,2018
25011,46.1,70935,64415,934,2766,18003,59522,30328,21028,9300,30328,229300,2018
25013,38.9,469116,296865,36369,115479,114896,53403,179043,108938,70105,179043,203100,2018
25015,36.3,161159,135333,4334,8882,34373,67044,58665,38587,20078,58665,277200,2018
25017,38.5,1595192,1156838,78649,125533,387781,97012,600032,374413,225619,600032,476500,2018
25019,40.1,11101,9447,570,505,2268,105171,3722,2576,1146,3722,1056500,2018
25021,40.9,698249,528919,45399,30363,174416,99511,263551,182313,81238,263551,452500,2018
25023,42.6,512135,416125,46146,19476,131659,85654,186306,141482,44824,186306,356700,2018
25025,32.7,791766,356650,159705,179702,153409,64582,307870,111194,196676,307870,463200,2018
25027,40.1,822280,633922,36777,91732,201984,71895,307294,199681,107613,307294,269900,2018
26001,58.2,10364,9924,40,149,3044,39735,5008,4398,610,5008,99800,2018
26003,49.4,9194,7706,692,137,2019,46007,3094,2628,466,3094,123500,2018
26005,39.6,115250,102072,1562,8392,31202,59883,43000,35394,7606,43000,157400,2018
26007,47.8,28612,27435,148,382,7797,41991,12717,9859,2858,12717,95600,2018
26009,50.7,23177,21985,79,517,6841,52589,9805,8440,1365,9805,157600,2018
26011,49.6,15165,14377,89,301,4269,40769,6684,5514,1170,6684,90000,2018
26013,45,8507,6198,834,132,1955,42444,3036,2458,578,3036,102700,2018
26015,42.6,60057,56645,226,1714,17243,61016,23840,19624,4216,23840,154100,2018
26017,43.3,104786,94510,1675,5503,27674,48005,43891,34103,9788,43891,100500,2018
26019,49.6,17552,16466,67,435,4457,56639,6733,6037,696,6733,172000,2018
26021,41.9,154807,115938,22572,8340,41127,49135,63908,44588,19320,63908,146300,2018
26023,41.3,43584,39488,965,2019,10973,50536,16506,12310,4196,16506,104100,2018
26025,39.8,134473,104722,14087,6885,33643,47426,53659,37280,16379,53659,105300,2018
26027,45,51460,44351,2533,1949,14654,53571,20855,16784,4071,20855,134700,2018
26029,48.1,26219,24603,126,504,7350,53207,11379,9247,2132,11379,162900,2018
26031,50.7,25458,23470,215,351,7368,46161,11201,9227,1974,11201,125100,2018
26033,39.7,37834,26418,2453,702,8570,44483,14046,9721,4325,14046,112300,2018
26035,47.2,30616,29067,186,592,8205,37369,12406,10111,2295,12406,88400,2018
26037,40.6,77896,70149,1349,3506,20448,67482,29421,23173,6248,29421,167900,2018
26039,50.5,13836,13109,84,265,4074,47443,6047,4937,1110,6047,101400,2018
26041,47,36190,33675,106,461,10137,46490,15949,12675,3274,15949,110500,2018
26043,46.4,25570,24349,157,381,7138,48966,11087,8618,2469,11087,99600,2018
26045,41,109155,90678,7024,5793,29049,62474,44390,31919,12471,44390,147300,2018
26047,45.3,33039,30148,208,532,9267,54055,14510,10638,3872,14510,178300,2018
26049,40.3,409361,296767,80370,13797,107362,47006,167889,116693,51196,167889,104800,2018
26051,49.8,25289,24275,85,397,7013,43290,10999,9292,1707,10999,104700,2018
26053,48.8,15414,13814,701,207,3714,38798,6619,5210,1409,6619,69900,2018
26055,42.9,91746,84929,960,2584,23873,61485,37134,28329,8805,37134,194200,2018
26057,39.2,41067,35430,2203,2454,9940,44991,15177,11042,4135,15177,94300,2018
26059,42.2,45830,43493,328,1034,11965,48392,17904,13738,4166,17904,112000,2018
26061,32.7,36360,33425,250,572,7586,42852,13340,9054,4286,13340,106900,2018
26063,49,31543,30066,124,741,8770,46320,13918,11290,2628,13918,97300,2018
26065,31.8,289564,202487,31619,22286,61068,50940,112200,65324,46876,112200,129000,2018
26067,38.7,64176,56714,2889,3032,15891,54343,22858,17621,5237,22858,122600,2018
26069,52.6,25247,23740,168,537,7003,42102,11631,9261,2370,11631,91100,2018
26071,54.1,11212,10614,57,221,2942,38918,5327,4305,1022,5327,77800,2018
26073,27.7,70775,60470,1836,2753,14027,44408,24889,15378,9511,24889,131500,2018
26075,41.2,158913,134691,12576,5523,40284,51431,61696,45279,16417,61696,124100,2018
26077,34.2,261573,203197,27517,12593,60903,54431,102809,65624,37185,102809,153800,2018
26079,44.5,17463,16468,135,337,4911,46004,7139,5764,1375,7139,108200,2018
26081,35.1,643140,475966,59543,67179,158849,60351,239236,165201,74035,239236,163500,2018
26083,56.7,2130,2070,31,12,730,49779,1081,956,125,1081,113500,2018
26085,52.7,11763,9963,939,311,2697,34631,4517,3799,718,4517,84400,2018
26087,43.9,88202,81027,1090,4092,24032,58952,33320,27831,5489,33320,159000,2018
26089,53.7,21639,19483,79,938,6387,63831,9152,8019,1133,9152,256300,2018
26091,41.7,98474,85486,2421,7784,25225,53972,38222,29578,8644,38222,133300,2018
26093,43.2,188482,177990,1093,4468,52070,80897,71180,60662,10518,71180,233400,2018
26095,44.7,6364,4967,463,198,1414,42255,2190,1777,413,2190,83800,2018
26097,52,10817,7942,297,185,3185,46507,5284,3906,1378,5284,135000,2018
26099,40.8,868704,691478,98622,22212,226394,60466,343592,250757,92835,343592,157700,2018
26101,49.2,24444,21801,655,738,5953,47172,9591,7910,1681,9591,120900,2018
26103,39,66939,61724,1079,1001,15595,50771,26203,18167,8036,26203,149900,2018
26105,46.1,28884,26416,269,1314,7860,49663,12115,9474,2641,12115,137700,2018
26107,36.5,43264,39545,1227,958,9718,44460,15858,11623,4235,15858,117700,2018
26109,48.2,23234,21637,65,404,6295,45508,10665,8364,2301,10665,95800,2018
26111,41.7,83389,76388,1149,2212,23191,59271,34017,25722,8295,34017,137600,2018
26113,43.7,15006,14115,62,426,4153,44766,6027,4905,1122,6027,111400,2018
26115,42.4,149699,136797,3520,5261,40823,61514,59279,47473,11806,59279,155700,2018
26117,40.7,63209,58050,1332,2197,16281,47000,23761,18579,5182,23761,107400,2018
26119,55.7,9261,8895,32,118,2626,42305,4195,3605,590,4195,100000,2018
26121,39.3,173043,132234,23531,9655,44389,48329,65619,48916,16703,65619,111000,2018
26123,42.5,48142,43613,612,2792,13037,46724,19007,15653,3354,19007,111200,2018
26125,40.9,1250843,904717,170007,50057,322362,76387,501260,354845,146415,501260,228800,2018
26127,42.7,26417,21626,275,3913,7380,46217,10157,8273,1884,10157,112200,2018
26129,50.3,20928,19830,77,443,6040,40150,9296,7604,1692,9296,93400,2018
26131,58.1,5968,5670,33,87,1711,38906,2876,2535,341,2876,68300,2018
26133,43.8,23232,22003,253,418,6079,42689,9100,7431,1669,9100,93500,2018
26135,52.1,8277,7919,53,126,2332,40255,3824,3222,602,3824,86800,2018
26137,44.7,24397,23042,97,412,6762,52645,9886,7812,2074,9886,135500,2018
26139,35,284034,238601,4132,27450,73552,67468,101223,79314,21909,101223,179300,2018
26141,54.7,12797,12245,70,168,3869,46439,5808,5153,655,5808,102300,2018
26143,55.8,23877,22706,35,424,6674,40302,10899,8992,1907,10899,102700,2018
26145,40.8,192778,133979,34953,16151,49725,46919,78648,56288,22360,78648,97700,2018
26147,43.5,159566,145498,3345,5281,42924,55240,64805,49758,15047,64805,146500,2018
26149,39.7,60897,52765,1324,4710,16490,50117,24022,17816,6206,24022,115100,2018
26151,45.1,41376,38927,218,1519,11416,45277,17179,13708,3471,17179,106400,2018
26153,51.6,8069,6925,41,81,2170,40747,3351,2760,591,3351,109300,2018
26155,42.4,68493,64514,396,1995,19139,54742,27741,20899,6842,27741,115300,2018
26157,44.4,53250,49787,596,1779,14914,47694,21759,17868,3891,21759,101300,2018
26159,41.6,75272,61212,2371,8586,19927,52351,29013,22415,6598,29013,131400,2018
26161,33.4,365961,257202,42619,16999,80883,69434,140210,85122,55088,140210,246000,2018
26163,37.9,1761382,873218,681837,103202,414597,45321,676587,419567,257020,676587,102700,2018
26165,41.8,33111,31335,207,631,8774,44166,13053,9968,3085,13053,100200,2018
27001,55.1,15834,14878,84,214,5023,45989,7713,6346,1367,7713,174400,2018
27003,38.4,347431,284994,20216,15330,90909,79923,126848,101740,25108,126848,218800,2018
27005,41.8,33773,29190,184,674,9068,59278,13487,10634,2853,13487,187600,2018
27007,33.7,46117,33283,496,1064,10887,47410,17271,11602,5669,17271,157000,2018
27009,35.6,39779,36061,1322,903,10421,56357,16217,10843,5374,16217,166700,2018
27011,48.9,5016,4892,2,80,1417,51920,2274,1661,613,2274,97900,2018
27013,30.7,66322,58588,2287,2305,14976,55861,25783,15958,9825,25783,177800,2018
27015,42.1,25211,23600,179,1076,6911,57728,10731,8341,2390,10731,135800,2018
27017,40.7,35540,31337,629,625,9111,60390,13418,10774,2644,13418,166200,2018
27019,37.5,100416,89618,1656,4156,26994,97895,35852,29217,6635,35852,301900,2018
27021,48.9,29022,24096,122,621,8691,50173,13007,10632,2375,13007,182700,2018
27023,41.6,12010,10548,77,825,3250,54552,5098,3432,1666,5098,114600,2018
27025,41,54727,51232,693,1146,14728,80409,20102,17267,2835,20102,219400,2018
27027,32.5,62801,55131,1905,2796,15187,65000,23782,16282,7500,23782,183300,2018
27029,42.7,8812,7474,34,181,2224,46291,3458,2754,704,3458,123800,2018
27031,52.3,5311,4557,24,120,1717,52271,2699,2020,679,2699,252900,2018
27033,42.6,11372,9841,76,844,3155,53354,4850,3792,1058,4850,90800,2018
27035,44.3,63855,60683,462,923,17523,54508,26684,20229,6455,26684,194400,2018
27037,37.8,418201,330586,24310,29186,111146,83288,160144,119031,41113,160144,252000,2018
27039,38.3,20582,18990,49,1031,5707,71669,7711,6355,1356,7711,174400,2018
27041,44.1,37203,35738,166,594,10681,60676,16395,12168,4227,16395,209800,2018
27043,46.1,13896,12676,25,928,3850,52286,6115,4688,1427,6115,88500,2018
27045,42.4,20888,20163,102,322,5880,59451,8595,6911,1684,8595,152900,2018
27047,44.2,30526,26177,375,2938,8489,52447,12970,9774,3196,12970,111400,2018
27049,42.5,46217,42596,519,1543,12753,64765,19313,14486,4827,19313,196100,2018
27051,45.2,5938,5658,10,134,1786,55912,2600,2069,531,2600,105700,2018
27053,36.4,1235478,854494,158822,85264,288997,74113,503476,314239,189237,503476,260300,2018
27055,45.2,18663,17952,184,202,5327,58729,8181,6544,1637,8181,167600,2018
27057,48.6,20862,19405,126,429,6159,55472,8705,7133,1572,8705,189500,2018
27059,39.8,38974,36643,170,751,10327,72473,14702,12048,2654,14702,186000,2018
27061,46.1,45203,41533,218,638,12639,53022,19346,15462,3884,19346,159000,2018
27063,44.3,10047,9311,13,348,2810,57010,4388,3427,961,4388,120000,2018
27065,44.8,16004,15211,56,248,4364,53300,6449,5358,1091,6449,152600,2018
27067,39.1,42658,34537,2014,5077,11434,59089,16699,12350,4349,16699,168400,2018
27069,47.3,4337,4147,37,91,1185,57112,1891,1516,375,1891,74100,2018
27071,49.2,12644,11795,61,41,3386,47129,5566,4297,1269,5566,106300,2018
27073,50.4,6773,6451,57,149,2009,52199,3103,2497,606,3103,85600,2018
27075,50.4,10569,10087,78,162,3280,59516,5183,4193,990,5183,170400,2018
27077,51.3,3809,3544,1,64,1022,49068,1585,1289,296,1585,152400,2018
27079,41.2,27983,25596,235,1643,7528,67451,10874,8814,2060,10874,197600,2018
27081,45.8,5707,5503,15,109,1541,52301,2470,1938,532,2470,94300,2018
27083,35.5,25839,21801,869,1721,6499,55525,10050,6851,3199,10050,141100,2018
27085,40.6,35825,32662,197,2163,9701,61275,14884,11391,3493,14884,157900,2018
27087,35.9,5506,2520,28,229,1250,44537,1938,1353,585,1938,94900,2018
27089,43.8,9392,8777,36,415,2654,58723,3964,3241,723,3964,111500,2018
27091,45.3,19964,18623,55,851,5383,53915,8653,6336,2317,8653,114900,2018
27093,42.5,23079,21738,128,883,6222,61856,9191,7275,1916,9191,165500,2018
27095,40.4,25728,22928,109,604,6754,53888,10136,7604,2532,10136,157200,2018
27097,42.1,32949,31565,176,547,9118,54962,13488,10525,2963,13488,165200,2018
27099,39.1,39602,31543,1421,4471,10096,53665,15502,11403,4099,15502,120500,2018
27101,48.1,8353,7800,49,320,2380,57500,3702,3020,682,3702,113300,2018
27103,36.3,33783,30081,1040,1503,8550,65027,12738,9363,3375,12738,182100,2018
27105,35.7,21839,13108,986,5931,5359,54149,7897,5629,2268,7897,120900,2018
27107,44.2,6559,5876,29,329,1758,55206,2776,2244,532,2776,93400,2018
27109,37.2,153065,123299,8837,7402,40422,74880,60770,44453,16317,60770,199500,2018
27111,46.7,57992,53798,739,1945,16293,57131,24226,19100,5126,24226,179500,2018
27113,39.8,14184,12898,153,507,3661,59036,5970,4426,1544,5970,142100,2018
27115,44.5,29129,26052,584,836,6799,49138,10690,8523,2167,10690,157400,2018
27117,42.2,9185,8136,115,604,2542,52309,4007,2966,1041,4007,97700,2018
27119,38.7,31591,27591,597,2016,7794,57151,12516,9182,3334,12516,158200,2018
27121,45.9,10980,10565,41,149,3217,58132,4972,3878,1094,4972,165000,2018
27123,34.9,541493,337973,62495,40569,122544,62304,209069,123968,85101,209069,219400,2018
27125,42.5,4008,3695,10,149,1135,56588,1691,1418,273,1691,113600,2018
27127,43.1,15331,13382,115,510,4074,53230,6240,4865,1375,6240,100800,2018
27129,44.3,14721,12996,67,1228,3951,57886,6180,4879,1301,6180,102700,2018
27131,36.5,65765,54495,3507,5222,15570,65758,23045,17172,5873,23045,196500,2018
27133,40.9,9413,8830,107,282,2741,59890,3978,2964,1014,3978,137100,2018
27135,41.4,15462,14248,134,192,4049,59644,5995,4783,1212,5995,125700,2018
27137,41.1,200080,182551,2957,3284,49018,53344,85644,60731,24913,85644,152000,2018
27139,36.1,143372,117245,5711,7275,37284,97744,48510,39930,8580,48510,285200,2018
27141,35.8,93231,85362,2045,2369,24265,85818,31737,26230,5507,31737,217200,2018
27143,41.6,14912,13210,127,1326,4099,62761,6038,4771,1267,6038,151000,2018
27145,34.3,156819,136301,9048,5168,37957,60606,58891,40618,18273,58891,176000,2018
27147,38.9,36676,31838,1112,2806,9604,62731,14498,10952,3546,14498,158500,2018
27149,33.3,9784,8629,109,554,2181,58363,3629,2455,1174,3629,154100,2018
27151,44,9411,8641,210,453,2623,48577,4227,2947,1280,4227,103100,2018
27153,44,24440,22352,145,1399,6645,52872,9841,8058,1783,9841,149300,2018
27155,48.4,3337,2999,22,91,1041,48784,1584,1264,320,1584,82000,2018
27157,45.2,21500,20374,117,613,6082,65138,8841,7156,1685,8841,173100,2018
27159,41.5,13646,12887,145,257,3595,45860,5677,4405,1272,5677,123700,2018
27161,40.2,18809,16795,382,1109,4888,55612,7427,5846,1581,7427,150700,2018
27163,39.3,253317,210848,10930,10248,67185,92376,93184,76033,17151,93184,277400,2018
27165,40.9,10973,7984,89,2693,2716,51097,4318,3274,1044,4318,94300,2018
27167,44.4,6343,5944,48,52,1839,54935,2826,2237,589,2826,125600,2018
27169,34.8,50847,46422,681,1459,11363,55529,19515,13629,5886,19515,161100,2018
27171,36.6,132745,123050,1850,3807,35304,81881,47246,38584,8662,47246,225600,2018
27173,42.3,9868,8863,62,448,2817,56943,4165,3247,918,4165,101800,2018
28001,41,31547,11408,17815,1776,7093,29203,11341,7002,4339,11341,92800,2018
28003,39.7,37180,30823,4332,1181,9644,40180,14502,10306,4196,14502,92400,2018
28005,46.5,12468,7156,5239,0,3193,31854,5003,4255,748,5003,75500,2018
28007,39.7,18581,9990,7910,386,4998,34756,7129,5046,2083,7129,76000,2018
28009,40.4,8253,4986,2938,213,2011,35974,3033,2528,505,3033,68800,2018
28011,35.2,32592,10579,20869,701,7654,29912,12159,6587,5572,12159,94700,2018
28013,40.8,14571,9429,3962,858,3857,36440,5797,4167,1630,5797,67700,2018
28015,47,10129,6511,3501,29,2627,43060,3658,2955,703,3658,89300,2018
28017,36.8,17279,8627,7505,815,4401,35939,6426,4573,1853,6426,66000,2018
28019,44,8321,5613,2594,33,1874,37203,3164,2417,747,3164,81600,2018
28021,33.7,9120,1063,7972,13,1893,26732,3009,2059,950,3009,63000,2018
28023,42.1,15928,10083,5696,66,4293,39246,6258,5096,1162,6258,79700,2018
28025,39.5,19808,7722,11793,137,5308,35121,7755,5520,2235,7755,87400,2018
28027,34.2,23802,5045,18413,56,5674,30009,8744,4544,4200,8744,67200,2018
28029,38.2,28721,12653,14895,910,6645,40361,9623,7569,2054,9623,97900,2018
28031,37.7,19091,11569,7210,92,4803,35931,6794,5466,1328,6794,78600,2018
28033,36.7,176132,115328,45944,8599,45319,65169,62078,45743,16335,62078,162000,2018
28035,32.4,75517,43019,27895,2246,17232,40675,28033,15327,12706,28033,120700,2018
28037,42.1,7757,4899,2793,51,2210,40810,3004,2362,642,3004,76500,2018
28039,36.3,23710,20716,1908,652,5175,48319,7362,6149,1213,7362,109800,2018
28041,39.1,13714,9896,3496,162,2696,49447,4172,3538,634,4172,80900,2018
28043,39.8,21278,11683,9205,140,5482,36877,8224,5478,2746,8224,99700,2018
28045,44,46653,39537,3776,1792,13085,47543,19519,14555,4964,19519,144400,2018
28047,36,202626,130164,49298,11032,51328,45566,78863,44176,34687,78863,144500,2018
28049,34.4,241774,60215,173948,3741,56734,43005,88705,51829,36876,88705,115200,2018
28051,35.1,18075,2827,15131,46,4116,21093,6269,3802,2467,6269,56100,2018
28053,38,8539,1779,6470,267,2104,28507,3171,1919,1252,3171,68900,2018
28055,40.1,1328,513,799,16,280,25776,484,222,262,484,57500,2018
28057,40,23480,21189,1658,360,6120,40510,8706,6774,1932,8706,89500,2018
28059,38.8,142014,96328,30025,8917,33751,51142,51429,35968,15461,51429,129400,2018
28061,40.6,16529,7408,8933,64,4849,35931,6690,5669,1021,6690,73400,2018
28063,39.3,7346,958,6310,28,1583,20188,2530,1689,841,2530,62300,2018
28065,44.3,11495,4337,7036,34,3013,30083,4839,3692,1147,4839,84200,2018
28067,37.2,68454,44329,19952,2993,17219,41263,24774,18107,6667,24774,92100,2018
28069,41.8,10107,3439,6156,132,2206,28176,3710,2816,894,3710,71200,2018
28071,29.9,53459,37425,12622,1411,11390,47132,19317,11822,7495,19317,188600,2018
28073,35.4,61223,45551,12240,1601,15542,58188,22213,15376,6837,22213,170400,2018
28075,37.8,77323,40786,33546,1755,19083,41704,29657,19408,10249,29657,93100,2018
28077,40.3,12630,8235,4193,79,3391,42290,4793,3702,1091,4793,93200,2018
28079,36.6,22870,10794,9550,1035,5636,33482,8168,5906,2262,8168,78500,2018
28081,37.2,84915,55968,24653,2228,21618,47978,32267,21392,10875,32267,131300,2018
28083,33.8,29804,6707,21859,786,6256,26052,10224,5118,5106,10224,79700,2018
28085,38.6,34432,23153,10700,375,8932,40355,12827,9672,3155,12827,99600,2018
28087,37.1,59437,30868,25936,1212,15109,45355,22742,13978,8764,22742,131800,2018
28089,37,103498,57464,39296,3054,28286,71690,39020,28028,10992,39020,215100,2018
28091,40.4,25202,16351,8118,390,6361,31446,9543,7692,1851,9543,85100,2018
28093,40.2,35787,17068,17118,1281,9010,41572,13074,9933,3141,13074,108000,2018
28095,41.2,35840,24007,11044,438,9201,40940,14043,10426,3617,14043,88200,2018
28097,42.1,10198,5322,4414,135,3283,33667,4619,3300,1319,4619,80000,2018
28099,36.8,29376,17219,6183,599,7425,36875,10699,7775,2924,10699,81400,2018
28101,36.6,21524,13149,6519,402,5596,33831,8042,6265,1777,8042,83000,2018
28103,36.4,10828,2799,7820,148,2692,36000,4020,2924,1096,4020,60800,2018
28105,25.8,49481,28032,18298,818,9170,38800,17687,8996,8691,17687,161100,2018
28107,37.8,34243,16095,17021,693,8279,36563,12447,9064,3383,12447,77400,2018
28109,40.9,55149,45145,7037,1673,14826,45820,20752,16085,4667,20752,128600,2018
28111,40.9,12028,9299,2368,181,3182,39007,4563,3804,759,4563,83700,2018
28113,37.3,39737,17334,21177,686,9119,30910,14676,9867,4809,14676,91400,2018
28115,36.4,31315,24064,4814,2055,7757,41379,10788,7735,3053,10788,102700,2018
28117,39,25360,20953,3130,354,6355,37519,9399,6831,2568,9399,91800,2018
28119,38.4,7372,1965,5282,107,1761,25510,3055,1772,1283,3055,52300,2018
28121,37.4,151240,112447,30917,4141,39932,64557,55595,42383,13212,55595,160000,2018
28123,36.5,28415,14081,10849,3148,7237,33735,10435,7677,2758,10435,68700,2018
28125,42.1,4511,1132,3337,5,994,28799,1755,1164,591,1755,61800,2018
28127,39.2,27073,16656,9878,93,6398,37946,9361,7536,1825,9361,84200,2018
28129,40.1,16063,11916,3706,270,4196,41657,5872,4872,1000,5872,95400,2018
28131,37.5,18375,14005,3539,373,4544,44883,6135,4682,1453,6135,117800,2018
28133,35.3,26532,6342,19595,457,5467,30029,8389,4605,3784,8389,73900,2018
28135,34.6,14361,5037,7078,1978,2785,30028,4253,3145,1108,4253,63500,2018
28137,37.6,28493,18385,8352,760,7446,51056,10264,7709,2555,10264,117800,2018
28139,39.4,21990,16968,3679,1023,5621,39839,7983,5823,2160,7983,83100,2018
28141,42.3,19478,18156,551,614,5200,37312,7635,5763,1872,7635,85300,2018
28143,33.9,10170,1957,7984,85,2705,37822,3943,1598,2345,3943,101600,2018
28145,38.2,28356,22242,4145,1208,7014,41287,9951,7194,2757,9951,95000,2018
28147,39.9,14601,7685,6699,89,3542,29804,5683,5069,614,5683,90400,2018
28149,38.8,47075,22286,23124,1023,11921,43039,18766,12088,6678,18766,118600,2018
28151,36.9,47086,11921,33893,729,11477,30834,18299,9888,8411,18299,74700,2018
28153,38,20422,11748,8401,54,5620,37970,7734,6311,1423,7734,84000,2018
28155,39.8,9828,7672,1895,144,2748,40683,3787,2798,989,3787,83100,2018
28157,37.5,8990,2503,6379,37,1750,26599,2898,2347,551,2898,70000,2018
28159,41.6,18358,9195,8733,225,4982,36214,7396,5348,2048,7396,84100,2018
28161,42.6,12421,7215,4970,198,3407,41864,5161,3782,1379,5161,83100,2018
28163,35.7,27974,9829,15733,1805,5552,31402,8689,5460,3229,8689,81400,2018
29001,27.7,25325,22880,870,337,4971,40046,9513,5712,3801,9513,118100,2018
29003,42.4,17403,16490,274,413,4810,55683,6807,5323,1484,6807,140100,2018
29005,48.3,5270,5099,20,66,1472,48385,2505,1762,743,2505,85600,2018
29007,39.7,25735,22353,1569,767,5878,43761,9328,6185,3143,9328,98300,2018
29009,43.5,35493,30566,55,3262,9436,41463,13211,9726,3485,13211,116400,2018
29011,41.4,11850,10960,35,312,3278,41625,4931,3463,1468,4931,96100,2018
29013,41.8,16374,15449,238,352,4649,46186,6706,4876,1830,6706,114500,2018
29015,53.3,18989,18046,54,376,5090,38028,7947,6606,1341,7947,116500,2018
29017,44.1,12281,11834,68,136,3312,42985,4669,3776,893,4669,105400,2018
29019,30.8,176515,139453,15465,5950,40348,54043,69957,38686,31271,69957,179800,2018
29021,37.4,89076,74318,4845,5780,20368,50457,33432,21219,12213,33432,118400,2018
29023,40.1,42733,37949,2437,887,10963,39058,16357,10425,5932,16357,109800,2018
29025,42.6,9049,8569,47,194,2393,48033,3682,2747,935,3682,107900,2018
29027,38.6,44840,40418,1932,919,10830,55376,16038,11685,4353,16038,144200,2018
29029,51.1,45096,42578,315,1203,11521,52087,16096,12909,3187,16096,183500,2018
29031,36.6,78324,67505,5853,1788,18633,51730,29366,19239,10127,29366,155000,2018
29033,43.1,8843,8384,152,138,2408,42149,3552,2569,983,3552,84100,2018
29035,41,6197,5851,3,148,1582,39415,2366,1801,565,2366,116600,2018
29037,39.8,102678,90625,3650,4418,28824,67659,39444,30052,9392,39444,171800,2018
29039,44.3,13938,13204,6,300,3905,39412,5785,4187,1598,5785,105000,2018
29041,45.5,7546,7177,183,38,1886,46992,2779,2252,527,2779,91600,2018
29043,37.9,84275,78804,568,2416,22868,57019,31097,23065,8032,31097,162900,2018
29045,43.9,6800,6598,23,13,1971,47955,2942,2159,783,2942,88100,2018
29047,37.1,239164,195208,14075,16014,60672,68367,90285,62389,27896,90285,167700,2018
29049,40.7,20475,19212,380,421,5859,58510,8157,6156,2001,8157,152400,2018
29051,38.5,76740,62472,8916,2144,19111,57587,29749,20094,9655,29749,160300,2018
29053,39,17622,15513,1118,337,4083,48750,6428,4504,1924,6428,131100,2018
29055,41.7,24280,23138,70,472,6155,38036,9473,6566,2907,9473,117900,2018
29057,46.4,7590,7127,21,156,2143,39979,3117,2427,690,3117,81300,2018
29059,43.5,16499,15638,2,334,4495,41551,6253,4656,1597,6253,111900,2018
29061,40.5,8302,7972,85,129,2081,50380,2991,2348,643,2991,107500,2018
29063,40.2,12564,10557,1228,303,2486,50000,3812,2613,1199,3812,113500,2018
29065,44.4,15504,14659,89,258,4087,39916,6300,4434,1866,6300,110900,2018
29067,47.6,13374,13089,14,203,3749,34372,5126,4088,1038,5126,113200,2018
29069,39.9,30428,24573,2961,1985,7804,34186,12427,7816,4611,12427,73700,2018
29071,40.8,102781,97777,694,1748,28599,55312,40780,29916,10864,40780,160600,2018
29073,45.8,14746,14164,52,200,4208,53439,6116,4842,1274,6116,133200,2018
29075,41.5,6665,6408,46,99,1725,42689,2601,1924,677,2601,87200,2018
29077,36,288429,253379,9348,10430,71488,44808,122026,70091,51935,122026,141200,2018
29079,40.8,10039,9456,25,235,2488,42574,3985,2679,1306,3985,91400,2018
29081,43,8554,8160,73,185,2289,40168,3556,2564,992,3556,74600,2018
29083,44.2,21765,20387,289,511,5781,43911,9199,6714,2485,9199,102300,2018
29085,55,9368,8905,9,151,2537,36190,4020,3273,747,4020,94900,2018
29087,48.4,4456,4285,30,26,1305,45610,2056,1481,575,2056,96100,2018
29089,39.3,10113,9170,531,153,2442,50372,3559,2761,798,3559,116100,2018
29091,40.6,40102,37838,188,848,10588,36143,15922,10888,5034,15922,104500,2018
29093,45.4,10221,9653,124,177,2753,37188,4156,2899,1257,4156,83700,2018
29095,36.7,692003,431413,162022,61310,164832,52805,282653,165222,117431,282653,139000,2018
29097,36,119238,100642,2263,9369,29477,46929,45261,29333,15928,45261,115900,2018
29099,39,223302,211038,2023,4251,61471,63030,84393,67221,17172,84393,158100,2018
29101,30.1,53689,46152,2309,2260,13052,53056,19939,11904,8035,19939,151100,2018
29103,44,3951,3806,21,40,1006,40383,1533,1226,307,1533,71900,2018
29105,40.4,35507,33170,196,846,10078,46192,13866,9508,4358,13866,114400,2018
29107,42.3,32589,30017,634,897,8896,54661,12959,9398,3561,12959,127300,2018
29109,39.6,38133,34101,211,2771,10357,43373,14604,10500,4104,14604,105700,2018
29111,40.3,10027,9288,330,177,2486,47764,3766,2757,1009,3766,87000,2018
29113,37,55563,51745,1052,1330,14045,61628,18738,14668,4070,18738,157500,2018
29115,42.1,12186,11575,48,270,3381,43642,5068,3662,1406,5068,82700,2018
29117,40.3,15076,13971,401,265,3823,47885,5882,4008,1874,5882,103500,2018
29119,38.3,22827,17787,450,2642,6127,42019,8110,5643,2467,8110,97400,2018
29121,43.3,15254,14318,271,210,3695,40007,5889,4371,1518,5889,95600,2018
29123,42.1,12205,11561,123,291,3355,41322,5002,3635,1367,5002,98600,2018
29125,45,8884,8499,21,233,2396,44436,3645,2664,981,3645,122200,2018
29127,39.1,28672,25837,1167,495,7518,46762,11500,7399,4101,11500,121400,2018
29129,43,3664,3496,14,71,826,44085,1326,1016,310,1326,87500,2018
29131,40.8,25049,23789,111,470,6746,42718,9804,7244,2560,9804,134800,2018
29133,40.4,13748,9844,3284,282,3558,32846,5040,2998,2042,5040,75300,2018
29135,37.9,15958,14290,601,736,3828,54828,5346,4095,1251,5346,123500,2018
29137,45.4,8654,8057,306,142,2405,43973,3632,2701,931,3632,101100,2018
29139,44,11545,10882,169,216,3242,45862,4891,3462,1429,4891,104900,2018
29141,46.1,20137,18981,161,446,5040,37727,7755,6021,1734,7755,122300,2018
29143,41.7,17811,14246,2780,319,4791,35399,7312,4516,2796,7312,75500,2018
29145,39.7,58202,50217,530,3059,15618,49023,22268,15764,6504,22268,122900,2018
29147,29.2,22547,20904,637,374,4918,43349,8275,4768,3507,8275,124600,2018
29149,46.8,10699,10077,16,184,2775,32534,4307,3269,1038,4307,90200,2018
29151,40.3,13619,13252,39,108,3643,58476,5113,4259,854,5113,146000,2018
29153,51.3,9236,8820,3,161,2666,32601,4144,3191,953,4144,100500,2018
29155,37.8,17031,11706,4554,422,4335,33390,6845,3680,3165,6845,78600,2018
29157,40.6,19146,18275,56,428,5400,54964,7605,5670,1935,7605,138500,2018
29159,37.9,42371,36014,1335,3675,10722,44382,15921,10659,5262,15921,115200,2018
29161,35.2,44789,39782,1115,1105,11132,42846,17601,10626,6975,17601,129400,2018
29163,39.1,18489,16306,1327,415,4287,45753,6650,4704,1946,6650,106100,2018
29165,38.3,98824,80536,6516,5821,25783,76912,38613,25421,13192,38613,216600,2018
29167,37.5,31549,29594,299,757,7826,44892,11557,7995,3562,11557,125700,2018
29169,27.7,52591,36556,6064,5769,10216,51665,15026,7315,7711,15026,151200,2018
29171,46.4,4815,4633,13,7,1233,37367,1803,1333,470,1803,84300,2018
29173,45,10217,9763,130,126,2954,55546,4004,3344,660,4004,136100,2018
29175,39.1,24945,22141,1453,510,5563,46610,8347,6148,2199,8347,101700,2018
29177,41.8,22825,21415,394,547,6124,59857,8785,6802,1983,8785,129300,2018
29179,46.1,6315,5937,121,121,1809,40929,2638,2091,547,2638,95100,2018
29181,42.7,13693,13014,52,184,3409,33343,5154,4069,1085,5154,85000,2018
29183,38.2,389985,341007,17052,12529,104282,81411,144643,116278,28365,144643,208900,2018
29185,49.9,9383,8864,70,119,2602,38470,4126,3207,919,4126,83600,2018
29186,43.4,17871,17092,316,203,5231,56234,7134,5532,1602,7134,158300,2018
29187,39.6,66342,60995,2911,1022,16385,45774,24910,17005,7905,24910,120700,2018
29189,40.3,998684,663664,239475,28303,258954,65300,403547,278370,125177,403547,190100,2018
29195,38,23102,18621,1086,2296,5452,43201,8562,5900,2662,8562,102000,2018
29197,39.3,4502,4373,23,28,1010,39697,1588,1135,453,1588,70500,2018
29199,37.5,4898,4772,79,0,1197,42965,1820,1290,530,1820,87200,2018
29201,39.9,38729,32276,4456,878,10496,42231,15428,10325,5103,15428,106300,2018
29203,45.1,8246,7755,12,150,2040,32180,3173,2271,902,3173,110100,2018
29205,41.5,6061,5786,117,116,1648,44051,2459,1850,609,2459,74700,2018
29207,41.4,29512,28193,340,501,7475,40567,11684,8029,3655,11684,99300,2018
29209,53.3,31527,29944,50,694,9165,46443,12841,10529,2312,12841,165400,2018
29211,42.6,6317,4867,184,1150,1347,42604,2174,1561,613,2174,75400,2018
29213,42.1,54720,48718,681,3153,15203,41487,22366,13394,8972,22366,128200,2018
29215,42.7,25671,23406,579,539,6428,35277,9579,7040,2539,9579,110300,2018
29217,40.9,20691,19453,184,434,5363,43379,8170,5691,2479,8170,99000,2018
29219,40.1,33908,31145,695,1118,9072,57948,12232,9519,2713,12232,172400,2018
29221,40.7,24931,23518,492,332,6478,39621,9114,7376,1738,9114,93700,2018
29223,47.3,13308,12644,74,230,3533,34391,5448,4053,1395,5448,74900,2018
29225,37.1,38082,35935,394,765,9763,47421,13496,10027,3469,13496,127900,2018
29227,47.9,2040,1971,7,14,604,52500,856,657,199,856,66000,2018
29229,42,18293,17417,105,324,4886,32752,7292,5059,2233,7292,100400,2018
29510,35.5,311273,134617,145696,12363,64793,41107,140455,60920,79535,140455,131900,2018
30001,42.1,9393,8542,6,421,2294,44809,3977,2670,1307,3977,194900,2018
30003,30.8,13376,3630,6,837,2921,46365,3687,2216,1471,3687,110900,2018
30005,33.8,6727,3028,26,238,1534,38083,2320,1366,954,2320,89800,2018
30007,46.9,5834,5485,3,161,1558,56469,2420,1971,449,2420,203700,2018
30009,50.3,10546,9959,41,259,2778,57538,4531,3535,996,4531,239500,2018
30011,50.5,1318,1282,0,3,387,44196,625,512,113,625,101300,2018
30013,38.2,81746,69891,1020,3569,21358,48160,34444,22114,12330,34444,171700,2018
30015,40.9,5789,4447,3,136,1495,40942,2256,1472,784,2256,137200,2018
30017,40.7,11845,10909,68,391,3071,55841,4889,3361,1528,4889,160700,2018
30019,50.7,1753,1639,0,84,516,54750,856,691,165,856,136100,2018
30021,40.5,9191,8487,114,285,2409,59820,3972,2703,1269,3972,156600,2018
30023,48.5,9100,8214,63,306,2206,41783,3855,2645,1210,3855,120300,2018
30025,39.3,2838,2655,40,61,811,60750,1302,873,429,1302,165700,2018
30027,46,11273,10626,18,258,2983,50327,4975,3583,1392,4975,134900,2018
30029,42.1,98082,91142,296,2652,24661,52966,38252,27768,10484,38252,259400,2018
30031,33.5,104729,96125,351,3777,24365,61499,41985,25731,16254,41985,330400,2018
30033,43.2,1141,1139,0,2,317,45893,447,333,114,447,105800,2018
30035,31.4,13699,4236,38,402,2465,31029,4178,2475,1703,4178,109800,2018
30037,56,724,644,0,59,216,39952,337,251,86,337,105100,2018
30039,54.3,3269,3130,5,74,724,48958,1280,927,353,1280,216500,2018
30041,34.5,16439,11459,37,593,4026,47141,6274,3867,2407,6274,140900,2018
30043,47.9,11778,10933,26,285,3223,66867,4444,3776,668,4444,277500,2018
30045,52.2,1951,1861,0,44,587,45764,923,676,247,923,141100,2018
30047,42.3,29774,19409,81,1314,7924,45488,11849,8551,3298,11849,235300,2018
30049,41,67077,61384,175,2165,17227,62130,27800,19054,8746,27800,230600,2018
30051,49.1,2280,2219,0,49,577,47419,886,554,332,886,114000,2018
30053,52.6,19358,17974,12,575,4972,38287,8259,6464,1795,8259,190500,2018
30055,50.1,1630,1531,0,59,469,47500,704,576,128,704,126300,2018
30057,52.6,8218,7554,2,412,1998,50247,3481,2593,888,3481,254900,2018
30059,45.9,1968,1857,0,53,458,43109,749,532,217,749,155000,2018
30061,52.6,4211,3853,3,81,996,41905,1699,1240,459,1699,166000,2018
30063,35.6,115983,103647,559,3714,27292,51270,48608,28553,20055,48608,271400,2018
30065,48,4807,4621,0,128,1293,41612,2077,1483,594,2077,180400,2018
30067,46.2,16246,15187,50,484,4389,49194,7691,5314,2377,7691,255700,2018
30069,52.1,432,424,0,0,110,44688,187,126,61,187,133300,2018
30071,47.2,4124,3477,0,102,986,46222,1770,1347,423,1770,126500,2018
30073,40.5,6044,4919,26,119,1357,45458,2114,1558,556,2114,123500,2018
30075,53,1619,1508,0,44,488,52457,769,557,212,769,122900,2018
30077,45.3,6861,6155,24,130,1656,49652,2388,1634,754,2388,149500,2018
30079,51.8,1342,1323,0,18,361,47250,540,469,71,540,109400,2018
30081,48.8,41902,39000,34,1440,11368,48930,17108,13021,4087,17108,262600,2018
30083,38.9,11360,10121,0,604,2845,67272,4493,2853,1640,4493,217400,2018
30085,30.3,11228,3939,35,414,2022,42904,3156,1938,1218,3156,119400,2018
30087,36.4,9250,5121,10,457,2157,56549,3147,2236,911,3147,116800,2018
30089,53.2,11521,10393,19,327,3230,36984,4953,3791,1162,4953,224200,2018
30091,44.9,3574,3258,0,95,955,54321,1645,1275,370,1645,135900,2018
30093,39.8,34814,31485,205,1597,8149,42237,15158,10135,5023,15158,143300,2018
30095,46.6,9410,8734,20,370,2587,63785,3716,2951,765,3716,246600,2018
30097,51.5,3653,3396,8,111,1055,49514,1547,1151,396,1547,242100,2018
30099,44.6,6080,5695,10,95,1652,51862,2475,1725,750,2475,163000,2018
30101,41.2,4976,4359,8,183,1151,46823,1898,1097,801,1898,136300,2018
30103,52.1,777,746,0,6,260,42292,365,246,119,365,100000,2018
30105,44.4,7532,6366,6,199,2123,55882,3436,2620,816,3436,131800,2018
30107,40.4,2149,2014,0,57,493,41186,821,579,242,821,89800,2018
30109,46,1175,1118,0,49,356,50202,497,391,106,497,102500,2018
30111,38.2,157816,136703,900,8671,40368,59117,65025,44423,20602,65025,216900,2018
31001,37.4,31583,27262,178,3141,7756,51536,12710,8674,4036,12710,118300,2018
31003,45.3,6372,6071,45,203,1801,48716,2675,2064,611,2675,80600,2018
31005,47.1,418,397,0,3,106,43854,193,131,62,193,104600,2018
31007,48.5,696,640,0,42,229,59625,279,204,75,279,136000,2018
31009,46.6,480,480,0,0,151,50870,218,145,73,218,83900,2018
31011,44.6,5313,5128,22,112,1512,54063,2280,1777,503,2280,111800,2018
31013,40.7,11089,9072,42,1371,3093,56412,4801,3182,1619,4801,120100,2018
31015,52.3,2042,1941,9,15,622,50729,903,734,169,903,67100,2018
31017,51.1,2988,2870,1,42,824,41550,1434,1064,370,1434,80100,2018
31019,33.3,49030,42715,496,4326,11795,56952,19165,12176,6989,19165,165800,2018
31021,46.2,6528,6083,46,192,1923,51482,2919,2197,722,2919,94600,2018
31023,43.9,8067,7647,36,261,2249,55562,3377,2643,734,3377,112600,2018
31025,41.6,25702,24129,153,811,7070,71139,10005,8156,1849,10005,170700,2018
31027,43.6,8523,8246,4,156,2349,58978,3456,2814,642,3456,121000,2018
31029,45.6,3734,3335,2,369,1134,55833,1714,1323,391,1714,122700,2018
31031,43.6,5790,5110,1,182,1663,53684,2566,1566,1000,2566,120700,2018
31033,41,9852,8846,10,666,2508,56538,4434,3049,1385,4434,104900,2018
31035,42.5,6232,5556,4,559,1704,56316,2574,2024,550,2574,88300,2018
31037,34.3,10760,5342,374,4892,2543,56528,3718,2639,1079,3718,87800,2018
31039,43.6,8991,7949,7,891,2404,55190,3752,2598,1154,3752,115200,2018
31041,43.2,10830,10266,25,328,3278,49891,4846,3370,1476,4846,94800,2018
31043,33.8,20317,9949,897,7824,5731,55017,7456,4908,2548,7456,114900,2018
31045,34.9,8896,7573,142,449,2154,51748,3623,2343,1280,3623,120000,2018
31047,35.9,23804,14171,1431,7883,6475,53769,8997,6097,2900,8997,99200,2018
31049,47,1894,1683,4,148,553,48500,824,624,200,824,78200,2018
31051,42,5746,4873,16,762,1593,56775,2311,1814,497,2311,90700,2018
31053,39,36683,30938,261,4519,10012,53101,15289,9552,5737,15289,122600,2018
31055,34.5,554992,387564,60722,68770,133506,61688,215787,132654,83133,215787,161400,2018
31057,42.3,2023,1690,4,317,531,44350,865,609,256,865,76300,2018
31059,47.7,5574,5227,31,220,1572,55625,2510,1898,612,2510,79100,2018
31061,50.7,3006,2881,11,67,875,49235,1354,1131,223,1354,65200,2018
31063,45.5,2609,2516,2,27,712,51855,1116,836,280,1116,100200,2018
31065,46.5,4786,4490,7,190,1342,47989,2142,1540,602,2142,68800,2018
31067,44,21595,20455,160,517,5621,51662,9160,6277,2883,9160,115500,2018
31069,50.3,1860,1755,4,81,519,44471,871,672,199,871,81100,2018
31071,51.4,1975,1908,4,39,594,48545,886,692,194,886,98500,2018
31073,50.4,2015,1930,9,46,583,62545,877,638,239,877,115100,2018
31075,45.3,718,694,5,12,198,39479,293,220,73,293,57700,2018
31077,45.7,2410,2317,12,50,673,47128,1034,826,208,1034,79100,2018
31079,36,61343,41227,1493,16704,15486,54742,22870,14202,8668,22870,142300,2018
31081,41.5,9178,8721,48,298,2770,64042,3699,2990,709,3699,140400,2018
31083,47.9,3438,3229,28,135,939,50344,1521,1218,303,1521,88200,2018
31085,44.4,943,874,0,69,268,45515,413,290,123,413,62500,2018
31087,46.8,2843,2804,3,31,717,42902,1209,882,327,1209,57800,2018
31089,43.2,10245,9601,12,464,2872,57468,4435,3259,1176,4435,108500,2018
31091,55.9,691,664,6,21,178,39115,319,206,113,319,84200,2018
31093,43.1,6405,6117,12,165,1815,54399,2684,2077,607,2684,127400,2018
31095,45.7,7188,6757,18,268,1914,43295,3283,2364,919,3283,80100,2018
31097,40.6,5197,4187,334,524,1241,52794,1820,1369,451,1820,83200,2018
31099,40.1,6552,6053,8,399,1654,56952,2682,1948,734,2682,140000,2018
31101,49.5,8099,7296,70,567,2377,48901,3844,2712,1132,3844,114200,2018
31103,45.4,792,780,0,8,228,49688,326,244,82,326,71400,2018
31105,45.6,3667,3167,8,394,989,43856,1571,1112,459,1571,79800,2018
31107,46.9,8460,7276,23,223,2343,49752,3674,2690,984,3674,89300,2018
31109,33.3,310094,253065,12061,21280,72982,58009,122646,73619,49027,122646,167900,2018
31111,40.3,35433,31223,404,2957,9614,56794,14985,9780,5205,14985,135700,2018
31113,38.9,886,855,0,26,229,51607,341,242,99,341,110800,2018
31115,56.9,585,573,0,10,197,53125,279,234,45,279,122600,2018
31117,50.9,454,430,0,9,139,48882,203,139,64,203,119300,2018
31119,36.8,35164,28124,480,5213,9107,52857,14254,9364,4890,14254,136900,2018
31121,43.6,7803,7239,67,332,2205,54197,3324,2434,890,3324,100800,2018
31123,42.5,4841,3959,41,752,1197,45121,1982,1435,547,1982,92900,2018
31125,44.3,3554,3430,16,95,980,45833,1546,1194,352,1546,78400,2018
31127,39.3,7004,6587,104,188,1907,51922,2877,2073,804,2877,109500,2018
31129,49.3,4275,4074,7,116,1165,42049,1914,1449,465,1914,70800,2018
31131,41.5,15896,14173,60,1236,4209,54828,6452,4649,1803,6452,134700,2018
31133,50,2676,2554,0,48,765,46314,1219,1020,199,1219,71600,2018
31135,42.7,2907,2767,8,117,850,62469,1225,951,274,1225,113100,2018
31137,42.6,9120,8436,23,504,2506,57241,3927,2818,1109,3927,127000,2018
31139,41.5,7157,6904,17,124,2055,56620,3026,2303,723,3026,116700,2018
31141,38.5,33063,26131,160,6083,8558,62617,13000,9360,3640,13000,143900,2018
31143,45.2,5255,4890,4,282,1448,61962,2052,1642,410,2052,100200,2018
31145,41.1,10806,9938,80,542,2927,46859,4459,3279,1180,4459,99600,2018
31147,48,8009,7397,17,157,2316,48096,3772,2909,863,3772,66800,2018
31149,50.9,1350,1315,10,17,403,52604,626,457,169,626,78300,2018
31151,35.8,14288,9982,129,3517,3512,51143,5073,3535,1538,5073,98000,2018
31153,34.4,178351,145153,6384,16120,47379,79549,65045,44950,20095,65045,183700,2018
31155,40.8,21024,20068,64,456,5750,66718,8326,6534,1792,8326,161800,2018
31157,39.5,36255,26199,239,8590,9499,50157,14613,10082,4531,14613,121900,2018
31159,37.9,17127,16225,79,457,4512,67591,6596,4747,1849,6596,162600,2018
31161,45.9,5234,4270,40,261,1372,41719,2251,1610,641,2251,72300,2018
31163,49.9,3042,2933,0,66,854,51172,1358,1043,315,1358,89400,2018
31165,47,1266,1158,6,6,388,46875,579,423,156,579,113900,2018
31167,41.2,5992,5518,85,318,1781,62687,2410,2001,409,2410,115100,2018
31169,47,5098,4858,23,119,1488,50734,2283,1797,486,2283,66800,2018
31171,41.1,645,629,0,3,186,50682,292,212,80,292,120300,2018
31173,27.8,7140,2586,19,398,1613,48149,2175,1298,877,2175,81900,2018
31175,45.5,4224,4019,20,132,1237,55170,1840,1365,475,1840,107800,2018
31177,41.4,20219,19131,170,584,5800,70753,8125,6397,1728,8125,185800,2018
31179,31.8,9367,8451,166,541,2320,62623,3657,2346,1311,3657,135900,2018
31181,45.2,3571,3276,9,176,936,42298,1519,1178,341,1519,78300,2018
31183,49.8,822,812,0,5,234,52083,357,252,105,357,89000,2018
31185,40.2,13799,12530,210,691,3665,59779,5691,4022,1669,5691,127500,2018
32001,39.5,24010,17684,576,3260,6324,51514,9819,6456,3363,9819,174100,2018
32003,37.1,2141574,931411,235651,662081,488867,56802,767954,408047,359907,767954,238300,2018
32005,51.5,47828,38725,304,5981,14016,62503,20579,14376,6203,20579,346500,2018
32007,33.9,52252,34958,239,12667,12477,77209,17688,12793,4895,17688,200800,2018
32009,48.3,981,776,11,186,209,40000,454,264,190,454,74000,2018
32011,47.3,1830,1613,1,120,525,77625,750,549,201,750,84400,2018
32013,35.6,16904,10973,70,4521,4228,70373,6271,4723,1548,6271,173300,2018
32015,37.2,5746,3907,6,1498,1547,93583,2087,1680,407,2087,185300,2018
32017,45.2,5174,4461,155,442,1297,56414,2041,1502,539,2041,134700,2018
32019,44.1,53155,40178,479,8843,13488,55493,20528,14524,6004,20528,183900,2018
32021,50.1,4448,2611,110,537,1110,41163,1938,1322,616,1938,85900,2018
32023,52.7,43705,33580,1033,6286,11015,45711,18668,13252,5416,18668,139100,2018
32027,43.4,6611,4340,280,1597,1351,50846,1933,1423,510,1933,100800,2018
32029,52.9,3941,3330,32,203,1042,62284,1598,1398,200,1598,222900,2018
32031,38.1,450486,285766,9605,108922,109643,61155,177632,103092,74540,177632,299400,2018
32033,39.2,9737,7027,507,1522,2215,62993,3529,2608,921,3529,151900,2018
32510,42.8,54467,36753,908,12931,13831,52034,22461,12511,9950,22461,242200,2018
33001,47.1,60640,57698,392,990,16404,68368,24739,19027,5712,24739,222300,2018
33003,51.7,47840,45899,226,678,13561,61116,21070,16726,4344,21070,236500,2018
33005,42.7,76263,71856,512,1354,18629,63057,30319,21169,9150,30319,190600,2018
33007,48.1,32038,29514,866,938,8394,45696,13720,9729,3991,13720,124900,2018
33009,42.9,89811,81665,909,2089,21455,63153,34752,23972,10780,34752,220400,2018
33011,40.5,411087,348822,9336,26843,105483,78655,159200,104999,54201,159200,265000,2018
33013,42.8,149452,138383,1895,3104,38526,72478,57843,41397,16446,57843,232100,2018
33015,44.3,305129,283087,2135,8713,84161,90429,120147,92577,27570,120147,310200,2018
33017,36.9,128237,116576,1060,3003,30664,70650,48548,32187,16361,48548,226600,2018
33019,46.1,43125,41047,291,644,11628,60780,17740,12975,4765,17740,174000,2018
34001,41.5,268539,151667,38177,50129,66553,59989,99874,67336,32538,99874,218300,2018
34003,41.8,929999,532426,49361,180529,244841,95837,338249,217881,120368,338249,459200,2018
34005,41.5,446367,303118,71016,35026,115969,84992,165496,125355,40141,165496,247600,2018
34007,38.7,507367,290029,92935,83057,125116,67118,187158,124840,62318,187158,195800,2018
34009,49.3,93705,80121,4304,6988,26127,63690,39904,30960,8944,39904,296600,2018
34011,37.2,153400,72033,27616,46254,34788,52593,50608,32602,18006,50608,162500,2018
34013,37.5,793555,244690,306647,180241,182151,59302,282502,124873,157629,282502,372600,2018
34015,40.3,290852,229296,28828,17292,74097,85160,104587,83845,20742,104587,216700,2018
34017,35.1,668631,192905,72198,288749,158774,66289,255429,80382,175047,255429,364100,2018
34019,46.2,125051,107582,3138,7942,34597,112535,47180,39290,7890,47180,402800,2018
34021,38.7,368762,185755,73089,63371,87942,79990,129873,82934,46939,129873,284200,2018
34023,38.4,826698,362322,78052,171616,208083,85954,284174,179974,104200,284174,336200,2018
34025,43.2,623387,469708,41485,66528,161885,95699,233874,172322,61552,233874,408400,2018
34027,42.6,494383,355172,15554,64765,129534,111316,180896,134600,46296,180896,448800,2018
34029,42.9,591939,502194,16434,53964,150050,68021,225270,180179,45091,225270,272900,2018
34031,37,504041,210740,52922,206100,118949,66476,163670,86668,77002,163670,336600,2018
34033,42,63336,47292,8172,5475,15687,64309,23908,16853,7055,23908,185300,2018
34035,41.6,330176,189041,30340,47729,85297,111772,117012,88500,28512,117012,420500,2018
34037,44.5,142298,123534,2895,11109,38043,90520,53361,44007,9354,53361,266000,2018
34039,38.5,553066,222752,111523,171745,135895,77095,188987,111289,77698,188987,357300,2018
34041,44,106293,87628,4571,9411,27990,78145,41350,29723,11627,41350,260000,2018
35001,37.3,677692,264358,16622,337627,159289,51643,265657,166905,98752,265657,194300,2018
35003,59.1,3539,2885,0,635,882,42480,1381,1276,105,1381,161800,2018
35005,35.6,65459,25853,1005,36797,15945,43197,23169,15993,7176,23169,108700,2018
35006,36.8,26978,5286,250,10319,6222,37368,8939,6239,2700,8939,86800,2018
35007,49,12353,5777,60,6105,3241,33783,5678,3914,1764,5678,107400,2018
35009,31.1,50199,24184,2650,20872,11973,46182,18515,10633,7882,18515,127700,2018
35011,37,2060,1072,33,949,354,31028,705,468,237,705,95600,2018
35013,32.9,215338,59223,3598,146485,52524,39164,77453,47873,29580,77453,141700,2018
35015,35.3,57437,27317,821,27799,15019,62982,21264,15057,6207,21264,148300,2018
35017,45.8,28061,12915,157,14127,7157,37880,12003,8436,3567,12003,126700,2018
35019,42.6,4382,830,50,3434,689,24085,1404,918,486,1404,85400,2018
35021,60.1,459,283,0,171,107,30875,211,132,79,211,83000,2018
35023,43.3,4371,1782,27,2535,1142,36339,1753,1233,520,1753,83400,2018
35025,31.7,70126,25311,2543,40594,16423,59797,22114,14973,7141,22114,123900,2018
35027,51,19482,12176,161,6362,5015,42267,7815,6017,1798,7815,206600,2018
35028,42.5,18356,13241,36,3236,5015,115248,7567,5611,1956,7567,292200,2018
35029,37.8,24264,7301,271,16164,5226,27377,9025,5460,3565,9025,84500,2018
35031,32,72849,6447,421,10434,14182,31674,20295,14426,5869,20295,64500,2018
35033,49.2,4563,712,1,3701,865,26968,1535,1155,380,1535,103300,2018
35035,35.6,65745,32387,2137,24999,14488,42752,23391,15280,8111,23391,108300,2018
35037,43.8,8373,4179,122,3781,1518,27075,3060,1946,1114,3060,72200,2018
35039,40.6,39307,4910,164,28046,NA,NA,NA,9548,2850,12398,164800,2018
35041,29.8,19117,10037,447,7941,4265,40775,6993,4268,2725,6993,113800,2018
35043,39.9,140769,61920,2894,54038,34939,59420,50340,39428,10912,50340,191300,2018
35045,35,127455,49334,712,25619,30530,50582,43134,30986,12148,43134,150400,2018
35047,43.2,28034,5029,296,21757,5987,31660,11292,8041,3251,11292,127200,2018
35049,45.8,148917,63627,1283,76404,36678,59192,61972,43572,18400,61972,282600,2018
35051,56,11135,7246,65,3369,2761,30451,5377,4082,1295,5377,111900,2018
35053,39.2,17000,5895,60,8445,2449,36146,4550,3351,1199,4550,97200,2018
35055,48.2,32888,11566,71,18738,6974,36758,12127,9158,2969,12127,236600,2018
35057,43.6,15595,8016,273,6679,3777,37218,5664,4719,945,5664,112600,2018
35059,40.6,4175,2143,82,1746,805,37936,1381,965,416,1381,81300,2018
35061,39.1,75956,25066,704,45843,19029,45084,27489,22179,5310,27489,136000,2018
36001,37.9,307426,223319,35930,17925,69288,64535,126008,71253,54755,126008,218100,2018
36003,38.8,47025,44391,639,744,11505,47033,18009,13533,4476,18009,73900,2018
36005,33.9,1437872,133874,421275,803636,327543,38085,499728,97983,401745,499728,382900,2018
36007,39.8,194402,162872,10047,7974,46416,50859,78594,51327,27267,78594,115600,2018
36009,42,77686,70425,1224,1605,19741,47240,31433,22458,8975,31433,86200,2018
36011,42.7,77868,70280,3241,2232,19713,56579,31251,22189,9062,31251,123000,2018
36013,42.5,129656,113526,2975,9585,32457,45332,52572,36802,15770,52572,86300,2018
36015,41.3,85740,74077,4940,2595,21610,53299,34373,23349,11024,34373,106500,2018
36017,44.7,48348,45846,429,1038,12862,50595,20616,15370,5246,20616,97000,2018
36019,39.3,80794,72705,3297,2310,19706,55178,31395,21264,10131,31395,132000,2018
36021,47.8,60919,52771,2564,2827,15781,63032,25243,18201,7042,25243,231100,2018
36023,36.4,48123,44579,693,1278,11250,54489,17685,11710,5975,17685,118100,2018
36025,47.5,45502,41958,720,1742,11674,48827,19030,14132,4898,19030,136300,2018
36027,42,293894,211310,28478,34970,71979,78028,107347,73809,33538,107347,278100,2018
36029,40.4,919866,696992,119231,49413,228936,55673,387847,251238,136609,387847,146500,2018
36031,47,37751,34773,1080,1133,9969,56196,15425,11663,3762,15425,151900,2018
36033,40.6,50692,41423,2915,1759,12316,51696,19088,13829,5259,19088,105500,2018
36035,43.8,53743,49973,1058,1581,14247,50248,22439,16036,6403,22439,108700,2018
36037,43.3,58112,52697,1249,1849,15165,59338,23681,17201,6480,23681,117600,2018
36039,45.8,47617,40625,2763,2753,10179,53617,17117,12681,4436,17117,174700,2018
36041,54,4575,4363,37,71,751,57552,1124,963,161,1124,164900,2018
36043,44,62505,59147,714,1309,15656,51862,24583,17821,6762,24583,97200,2018
36045,32.4,114448,93636,6452,8485,28699,52268,43267,24108,19159,43267,149500,2018
36047,35.1,2600747,940759,787705,499279,585424,56015,950856,285330,665526,950856,665300,2018
36049,42,26719,25607,206,456,7067,52380,10242,8111,2131,10242,120000,2018
36051,40.8,63907,58112,1696,2223,15511,56071,24383,17903,6480,24383,126700,2018
36053,41.7,71359,66547,1158,1547,16706,60228,26026,19965,6061,26026,131800,2018
36055,38.9,744248,527127,107709,63631,181700,57479,300796,191759,109037,300796,144700,2018
36057,41.4,49426,40461,858,6766,12326,45837,19665,13375,6290,19665,101000,2018
36059,41.6,1356564,824425,151236,225581,341992,111240,445517,359301,86216,445517,474800,2018
36061,37.3,1632480,765564,203849,423683,322848,82459,758133,182949,575184,758133,944600,2018
36063,43.2,211704,181515,14890,6054,55018,54085,88211,62872,25339,88211,119300,2018
36065,41.2,230782,190102,13748,12892,56873,53844,90014,60296,29718,90014,123100,2018
36067,39,464242,357879,50528,22258,113449,59225,185624,120348,65276,185624,142300,2018
36069,43.5,109472,98548,2503,5058,28051,63359,44286,32639,11647,44286,160000,2018
36071,36.9,378227,245605,37246,75705,88791,76716,126776,86266,40510,126776,263700,2018
36073,43.2,41175,35622,2457,1961,10984,51843,16333,12346,3987,16333,95600,2018
36075,40,119104,112214,1106,2995,30641,53597,46032,33504,12528,46032,102000,2018
36077,42,60244,54982,1071,2175,14923,53121,23556,17174,6382,23556,144000,2018
36079,44.1,99070,78745,2548,14195,25875,102186,34847,28718,6129,34847,356300,2018
36081,38.7,2298513,581373,396320,643563,529069,64987,779234,347739,431495,779234,504900,2018
36083,39.9,159431,133232,9399,7650,39187,65851,64563,40708,23855,64563,185100,2018
36085,40,474101,292360,43906,86976,123094,79267,166152,115839,50313,166152,478600,2018
36087,36.1,323686,204842,36781,56383,74839,91108,100005,68681,31324,100005,434000,2018
36089,38.9,109558,100770,2429,2532,26421,49305,41669,30183,11486,41669,91600,2018
36091,42.6,227377,206104,3489,7059,61712,80839,93876,67383,26493,93876,251200,2018
36093,39.9,154883,113649,14824,10707,31928,63785,53295,35455,17840,53295,165400,2018
36095,45.1,31364,29308,472,972,7974,53989,12559,9415,3144,12559,143500,2018
36097,46.2,17992,17133,162,313,4679,51479,7304,5684,1620,7304,121300,2018
36099,42.2,34612,30873,1617,1158,8515,54695,13522,10003,3519,13522,101400,2018
36101,42.6,96927,90861,1472,1571,25789,51789,40183,28841,11342,40183,98200,2018
36103,41.3,1487901,1013391,108250,281315,357400,96675,487981,390897,97084,487981,386800,2018
36105,42.9,75211,54110,5706,11836,17952,56256,27890,18872,9018,27890,169500,2018
36107,44,49045,46642,292,927,13673,60736,20045,15427,4618,20045,117100,2018
36109,30.9,102962,79657,3808,5156,20499,58743,39326,21749,17577,39326,199400,2018
36111,43.7,179303,142515,9614,17976,42806,63348,69539,47815,21724,69539,225500,2018
36113,46.4,64480,60623,816,1589,16735,59813,27553,19547,8006,27553,193800,2018
36115,44,61828,57178,1706,1642,15913,54114,24009,17507,6502,24009,145900,2018
36117,43.6,90856,81906,2594,3878,24472,55765,36504,27723,8781,36504,121700,2018
36119,40.8,968815,523474,130640,235243,239615,92758,347332,212889,134443,347332,528300,2018
36121,41.9,40565,36471,1710,1320,10419,57914,15815,12071,3744,15815,112200,2018
36123,41.3,25009,23686,207,549,5891,54343,9029,7152,1877,9029,128800,2018
37001,39.5,160576,103713,30569,19905,41309,45735,64059,41668,22391,64059,147800,2018
37003,43.4,37119,32245,2105,1723,9746,44961,13722,10334,3388,13722,130600,2018
37005,49.5,10973,9548,255,1054,3262,37558,4746,3561,1185,4746,126000,2018
37007,40.5,25306,11288,12333,999,5840,39126,9516,6370,3146,9516,89300,2018
37009,47.7,26786,24800,199,1336,8077,40978,11805,8875,2930,11805,152500,2018
37011,44.4,17501,15298,770,896,4404,38134,6587,4918,1669,6587,150600,2018
37013,45.7,47243,31094,11826,3609,12375,43688,19325,13614,5711,19325,128300,2018
37015,45.2,19644,6735,11899,408,4829,33143,7976,5972,2004,7976,80900,2018
37017,43.6,33778,18466,11648,2523,9127,32378,13968,9886,4082,13968,90000,2018
37019,52.8,126860,103713,12966,6028,37172,54406,54226,42857,11369,54226,199900,2018
37021,42.1,254474,212773,15745,16529,61824,50668,107093,68272,38821,107093,222300,2018
37023,43.6,89712,73269,5757,5342,23299,42516,34672,25072,9600,34672,116400,2018
37025,37.9,201448,134629,34633,20560,53006,64174,72299,51670,20629,72299,189100,2018
37027,44.1,81779,71612,3919,4315,22642,42072,32594,23242,9352,32594,115700,2018
37029,40.7,10447,8400,1462,296,3135,63349,3836,3088,748,3836,210300,2018
37031,47.9,68920,59524,3859,2930,18982,54428,29690,21435,8255,29690,207900,2018
37033,45.6,22746,13913,7492,867,6326,43961,9110,7180,1930,9110,109100,2018
37035,41.4,156729,118864,12479,14810,41986,51157,61099,42417,18682,61099,141900,2018
37037,46.7,69791,49922,7909,8626,19664,63531,28527,21817,6710,28527,265900,2018
37039,50.9,27668,25251,364,846,7898,40294,11895,9536,2359,11895,152200,2018
37041,44.7,14205,8495,4834,515,4021,42621,5984,4144,1840,5984,124700,2018
37043,52,10813,10133,226,340,3455,38801,5062,3855,1207,5062,165900,2018
37045,41.9,97159,70967,20205,3317,24781,40393,36882,24900,11982,36882,114300,2018
37047,42,56293,33397,17134,2941,14754,36398,22306,16041,6265,22306,87300,2018
37049,36.6,103082,67962,21871,7404,27380,50870,40871,25544,15327,40871,158300,2018
37051,31.2,332106,146144,119158,37826,78282,45716,124418,63395,61023,124418,132500,2018
37053,42.9,25796,22492,1452,981,7478,66284,10148,8384,1764,10148,251800,2018
37055,46.1,35741,31294,671,2567,10191,58012,15441,10949,4492,15441,287600,2018
37057,42.3,164664,132548,14843,11516,45631,47271,65471,45905,19566,65471,137000,2018
37059,45,41991,35562,2305,2796,11503,57611,15999,12444,3555,15999,172700,2018
37061,40.6,59062,30570,14318,12909,14744,38850,21781,15252,6529,21781,87000,2018
37063,35.2,306457,129434,111859,41189,71722,58190,123444,66379,57065,123444,209300,2018
37065,41,53332,19394,30485,2358,14454,35516,21371,12687,8684,21371,85200,2018
37067,38.3,371573,211844,95294,46913,91594,50128,146685,90273,56412,146685,154500,2018
37069,41.3,64902,41244,16296,5276,17802,53175,24749,18137,6612,24749,143700,2018
37071,40.1,216585,158164,34288,14642,54846,49384,81494,54033,27461,81494,136500,2018
37073,45.7,11563,7288,3891,41,3125,52205,4477,3505,972,4477,144000,2018
37075,46,8557,7428,13,129,2167,36525,3288,2761,527,3288,119200,2018
37077,42.6,58874,34254,17718,4563,15169,55628,21030,15485,5545,21030,149400,2018
37079,41.2,21008,9863,7393,3116,4900,38306,7259,5130,2129,7259,85900,2018
37081,37.1,523582,266383,175353,40824,127859,51072,202731,119449,83282,202731,162400,2018
37083,43.1,51737,19937,27237,1440,13761,34251,21116,13233,7883,21116,86100,2018
37085,34.2,130361,80530,26503,16196,32197,51630,45086,29077,16009,45086,148400,2018
37087,47.6,60433,56133,617,2307,16914,49800,26336,18938,7398,26336,175600,2018
37089,47.1,113625,94557,3563,11423,31311,52815,48281,35002,13279,48281,203400,2018
37091,42.1,24153,8078,14154,897,5614,37005,8899,5973,2926,8899,85400,2018
37093,32.5,53239,21465,17412,6950,12824,47535,17722,11988,5734,17722,139000,2018
37095,40,5393,3178,1636,536,1408,45466,1769,1204,565,1769,108300,2018
37097,40.4,172525,131544,20869,12869,46913,58198,65246,46908,18338,65246,180700,2018
37099,37.5,42256,34202,897,2376,9816,44028,16642,10740,5902,16642,192300,2018
37101,38.1,191172,130482,28921,25735,49556,56842,67154,48064,19090,67154,156800,2018
37103,47.2,9695,6041,3013,445,2741,36892,4137,3012,1125,4137,88700,2018
37105,38.2,60125,34901,11642,11556,15104,48873,21744,14489,7255,21744,138300,2018
37107,42.2,57227,28294,22190,4364,15189,38387,23121,13739,9382,23121,95700,2018
37109,43.2,81441,69273,4048,5755,23517,53318,32022,24475,7547,32022,160800,2018
37111,43.6,45109,39462,1614,2700,12824,40913,17961,12902,5059,17961,113900,2018
37113,49.8,34410,30726,464,2367,9934,43597,15699,11422,4277,15699,165800,2018
37115,44,21405,20140,358,514,5600,42410,8452,6133,2319,8452,180400,2018
37117,46.1,23054,12003,9662,895,6366,39205,9471,6606,2865,9471,88400,2018
37119,35,1054314,498733,324864,137405,249120,64312,403546,227899,175647,403546,219800,2018
37121,47.1,15040,13897,50,793,4070,44186,6361,5109,1252,6361,150100,2018
37123,43.3,27338,17296,4914,4176,7179,42346,10411,7564,2847,10411,108300,2018
37125,44.5,95629,73821,12083,6214,25002,57899,38965,29353,9612,38965,210200,2018
37127,41.4,94003,47356,36713,6408,24306,48362,36720,24114,12606,36720,126200,2018
37129,38.7,224231,172855,30738,12159,53140,52716,93636,53572,40064,93636,233700,2018
37131,49,20186,7805,11394,427,5718,35499,8628,5957,2671,8628,83100,2018
37133,26.2,193912,128818,26115,24094,45354,49491,64065,33808,30257,64065,153900,2018
37135,34.7,142938,99124,16035,12014,31886,68211,52529,32539,19990,52529,292500,2018
37137,52.1,12742,9458,2296,477,3490,44947,5352,4020,1332,5352,154500,2018
37139,38.2,39479,21648,14362,2031,9942,48279,14780,9020,5760,14780,158700,2018
37141,42.9,59020,44138,8783,4069,14305,52989,21766,17520,4246,21766,179500,2018
37143,49.6,13459,9704,3183,346,4027,45915,5919,4388,1531,5919,169900,2018
37145,43.2,39305,26088,10424,1659,10764,48811,15744,11834,3910,15744,117100,2018
37147,32.2,177372,96999,61235,10903,41214,44315,69169,36232,32937,69169,141100,2018
37149,52.4,20458,17543,1050,1184,5547,48834,9047,6638,2409,9047,212300,2018
37151,41.5,142958,113446,8495,16069,38397,45006,56041,40260,15781,56041,120800,2018
37153,40.5,45189,25901,14303,2870,12166,36091,18546,12260,6286,18546,80100,2018
37155,36.4,133442,34012,31882,11566,31052,33679,45969,29877,16092,45969,74600,2018
37157,44.5,91270,66181,16759,5496,24607,42490,37201,25695,11506,37201,111400,2018
37159,40.2,139605,101058,22176,11986,35664,48667,52301,36123,16178,52301,130700,2018
37161,44.7,66532,55513,6404,2817,16964,40347,26345,18787,7558,26345,114800,2018
37163,40.3,63561,32569,15844,12297,15643,39068,23537,16191,7346,23537,88800,2018
37165,39.4,35262,15376,13727,1030,8824,35617,13113,8034,5079,13113,84500,2018
37167,42.3,61114,49409,6751,2506,16820,49590,23717,17435,6282,23717,134100,2018
37169,46,45905,41883,1957,1314,13353,46169,19302,14997,4305,19302,128600,2018
37171,43.8,72099,60718,2659,7450,19696,41068,28985,20933,8052,28985,121000,2018
37173,41.4,14254,8868,60,731,3572,36773,5443,3887,1556,5443,123200,2018
37175,50.7,33513,30264,1500,1090,9858,46629,14123,10846,3277,14123,211300,2018
37177,49.2,4119,2197,1540,263,1038,35472,1631,1171,460,1631,109900,2018
37179,38,226694,164562,25471,25045,59919,75397,75165,60516,14649,75165,229200,2018
37181,40.7,44482,17801,22213,3369,10969,37282,16854,10061,6793,16854,97700,2018
37183,36,1046558,631197,207445,105361,261233,76956,390498,249558,140940,390498,265800,2018
37185,47.6,20033,7676,10121,753,4616,35962,7780,5643,2137,7780,95000,2018
37187,45.5,12156,5404,5755,641,2878,35512,5073,3208,1865,5073,85000,2018
37189,31.2,54117,49725,886,1882,11053,45268,20355,12345,8010,20355,239400,2018
37191,37.6,124002,66640,37521,14320,32399,42192,48153,29626,18527,48153,121900,2018
37193,44.5,68460,59940,2750,4316,18849,40829,28355,21036,7319,28355,124000,2018
37195,40.6,81336,38386,31763,8310,20730,42850,32128,18964,13164,32128,121300,2018
37197,44.1,37665,31807,1308,4120,10776,42876,15448,11848,3600,15448,125800,2018
37199,47.4,17667,16360,129,899,5036,39888,7402,5496,1906,7402,149800,2018
38001,46.1,2351,2149,48,41,677,54875,1046,758,288,1046,148800,2018
38003,44.9,10836,10053,261,213,2848,57064,5085,3500,1585,5085,118800,2018
38005,30.5,6886,2817,2,63,1609,44313,2285,1492,793,2285,73600,2018
38007,40.6,946,873,11,57,276,92604,385,282,103,385,181600,2018
38009,45.1,6589,6041,60,148,1890,59882,3065,2400,665,3065,149400,2018
38011,41.4,3195,2981,1,173,891,65063,1398,1043,355,1398,149300,2018
38013,34.6,2213,2076,14,69,550,74931,877,694,183,877,114500,2018
38015,36.9,93737,83803,1950,2195,24642,69719,39495,27039,12456,39495,250600,2018
38017,32.2,174202,149999,8804,4505,41649,62031,74205,39207,34998,74205,211500,2018
38019,49.9,3824,3637,4,45,1169,67591,1737,1402,335,1737,98600,2018
38021,43.1,4970,4641,57,170,1412,60918,2170,1561,609,2170,105300,2018
38023,54,2369,2173,26,57,676,60074,1119,845,274,1119,159300,2018
38025,38.8,4387,3688,68,119,1117,70500,1648,1281,367,1648,189100,2018
38027,44,2313,2038,0,0,637,51563,1052,725,327,1052,83500,2018
38029,52.6,3352,3211,0,26,972,51029,1556,1294,262,1556,101700,2018
38031,45.6,3290,3141,7,51,911,60613,1440,1104,336,1440,127800,2018
38033,44.6,1882,1776,0,60,466,56087,856,579,277,856,120000,2018
38035,29.5,70400,59201,2792,2887,16308,51951,30215,14675,15540,30215,193300,2018
38037,51.9,2380,2324,1,12,649,50962,1094,943,151,1094,77700,2018
38039,50.2,2266,2160,31,6,644,52794,1056,767,289,1056,98200,2018
38041,45.1,2576,2339,9,83,699,56761,1079,869,210,1079,111000,2018
38043,45.2,2460,2320,10,108,766,57734,1055,777,278,1055,104900,2018
38045,48.4,4100,3947,22,59,1156,59426,1813,1357,456,1813,103200,2018
38047,52.6,1927,1878,1,24,545,58144,883,743,140,883,84300,2018
38049,42.8,5927,5638,25,135,1734,62637,2628,2224,404,2628,123200,2018
38051,53.5,2654,2515,24,41,802,50739,1317,1003,314,1317,76600,2018
38053,30.7,12536,9754,67,969,2454,80732,3899,2170,1729,3899,211900,2018
38055,46.1,9608,8595,59,229,2883,65648,4333,3497,836,4333,163000,2018
38057,43.9,8570,7947,76,249,2557,79890,3702,3060,642,3702,175200,2018
38059,37.7,30544,27581,133,960,8463,67584,13536,9540,3996,13536,199800,2018
38061,33.5,10152,6281,118,764,2118,70678,3235,2197,1038,3235,167900,2018
38063,52.9,2920,2817,0,75,817,48798,1479,1066,413,1479,85200,2018
38065,50,1837,1668,18,32,563,68333,750,657,93,750,177600,2018
38067,47.9,7016,6388,20,244,2018,64962,3180,2447,733,3180,89700,2018
38069,45.8,4210,3956,32,37,1096,48802,1937,1395,542,1937,114800,2018
38071,41.6,11557,9714,13,303,2885,57313,5003,3027,1976,5003,152100,2018
38073,46.4,5361,5075,38,97,1479,61810,2367,1668,699,2367,123200,2018
38075,41,2495,2271,5,158,667,68182,1022,828,194,1022,140400,2018
38077,37.8,16288,14916,119,484,4216,61990,6760,4836,1924,6760,124300,2018
38079,30.8,14603,2697,91,93,3194,39884,4638,3282,1356,4638,81400,2018
38081,45.1,3883,3596,92,116,1185,67200,1834,1325,509,1834,105400,2018
38083,51.5,1405,1379,0,0,413,49261,689,552,137,689,83400,2018
38085,28.2,4413,555,6,187,820,40862,1110,502,608,1110,83000,2018
38087,50.8,704,659,39,0,217,63942,329,268,61,329,89500,2018
38089,33.9,30876,27118,668,1638,7187,75708,12150,7563,4587,12150,238100,2018
38091,50.5,1910,1869,11,30,549,65848,891,753,138,891,78300,2018
38093,40.2,21064,19476,258,507,5136,57642,9055,5819,3236,9055,146100,2018
38095,47.8,2246,2004,0,56,651,53696,1036,792,244,1036,74100,2018
38097,41.3,8019,7397,88,287,2137,62870,3349,2412,937,3349,139400,2018
38099,44.4,10802,9136,47,1227,3024,54414,4841,3696,1145,4841,85600,2018
38101,31.4,69034,57662,2657,4082,16399,67753,27564,16568,10996,27564,209400,2018
38103,52.1,4055,3966,0,52,1218,57989,1960,1562,398,1960,97900,2018
38105,31.5,34061,27581,1230,2306,8247,86575,13695,7301,6394,13695,256000,2018
39001,42,27878,26873,109,278,7209,36894,10835,7498,3337,10835,100200,2018
39003,39,103642,83961,12206,3077,26653,50552,40537,26952,13585,40537,113500,2018
39005,40.3,53477,51166,433,713,13748,52730,20439,14734,5705,20439,124900,2018
39007,42.4,98136,87980,3462,3997,24225,44823,37652,26382,11270,37652,108300,2018
39009,28.9,65936,59012,1830,1251,12169,37778,22620,12698,9922,22620,122000,2018
39011,41.3,45784,43853,228,772,12982,61758,18723,14323,4400,18723,143800,2018
39013,44.5,68472,63576,2766,639,16784,49361,26200,20021,6179,26200,98500,2018
39015,41.8,43679,42160,338,420,12372,52356,17434,12883,4551,17434,124500,2018
39017,36.5,378294,308495,29774,17487,94625,63358,138226,94470,43756,138226,165900,2018
39019,45.3,27578,26549,187,358,7768,52394,11126,8618,2508,11126,123900,2018
39021,42.4,38864,36308,711,596,10433,57103,15209,11044,4165,15209,126200,2018
39023,41.1,135198,113837,10565,4512,35710,48502,54905,35679,19226,54905,111600,2018
39025,39.8,203216,190326,2844,3822,54257,64822,77181,57321,19860,77181,164200,2018
39027,39.9,41896,39127,849,655,11112,51354,16370,10723,5647,16370,125300,2018
39029,44,104003,97786,2239,1793,27995,46306,41854,30506,11348,41854,106700,2018
39031,41.4,36574,35105,403,367,9720,44491,14461,10602,3859,14461,100000,2018
39033,43,42021,40093,369,682,11364,42892,17755,12427,5328,17755,87200,2018
39035,40.3,1253783,742480,367181,72492,302738,48435,538531,314766,223765,538531,128000,2018
39037,41.8,51734,49769,344,792,14336,52691,20838,15100,5738,20838,114900,2018
39039,40.6,38279,33123,619,3764,10544,57665,15213,11723,3490,15213,117700,2018
39041,38.6,197008,168906,6435,4982,52460,104322,68649,55800,12849,68649,293900,2018
39043,44.8,75136,62585,6459,3246,19848,52270,31301,21602,9699,31301,136700,2018
39045,39.3,152910,132498,10698,3242,40373,66175,55748,40508,15240,55748,173600,2018
39047,40.7,28645,26524,583,605,8037,46478,11736,7413,4323,11736,112700,2018
39049,34,1275333,811321,279711,69044,297301,58762,504702,269515,235187,504702,165800,2018
39051,40.8,42305,37727,162,3647,11902,60231,16425,12677,3748,16425,137000,2018
39053,40.6,30195,28216,714,399,7640,42113,11662,8576,3086,11662,106200,2018
39055,44.6,93961,89866,1149,1361,26282,79956,35285,30380,4905,35285,230200,2018
39057,38.1,165811,139196,11531,4622,43127,67109,65406,43414,21992,65406,168200,2018
39059,42.5,39274,37043,463,465,10241,43975,16098,11467,4631,16098,106600,2018
39061,36.8,812037,531958,207494,25836,195879,54976,339966,196427,143539,339966,149300,2018
39063,39.2,75690,67600,1089,4004,20106,55644,31887,22074,9813,31887,139900,2018
39065,35.5,31542,30010,207,517,7581,48773,11495,8155,3340,11495,98400,2018
39067,46,15307,14537,343,153,4199,48462,6200,4851,1349,6200,89800,2018
39069,41.3,27316,24601,210,2072,7862,59083,11065,8569,2496,11065,121900,2018
39071,40.4,43007,40987,678,446,11349,43297,16646,11524,5122,16646,111700,2018
39073,42.9,28495,27480,231,296,7730,50000,11120,8396,2724,11120,126700,2018
39075,31.3,43859,42926,45,409,10078,62111,12437,9458,2979,12437,200700,2018
39077,39.6,58457,52746,709,3764,15377,51559,22860,16066,6794,22860,120800,2018
39079,40.1,32524,31238,192,341,9132,45340,12892,9044,3848,12892,94600,2018
39081,44.8,66886,60487,3621,932,17336,44819,27363,18921,8442,27363,90000,2018
39083,38.9,61215,58431,602,895,15756,55131,23340,16731,6609,23340,147900,2018
39085,43.7,230052,203808,9112,9861,61571,63475,95980,71396,24584,95980,153100,2018
39087,41.6,60622,57494,1265,576,15516,44372,23540,16847,6693,23540,103000,2018
39089,39.7,172293,156063,6360,3154,44667,62715,64016,46611,17405,64016,164100,2018
39091,40.8,45307,42341,729,681,12754,55150,18654,13605,5049,18654,129100,2018
39093,41.8,306713,240740,23924,29923,80082,56965,119536,85598,33938,119536,145100,2018
39095,37.9,432379,297943,80556,30210,107407,46924,179065,107392,71673,179065,113100,2018
39097,40.7,43988,38991,2568,858,10590,65264,15080,10747,4333,15080,162200,2018
39099,43.5,231064,175986,33736,13489,59891,44682,98052,67349,30703,98052,103400,2018
39101,41.3,65344,57826,3607,1699,15826,45464,24616,16717,7899,24616,97500,2018
39103,41.9,177257,166613,2482,3554,48578,74243,68121,54937,13184,68121,189700,2018
39105,43.6,23160,22399,308,119,6261,43591,9193,7269,1924,9193,92900,2018
39107,39.9,40806,38988,252,781,11303,59417,16104,12330,3774,16104,144100,2018
39109,41.6,104800,96950,2152,1697,26790,57544,41081,28728,12353,41081,145800,2018
39111,46.3,14090,13706,39,150,3981,43956,5945,4497,1448,5945,104700,2018
39113,39.3,532034,378028,108566,15138,134675,49314,223894,136552,87342,223894,115400,2018
39115,44.3,14702,13559,681,49,4256,41731,6147,4788,1359,6147,96500,2018
39117,41.7,34976,33588,363,504,9172,56010,12650,10372,2278,12650,144900,2018
39119,40.2,86076,78838,2596,948,22125,45276,34239,23173,11066,34239,116200,2018
39121,49.7,14443,13333,816,103,3302,47456,4967,4172,795,4967,98400,2018
39123,49,40709,37579,467,2046,11915,57918,17691,13919,3772,17691,148400,2018
39125,42,18872,17416,141,881,5393,51933,7770,5975,1795,7770,94300,2018
39127,39.9,35985,34804,142,305,9741,48811,13547,10061,3486,13547,107600,2018
39129,39.4,57420,53289,1880,781,14169,62214,19728,14831,4897,19728,157800,2018
39131,40.8,28214,26881,311,302,7581,43729,10822,7279,3543,10822,106500,2018
39133,37.9,162644,145949,6609,2904,39442,56618,61993,43216,18777,61993,157300,2018
39135,42.6,41207,39771,228,339,11212,55374,16090,12443,3647,16090,119300,2018
39137,40,33969,31281,115,2066,9698,62001,13236,10684,2552,13236,151600,2018
39139,41.3,121324,103900,9424,2240,30569,47346,47998,32616,15382,47998,105600,2018
39141,40.9,77051,69055,4036,947,19957,48403,28747,20077,8670,28747,120900,2018
39143,41.8,59299,50206,1679,5822,15551,51701,23562,16812,6750,23562,113100,2018
39145,39.9,76377,71300,2029,1030,19445,39731,30086,20402,9684,30086,94500,2018
39147,39.4,55475,49919,1407,2794,14139,49936,21652,15512,6140,21652,101800,2018
39149,39.4,48797,45365,1298,749,13211,61042,18643,13168,5475,18643,139100,2018
39151,41.9,373475,323197,27264,7493,99335,52190,152649,104220,48429,152649,130700,2018
39153,40.9,541810,419051,77474,11168,138170,55448,224385,147453,76932,224385,140700,2018
39155,44.2,201794,176071,16448,3539,54215,45975,86163,60946,25217,86163,102500,2018
39157,41,92526,87645,576,2443,24574,51170,36817,25968,10849,36817,121900,2018
39159,38.4,55654,50010,1447,915,14385,82775,19546,15111,4435,19546,196500,2018
39161,40.9,28281,26619,344,913,8023,52754,11419,8525,2894,11419,102400,2018
39163,42.2,13111,12668,61,76,3477,42114,5111,3806,1305,5111,90600,2018
39165,39.3,226564,196153,7526,6038,61193,83330,81859,63466,18393,81859,210900,2018
39167,44.1,60671,57721,744,654,16384,48572,25139,18571,6568,25139,125600,2018
39169,38.5,116208,108896,1695,2302,30187,56348,43385,31704,11681,43385,145700,2018
39171,41.2,36936,34296,371,1598,9747,49491,15246,11539,3707,15246,98300,2018
39173,34.8,129936,114927,3395,7113,30852,59789,50443,33205,17238,50443,157900,2018
39175,42.1,22107,21013,42,630,6108,52940,9076,6600,2476,9076,115800,2018
40001,37.6,22113,8921,69,1461,5586,32986,7742,5309,2433,7742,83500,2018
40003,42.9,5857,4486,191,309,1433,59569,1958,1526,432,1958,78900,2018
40005,40.6,13874,9908,531,486,3695,38821,5302,3910,1392,5302,98800,2018
40007,40.3,5415,3962,14,1245,1519,51996,2027,1573,454,2027,101800,2018
40009,35.7,22621,17068,853,3273,5049,48725,7562,4914,2648,7562,120100,2018
40011,42.4,9634,7061,392,1003,2577,50391,3908,3000,908,3908,82900,2018
40013,37.5,45759,32705,856,2663,11356,43245,17157,10620,6537,17157,107700,2018
40015,37.3,29342,16783,652,3662,7070,44588,10199,7314,2885,10199,82500,2018
40017,35.9,136710,104830,3677,11788,33041,71157,44633,33823,10810,44633,160200,2018
40019,38.2,48406,34045,3108,3422,12134,49216,18336,12576,5760,18336,112400,2018
40021,35.1,48599,23265,634,3424,10599,40936,16507,11136,5371,16507,115900,2018
40023,42,14886,9087,1661,627,3787,32129,5991,4122,1869,5991,95500,2018
40025,43,2189,1694,5,473,599,46071,974,716,258,974,55800,2018
40027,33.9,276733,199785,12611,23307,69321,62863,105190,67327,37863,105190,159500,2018
40029,41.6,5618,3867,7,259,1457,40000,2236,1624,612,2236,84900,2018
40031,33,122561,69223,19507,15802,27925,52227,42610,23218,19392,42610,125400,2018
40033,42.9,5929,4526,131,453,1627,51623,2212,1731,481,2212,75400,2018
40035,42.3,14493,9250,439,516,3755,41701,5433,3866,1567,5433,104700,2018
40037,40.2,71160,54308,1513,2869,18970,49578,26642,19902,6740,26642,116200,2018
40039,31,29209,20037,927,5259,6905,48884,10505,6309,4196,10505,135500,2018
40041,46.7,42112,26942,144,1567,11113,39742,16574,12561,4013,16574,114900,2018
40043,40.2,4918,4062,8,353,1187,50037,1701,1280,421,1701,93700,2018
40045,44.1,4072,3528,9,296,1032,52705,1607,1179,428,1607,84700,2018
40047,36,62190,46693,2529,7557,15782,51332,23824,15355,8469,23824,106800,2018
40049,39.2,27823,21108,653,2375,7035,45066,10425,7126,3299,10425,95200,2018
40051,38.9,54733,44714,1215,3127,14638,58177,19836,15416,4420,19836,125800,2018
40053,43.3,4418,3907,50,215,1201,56287,1825,1385,440,1825,78500,2018
40055,41.2,5943,4457,495,669,1257,38322,2041,1412,629,2041,71700,2018
40057,41,2721,1576,238,778,807,41607,1183,863,320,1183,62600,2018
40059,38,3847,2907,4,896,891,50114,1297,1075,222,1297,79500,2018
40061,40.6,12704,8996,92,549,3429,39375,4864,3623,1241,4864,89600,2018
40063,39,13460,8495,804,724,2769,39265,4073,3037,1036,4073,70800,2018
40065,34.2,25384,15989,1666,6035,6586,45757,9868,5607,4261,9868,99000,2018
40067,41.9,6223,4862,80,645,1554,37319,2367,1652,715,2367,62500,2018
40069,39.8,11041,7700,206,576,2856,40077,4300,3095,1205,4300,79100,2018
40071,38.6,44880,33666,979,3519,11134,45426,17703,12138,5565,17703,88800,2018
40073,36.2,15618,11982,165,2439,3989,60656,5694,4495,1199,5694,140500,2018
40075,43.1,9001,6709,314,1039,2377,38209,3772,2624,1148,3772,62100,2018
40077,41.3,10495,6879,101,376,2827,42363,4042,2847,1195,4042,86200,2018
40079,39.4,49909,35760,1034,3452,12986,39769,18367,13115,5252,18367,88400,2018
40081,41.2,34854,28763,626,1166,8955,49362,12821,10139,2682,12821,107700,2018
40083,37.8,46044,35765,3913,2754,11382,62035,15665,12467,3198,15665,160700,2018
40085,40.1,9933,7118,253,1507,2266,52007,3193,2501,692,3193,106400,2018
40087,38.4,38634,30694,373,3048,10694,64492,14159,11221,2938,14159,171700,2018
40089,38.8,32966,20673,2613,1934,8933,35829,12791,9109,3682,12791,81600,2018
40091,47.3,19819,13486,535,534,5582,37086,8413,6537,1876,8413,96000,2018
40093,41.1,7718,6574,27,723,2158,54118,3050,2433,617,3050,94700,2018
40095,42.6,16376,10737,241,2846,4353,45828,6240,4493,1747,6240,88000,2018
40097,40.3,40980,26684,193,1422,11363,48853,15838,11515,4323,15838,109900,2018
40099,43,13875,10065,220,894,3544,51490,5354,3724,1630,5354,120000,2018
40101,37.9,69084,38800,7369,4164,17545,42689,26078,17189,8889,26078,101900,2018
40103,41.6,11411,9298,20,416,3336,53253,4607,3366,1241,4607,95800,2018
40105,42.3,10383,6955,257,305,2821,41895,4084,3045,1039,4084,83500,2018
40107,40,12115,7442,919,472,2759,38527,3962,2861,1101,3962,75900,2018
40109,34.5,782051,440781,116092,133943,185912,52855,299232,175496,123736,299232,148000,2018
40111,39.1,38889,24310,3286,1552,9658,42175,14665,10362,4303,14665,82600,2018
40113,42.1,47311,30067,5322,1668,12466,47789,18165,14015,4150,18165,113400,2018
40115,38.1,31566,20605,308,1761,8088,39070,11965,8216,3749,11965,85100,2018
40117,41.9,16428,12630,151,497,4517,47413,6205,4707,1498,6205,91500,2018
40119,27.1,81512,62757,3230,3820,16492,40944,30485,15515,14970,30485,154000,2018
40121,40.6,44382,30914,1284,2200,11762,45346,17745,12873,4872,17745,102200,2018
40123,35.6,38358,25251,762,2013,9422,49235,14354,9323,5031,14354,125700,2018
40125,37.5,72000,52317,2388,3647,18022,47683,26003,17917,8086,26003,115900,2018
40127,44.6,11119,7952,98,415,2960,37457,4463,3366,1097,4463,78500,2018
40129,40.5,3708,3111,17,261,883,47667,1352,986,366,1352,113400,2018
40131,39,90814,65483,962,4169,25713,62949,34452,26942,7510,34452,157300,2018
40133,39.2,25071,16235,1174,1240,6298,38706,9222,6417,2805,9222,72900,2018
40135,41,41359,26077,730,1680,10973,38328,15376,10928,4448,15376,94600,2018
40137,40.5,43983,35377,748,3320,11488,46166,16955,12237,4718,16955,105500,2018
40139,32.1,21121,9475,910,9564,4371,50450,6725,4379,2346,6725,105900,2018
40141,41.2,7515,4497,607,1986,2009,40462,2954,2281,673,2954,53100,2018
40143,35.5,642781,401570,63780,80012,158959,53902,251176,148269,102907,251176,150500,2018
40145,38.7,77850,55917,2673,4643,21606,61566,28748,22543,6205,28748,154400,2018
40147,40.2,52001,38015,1350,3065,13892,52103,20667,14633,6034,20667,117100,2018
40149,38.9,11432,9546,131,1125,3023,52510,4363,3142,1221,4363,82600,2018
40151,33.9,9127,7593,210,648,2110,56899,3351,2328,1023,3351,98400,2018
40153,36.3,20967,16833,286,2619,5292,58706,7255,5162,2093,7255,119500,2018
41001,48.2,15984,14515,149,651,4319,43921,6927,4850,2077,6927,160900,2018
41003,32.9,89780,72347,867,6545,20069,58655,35056,19922,15134,35056,303200,2018
41005,41.4,405788,334006,3478,34659,107460,76597,155456,109646,45810,155456,369100,2018
41007,43.9,38562,33048,272,3260,9631,52583,15910,9818,6092,15910,268100,2018
41009,43.3,50851,45157,269,2534,12863,59714,19296,14313,4983,19296,240500,2018
41011,48.5,63308,54038,416,4041,16347,43308,26640,17261,9379,26640,188300,2018
41013,47.8,22337,19719,29,1691,6198,44524,9339,6604,2735,9339,213000,2018
41015,56.1,22507,19467,102,1563,6014,46396,10440,7293,3147,10440,251500,2018
41017,42.3,180640,158096,1010,14199,48879,63680,72471,47606,24865,72471,336400,2018
41019,47,108323,95400,471,6130,29377,45812,45026,30754,14272,45026,186700,2018
41021,49.6,1907,1677,0,119,524,42976,848,537,311,848,112900,2018
41023,52.6,7183,6578,22,263,1937,45357,3294,2317,977,3294,143100,2018
41025,46.1,7228,6257,37,365,2137,41797,3157,2327,830,3157,117600,2018
41027,39.1,23131,14764,124,7280,5624,62935,8539,5638,2901,8539,355100,2018
41029,42.7,214267,174091,1266,26868,55629,50851,87417,55116,32301,87417,261700,2018
41031,40.5,23143,13934,203,4622,5383,50339,7892,5488,2404,7892,204100,2018
41033,47.5,85481,74478,379,6246,23050,43046,35978,24021,11957,35978,251000,2018
41035,42.4,66310,51964,496,8413,17277,43522,27402,17484,9918,27402,162100,2018
41037,49.1,7843,6644,15,627,2120,36627,3494,2228,1266,3494,125300,2018
41039,39.4,368882,302936,3526,31986,88873,49958,150780,88435,62345,150780,246500,2018
41041,51.3,47881,39563,215,4340,12513,46061,21110,13614,7496,21110,233400,2018
41043,39.7,122870,104885,496,10910,31814,52097,47030,29910,17120,47030,200900,2018
41045,35.9,30431,18699,308,10175,6782,42478,10138,5974,4164,10138,135500,2018
41047,36.4,335553,220808,3888,88282,79533,56097,116861,69495,47366,116861,225800,2018
41049,38.4,11215,6714,21,4024,2927,55440,3959,2746,1213,3959,133900,2018
41051,37,798647,558805,42275,91130,175264,64337,321968,174421,147547,321968,361300,2018
41053,37.1,81427,63876,853,11126,20287,58344,29692,19415,10277,29692,242600,2018
41055,51.5,1605,1474,9,58,447,48056,736,476,260,736,148300,2018
41057,48,26076,22025,96,2695,6691,47500,10816,7472,3344,10816,240400,2018
41059,36.3,76898,51079,700,20313,18188,51887,26886,17138,9748,26886,158200,2018
41061,39.6,26028,23161,170,1225,6733,48617,10481,6714,3767,10481,181800,2018
41063,52.6,6924,6449,16,203,2051,44953,3165,2078,1087,3165,227700,2018
41065,40.9,25866,19408,82,4597,6705,50973,10266,6400,3866,10266,199700,2018
41067,36.5,581821,385997,11228,96240,146683,78010,216507,132359,84148,216507,360400,2018
41069,58.7,1426,1215,0,138,388,33456,661,485,176,661,143500,2018
41071,38.1,103820,80283,868,16438,25152,59484,36197,25168,11029,36197,274900,2018
42001,43.6,102023,91088,1400,7045,27805,64507,39221,30293,8928,39221,201900,2018
42003,40.8,1225561,965283,155719,24925,304137,58383,537960,348200,189760,537960,147700,2018
42005,46.3,66331,64441,591,492,18990,49032,27990,21344,6646,27990,103600,2018
42007,45.1,166896,149576,9724,2541,45585,55828,70817,51882,18935,70817,133600,2018
42009,46.2,48611,47045,262,575,13237,49146,19674,15698,3976,19674,128200,2018
42011,39.9,416642,301862,17424,84748,106646,61522,154467,110715,43752,154467,174200,2018
42013,43.4,123842,117242,1956,1508,33038,47969,51625,36221,15404,51625,120300,2018
42015,44.5,61304,58839,258,880,16685,51457,24812,18699,6113,24812,146200,2018
42017,43.8,626370,528976,24044,32238,168084,86055,237383,181712,55671,237383,323300,2018
42019,43.2,186566,176963,1622,2685,51529,68472,76240,57655,18585,76240,197600,2018
42021,45.1,134550,124880,4240,2125,35807,45901,56793,42013,14780,56793,90900,2018
42023,52.2,4686,4509,3,41,1229,41485,2232,1627,605,2232,75800,2018
42025,46,63931,58887,1149,2885,16854,53624,25739,19943,5796,25739,141600,2018
42027,31.7,161443,138021,5857,4680,32728,58055,57908,35807,22101,57908,220500,2018
42029,40.4,517156,412881,29564,37858,134073,96726,189592,142649,46943,189592,347000,2018
42031,41.2,38827,37298,370,334,10022,45625,15824,10914,4910,15824,114300,2018
42033,44.7,80216,74692,2029,2341,20686,47270,31349,24309,7040,31349,94000,2018
42035,38.8,39074,37217,566,577,9512,49234,14744,10238,4506,14744,130900,2018
42037,40.8,66220,61794,1165,1767,16458,49889,26582,18462,8120,26582,149100,2018
42039,42.9,86164,81753,1523,1084,23071,49144,35012,25558,9454,35012,110900,2018
42041,40.5,247433,213477,8772,9218,63457,68895,98877,69592,29285,98877,197900,2018
42043,39.8,274515,182277,49035,24440,70149,58916,111684,70603,41081,111684,165200,2018
42045,39,563527,380020,117905,20697,138777,71539,206405,142678,63727,206405,239600,2018
42047,46.9,30608,29827,160,241,8719,51112,13727,10634,3093,13727,99000,2018
42049,39.4,275972,233112,18972,11367,69095,49716,110050,72413,37637,110050,130000,2018
42051,44.8,132289,121580,5126,1503,34760,44476,54511,40293,14218,54511,97200,2018
42053,40.4,7351,4518,2159,466,951,38383,1631,1401,230,1631,89500,2018
42055,41.4,153751,135872,5535,8354,42164,59713,60210,42159,18051,60210,175600,2018
42057,45,14506,13954,297,76,4028,51259,5950,4679,1271,5950,156800,2018
42059,42,37144,34741,1124,562,9453,54121,14211,10537,3674,14211,114400,2018
42061,43.5,45421,41240,2345,858,11578,48597,16808,12715,4093,16808,126800,2018
42063,39.8,85755,80563,1816,1107,21537,46877,33892,23832,10060,33892,115500,2018
42065,43.9,44084,42865,213,383,12269,46818,18465,13937,4528,18465,99800,2018
42067,42.7,24562,23195,256,872,6549,52765,9404,7158,2246,9404,145300,2018
42069,42.3,211454,181500,5462,15071,52525,50875,86628,56308,30320,86628,149700,2018
42071,38.6,538347,443218,19391,55213,139910,63823,199889,135976,63913,199889,200400,2018
42073,45.1,87382,80451,3156,1200,24437,48860,36907,27298,9609,36907,106500,2018
42075,41.2,138674,114749,2826,17542,36955,59114,53281,37201,16080,53281,169200,2018
42077,39.2,362613,237655,19471,85446,92651,62178,138008,89479,48529,138008,200100,2018
42079,43,317884,262783,11360,35075,81294,51646,128054,87798,40256,128054,125400,2018
42081,41.4,114859,104011,5436,2278,29880,52407,45897,31852,14045,45897,152400,2018
42083,42.9,41806,39083,980,873,10806,46953,17169,12656,4513,17169,79800,2018
42085,44.6,112630,101580,6308,1621,29724,48768,46028,33572,12456,46028,119600,2018
42087,43.8,46362,44508,361,696,13045,47526,19094,13437,5657,19094,109900,2018
42089,42.8,167586,111965,22300,25830,40250,63931,56770,44118,12652,56770,167000,2018
42091,41.3,821301,625341,72945,41162,216309,88166,313949,225434,88515,313949,305800,2018
42093,43,18294,16775,321,171,4670,57183,7482,5144,2338,7482,181500,2018
42095,42.1,301778,233249,14691,38717,78154,67565,114123,81833,32290,114123,214200,2018
42097,44.4,92325,85698,2303,3006,25078,47063,39132,27743,11389,39132,115200,2018
42099,43,45924,43890,422,854,12750,62266,18091,14440,3651,18091,166200,2018
42101,34.3,1575522,545784,646234,227711,321389,43744,594778,315097,279681,594778,156800,2018
42103,47.7,55498,44791,3203,5911,15441,64247,21871,18173,3698,21871,187000,2018
42105,46.7,16937,16365,68,218,4320,42821,6523,5029,1494,6523,105500,2018
42107,44.2,143555,131191,3967,5870,38182,49190,58733,44275,14458,58733,97400,2018
42109,39.9,40466,38472,369,904,10539,57638,14716,10621,4095,14716,161400,2018
42111,45.9,74949,70744,1848,1104,20190,48224,29708,23245,6463,29708,104300,2018
42113,53.1,6177,5737,185,134,1613,47346,2721,2235,486,2721,151800,2018
42115,48.2,41340,39829,289,698,11518,53059,17347,13284,4063,17347,162500,2018
42117,44.3,41226,39669,264,520,10837,50667,16178,11903,4275,16178,138700,2018
42119,39.4,45114,38002,2757,2643,9764,56026,14739,10613,4126,14739,180200,2018
42121,46.5,52376,50245,408,567,14579,47982,21915,16557,5358,21915,85700,2018
42123,47,40035,38753,181,420,11120,48409,17080,13088,3992,17080,95400,2018
42125,44.5,207547,191657,6249,3417,55379,61567,84100,63609,20491,84100,162600,2018
42127,48.1,51536,46773,1522,2220,12474,54851,18739,15078,3661,18739,181000,2018
42129,46.8,354751,333282,8421,4055,100627,58866,151665,117485,34180,151665,148900,2018
42131,44.2,27588,26401,254,508,7301,59308,10784,8396,2388,10784,164000,2018
42133,41,444014,372226,23443,32028,118697,63902,171244,127920,43324,171244,173200,2018
44001,44.2,48900,45111,621,1421,12431,75578,19553,13617,5936,19553,345200,2018
44003,43.8,163861,145885,2513,7624,43169,70223,68833,48097,20736,68833,224600,2018
44005,45,83075,71280,2649,4693,21549,77237,35217,21849,13368,35217,375000,2018
44007,37.3,634533,390443,51578,141206,145967,55233,238171,127394,110777,238171,223600,2018
44009,44.5,126242,115008,1640,3914,32550,81301,49111,36608,12503,49111,328300,2018
45001,43.8,24657,16975,6761,347,6178,36685,9455,7210,2245,9455,89000,2018
45003,41,166926,110879,40865,9365,45455,50036,66710,47802,18908,66710,142200,2018
45005,40.2,9214,2050,6957,138,1951,24560,3350,2255,1095,3350,52100,2018
45007,40.7,195995,151856,30736,7128,51632,47906,76632,53781,22851,76632,137200,2018
45009,41.9,14600,5215,8923,291,3523,32229,5422,3884,1538,5422,71400,2018
45011,40.9,21577,10905,9838,512,5447,36566,8326,5805,2521,8326,79900,2018
45013,44.8,182658,123543,32668,20412,48251,63110,70607,50558,20049,70607,288900,2018
45015,36,209065,133331,49446,13505,53230,59995,74931,53760,21171,74931,174000,2018
45017,46,14713,7912,6076,540,3849,44534,6121,4958,1163,6121,104000,2018
45019,37.6,394708,253360,107050,19944,92179,61028,156482,95678,60804,156482,295600,2018
45021,38.7,56711,41353,11354,2392,11655,35836,20373,14080,6293,20373,95300,2018
45023,41.5,32326,18994,11912,633,7820,40080,12453,9376,3077,12453,90500,2018
45025,42.3,46024,27869,14803,1947,12486,40033,17977,12763,5214,17977,82400,2018
45027,44.3,34017,16168,16503,1036,8776,37525,13327,10175,3152,13327,93800,2018
45029,42.2,37568,21228,14374,1187,9821,36276,15145,11470,3675,15145,85100,2018
45031,41.4,67253,36901,27353,1338,16965,36254,26592,18534,8058,26592,87800,2018
45033,37.5,30871,14134,14403,841,7223,29362,10968,7106,3862,10968,72800,2018
45035,36.5,155474,100136,38865,8057,37620,61698,54549,38933,15616,54549,186300,2018
45037,42.7,26769,15123,9708,1559,6451,49200,9063,6615,2448,9063,126500,2018
45039,46.4,22712,8629,12710,471,5864,36294,8979,6617,2362,8979,102700,2018
45041,39,138561,72317,58560,3522,35246,45479,52051,34065,17986,52051,130400,2018
45043,49.2,61605,39233,19153,1885,17320,48071,25111,19359,5752,25111,187200,2018
45045,38.1,498402,342233,89068,44630,125950,56789,189334,125913,63421,189334,172100,2018
45047,39.4,70264,42043,22062,4209,18026,40982,27207,17465,9742,27207,117300,2018
45049,39.7,19807,8103,10539,788,4047,32453,6924,5113,1811,6924,73000,2018
45051,45.2,320915,247646,43370,19290,83150,48279,128586,91039,37547,128586,172500,2018
45053,39.5,27900,11774,12015,3684,7247,41930,9982,6836,3146,9982,154400,2018
45055,41.7,64361,44372,15253,2690,17371,49392,24833,20404,4429,24833,124700,2018
45057,42,89546,62788,18978,4692,22856,55223,32632,25516,7116,32632,182400,2018
45059,41.1,66710,45321,16370,3119,17357,41578,25373,17864,7509,25373,91300,2018
45061,41.9,17606,5693,11292,423,4093,31651,6357,4656,1701,6357,73300,2018
45063,39,286316,215302,41302,16998,75479,59593,111265,82289,28976,111265,151900,2018
45065,53.9,9606,4802,4483,63,2634,42262,3967,3040,927,3967,117700,2018
45067,40.4,31562,12193,17860,880,7616,33046,11538,8146,3392,11538,76700,2018
45069,40.3,27131,10629,13696,896,6407,34203,9584,6303,3281,9584,64000,2018
45071,41.5,38068,22808,11997,2797,9967,42765,14939,10908,4031,14939,100000,2018
45073,45.3,76696,64850,5366,4083,21401,46056,31818,22981,8837,31818,155200,2018
45075,39.6,88454,29404,54253,1917,20033,36188,32966,22427,10539,32966,93200,2018
45077,36.2,122746,105401,8123,4377,30055,47024,47375,32019,15356,47375,138900,2018
45079,33.2,408263,174911,188510,20733,90375,53922,150309,88450,61859,150309,158200,2018
45081,41.9,20299,11763,5069,3165,5356,44486,7211,5313,1898,7211,107700,2018
45083,38.2,302195,207276,61317,20137,78311,50179,114640,79791,34849,114640,133700,2018
45085,36.3,106995,48574,50218,4147,27915,43792,41137,26608,14529,41137,113900,2018
45087,43.8,27644,17919,8537,402,7894,40120,11544,8004,3540,11544,77300,2018
45089,42.1,31794,9921,20476,727,8270,32351,12411,9261,3150,12411,66700,2018
45091,38.5,258641,183136,49180,13788,69043,62431,98155,70219,27936,98155,186000,2018
46003,38.3,2759,2434,31,200,713,59293,1161,871,290,1161,78300,2018
46005,37.3,18374,14249,143,1803,4720,51700,7770,5201,2569,7770,101000,2018
46007,29,3437,1155,2,286,751,48348,985,624,361,985,75700,2018
46009,42.8,6969,6056,104,195,1504,54450,2536,1888,648,2536,82300,2018
46011,26.7,34239,30973,485,1011,6864,56370,12764,7544,5220,12764,172300,2018
46013,36.9,38840,34071,824,1027,9888,56455,16184,10673,5511,16184,157900,2018
46015,41,5256,4440,1,138,1465,50839,2221,1401,820,2221,140600,2018
46017,25.8,2053,252,3,66,425,32500,564,259,305,564,49600,2018
46019,40.5,10177,9323,68,361,2635,44387,4178,3138,1040,4178,130900,2018
46021,51.3,1435,1420,0,4,396,52500,658,580,78,658,65300,2018
46023,35.9,9344,5888,7,311,2042,46389,3144,2206,938,3144,102200,2018
46025,41.3,3673,3449,1,111,927,47798,1536,1191,345,1536,88700,2018
46027,25,13925,12213,133,396,2697,43189,5223,2669,2554,5223,157600,2018
46029,38.8,27993,26027,168,638,7342,54774,11974,7897,4077,11974,168500,2018
46031,28.7,4168,1212,19,16,871,35441,1186,623,563,1186,57500,2018
46033,54.3,8573,7762,33,269,2848,55472,3941,3249,692,3941,216800,2018
46035,38.8,19901,18110,160,568,5274,47772,8687,5165,3522,8687,150100,2018
46037,48,5506,4745,0,117,1653,44145,2599,1907,692,2599,92900,2018
46039,44.4,4306,4169,0,126,1232,57930,1799,1437,362,1799,118500,2018
46041,27.8,5779,1166,6,58,1174,43954,1667,964,703,1667,63600,2018
46043,47.3,2930,2775,0,19,912,57419,1250,988,262,1250,84500,2018
46045,43.1,3940,3811,4,70,1054,68551,1563,1292,271,1563,103100,2018
46047,51.3,6774,5750,21,275,1888,50837,3119,2384,735,3119,121100,2018
46049,48.1,2322,2206,1,30,537,53889,902,723,179,902,86400,2018
46051,43.5,7217,6692,11,161,2137,62532,3212,2694,518,3212,125700,2018
46053,45.5,4201,3696,0,27,1144,44479,1845,1334,511,1845,74300,2018
46055,46.5,2082,1951,1,19,648,37420,909,727,182,909,86900,2018
46057,35.2,6000,5623,15,260,1644,65050,2215,1736,479,2215,129800,2018
46059,47.3,3301,3230,3,26,972,52438,1518,1048,470,1518,118700,2018
46061,36.3,3397,3384,0,0,785,63036,1069,947,122,1069,118600,2018
46063,42.7,1311,1193,27,26,387,57365,548,379,169,548,97100,2018
46065,38,17617,14565,56,541,4170,63564,7479,4979,2500,7479,174900,2018
46067,43.8,7315,6928,0,166,1916,54868,2862,2225,637,2862,84700,2018
46069,51,1331,1128,16,9,366,54891,598,474,124,598,78000,2018
46071,30.6,3287,1286,3,19,647,33438,884,535,349,884,54900,2018
46073,50.6,2029,1951,0,37,543,49519,917,676,241,917,79600,2018
46075,55.9,735,725,0,0,220,41103,403,324,79,403,78600,2018
46077,45.6,4967,4814,0,108,1443,59375,2296,1824,472,2296,105800,2018
46079,43.2,12574,11763,42,194,3061,59232,4675,3443,1232,4675,157200,2018
46081,41.9,25234,22980,211,805,6334,52245,11022,7232,3790,11022,203000,2018
46083,34.6,54914,51261,638,1099,14396,81422,19294,14946,4348,19294,218400,2018
46085,36,3869,2169,3,93,981,53263,1404,951,453,1404,86600,2018
46087,40,5511,5184,42,192,1572,62234,2209,1628,581,2209,124200,2018
46089,50,2364,2250,1,15,616,43804,1012,811,201,1012,56300,2018
46091,39.7,4895,4023,23,455,1210,63594,1862,1344,518,1862,113900,2018
46093,36.2,27424,24066,531,1156,7617,59218,10912,8056,2856,10912,180500,2018
46095,33,2055,832,0,102,487,31222,668,434,234,668,44500,2018
46097,44.1,2229,2122,21,44,638,51394,973,772,201,973,75000,2018
46099,34.7,186749,154609,9969,9067,46150,60028,75049,47770,27279,75049,173400,2018
46101,40.4,6506,5007,6,276,1728,58167,2636,1959,677,2636,125300,2018
46102,25.3,14335,615,12,562,2273,30347,2820,1485,1335,2820,20700,2018
46103,38.6,109294,87703,1146,5436,27535,55024,43598,30007,13591,43598,179900,2018
46105,47,2907,2777,0,46,831,56850,1285,942,343,1285,91200,2018
46107,51.3,2326,2157,0,68,625,53600,998,815,183,998,89800,2018
46109,38.5,10285,5850,63,342,2566,50495,3824,2604,1220,3824,102300,2018
46111,43.1,2388,2250,0,87,707,54899,1051,744,307,1051,76700,2018
46115,43.3,6543,6135,5,200,1653,52729,2635,1951,684,2635,79800,2018
46117,41.2,2997,2527,0,72,992,71763,1264,1023,241,1264,165800,2018
46119,45.5,1331,1270,0,18,368,64028,567,467,100,567,150400,2018
46121,24.3,10146,834,18,437,1903,24257,2703,1181,1522,2703,33500,2018
46123,46.4,5468,4465,0,11,1527,51027,2406,1763,643,2406,89400,2018
46125,43,8264,7892,27,189,2324,55380,3470,2706,764,3470,115000,2018
46127,40.6,15177,14045,128,456,4208,69563,6463,4570,1893,6463,172400,2018
46129,43,5510,4359,262,115,1333,52123,2296,1724,572,2296,82900,2018
46135,41.8,22717,20180,346,953,5927,54694,9359,6105,3254,9359,142700,2018
46137,31.6,2814,663,0,11,589,37143,744,427,317,744,56900,2018
47001,43.3,75775,67691,2470,2120,20273,49376,30483,20729,9754,30483,139800,2018
47003,37.5,47558,36770,3418,5709,12394,48945,16882,11512,5370,16882,140500,2018
47005,47.4,16112,14980,511,277,4024,33125,6786,5153,1633,6786,85800,2018
47007,44.5,14602,12967,659,326,3530,42889,4853,3600,1253,4853,129400,2018
47009,43.4,128443,117121,3299,4180,34664,54140,50159,37685,12474,50159,174600,2018
47011,39.5,104557,89794,4941,6217,27222,48140,39840,26202,13638,39840,154100,2018
47013,43.8,39687,38322,128,490,11104,38170,16172,11360,4812,16172,97200,2018
47015,42,13976,13167,234,300,3847,49523,5513,4043,1470,5513,155300,2018
47017,42.9,28018,23744,2853,715,7436,40810,11062,8057,3005,11062,87100,2018
47019,44.9,56391,53562,850,1013,15387,36589,23594,16482,7112,23594,119600,2018
47021,40.4,39929,37178,550,1140,10832,58641,14952,11540,3412,14952,176400,2018
47023,37.5,17150,14693,1771,188,4421,45667,5958,4528,1430,5958,114400,2018
47025,43,31613,30174,346,394,8617,36077,13238,9312,3926,13238,107500,2018
47027,48.8,7686,7258,262,52,2061,31487,3173,2375,798,3173,88700,2018
47029,44.9,35336,32999,585,807,9225,33614,14181,9677,4504,14181,111000,2018
47031,40.1,54531,48544,1332,2283,14686,47998,21626,14575,7051,21626,127200,2018
47033,40.4,14499,10755,1911,1515,3540,42047,5335,3707,1628,5335,98900,2018
47035,50.7,58634,55422,328,1731,17266,43893,25347,19783,5564,25347,143000,2018
47037,34.3,684017,384650,185754,69634,155835,56507,277903,150399,127504,277903,219900,2018
47039,45.8,11683,10722,438,198,3131,40233,4623,3536,1087,4623,94700,2018
47041,41.2,19601,17312,266,1574,5273,44134,7487,5163,2324,7487,137800,2018
47043,39.4,51988,46632,2150,1783,12762,50549,18978,13849,5129,18978,156600,2018
47045,40.1,37576,30110,4806,1254,10766,43762,15180,9432,5748,15180,99100,2018
47047,45.4,39692,27057,10857,1034,11424,59017,15410,12277,3133,15410,191200,2018
47049,45,17994,17386,30,269,5064,35084,7403,5675,1728,7403,100400,2018
47051,41.9,41512,36770,1971,1362,11155,49038,16431,12222,4209,16431,128900,2018
47053,40.1,49175,37770,8685,1317,12989,41886,19223,13345,5878,19223,94900,2018
47055,43.4,29167,24603,2877,663,7883,47528,11496,8083,3413,11496,123300,2018
47057,44.6,23013,21760,94,742,6593,42997,8948,7012,1936,8948,113500,2018
47059,44.5,68669,64004,1314,1919,18208,40138,27244,19867,7377,27244,118500,2018
47061,43.2,13331,11150,89,164,3534,36987,4838,3741,1097,4838,83100,2018
47063,40.4,63740,52050,2227,7374,16485,42589,24411,16205,8206,24411,132200,2018
47065,39.6,357546,254697,68493,19538,85591,53035,140890,89940,50950,140890,171400,2018
47067,44.6,6585,6384,37,55,1778,28990,2809,2231,578,2809,88800,2018
47069,40.5,25562,13930,10615,442,6006,38651,8907,6464,2443,8907,86200,2018
47071,45.3,25771,23658,1082,642,7241,39798,10267,7535,2732,10267,115800,2018
47073,44.6,56402,53692,794,841,15861,40335,23330,17187,6143,23330,118600,2018
47075,40.4,17779,7853,9005,779,4722,38362,7100,4287,2813,7100,102200,2018
47077,41.4,27859,24398,2174,625,7039,42430,10671,7880,2791,10671,93500,2018
47079,45.4,32279,28216,2736,803,9138,40837,13406,10250,3156,13406,101200,2018
47081,40.8,24678,22313,1230,596,5807,41998,8667,7022,1645,8667,111300,2018
47083,43.7,8176,7531,320,50,1972,43964,2943,2325,618,2943,98300,2018
47085,41.6,18318,16975,381,436,4233,41510,6858,5246,1612,6858,104200,2018
47087,46.6,11615,11094,79,234,2918,36703,4543,3447,1096,4543,107000,2018
47089,43.4,53247,49176,961,1908,14040,47264,19910,14769,5141,19910,142200,2018
47091,46.1,17789,16496,584,352,4579,34151,6858,5322,1536,6858,118700,2018
47093,37.3,456185,376585,39963,18777,113989,54437,183318,118293,65025,183318,174700,2018
47095,40.2,7526,5026,2180,169,1469,34966,2203,1262,941,2203,74500,2018
47097,38.2,26297,15976,8804,642,6777,37915,9754,5625,4129,9754,84100,2018
47099,39.4,42937,40235,746,892,11378,41553,16131,11955,4176,16131,103200,2018
47101,43.9,11956,11170,195,268,3331,37139,4758,3719,1039,4758,89700,2018
47103,43.1,33711,29347,2342,1154,9232,45736,13636,9990,3646,13636,124000,2018
47105,47.5,51610,45436,502,4393,14601,56078,20215,15513,4702,20215,199400,2018
47107,42.7,52773,47177,1963,2041,13485,41398,20427,15174,5253,20427,125300,2018
47109,42.9,25903,23306,1520,529,6694,36055,10022,7294,2728,10022,93600,2018
47111,39.4,23487,21643,72,1212,6512,36246,9202,6743,2459,9202,112500,2018
47113,38.2,97682,54942,36271,3692,24941,46223,37729,23561,14168,37729,127100,2018
47115,43.1,28417,26118,603,498,8256,48024,11582,8644,2938,11582,123500,2018
47117,39,32269,27495,2367,1643,8628,49370,12335,8726,3609,12335,124700,2018
47119,38.8,89776,71404,10376,5086,23905,54249,33572,23030,10542,33572,170400,2018
47121,44.7,11962,11279,236,241,3318,43250,4790,3842,948,4790,123400,2018
47123,43.6,45876,41804,935,1975,12478,38327,17694,13444,4250,17694,122600,2018
47125,30.6,196387,125395,37580,19483,50316,55972,70303,41672,28631,70303,159500,2018
47127,45.3,6322,5886,84,13,1903,52294,2602,2159,443,2602,168300,2018
47129,41.1,21596,20134,1091,273,5464,40166,7517,5976,1541,7517,98400,2018
47131,43,30520,25386,3039,1285,8534,39866,12715,8644,4071,12715,89200,2018
47133,42.9,22004,21174,139,304,5956,36558,8974,7132,1842,8974,115300,2018
47135,43,7912,7296,274,192,2352,34634,3317,2645,672,3317,83400,2018
47137,49.7,5088,5031,26,27,1617,41004,2218,1807,411,2218,151900,2018
47139,45.3,16782,15961,37,335,5010,41818,7096,5238,1858,7096,113800,2018
47141,36.3,76440,67691,1703,4721,19330,40888,31110,18879,12231,31110,155700,2018
47143,40.2,32628,29557,727,1614,8052,39451,12342,8672,3670,12342,113500,2018
47145,46.3,52897,49154,1282,940,13930,50003,20963,16071,4892,20963,138100,2018
47147,39.1,69344,58035,4830,4673,19578,61774,25388,19033,6355,25388,176300,2018
47149,33.3,307128,220085,43527,23900,76810,63846,109468,71672,37796,109468,190200,2018
47151,38.9,21954,21370,116,195,5938,35453,8703,6003,2700,8703,90400,2018
47153,43.3,14730,13805,28,517,4174,51750,5441,4156,1285,5441,141500,2018
47155,42.7,96287,87002,692,5612,25609,45943,36945,25177,11768,36945,168600,2018
47157,35.4,937005,338174,499489,58537,218784,49782,350260,193879,156381,350260,142300,2018
47159,40.7,19458,18100,512,511,5346,46404,7584,5634,1950,7584,132100,2018
47161,44.5,13301,12251,139,370,3596,42269,5246,3823,1423,5246,125500,2018
47163,44.9,156734,146608,2873,2867,43087,43442,66239,47698,18541,66239,133900,2018
47165,39.6,179473,152093,12587,8434,47700,64631,65645,48213,17432,65645,212100,2018
47167,37.5,61446,46642,11092,1675,16385,60167,21325,14990,6335,21325,145800,2018
47169,36,9573,8087,911,65,2010,52864,3054,2288,766,3054,133200,2018
47171,46.6,17780,16614,65,824,4983,39851,7521,5354,2167,7521,131000,2018
47173,42.3,19293,18602,86,303,5381,41352,7126,5314,1812,7126,120000,2018
47175,47.1,5704,5476,13,58,1551,37127,2163,1799,364,2163,92800,2018
47177,40.2,40454,34601,569,3612,10190,37715,15655,10858,4797,15655,108200,2018
47179,39.9,127055,112918,5084,4273,33033,46752,53190,34440,18750,53190,159400,2018
47181,42.9,16649,15001,1136,335,4151,38634,5954,4799,1155,5954,105600,2018
47183,38.4,33626,29247,2908,814,8683,38566,13605,9042,4563,13605,96000,2018
47185,43.1,26580,24876,534,654,7012,40745,9951,8024,1927,9951,110300,2018
47187,39.2,218648,185913,9220,10357,60827,109026,75344,60699,14645,75344,417700,2018
47189,40.2,132663,113507,9253,5372,37004,71513,48841,37523,11318,48841,243400,2018
48001,39.1,57863,34312,12127,10142,11463,43355,16459,11674,4785,16459,92900,2018
48003,31.2,17818,7215,321,9979,4146,74233,5508,4024,1484,5508,135600,2018
48005,37.2,87607,53216,12834,19174,22083,47714,30783,20440,10343,30783,100600,2018
48007,49.6,24763,16691,365,6756,5992,44865,9432,7344,2088,9432,158400,2018
48009,44.5,8789,7772,76,727,2435,64476,3332,2804,528,3332,133500,2018
48011,46.3,1916,1737,7,131,563,66563,708,569,139,708,137700,2018
48013,35.4,48828,16541,124,31200,11493,55265,15387,11583,3804,15387,100200,2018
48015,40.7,29565,18525,2576,7819,8260,65365,11041,8427,2614,11041,188900,2018
48017,33.5,7092,2346,46,4558,1564,46485,2111,1655,456,2111,68600,2018
48019,52.1,21763,17032,172,4010,5807,53683,8242,6925,1317,8242,167600,2018
48021,38.6,82577,43757,6097,30389,18337,62941,25345,19630,5715,25345,160100,2018
48023,47.3,3591,3050,112,370,995,40750,1474,1051,423,1474,70500,2018
48025,35.4,32691,10392,2535,19152,6151,42032,8537,5449,3088,8537,88200,2018
48027,30.8,342236,158804,72677,83630,83714,54184,120241,65252,54989,120241,141200,2018
48029,33.4,1925865,539435,136411,1155505,421737,55456,632574,372033,260541,632574,152400,2018
48031,49.9,11279,8712,2,2173,3195,63071,4297,3346,951,4297,235700,2018
48033,42.5,665,595,0,56,187,81985,261,196,65,261,113100,2018
48035,46.7,18122,14167,280,3263,5230,50882,7088,5534,1554,7088,110600,2018
48037,38.1,93858,60017,22765,7098,22841,47505,33731,21525,12206,33731,113300,2018
48039,35.6,353999,170322,47228,106731,88295,79270,118762,85302,33460,118762,173900,2018
48041,26.2,219193,122867,22279,55519,43877,46839,79053,36492,42561,79053,186000,2018
48043,43.3,9216,4722,21,4099,2262,43894,3942,2285,1657,3942,134300,2018
48045,46.3,1546,885,38,545,420,42647,632,470,162,632,65400,2018
48047,32.7,7180,400,4,6741,1476,27378,2052,1281,771,2052,64000,2018
48049,41.3,37834,27253,1340,8299,9450,45457,14016,10130,3886,14016,97500,2018
48051,42.6,17863,11617,2240,3657,4555,56235,6754,5390,1364,6754,109800,2018
48053,44.2,45750,33745,831,10120,12285,59238,16849,12690,4159,16849,182600,2018
48055,35.4,41401,16686,2425,21312,9469,52278,13225,8722,4503,13225,127800,2018
48057,37.7,21807,9314,528,10564,5185,55469,7604,5382,2222,7604,115000,2018
48059,42.9,13770,11900,66,1300,3345,44602,5319,4402,917,5319,89000,2018
48061,31.5,421750,38334,1673,377439,97344,37132,123185,82110,41075,123185,83300,2018
48063,38.7,12813,7176,2122,3159,3395,42604,4692,3366,1326,4692,87500,2018
48065,40.3,6032,5186,78,600,1607,70087,2247,1875,372,2247,111100,2018
48067,43.4,30087,22983,5177,1335,8409,45345,11789,9206,2583,11789,86200,2018
48069,35.3,7787,2523,70,5003,1741,45000,2532,1495,1037,2532,81900,2018
48071,35.4,40292,27186,3158,8793,10459,76850,13529,11354,2175,13529,185700,2018
48073,37.8,51903,31641,7008,11855,13001,46044,17940,12890,5050,17940,100700,2018
48075,30.9,7226,4172,552,2241,1471,40794,2235,1311,924,2235,80000,2018
48077,46.2,10387,9356,59,616,2778,51191,4045,3436,609,4045,90200,2018
48079,34.5,2904,1068,96,1684,692,42798,996,779,217,996,34100,2018
48081,50.3,3275,2475,20,698,1024,45551,1617,1210,407,1617,79100,2018
48083,46.5,8391,6463,254,1465,2262,43981,3460,2465,995,3460,70000,2018
48085,36.6,944350,547403,88702,143369,245934,94192,331336,217364,113972,331336,288900,2018
48087,39.2,2996,1878,195,834,776,42750,1055,813,242,1055,51800,2018
48089,42.5,21022,11855,2655,6200,5247,49504,7511,6141,1370,7511,116300,2018
48091,42,135097,91969,2544,36612,36247,75356,48903,36714,12189,48903,262400,2018
48093,44.8,13495,9438,87,3729,3676,47893,5260,4171,1089,5260,101400,2018
48095,41.9,4233,1706,89,2372,594,43355,873,616,257,873,93500,2018
48097,40.4,39571,29979,967,7043,10799,57646,15368,10380,4988,15368,145700,2018
48099,31.5,75389,44478,9991,13631,16097,51440,22314,12968,9346,22314,110100,2018
48101,37.9,1623,867,243,382,413,34375,686,444,242,686,41500,2018
48103,32.4,4839,1548,189,3080,1107,70398,1422,1226,196,1422,91900,2018
48105,35.9,3633,1295,32,2306,989,51152,1388,989,399,1388,79900,2018
48107,38.1,5861,2330,210,3261,1421,37899,2044,1451,593,2044,57800,2018
48109,43,2241,534,3,1646,430,33417,681,460,221,681,56900,2018
48111,31.6,7243,3655,63,3260,1714,51250,2404,1514,890,2404,82800,2018
48113,33.3,2586552,765816,572790,1033000,596110,56854,917276,459974,457302,917276,161500,2018
48115,33,12964,4630,763,7402,2965,44657,4322,3080,1242,4322,67300,2018
48117,32,18899,4781,144,13659,4421,51841,6139,3885,2254,6139,91800,2018
48119,42.3,5215,4232,391,380,1427,46138,2015,1498,517,2015,78400,2018
48121,35.2,807047,484341,74946,155047,200447,83376,283250,182646,100604,283250,255300,2018
48123,40.9,20435,11271,1865,7132,5136,53779,7088,5329,1759,7088,106200,2018
48125,43.9,2216,1463,68,673,518,41618,842,614,228,842,54100,2018
48127,33.7,10663,1008,5,9244,2249,27832,3309,2394,915,3309,73800,2018
48129,41.6,3387,2749,166,373,798,43224,1290,966,324,1290,69500,2018
48131,36.1,11355,1028,191,10135,2519,37382,3511,2228,1283,3511,49800,2018
48133,42.4,18270,14532,550,2963,3830,35325,6460,4890,1570,6460,68500,2018
48135,30.3,158342,52830,6704,94453,36123,60676,51954,34099,17855,51954,133900,2018
48137,49.3,2055,859,0,1194,424,40313,686,560,126,686,75300,2018
48139,36.1,168838,104141,15820,43737,43797,72213,55840,40760,15080,55840,172900,2018
48141,32,837654,102112,25430,690189,195000,44597,265724,163218,102506,265724,119100,2018
48143,30,41482,31082,674,8671,8832,48819,13961,8991,4970,13961,146000,2018
48145,39.3,17299,8878,4153,3987,3494,38032,5237,3864,1373,5237,66200,2018
48147,41.9,34175,27018,2133,3752,8381,50761,12231,8957,3274,12231,113200,2018
48149,47,25066,17917,1592,5212,6350,56297,9067,7303,1764,9067,165000,2018
48151,44.4,3883,2492,114,1185,1031,46827,1649,1222,427,1649,60100,2018
48153,36.9,5872,2184,164,3429,1698,48555,2328,1671,657,2328,63900,2018
48155,49.3,1408,1095,25,288,365,46354,557,466,91,557,45200,2018
48157,36,739342,249314,149334,179653,189308,95561,230381,178984,51397,230381,251100,2018
48159,43,10679,8460,408,1515,2791,52944,3806,2930,876,3806,137300,2018
48161,40.4,19709,13225,3103,2984,4960,48731,6865,5163,1702,6865,98800,2018
48163,31.4,19394,3035,757,15279,3502,42476,4624,3153,1471,4624,75300,2018
48165,27.9,20321,11299,391,8375,4455,59032,5737,4440,1297,5737,122800,2018
48167,37.5,327089,188666,40398,79406,82900,69369,119181,78968,40213,119181,185100,2018
48169,39,6288,2562,267,3272,1327,55039,1628,1044,584,1628,76400,2018
48171,50.3,26208,19653,19,6006,7462,58325,10717,7854,2863,10717,276100,2018
48173,36,1430,804,0,626,366,75833,432,294,138,432,221700,2018
48175,46,7531,4396,372,2699,1922,60492,2681,2259,422,2681,128900,2018
48177,36.5,20667,8667,1356,10436,5232,53006,7214,4923,2291,7214,112200,2018
48179,36.6,22685,14504,1007,6465,5185,47170,8000,5963,2037,8000,77600,2018
48181,39.9,128560,97457,6842,16817,32759,54370,47957,32331,15626,47957,125000,2018
48183,35.4,123494,71387,24767,22916,30084,49287,45532,27006,18526,45532,132000,2018
48185,40.3,27630,16163,4165,6616,6231,50298,8793,6794,1999,8793,124500,2018
48187,36.7,155137,78655,11140,58462,40509,70931,53107,40707,12400,53107,183900,2018
48189,33.1,34113,11669,1486,20153,7899,47080,11146,6746,4400,11146,80300,2018
48191,43.5,3074,1729,239,1057,856,32921,1301,794,507,1301,48200,2018
48193,46,8269,7004,42,1019,2178,47500,3108,2517,591,3108,127000,2018
48195,34.3,5547,2911,3,2618,1389,39229,1855,1357,498,1855,97400,2018
48197,42.4,3952,2693,271,851,1015,42238,1519,1112,407,1519,38100,2018
48199,39,56379,48896,3169,3142,14822,59105,20385,16332,4053,20385,120000,2018
48201,33.3,4602523,1384032,855008,1958963,1081602,60146,1583486,865645,717841,1583486,165300,2018
48203,37.9,66645,42414,14084,8627,16940,51202,23217,17095,6122,23217,124600,2018
48205,39.1,5767,3390,492,1524,1276,59280,1681,1069,612,1681,160000,2018
48207,42.4,5809,3758,192,1665,1463,46013,2125,1618,507,2125,51400,2018
48209,31.6,204150,111288,7421,78334,46216,65935,70881,43830,27051,70881,222300,2018
48211,35.2,4061,2502,34,1455,1033,63778,1323,841,482,1323,135000,2018
48213,43.9,80460,63153,5080,10072,21782,45798,30885,23583,7302,30885,102500,2018
48215,29.1,849389,54299,3619,781681,191857,38398,234879,159967,74912,234879,84000,2018
48217,42.1,35399,25039,2279,7247,9091,48823,12769,9399,3370,12769,98700,2018
48219,33.5,23162,10948,769,10970,5708,48116,7946,5577,2369,7946,88800,2018
48221,46.7,56901,48047,466,7026,15284,59049,21969,16819,5150,21969,180900,2018
48223,39.5,36240,26657,2523,6043,9844,51877,13405,9365,4040,13405,100100,2018
48225,44,22955,14185,5676,2511,5251,34297,8209,5660,2549,8209,84500,2018
48227,36.6,36667,18015,2027,15394,7388,51528,11036,7350,3686,11036,93100,2018
48229,37.6,4098,720,49,3212,651,29318,900,683,217,900,46000,2018
48231,37.8,92152,66540,7297,14595,22094,51928,32369,22446,9923,32369,114500,2018
48233,37.3,21571,15250,474,4959,5051,50651,7191,5819,1372,7191,77300,2018
48235,44.1,1524,1086,54,374,430,54706,634,499,135,634,137500,2018
48237,39.7,8842,6854,415,1465,2217,51700,3160,2584,576,3160,83000,2018
48239,38.5,14820,8717,947,4873,3680,60276,5237,3566,1671,5237,103300,2018
48241,40.9,35504,26471,5833,2360,8462,46088,12583,9650,2933,12583,104600,2018
48243,54.8,2234,1422,18,727,571,53194,1050,850,200,1050,112900,2018
48245,36,255210,104869,85589,51461,60264,48463,94002,57625,36377,94002,107800,2018
48247,34.7,5282,371,2,4890,1177,32049,1710,1237,473,1710,66800,2018
48249,34.8,41192,7432,254,33060,9394,42005,13043,8916,4127,13043,76300,2018
48251,36.8,163475,119128,4982,34048,43042,62066,56433,41781,14652,56433,144700,2018
48253,38.5,19891,10613,2842,5447,3874,45694,5593,4101,1492,5593,75400,2018
48255,34.7,15387,5645,1218,8304,2778,52252,4246,3108,1138,4246,97800,2018
48257,35.6,118910,77641,12799,24531,28931,65390,37364,28509,8855,37364,161600,2018
48259,42.1,41982,30601,286,9894,10560,82390,14159,10320,3839,14159,326800,2018
48261,39.5,595,72,0,522,154,36125,209,71,138,209,31400,2018
48263,51.8,749,613,8,122,176,45926,318,223,95,318,39700,2018
48265,47.7,51365,35484,759,13702,13896,52473,20766,14970,5796,20766,170600,2018
48267,52.9,4408,3193,1,1114,1350,42500,1948,1480,468,1948,165000,2018
48269,46.5,228,190,0,38,53,65125,91,34,57,91,38300,2018
48271,41.7,3675,1375,3,2297,681,31468,1170,868,302,1170,72800,2018
48273,28,31425,6419,907,22849,6728,42021,10946,5689,5257,10946,88200,2018
48275,39.5,3733,2191,213,1269,926,46146,1330,1122,208,1330,43800,2018
48277,40.8,49532,37005,6135,3804,13117,43562,19313,12552,6761,19313,94800,2018
48279,36,13262,5252,442,7325,3337,43396,4754,3345,1409,4754,64700,2018
48281,42.2,20640,14980,903,4025,5691,58194,7738,5849,1889,7738,142900,2018
48283,33.8,7409,1125,94,6104,1563,51792,2216,1515,701,2216,81600,2018
48285,43.5,19941,14734,1255,3694,5602,53021,7756,5820,1936,7756,155600,2018
48287,41.5,16952,10773,1889,3970,4574,55000,6104,4812,1292,6104,125700,2018
48289,45,17098,13048,1174,2457,4198,44818,6249,4907,1342,6249,110100,2018
48291,35.7,81862,52825,8062,19098,18670,49850,26203,19501,6702,26203,101200,2018
48293,40,23515,13816,4058,5101,5817,42680,8169,6116,2053,8169,90000,2018
48295,34.9,3469,2252,18,1051,900,57372,1256,926,330,1256,86300,2018
48297,42.2,12123,6847,336,4782,2509,55766,3675,2970,705,3675,94700,2018
48299,57.6,20640,17880,26,2113,5757,52178,8491,6791,1700,8491,186100,2018
48301,55.4,102,83,0,16,21,81875,33,21,12,33,NA,2018
48303,30.7,301454,162667,20528,105514,70124,50473,112185,61951,50234,112185,130800,2018
48305,38.2,5808,2852,61,2751,1589,43524,2133,1467,666,2133,79300,2018
48307,44.6,8098,4945,148,2587,2126,45329,3255,2435,820,3255,85600,2018
48309,33.2,248429,139766,35575,64733,59206,48199,89034,52210,36824,89034,133400,2018
48311,40.2,662,326,0,332,174,68750,223,163,60,223,106600,2018
48313,34.7,14128,7815,2111,3230,2864,49428,4201,3093,1108,4201,112800,2018
48315,50.1,10083,7142,2361,406,2767,37283,4459,3498,961,4459,93000,2018
48317,32.2,5614,2978,48,2574,1208,69722,1626,1250,376,1626,133100,2018
48319,46.9,4161,3029,1,978,1004,40708,1667,1184,483,1667,163600,2018
48321,37.8,36743,16330,3587,15441,8893,45500,13636,9313,4323,13636,107500,2018
48323,29.6,57970,1439,236,55206,13209,38035,16307,10766,5541,16307,94800,2018
48325,39.3,49334,21679,1157,25470,11486,61059,15470,12349,3121,15470,139800,2018
48327,49.1,2123,1319,14,728,583,40606,992,634,358,992,57000,2018
48329,31.7,164194,75960,9934,72325,39133,78888,55980,37361,18619,55980,197400,2018
48331,41.3,24664,15426,2093,6459,6424,47081,9381,6432,2949,9381,97100,2018
48333,50.6,4902,3901,10,968,1108,41827,1750,1427,323,1750,123400,2018
48335,34.1,8558,4159,847,3381,1622,49670,2441,1899,542,2441,70000,2018
48337,43.4,19409,16694,120,2111,5614,51774,7995,5680,2315,7995,112700,2018
48339,36.9,554445,370662,25296,131147,143989,77416,192823,137540,55283,192823,223900,2018
48341,30.2,21801,7174,627,11973,4840,51527,6626,4302,2324,6626,115100,2018
48343,43,12424,8046,2927,1176,3455,42961,5048,3760,1288,5048,86300,2018
48345,38.3,1156,861,19,224,308,43750,465,315,150,465,55800,2018
48347,30.6,65558,39079,11311,12565,15342,43598,23904,13445,10459,23904,119700,2018
48349,38.6,48583,27526,6124,13013,12571,47920,17397,12091,5306,17397,95000,2018
48351,44.3,14057,10335,2771,497,3527,40950,4978,4303,675,4978,74600,2018
48353,38.5,14966,8432,743,5527,3636,44346,5469,3668,1801,5469,72000,2018
48355,35.3,360486,107652,13071,228462,87387,55048,128926,74572,54354,128926,130700,2018
48357,31.6,10348,4512,18,5564,2531,49928,3443,2506,937,3443,99300,2018
48359,29.8,2090,1559,100,353,385,63315,527,408,119,527,95700,2018
48361,37.8,84047,68118,7090,6165,22417,55700,31989,24313,7676,31989,107600,2018
48363,40.5,28317,21299,628,5625,7049,45979,10312,7500,2812,10312,95900,2018
48365,39.3,23440,17184,4023,2013,6286,51569,8827,6583,2244,8827,98300,2018
48367,39.7,129802,108865,1762,15562,33696,74625,44255,34440,9815,44255,198400,2018
48369,33.9,9852,3401,107,6201,2530,54184,3318,2301,1017,3318,92300,2018
48371,35.9,15797,4040,567,10837,3266,52282,4557,3235,1322,4557,75100,2018
48373,43.6,47837,33877,4850,7193,12530,46182,17803,13601,4202,17803,94300,2018
48375,33.8,120899,53755,11591,45905,28308,43157,43944,24315,19629,43944,90100,2018
48377,41.8,7123,987,0,5956,1574,27061,2627,1403,1224,2627,58400,2018
48379,48.3,11473,9814,322,1019,3038,49872,4331,3407,924,4331,121100,2018
48381,35.6,132475,96014,3726,27678,33856,67397,49187,34560,14627,49187,162700,2018
48383,31.4,3752,1064,27,2652,883,70478,1147,801,346,1147,94100,2018
48385,55,3389,2709,5,672,696,34813,1227,1000,227,1227,103000,2018
48387,45.6,12275,8982,2080,902,3259,37955,5048,3833,1215,5048,67200,2018
48389,35.6,15125,3117,312,11352,2640,58384,3713,2625,1088,3713,62200,2018
48391,41.9,7236,3028,400,3631,1810,48112,2577,1829,748,2577,82500,2018
48393,38,885,726,0,123,235,73854,311,232,79,311,132100,2018
48395,40.9,16890,9728,3276,3481,4427,54201,6358,4805,1553,6358,104000,2018
48397,37.6,93642,67046,5670,16206,25523,94767,31649,25421,6228,31649,244400,2018
48399,40.8,10310,6368,317,3495,2580,41732,3749,2611,1138,3749,77600,2018
48401,38.5,53595,34324,9131,8855,13065,52329,17960,13767,4193,17960,118500,2018
48403,52.7,10458,8966,650,455,2791,33257,4099,3617,482,4099,101200,2018
48405,49.4,8327,5741,1760,583,2321,35509,3356,2689,667,3356,86700,2018
48407,44.7,27819,20779,2846,3563,6515,44658,9487,7795,1692,9487,109000,2018
48409,35.3,67046,26032,1003,38483,17078,55229,23121,15603,7518,23121,117700,2018
48411,40.7,5962,3846,134,1790,1332,44698,2104,1403,701,2104,97900,2018
48413,35,3061,1444,13,1603,753,55677,1105,871,234,1105,69800,2018
48415,36.1,17239,9158,837,6917,3909,55889,5884,4499,1385,5884,88100,2018
48417,43,3311,2830,6,385,800,45187,1234,997,237,1234,80300,2018
48419,37.2,25478,15729,4576,4605,6488,40764,9292,6872,2420,9292,72600,2018
48421,40.4,3058,1721,9,1302,782,56576,1055,804,251,1055,98400,2018
48423,36.6,225015,134889,38735,43377,53375,53511,77195,50844,26351,77195,153500,2018
48425,40.9,8743,6911,54,1648,2576,53162,3239,2338,901,3239,191600,2018
48427,28.7,63894,465,21,63299,13054,29294,16238,12009,4229,16238,68300,2018
48429,38.6,9372,6709,222,2199,2305,45336,3268,2643,625,3268,71400,2018
48431,44.9,1141,606,3,516,343,59286,462,398,64,462,64700,2018
48433,52,1385,1075,48,256,372,48000,582,440,142,582,58200,2018
48435,38.4,3865,1470,3,2385,1039,60543,1484,999,485,1484,95700,2018
48437,35.7,7484,3514,393,3254,1808,38418,2514,1787,727,2514,73800,2018
48439,34.3,2019977,958302,319829,576242,488262,64874,698995,422710,276285,698995,170300,2018
48441,32.3,136348,87125,10287,32869,32751,50818,49482,29017,20465,49482,119100,2018
48443,51.9,862,265,23,548,209,33750,396,331,65,396,72100,2018
48445,34.7,12615,5071,584,6859,2957,44975,4041,2777,1264,4041,76100,2018
48447,46.6,1567,1292,16,235,474,44196,703,498,205,703,68000,2018
48449,33.8,32730,14871,2953,14015,8170,46698,10694,7084,3610,10694,97600,2018
48451,33.9,117466,63195,4702,46319,27453,51675,43131,26961,16170,43131,130800,2018
48453,33.9,1203166,590373,94922,407676,260654,71767,458484,239208,219276,458484,298800,2018
48455,48.7,14569,11451,1318,1420,4017,40407,5918,4690,1228,5918,79700,2018
48457,42.7,21496,17043,2411,1621,4911,43936,7020,5990,1030,7020,85400,2018
48459,40.9,40769,32817,3368,3423,10023,50906,14036,10962,3074,14036,123800,2018
48461,37.2,3634,1525,237,1837,884,52257,1305,952,353,1305,65700,2018
48463,33.9,27009,7223,86,19247,6104,41752,8683,6423,2260,8683,80700,2018
48465,31.7,49027,7612,611,40086,11576,45521,15429,9713,5716,15429,95900,2018
48467,42.9,54368,45714,1423,5741,13955,51935,19615,15148,4467,19615,121900,2018
48469,35.7,91970,41428,5205,42733,22482,55631,32544,21431,11113,32544,136900,2018
48471,35.4,71539,40510,16393,12787,12816,41855,21636,11071,10565,21636,149100,2018
48473,29,49987,21571,12222,14903,10817,57654,14807,10016,4791,14807,174900,2018
48475,33.2,11586,4724,533,6131,2717,64630,3956,2809,1147,3956,86100,2018
48477,41.6,34796,22364,5771,5483,8544,56237,12381,9182,3199,12381,170900,2018
48479,28.6,272053,9513,780,259797,58772,42293,73659,46017,27642,73659,119900,2018
48481,37.2,41551,18643,5747,16983,10663,49619,15256,10220,5036,15256,122900,2018
48483,39,5482,3740,142,1448,1586,49352,2254,1415,839,2254,85800,2018
48485,34.3,131818,86518,13116,24818,30257,46575,47951,29284,18667,47951,96000,2018
48487,37.8,12906,7583,1221,3739,3398,48773,5263,3301,1962,5263,73200,2018
48489,33.6,21754,2412,129,19170,4675,29944,5810,4345,1465,5810,56800,2018
48491,36.1,527057,316640,31855,128133,126630,83679,174754,120222,54532,174754,245100,2018
48493,40.2,48198,27657,642,18995,12427,72445,15820,13096,2724,15820,181200,2018
48495,32.5,7802,2811,159,4689,1830,59167,2572,2099,473,2572,64400,2018
48497,38.4,64639,49868,759,12300,16502,61709,22080,16982,5098,22080,154000,2018
48499,48.2,43815,36273,2335,4313,11734,48534,16531,13221,3310,16531,130200,2018
48501,31.2,8571,2763,25,5643,2087,68814,2676,2121,555,2676,100000,2018
48503,41.4,18114,14176,354,3332,5349,47194,7105,5547,1558,7105,89000,2018
48505,29.6,14369,615,0,13542,3383,31113,4405,3103,1302,4405,69500,2018
48507,32.9,12131,602,60,11372,2705,30988,3509,2478,1031,3509,48500,2018
49001,33.4,6443,5611,0,729,1639,54212,2277,1686,591,2277,161700,2018
49003,32.5,53001,46154,260,4912,13782,59937,17302,13224,4078,17302,189900,2018
49005,25.1,122336,102021,934,13033,28153,56840,37645,23571,14074,37645,218400,2018
49007,37.2,20356,16926,127,2702,5228,50278,7844,5719,2125,7844,136100,2018
49009,46.1,612,577,1,20,112,81250,145,129,16,145,211300,2018
49011,30.8,340621,286663,4324,32175,83784,79690,102865,79822,23043,102865,265900,2018
49013,31,20219,17237,85,1661,5227,63919,6644,4959,1685,6644,183400,2018
49015,35.4,10248,9349,17,642,2738,52055,3589,2828,761,3589,139500,2018
49017,41.2,5017,4468,3,297,1274,52337,1741,1368,373,1741,179900,2018
49019,40.7,9616,7933,51,1000,2807,48673,4006,2593,1413,4006,238000,2018
49021,29.1,49691,42722,264,4265,11806,46809,16204,10420,5784,16204,201400,2018
49023,30.4,10948,10096,18,514,2695,62237,3390,2702,688,3390,203200,2018
49025,41.7,7350,6724,16,342,1538,48269,2634,2083,551,2634,190000,2018
49027,35.8,12733,10571,0,1662,3432,60445,4306,3369,937,4306,145600,2018
49029,32.4,11391,10829,77,315,2973,89274,3306,2781,525,3306,359300,2018
49031,44.7,1904,1854,2,34,364,39440,499,439,60,499,155100,2018
49033,30.6,2350,2033,0,256,474,49886,620,477,143,620,192200,2018
49035,32.6,1120805,801714,19465,203140,259153,71230,369429,246459,122970,369429,281800,2018
49037,31.5,15281,6662,26,863,3019,44680,3992,3194,798,3992,133200,2018
49039,31.9,29366,25233,275,2829,6625,51720,8483,6308,2175,8483,174000,2018
49041,35.2,21118,19395,141,1076,5489,53020,7261,5620,1641,7261,156700,2018
49043,39,40511,34232,304,4662,10760,100453,14555,11093,3462,14555,598900,2018
49045,31.3,65185,54359,329,7933,15814,71020,19901,15868,4033,19901,209700,2018
49047,30.3,36323,29674,179,3066,7703,66736,10625,8198,2427,10625,191900,2018
49049,24.6,590440,488201,3210,68285,131197,70408,160649,108605,52044,160649,280100,2018
49051,33.4,30523,25526,45,4082,7339,77449,9567,6820,2747,9567,388900,2018
49053,36.4,160537,135891,1042,16435,40965,56877,54702,38125,16577,54702,262200,2018
49055,41,2694,2456,9,159,710,44694,1021,766,255,1021,176600,2018
49057,32.5,247731,189127,2509,45034,60084,64636,82417,59759,22658,82417,197800,2018
50001,43.7,36939,34241,432,849,9266,65093,14733,10914,3819,14733,241900,2018
50003,47,35920,33893,136,675,9341,53040,14927,10948,3979,14927,209100,2018
50005,44.2,30425,28877,283,481,7546,49348,12214,8817,3397,12214,168200,2018
50007,36.5,162052,143938,3990,3685,37596,69896,65400,41185,24215,65400,288200,2018
50009,50.4,6208,5924,62,83,1731,41045,2756,2209,547,2756,131700,2018
50011,40,49025,46050,292,742,12759,64258,18582,13844,4738,18582,213400,2018
50013,47.8,6965,6473,55,133,2011,69583,2967,2445,522,2967,270800,2018
50015,40.9,25268,23930,225,444,6516,60365,10607,7692,2915,10607,228000,2018
50017,46.1,28937,27636,188,392,7916,60159,12286,9941,2345,12286,191700,2018
50019,45.8,26911,25635,120,387,7407,47915,11679,8997,2682,11679,162200,2018
50021,46.6,59273,56564,489,845,15028,54973,25145,18231,6914,25145,176600,2018
50023,43.7,58477,55120,462,1111,15167,62108,24865,17604,7261,24865,222600,2018
50025,47,43150,40232,479,982,11275,52659,19118,12960,6158,19118,212500,2018
50027,47.7,55427,52510,389,868,14847,58303,24310,17783,6527,24310,216800,2018
51001,45.9,32742,19691,9569,2934,8687,43210,13401,9093,4308,13401,165000,2018
51003,38.8,106355,81835,10314,6168,25732,75394,40612,25391,15221,40612,344500,2018
51005,47.4,15286,13992,823,218,4135,47794,6741,5237,1504,6741,116500,2018
51007,46,12854,9426,2737,383,3441,58526,4789,4036,753,4789,204400,2018
51009,44.3,31882,23951,5665,774,8176,49170,12044,9349,2695,12044,153300,2018
51011,42.9,15577,11945,3079,228,4566,56176,6095,4733,1362,6095,155300,2018
51013,34.5,231803,143154,20048,36180,48455,117374,104716,45504,59212,104716,669400,2018
51015,44.8,74701,68097,3030,1970,20813,61305,29297,23110,6187,29297,212300,2018
51017,47.6,4393,4033,78,165,1076,46137,1999,1443,556,1999,151500,2018
51019,46.2,77908,68486,5285,1646,22533,61541,31206,25472,5734,31206,200500,2018
51021,46.1,6447,6211,119,48,1849,50511,2523,2087,436,2523,102400,2018
51023,47,33222,30848,981,547,9681,68410,13161,11353,1808,13161,225200,2018
51025,43.2,16665,6780,9072,364,3918,41927,6048,4336,1712,6048,110800,2018
51027,46.5,22138,21059,638,96,5890,30806,8871,6925,1946,8871,70800,2018
51029,42.7,17004,10396,5771,408,3790,46261,5827,4385,1442,5827,127300,2018
51031,42.8,55170,44142,7898,1298,15365,50258,22957,17271,5686,22957,155000,2018
51033,40,30184,19163,8292,1381,7807,64715,10911,8868,2043,10911,195100,2018
51035,47.4,29738,28174,124,996,8370,43532,12375,9526,2849,12375,109200,2018
51036,50.3,6995,2925,3255,129,1898,59192,2856,2387,469,2856,168900,2018
51037,45.8,12095,8189,3506,243,2848,39212,4543,3156,1387,4543,107400,2018
51041,38.8,339447,211628,76417,28910,89638,80214,123010,92822,30188,123010,231700,2018
51043,46.6,14365,12427,684,748,3769,77936,5639,4216,1423,5639,335600,2018
51045,48.3,5113,5092,7,2,1388,55484,2266,1636,630,2266,171400,2018
51047,38.8,50450,35647,6642,5180,12425,73116,16903,12539,4364,16903,285300,2018
51049,45.5,9786,6193,3136,27,2577,46221,3963,2892,1071,3963,146300,2018
51051,44.3,14960,14612,99,133,3777,29226,5841,4456,1385,5841,75700,2018
51053,43.2,28308,17498,9061,956,6979,55880,10391,7900,2491,10391,162300,2018
51057,46,11036,6049,4281,390,2889,52681,4463,3108,1355,4463,188100,2018
51059,37.9,1143529,585961,107306,185551,281953,121133,394447,268346,126101,394447,550000,2018
51061,41.4,69115,55571,5022,5498,17886,97469,24333,19017,5316,24333,384100,2018
51063,47,15666,14625,289,464,4504,49729,6480,5326,1154,6480,170000,2018
51065,43.3,26282,20631,3528,880,7157,74931,9842,8256,1586,9842,230600,2018
51067,46.6,56233,48923,4362,1548,16261,52639,23104,18447,4657,23104,178000,2018
51069,40.6,85153,71448,3407,7003,23069,73250,30973,24065,6908,30973,245100,2018
51071,44.5,16814,15968,363,285,4646,52478,6987,5363,1624,6987,121000,2018
51073,44.7,37161,31556,3003,1287,10402,66701,14759,11261,3498,14759,228300,2018
51075,48.3,22482,17458,3576,611,6425,89741,8426,7157,1269,8426,344000,2018
51077,47.7,15811,14221,706,514,4130,33969,6542,5184,1358,6542,95100,2018
51079,40.1,19410,16069,1085,1141,5274,64979,7357,5898,1459,7357,238300,2018
51081,39.8,11659,4286,6908,267,2458,44534,3688,2698,990,3688,96400,2018
51083,46.1,34779,20776,12036,703,9259,42289,14025,10476,3549,14025,112700,2018
51085,42.9,104449,87880,9395,3058,29173,88652,38599,31513,7086,38599,275800,2018
51087,38.5,325642,174734,95769,17959,80655,68572,127111,79703,47408,127111,233400,2018
51089,47.2,51588,36240,11246,2740,13709,36683,21598,15629,5969,21598,94200,2018
51091,59.3,2214,2203,0,0,703,46147,1123,920,203,1123,180100,2018
51093,44.4,36372,25742,7944,1075,10285,71376,14304,10692,3612,14304,262300,2018
51095,46.4,74153,56209,9521,4138,20463,83048,28766,21434,7332,28766,339600,2018
51097,45.7,7052,4655,1785,223,1778,54516,2826,2362,464,2826,161800,2018
51099,37.3,25890,19069,4212,1282,6864,87321,9103,7014,2089,9103,301600,2018
51101,41.4,16497,12573,2700,257,4793,68720,6170,5321,849,6170,206100,2018
51103,56.7,10804,7319,3320,47,3147,50739,5142,3890,1252,5142,237700,2018
51105,44.4,24134,22410,984,455,5975,32718,9149,6465,2684,9149,88000,2018
51107,36,385143,218954,27568,52119,97462,136268,125309,97513,27796,125309,492300,2018
51109,44.7,35380,27338,5207,986,9484,59343,13575,10818,2757,13575,218100,2018
51111,45.5,12278,7343,3775,549,2956,41868,4331,3088,1243,4331,116000,2018
51113,44.8,13139,11140,910,352,3685,54197,5078,3714,1364,5078,253000,2018
51115,52.9,8796,7534,906,79,2450,67009,3908,3406,502,3908,224800,2018
51117,48.4,30847,18546,10983,888,7534,42025,11815,8257,3558,11815,133200,2018
51119,53.4,10700,8286,1653,79,2854,51917,4454,3585,869,4454,263900,2018
51121,28.5,97997,81916,4302,3110,19158,54641,35483,19530,15953,35483,221900,2018
51125,50.1,14812,12087,1887,607,4486,62446,6445,4787,1658,6445,243800,2018
51127,43.7,21103,16736,2391,665,5990,79698,7754,6606,1148,7754,264800,2018
51131,48.5,11957,6469,4001,1037,3147,43553,5151,3371,1780,5151,164000,2018
51133,57.3,12223,8526,3340,91,4009,58677,5686,4852,834,5686,285900,2018
51135,41.7,15500,8442,6197,657,3783,42869,5542,3396,2146,5542,139900,2018
51137,42.1,35612,27944,4403,1695,9496,68481,13453,10448,3005,13453,233800,2018
51139,45.1,23749,22380,364,464,6232,47951,9338,6546,2792,9338,168700,2018
51141,49.6,17859,16026,1024,527,5046,40486,7685,5878,1807,7685,116400,2018
51143,46.7,61676,45710,12329,1591,18376,45382,26330,19750,6580,26330,117400,2018
51145,45.1,28574,24339,3078,608,7933,83914,10178,9119,1059,10178,271400,2018
51147,30.8,22956,14161,7326,880,4466,46189,7187,4808,2379,7187,161400,2018
51149,37,37894,20903,11599,2979,8329,67001,11415,7648,3767,11415,218200,2018
51153,34.9,456749,199529,91650,105050,108590,103445,140473,102811,37662,140473,369300,2018
51155,46.3,34234,31097,1575,584,9427,52638,14525,10507,4018,14525,144800,2018
51157,50.1,7332,6532,354,263,1940,68438,2976,2196,780,2976,359800,2018
51159,45.8,8878,5399,2441,603,2195,49831,3139,2262,877,3139,181900,2018
51161,43.6,93583,80644,5290,2731,26150,65467,38343,28403,9940,38343,194800,2018
51163,48.7,22509,20839,726,407,6110,54805,8979,7033,1946,8979,213000,2018
51165,41.6,79444,70771,1654,5383,22134,59817,30946,22832,8114,30946,210000,2018
51167,45.4,27408,26529,358,190,7136,39482,10965,8343,2622,10965,96900,2018
51169,46.9,22009,21291,162,293,5671,39144,8767,6833,1934,8767,94400,2018
51171,44.4,43045,37872,810,3019,11284,54921,17315,12229,5086,17315,207900,2018
51173,44.9,31059,29243,714,628,8550,40425,12881,9193,3688,12881,95000,2018
51175,46.1,17939,10934,5888,277,4942,54611,6522,4771,1751,6522,169500,2018
51177,38.1,131412,90393,20564,12308,33710,85330,43677,33923,9754,43677,276800,2018
51179,35.3,144012,90152,24073,17782,37406,106773,46328,35289,11039,46328,334600,2018
51181,49.6,6600,3457,2983,50,1984,54844,2760,2121,639,2760,190400,2018
51183,39.8,11486,4392,6432,333,2534,45801,3814,2564,1250,3814,126300,2018
51185,44.9,42080,39524,1357,409,11455,40978,17042,12923,4119,17042,95300,2018
51187,40.7,39449,34371,1454,1716,9792,68189,14379,11072,3307,14379,240000,2018
51191,45.9,54406,51854,737,817,14965,46262,22331,16799,5532,22331,141300,2018
51193,47.9,17638,11275,4621,1110,4634,54268,7612,5669,1943,7612,210900,2018
51195,40.7,39025,35744,2162,481,10108,38345,15126,9980,5146,15126,85600,2018
51197,44.9,28940,27172,928,347,7903,48043,11955,9112,2843,11955,130800,2018
51199,39.5,67587,48240,8569,4173,19271,90367,24617,17676,6941,24617,324400,2018
51510,36.5,156505,81050,33385,26247,33939,96733,69979,29989,39990,69979,557000,2018
51520,42.2,16843,14702,1191,102,4525,37904,7402,4362,3040,7402,112200,2018
51530,37.5,6399,5634,381,62,1688,34273,2539,1694,845,2539,122100,2018
51540,31.3,47042,30923,8773,2531,8644,58933,18613,8045,10568,18613,283800,2018
51550,36.7,237820,137582,69494,14120,63308,75790,84230,60083,24147,84230,265600,2018
51570,40.3,17593,12861,2484,1011,4453,53716,7054,4484,2570,7054,168000,2018
51580,42.8,5582,4533,710,144,1538,39432,2409,1771,638,2409,74200,2018
51590,41.1,41512,17864,20186,1711,10601,36301,18479,9878,8601,18479,91100,2018
51595,38.4,5381,1210,3749,296,1364,30857,2119,879,1240,2119,123800,2018
51600,38.1,23865,13552,1099,4039,5794,111574,8553,6066,2487,8553,533300,2018
51610,38.8,14067,10093,640,1501,3529,124796,5262,3243,2019,5262,757300,2018
51620,38.9,8211,3049,4833,90,2216,40375,3526,1755,1771,3526,168300,2018
51630,30.3,28469,17014,5873,3062,5600,63274,10582,3829,6753,10582,346500,2018
51640,45.1,6638,4999,477,1099,1825,31938,2742,1799,943,2742,101100,2018
51650,36.1,135583,52397,66901,7599,32350,54550,53700,30167,23533,53700,186400,2018
51660,25.1,53391,35552,3527,10324,8834,43893,16768,6398,10370,16768,197400,2018
51670,36.5,22408,10682,9250,1705,5607,40497,9193,4572,4621,9193,119700,2018
51678,21.7,7110,5838,447,362,880,36466,1984,1050,934,1984,203600,2018
51680,28.2,80131,49944,22739,3194,16186,43374,28069,13953,14116,28069,158800,2018
51683,33.7,41457,17325,5492,14863,9473,78462,12749,8301,4448,12749,313100,2018
51685,35.3,16423,5676,2121,6359,3290,80667,4706,3098,1608,4706,281500,2018
51690,40.8,13101,5935,6077,703,3308,33224,5630,3283,2347,5630,86800,2018
51700,33.3,180145,78214,71563,15798,42025,51884,69324,34043,35281,69324,193100,2018
51710,30.5,245592,106733,100369,19359,50556,49146,88155,38029,50126,88155,199400,2018
51720,37.3,3990,3554,185,43,1048,28071,1819,843,976,1819,91700,2018
51730,38.7,31827,4780,24486,1522,6854,36135,13274,5376,7898,13274,108200,2018
51735,43.2,12039,11066,141,311,3399,96831,4615,3849,766,4615,325000,2018
51740,35.2,95311,36177,49759,4106,21670,50224,36471,19810,16661,36471,171800,2018
51750,22.9,17630,14640,1708,512,2368,36743,5438,2676,2762,5438,164600,2018
51760,33.8,223787,90339,106373,14950,40339,45117,89846,37956,51890,89846,220700,2018
51770,38.7,99621,58808,28128,6104,23065,43028,42037,21783,20254,42037,133200,2018
51775,41.3,25519,21775,1674,827,6079,57185,9881,6415,3466,9881,176800,2018
51790,42.5,24452,19822,2790,729,5927,48049,10520,5974,4546,10520,164800,2018
51800,38.2,89160,44134,36669,3764,24277,70664,33198,23001,10197,33198,246600,2018
51810,35.9,450135,279288,83234,36043,116983,74186,169290,108486,60804,169290,274300,2018
51820,39.4,21926,16660,2873,1674,5191,45738,9144,5359,3785,9144,167600,2018
51830,24.6,14788,10060,2077,1044,2178,56163,4670,2301,2369,4670,300100,2018
51840,37.3,27789,18442,2740,4842,6126,53797,10554,4950,5604,10554,236800,2018
53001,28.3,19452,6711,65,12246,4428,49142,5881,3730,2151,5881,154500,2018
53003,45,22337,20302,98,853,5807,50423,9171,6449,2722,9171,181800,2018
53005,35.7,194168,137753,2955,41336,48375,65650,70983,48522,22461,70983,216900,2018
53007,40.2,75757,51592,292,21074,18334,56135,28038,18454,9584,28038,274500,2018
53009,50.5,74487,61789,750,4640,19916,49913,32732,23126,9606,32732,238500,2018
53011,38.2,465384,367277,7386,43347,119493,71636,171522,114096,57426,171522,296800,2018
53013,49.4,4001,3439,30,306,1101,51111,1758,1209,549,1758,170800,2018
53015,41.5,105112,88131,745,9248,27113,51752,41397,27338,14059,41397,197000,2018
53017,37.1,41371,26687,133,12948,11057,60452,15064,10505,4559,15064,250800,2018
53019,49.6,7576,5563,11,347,1997,41924,3097,2270,827,3097,172200,2018
53021,30,90660,36897,1673,47907,20306,62002,26316,18072,8244,26316,187900,2018
53023,45.5,2224,1993,0,47,656,52525,997,699,298,997,139100,2018
53025,32.7,94860,51477,639,39171,21955,54982,30651,18946,11705,30651,171500,2018
53027,43.7,71967,57309,700,7092,17902,47770,28263,18714,9549,28263,168500,2018
53029,44.2,81636,64895,2506,6112,23577,64809,34364,23811,10553,34364,337800,2018
53031,57.9,30856,27362,231,1102,8934,54471,14239,10433,3806,14239,311100,2018
53033,37.1,2163257,1307511,132775,206735,521183,89418,865627,494443,371184,865627,493500,2018
53035,39,262475,202208,6423,19782,68471,71610,101662,67694,33968,101662,299600,2018
53037,33.1,44825,37715,403,3922,9681,55193,18003,10357,7646,18003,275000,2018
53039,46.6,21396,17586,46,2581,5445,54056,8539,5662,2877,8539,235900,2018
53041,43.1,76947,64492,376,7692,19912,50216,30262,21096,9166,30262,191100,2018
53043,48.4,10435,9553,71,341,3072,50744,4485,3550,935,4485,153800,2018
53045,45.6,62627,50641,651,6061,15110,55726,23535,18033,5502,23535,216000,2018
53047,42.9,41638,27225,193,8211,11699,45808,17527,11601,5926,17527,173500,2018
53049,53.1,21281,17492,72,2009,5770,44846,9087,7070,2017,9087,170800,2018
53051,50.6,13219,11708,30,483,4049,48583,5782,4543,1239,5782,208400,2018
53053,36.1,859840,579099,55321,91436,212302,67868,317699,195890,121809,317699,277000,2018
53055,56.1,16473,14606,112,1024,4867,60711,8025,5921,2104,8025,470500,2018
53057,41.5,123907,92387,859,22677,32419,62865,47937,32378,15559,47937,286200,2018
53059,46.3,11620,10210,103,720,3236,58598,4685,3331,1354,4685,282400,2018
53061,37.8,786620,553205,21751,78883,199589,82751,289737,193536,96201,289737,371600,2018
53063,37.5,497875,422655,7709,27693,125905,54852,198489,124339,74150,198489,209000,2018
53065,46.6,44214,38337,193,1604,11995,49200,17433,13519,3914,17433,187000,2018
53067,39,274684,207154,8054,23964,71946,69592,108070,68791,39279,108070,271300,2018
53069,54.3,4189,3651,54,264,1401,54085,1844,1583,261,1844,207000,2018
53071,37.1,60236,43303,1031,12789,14341,56533,22304,14400,7904,22304,209800,2018
53073,37,216812,172002,2065,19977,51611,59285,85008,52715,32293,85008,318400,2018
53075,24.6,48593,38353,1041,3005,8746,42163,17910,7725,10185,17910,208200,2018
53077,32.8,249325,108938,1935,121944,59595,49871,82300,52001,30299,82300,167700,2018
54001,41.7,16730,15991,207,85,4252,39580,6416,4533,1883,6416,104800,2018
54003,38.8,113495,95601,8207,4795,29901,60615,43237,32025,11212,43237,172800,2018
54005,42.7,22817,22299,209,52,6418,38642,9148,6920,2228,9148,69900,2018
54007,45.2,14282,13852,42,153,4003,42213,5491,4349,1142,5491,93000,2018
54009,46.2,22772,21799,377,199,6387,49772,9957,7437,2520,9957,92000,2018
54011,38.5,95318,85679,4803,1327,21919,38321,39628,24648,14980,39628,123200,2018
54013,47.6,7396,7191,2,152,2017,37610,2864,2314,550,2864,73500,2018
54015,43.9,8785,8714,1,7,2258,35875,3261,2676,585,3261,82100,2018
54017,45.1,8536,8149,115,63,1811,46449,2647,2293,354,2647,116800,2018
54019,43.8,44126,40797,2232,493,11939,40379,17795,14088,3707,17795,90500,2018
54021,39.7,8205,6645,900,328,1680,35810,2670,1942,728,2670,91300,2018
54023,46.2,11641,11258,191,92,2899,41071,4556,3667,889,4556,137300,2018
54025,45.4,35347,32664,862,666,9475,39038,15285,10945,4340,15285,120500,2018
54027,46.5,23363,22384,322,328,5973,40099,9663,6759,2904,9663,143700,2018
54029,46.4,29680,27858,532,449,7831,45580,12697,9141,3556,12697,92000,2018
54031,45.4,13842,12478,762,218,4085,47186,5521,3980,1541,5521,126400,2018
54033,42.3,68209,64316,1130,1099,17763,50433,27436,20161,7275,27436,113500,2018
54035,43.4,29018,28161,23,142,7734,44783,11178,8770,2408,11178,121000,2018
54037,40.7,56179,46896,3524,3111,14824,76503,20895,15640,5255,20895,240600,2018
54039,43.3,185710,163003,13336,2025,49130,45426,79437,54678,24759,79437,112400,2018
54041,42.9,16276,15701,43,193,4443,39423,6577,4596,1981,6577,104800,2018
54043,43,21078,20629,84,180,5610,37679,7879,6089,1790,7879,81700,2018
54045,43.3,33801,32428,558,303,9758,38123,13875,10182,3693,13875,90100,2018
54047,44.6,19217,17036,1616,251,5188,26547,7711,6120,1591,7711,33800,2018
54049,41.2,56497,52337,2043,716,14989,48605,22942,17189,5753,22942,112800,2018
54051,45.2,31645,30612,310,319,8094,43918,12232,9818,2414,12232,103300,2018
54053,44.1,26939,26065,110,184,7348,40347,10849,8687,2162,10849,77400,2018
54055,42.7,60486,54644,3682,690,15765,39372,24882,17676,7206,24882,92200,2018
54057,43.9,27278,25655,944,243,7330,46354,11184,8049,3135,11184,135100,2018
54059,42.7,24741,23714,655,0,7189,31305,10772,7970,2802,10772,75800,2018
54061,31.2,105252,92582,3795,2182,20482,49926,38856,21852,17004,38856,188700,2018
54063,46.7,13467,12941,122,121,3776,36493,5744,4592,1152,5744,108100,2018
54065,47.6,17624,16826,126,268,4666,50661,7166,5892,1274,7166,179800,2018
54067,45,25324,24571,162,138,7325,38468,10472,8257,2215,10472,93100,2018
54069,43.5,42547,39238,1708,469,10145,48418,17351,11991,5360,17351,119400,2018
54071,50.5,7056,6681,239,64,2068,41210,3154,2561,593,3154,122300,2018
54073,43.4,7507,7375,16,44,2072,48563,2869,2280,589,2869,107000,2018
54075,48.7,8531,8382,37,45,2234,39702,3579,2916,663,3579,124300,2018
54077,42.4,33837,30759,1563,842,8640,48317,12383,10303,2080,12383,106800,2018
54079,41.8,56652,54131,663,644,15341,59626,21665,17824,3841,21665,163800,2018
54081,42.4,76232,66402,5784,1227,21164,42296,31119,23030,8089,31119,105700,2018
54083,43.5,29065,27879,568,266,7156,41094,11254,7929,3325,11254,99200,2018
54085,46,9932,9787,7,52,2678,44472,3930,3135,795,3930,85800,2018
54087,45.1,14205,13764,12,150,3742,34300,5679,4375,1304,5679,93800,2018
54089,48.2,13018,11953,553,223,3531,36049,5489,4072,1417,5489,95400,2018
54091,43.2,16951,16239,163,169,4326,47205,6661,5163,1498,6661,103600,2018
54093,48.7,7027,6843,16,28,1962,45655,3103,2461,642,3103,117100,2018
54095,46.7,8909,8716,30,24,2168,41108,3298,2660,638,3298,97400,2018
54097,42,24605,23636,396,322,6200,40401,9378,7055,2323,9378,112600,2018
54099,43.7,40708,39648,222,265,10414,36875,15799,11755,4044,15799,97800,2018
54101,46.8,8518,8492,3,6,2560,34312,3811,2732,1079,3811,67200,2018
54103,45.9,15614,15152,158,54,3864,42125,5891,4700,1191,5891,101000,2018
54105,44.7,5797,5630,83,64,1655,40189,2499,2049,450,2499,86100,2018
54107,43.3,85556,81457,1139,948,23250,45958,36018,25684,10334,36018,118600,2018
54109,44.2,21711,21116,210,44,6403,40045,8823,7270,1553,8823,67200,2018
55001,53.3,20073,18200,568,781,5472,43280,8619,7128,1491,8619,125100,2018
55003,41.8,15712,12958,110,438,3904,43861,6546,4473,2073,6546,110100,2018
55005,44.1,45252,42355,627,1111,12560,50903,19108,14342,4766,19108,150200,2018
55007,52,14992,12712,118,279,4541,52910,6963,5763,1200,6963,166300,2018
55009,37.2,259786,211094,5859,21835,66687,59963,104133,67905,36228,104133,167000,2018
55011,46,13167,12626,74,273,3849,57134,5713,4304,1409,5713,155900,2018
55013,52.5,15258,13808,81,270,4800,49982,7303,5916,1387,7303,156100,2018
55015,40.1,49807,45371,415,2069,14564,72530,19567,15815,3752,19567,173200,2018
55017,40.9,63635,59628,777,1094,17106,57288,25485,18539,6946,25485,159000,2018
55019,37.6,34491,32194,95,1530,8780,51872,12800,9957,2843,12800,121300,2018
55021,42.4,56954,52888,701,1837,15896,65348,23790,17490,6300,23790,187000,2018
55023,46,16288,15409,305,230,4104,48853,6618,5038,1580,6618,131100,2018
55025,34.9,529843,422848,26683,33285,125632,70541,219490,127283,92207,219490,252300,2018
55027,42.5,87776,79065,2376,4106,22761,58870,34605,24133,10472,34605,159100,2018
55029,52.4,27439,25812,143,819,8985,58287,13196,10278,2918,13196,207100,2018
55031,41.9,43402,39819,556,671,11351,52480,18920,12658,6262,18920,143700,2018
55033,34.3,44498,41357,246,817,10522,56268,16818,11329,5489,16818,161800,2018
55035,34.4,102991,92950,880,2448,23688,55711,40753,25744,15009,40753,161600,2018
55037,52.4,4337,4223,13,61,1280,49128,2010,1704,306,2010,130800,2018
55039,41.5,102315,92042,1409,5125,27090,59373,41346,29448,11898,41346,152900,2018
55041,46.7,9018,7160,68,208,2587,44313,4029,3104,925,4029,130200,2018
55043,35.7,51828,49313,703,831,11955,52958,19401,13545,5856,19401,144000,2018
55045,42.9,36864,34811,162,1110,10075,62699,15098,11238,3860,15098,166900,2018
55047,45.4,18757,17360,177,898,5122,53260,7935,5953,1982,7935,142600,2018
55049,42.5,23620,22534,191,411,6638,62785,9835,7251,2584,9835,174500,2018
55051,54.5,5715,5465,47,73,1710,40801,3003,2249,754,3003,113100,2018
55053,41.6,20506,17692,435,671,5192,52984,8083,6020,2063,8083,133200,2018
55055,40.7,84652,75987,669,5924,22481,63676,32866,23025,9841,32866,184300,2018
55057,45.2,26419,24238,607,788,6673,51056,10640,8185,2455,10640,124100,2018
55059,38.2,168330,128019,11908,21745,41876,60929,63423,41807,21616,63423,169000,2018
55061,44.2,20360,19289,81,572,5666,63118,8238,6525,1713,8238,157700,2018
55063,35.8,117850,106101,1682,2182,27826,55479,47319,29880,17439,47319,167100,2018
55065,41.4,16735,15787,107,625,4550,59629,6679,5088,1591,6679,134600,2018
55067,48.2,19164,18023,153,368,5351,46557,8594,6491,2103,8594,113200,2018
55069,47.2,27848,26617,169,421,8215,56086,12547,9724,2823,12547,139800,2018
55071,44.7,79407,72170,704,3044,21623,53489,34463,25891,8572,34463,127200,2018
55073,40.6,135264,120282,856,3636,36724,59543,55377,40331,15046,55377,152000,2018
55075,48.3,40537,38673,284,669,11289,47497,18631,13910,4721,18631,117100,2018
55077,49.8,15207,14211,94,495,4077,49586,6516,5279,1237,6516,150300,2018
55078,31.7,4579,447,21,258,1083,43872,1443,946,497,1443,103300,2018
55079,34.7,954209,493723,249011,140575,215024,48742,382070,189080,192990,382070,153600,2018
55081,39.5,45502,41352,722,1983,11621,58178,17772,12503,5269,17772,149400,2018
55083,46.5,37556,35731,146,650,10869,57105,15940,13231,2709,15940,155300,2018
55085,50.9,35345,33586,215,517,9792,54198,15403,12938,2465,15403,167800,2018
55087,37.9,184754,162129,2431,7789,48512,63536,72947,51482,21465,72947,163800,2018
55089,43.9,88284,80956,1191,2526,25144,82807,35625,26992,8633,35625,273000,2018
55091,46.3,7262,7017,28,121,2043,53140,3095,2487,608,3095,148700,2018
55093,36.8,41603,39270,177,826,10409,72111,15367,11119,4248,15367,197500,2018
55095,45.2,43349,41233,172,818,12278,56932,18314,14355,3959,18314,164700,2018
55097,36.7,70599,64422,499,2224,17374,57368,28357,19539,8818,28357,163300,2018
55099,51.6,13490,12719,102,239,4101,46742,6605,5188,1417,6605,122700,2018
55101,40.1,195398,141413,21257,25142,52243,59749,76384,51822,24562,76384,169900,2018
55103,45.1,17539,16620,87,393,4983,51335,7626,5758,1868,7626,136800,2018
55105,39.5,161769,134381,6989,13782,41895,55832,64538,43857,20681,64538,139800,2018
55107,49.1,14183,13451,138,259,4033,44302,6382,4928,1454,6382,110400,2018
55109,38.6,87917,82704,664,2023,24238,81124,33674,25654,8020,33674,233600,2018
55111,41.2,63596,58000,503,3128,16906,56732,26178,18015,8163,26178,174500,2018
55113,50.2,16370,12559,89,427,5053,44555,7634,5594,2040,7634,164700,2018
55115,45,41009,35637,154,1119,11184,54143,17019,13030,3989,17019,136600,2018
55117,41.3,115205,97489,2071,7168,30933,58943,47303,33193,14110,47303,153700,2018
55119,43.4,20356,19547,94,404,5934,51698,8632,6696,1936,8632,131900,2018
55121,40.5,29438,26497,135,2340,7724,55865,11936,8631,3305,11936,151400,2018
55123,41.9,30516,29385,79,476,8217,50905,12080,9292,2788,12080,152300,2018
55125,54.1,21593,18326,56,534,6864,44285,10914,8354,2560,10914,206900,2018
55127,39.7,103013,88085,953,11372,26787,61106,40372,27346,13026,40372,196400,2018
55129,50.7,15689,14806,60,279,4564,48422,7062,5602,1460,7062,152700,2018
55131,42.9,134535,125160,1643,4181,38089,74062,54138,41836,12302,54138,225800,2018
55133,43.2,398879,354230,6236,18469,110394,84331,157548,120367,37181,157548,272100,2018
55135,45.4,51444,48571,216,1572,14055,57680,22024,16389,5635,22024,145600,2018
55137,49,24116,21596,430,1524,6630,51195,9869,8073,1796,9869,143100,2018
55139,38.2,169926,151159,3763,6789,42219,57124,70173,45603,24570,70173,149500,2018
55141,43.8,73274,67746,444,2122,20058,53473,32245,23397,8848,32245,129900,2018
56001,27.3,38102,31583,397,3600,7456,46865,16027,7971,8056,16027,226900,2018
56003,41.3,11901,10460,53,1065,2971,53435,4494,3269,1225,4494,154600,2018
56005,33.5,47708,41756,127,4074,12359,79916,17488,12626,4862,17488,220200,2018
56007,38,15477,12011,165,2780,4258,60206,6341,4331,2010,6341,165700,2018
56009,40.1,13997,12426,1,1118,3680,63923,5429,3908,1521,5429,207900,2018
56011,42.6,7410,6997,12,87,2087,64055,2924,2448,476,2924,220200,2018
56013,38.4,40076,28014,235,2753,9835,54242,15003,10488,4515,15003,194100,2018
56015,43.4,13438,11555,10,1427,3567,49774,5209,3849,1360,5209,168200,2018
56017,49.5,4680,4388,0,147,1437,51875,2209,1681,528,2209,151800,2018
56019,45.5,8515,7800,45,188,2474,55991,3828,2718,1110,3828,257800,2018
56021,36.9,97692,77066,2267,14138,26007,64220,39179,27332,11847,39179,214000,2018
56023,39.3,19011,17564,18,871,4918,64519,7075,5571,1504,7075,231700,2018
56025,36.6,80610,70036,1008,6723,20315,60550,32851,22023,10828,32851,202600,2018
56027,41,2448,2189,13,113,598,39359,978,743,235,978,144900,2018
56029,44.4,29121,26501,45,1582,8026,62666,11977,8591,3386,11977,254800,2018
56031,47.1,8673,7693,1,698,2574,47096,3936,2904,1032,3936,173700,2018
56033,42.1,30012,27543,114,1252,8052,58521,13159,8935,4224,13159,261500,2018
56035,39.4,9951,8883,0,731,2275,78680,3275,2654,621,3275,272600,2018
56037,34.6,44117,35107,336,7042,10824,73008,15871,11962,3909,15871,205800,2018
56039,39.3,23059,18813,245,3433,5305,83831,9158,5287,3871,9158,827400,2018
56041,35.5,20609,18042,20,1884,5355,58235,7735,5822,1913,7735,177500,2018
56043,43.5,8129,6666,1,1153,2302,53426,3422,2629,793,3422,162700,2018
56045,42.9,7100,6466,36,107,2017,52867,3062,2379,683,3062,169900,2018
72001,40.9,18181,52,0,18123,4194,12902,5861,3191,2670,5861,85200,2018
72003,42.3,38643,2115,20,36113,9253,16347,12819,9538,3281,12819,86300,2018
72005,41.5,54166,743,161,52858,14998,16693,21604,12901,8703,21604,120400,2018
72007,41.4,26275,221,0,26054,6270,17255,8469,5665,2804,8469,117300,2018
72009,41.6,23457,42,9,23363,6370,19720,8301,6579,1722,8301,114100,2018
72011,41.8,27368,874,0,26338,6516,19379,8933,6869,2064,8933,88800,2018
72013,42,87242,466,25,86692,21884,18001,31788,21592,10196,31788,97400,2018
72015,39.6,18111,38,0,18073,4351,16976,6002,4598,1404,6002,88900,2018
72017,39.9,24299,37,0,24249,5680,16889,8010,5907,2103,8010,106200,2018
72019,36.4,28755,0,0,28755,6745,15970,8918,6552,2366,8918,101200,2018
72021,41.3,182955,1139,226,181344,47309,26017,67940,46253,21687,67940,134900,2018
72023,43.2,49005,66,0,48939,10275,16080,15656,9523,6133,15656,112400,2018
72025,40.5,131363,1081,92,130019,33449,25006,48629,33384,15245,48629,131300,2018
72027,40.8,32222,200,20,32002,8362,16831,11431,7994,3437,11431,100200,2018
72029,39.1,46108,75,0,45982,10564,20673,14498,10815,3683,14498,110200,2018
72031,42,157453,1127,239,155567,42344,29434,63401,44153,19248,63401,143900,2018
72033,39.8,24888,159,0,24635,6217,18253,8792,5331,3461,8792,119200,2018
72035,42.4,44530,130,0,44399,11482,21320,16183,10503,5680,16183,117400,2018
72037,41.9,11853,121,13,11690,2907,19103,4367,3158,1209,4367,92600,2018
72039,41.9,16912,150,0,16762,4277,15071,5870,3962,1908,5870,89700,2018
72041,39.8,40343,148,62,40065,9439,19949,12913,8701,4212,12913,121700,2018
72043,40.7,39265,216,8,39040,9243,19833,13346,10264,3082,13346,88800,2018
72045,38.6,19539,94,0,19427,4016,12812,5836,3395,2441,5836,89700,2018
72047,39,34165,323,0,33811,8284,15088,10768,8504,2264,10768,89900,2018
72049,42.8,1314,97,0,1211,256,23802,475,302,173,475,113500,2018
72051,40,37208,545,0,36628,8931,29667,11881,9222,2659,11881,139000,2018
72053,41.2,32001,271,60,31568,8179,19068,12231,7955,4276,12231,99500,2018
72054,39.8,11910,140,0,11770,3297,20315,4291,3317,974,4291,93200,2018
72055,42.1,16783,142,0,16618,3554,13242,5469,3928,1541,5469,90900,2018
72057,38.5,41706,421,74,41209,9472,16374,14476,10418,4058,14476,88900,2018
72059,41,19008,80,0,18916,4756,16922,6485,4612,1873,6485,80300,2018
72061,43.6,88663,1050,122,87292,20562,33937,30963,22849,8114,30963,177400,2018
72063,38.6,46894,715,160,45809,10852,33661,14780,12337,2443,14780,143500,2018
72065,41.5,40390,44,0,40346,10192,17201,14093,10448,3645,14093,93500,2018
72067,45.8,16180,14,18,16148,3961,19394,6253,4574,1679,6253,101600,2018
72069,42.1,53466,309,22,53056,12534,19880,17896,13149,4747,17896,95400,2018
72071,41.6,42420,394,98,41825,10676,16748,15012,9277,5735,15012,105300,2018
72073,37.8,14906,57,0,14849,3988,15424,5087,3081,2006,5087,94100,2018
72075,38.1,46960,51,12,46888,11811,20845,15673,11400,4273,15673,93300,2018
72077,38.4,39128,257,0,38852,8880,18969,12718,8946,3772,12718,108500,2018
72079,44,23315,42,0,23235,5376,13747,7911,4539,3372,7911,88800,2018
72081,42.2,26451,65,8,26337,7397,14540,9960,5804,4156,9960,88000,2018
72083,41.1,8599,50,0,8549,2014,13435,2872,1943,929,2872,83400,2018
72085,39,37768,32,54,37663,9602,21792,12527,9361,3166,12527,118500,2018
72087,38.9,26463,7,20,26397,6293,17402,8728,6254,2474,8728,103200,2018
72089,41.2,18547,204,0,18268,4711,20829,6519,4623,1896,6519,110400,2018
72091,41.5,39692,388,107,39080,11192,19459,15337,11229,4108,15337,108400,2018
72093,43.2,6202,10,0,6192,1336,13262,1930,1417,513,1930,90800,2018
72095,44.4,11023,127,0,10896,2799,19788,3882,2810,1072,3882,89400,2018
72097,40.7,77255,419,67,76645,18051,14120,29912,17518,12394,29912,98700,2018
72099,39.5,36872,139,12,36564,9608,14155,13278,8549,4729,13278,96500,2018
72101,37.9,31320,99,18,31157,7672,20589,9943,6981,2962,9943,100300,2018
72103,37.7,26266,95,0,26100,5646,19356,8317,6444,1873,8317,91200,2018
72105,39.4,28557,38,0,28519,6316,19332,8520,6600,1920,8520,89900,2018
72107,38.9,21407,59,24,21324,5161,13319,6734,4404,2330,6734,89800,2018
72109,43.9,17334,44,0,17290,3942,15761,6233,4288,1945,6233,92200,2018
72111,37.3,20984,43,0,20919,5381,17592,6987,5275,1712,6987,75000,2018
72113,40.4,143926,810,89,142988,35866,17173,52696,34277,18419,52696,98800,2018
72115,40.4,24036,167,89,23760,5855,16630,8286,5397,2889,8286,108000,2018
72117,45.4,14269,1303,23,12676,3209,21591,5128,3576,1552,5128,121500,2018
72119,40.7,50550,271,0,50257,11437,22509,15732,11870,3862,15732,114000,2018
72121,42.1,23054,36,4,23014,5252,16846,7493,5719,1774,7493,96700,2018
72123,39.9,28633,14,0,28500,7208,16887,10374,8319,2055,10374,85700,2018
72125,43.2,32114,173,15,31903,7515,15619,11840,8484,3356,11840,90300,2018
72127,42.5,344606,4438,769,338194,83455,22146,144573,77390,67183,144573,155700,2018
72129,41,37873,0,0,37817,9615,18821,13749,10276,3473,13749,108500,2018
72131,43.3,37964,642,0,37127,10126,14812,13904,8984,4920,13904,97800,2018
72133,37.8,22066,89,0,21977,5115,17640,7465,5642,1823,7465,92400,2018
72135,37.7,73405,361,71,72671,17422,28863,22032,18307,3725,22032,137500,2018
72137,39.8,79726,626,102,78932,18656,24899,27258,20080,7178,27258,127400,2018
72139,39.8,67780,413,16,67311,17544,31193,23982,15993,7989,23982,147300,2018
72141,42.8,29402,162,25,29215,7226,16533,9851,6259,3592,9851,91600,2018
72143,38.6,37724,366,66,37132,8973,18895,12229,8350,3879,12229,116000,2018
72145,40.7,53371,1481,52,51797,12747,19096,18081,14396,3685,18081,107600,2018
72147,43.6,8771,498,0,8247,1350,15539,2470,1792,678,2470,104200,2018
72149,38.8,22993,37,19,22936,5658,19855,7712,5475,2237,7712,90900,2018
72151,42.5,34149,15,0,34122,7851,16013,11722,8490,3232,11722,88100,2018
72153,43,36439,48,16,36344,6912,14954,10790,8143,2647,10790,92000,2018
01001,38.2,55380,41315,10524,1565,15076,58731,21397,15682,5715,21397,154500,2019
01003,43,212830,176803,19525,9711,53467,58320,80930,60896,20034,80930,197900,2019
01005,40.4,25361,11618,12031,1105,6187,32525,9345,5691,3654,9345,90700,2019
01007,40.9,22493,16763,4981,579,4789,47542,6891,5128,1763,6891,92800,2019
01009,40.7,57681,50121,881,5342,14874,49358,20847,16423,4424,20847,127800,2019
01011,40.2,10248,2191,7666,262,2504,37785,3521,2504,1017,3521,70300,2019
01013,40.8,19828,10232,8928,277,4331,40688,6506,4551,1955,6506,95900,2019
01015,39.6,114618,82608,23682,4352,29960,47255,44605,31254,13351,44605,118000,2019
01017,42,33660,18697,13316,800,8553,42289,13448,9072,4376,13448,97100,2019
01019,46.5,25903,23759,1191,413,7307,41919,10737,8304,2433,10737,123400,2019
01021,38.7,44055,35302,4041,3457,11908,47468,16927,12610,4317,16927,107300,2019
01023,46.3,12925,7287,5500,53,3440,35892,5300,4288,1012,5300,74100,2019
01025,42.5,24128,12720,11044,79,5662,37404,9090,6372,2718,9090,112500,2019
01027,43.3,13337,10717,2068,419,3704,40845,5198,3922,1276,5198,107800,2019
01029,43.1,14916,13826,410,367,3806,44741,5680,4324,1356,5680,116500,2019
01031,39.3,51662,36239,8680,3763,13747,55637,19924,13099,6825,19924,147400,2019
01033,42.4,54771,42830,8809,1557,14797,48065,21880,15796,6084,21880,120800,2019
01035,44.8,12394,6203,5919,84,2997,37837,4553,3465,1088,4553,81000,2019
01037,48.4,10757,6970,3615,109,2657,38990,4032,3195,837,4032,84000,2019
01039,43.3,37200,30984,4981,629,9924,42189,14852,11061,3791,14852,97600,2019
01041,41.7,13844,9827,3202,110,3384,43163,4943,3731,1212,4943,81000,2019
01043,40.8,82853,76129,1034,3611,21574,44918,31034,23216,7818,31034,128600,2019
01045,37.3,49277,33787,9749,3210,12515,47214,18806,11300,7506,18806,112000,2019
01047,39.6,39149,10694,27572,419,10328,33845,15910,9441,6469,15910,83300,2019
01049,39.5,71310,57359,1021,10376,18349,40440,26040,18627,7413,26040,106100,2019
01051,38.7,81144,59364,17223,2404,21530,60891,29708,21763,7945,29708,166600,2019
01053,40,37057,22321,11850,865,8019,36275,13089,8943,4146,13089,99400,2019
01055,41.4,102748,80001,15861,3982,25852,44637,38942,28267,10675,38942,113700,2019
01057,43.7,16494,13937,1843,297,4774,39856,6802,5255,1547,6802,88500,2019
01059,38.6,31466,24181,1349,5400,7669,43514,11048,7821,3227,11048,95000,2019
01061,43.2,26417,22151,2487,1051,6902,41732,10383,7476,2907,10383,100900,2019
01063,40.9,8324,1435,6614,145,1542,24145,2951,1979,972,2951,80400,2019
01065,40.5,14809,5854,8792,4,3611,34046,5650,4285,1365,5650,89300,2019
01067,44.4,17133,11851,4549,449,4505,50017,6630,5525,1105,6630,118800,2019
01069,40.1,104702,69580,28021,3479,25747,47580,39311,25829,13482,39311,137600,2019
01071,43.1,51852,46277,1775,1519,14456,41769,20695,15629,5066,20695,104900,2019
01073,37.7,659680,329108,282363,25557,163802,53901,261231,163799,97432,261231,159100,2019
01075,44.8,13885,11940,1479,229,3895,38364,5856,4429,1427,5856,80900,2019
01077,41,92556,78414,9388,2476,24731,48094,38471,26214,12257,38471,145000,2019
01079,42.4,33058,25285,3496,724,9101,44886,12677,9845,2832,12677,110500,2019
01081,31.9,161152,108684,36623,5925,37089,51463,60237,37111,23126,60237,169300,2019
01083,39.7,94727,72508,12880,5700,22692,59686,32143,24951,7192,32143,158800,2019
01085,42,10079,2485,7495,50,2741,30036,4251,3157,1094,4251,70000,2019
01087,38.6,18708,2966,15442,152,4279,33370,7474,4894,2580,7474,80800,2019
01089,38.5,362276,234316,87115,17928,95547,65449,148189,99046,49143,148189,186100,2019
01091,42.2,19321,8672,10348,196,3833,33241,7361,5262,2099,7361,84400,2019
01093,44.3,29866,27433,1025,777,8030,35930,11997,9015,2982,11997,92800,2019
01095,38.8,95643,77236,2549,13357,24015,45983,34883,24480,10403,34883,128800,2019
01097,37.9,414114,235599,147186,12018,100431,47583,156251,100853,55398,156251,130200,2019
01099,43.3,21270,11544,9010,81,5124,30441,8166,5197,2969,8166,102200,2019
01101,36.4,226941,76937,131160,7978,55155,50124,89527,52265,37262,89527,129800,2019
01103,40.6,119213,90163,15132,9962,31182,52156,45918,33392,12526,45918,137000,2019
01105,36.9,9293,2727,6441,110,1476,23447,3070,2206,864,3070,65000,2019
01107,42.2,20243,10860,8065,985,5074,39848,7637,5747,1890,7637,96000,2019
01109,31.2,33333,18672,12194,750,6422,37446,11601,7225,4376,11601,120000,2019
01111,43.4,22647,17052,4455,668,5720,43395,8702,6670,2032,8702,96100,2019
01113,36.3,57952,26696,25158,3182,14948,42443,23262,13999,9263,23262,122000,2019
01115,40.3,87989,75556,8418,2133,23400,58308,32036,25595,6441,32036,154900,2019
01117,39.3,213432,166190,25665,12208,56666,77799,79630,64123,15507,79630,211900,2019
01119,35.6,12797,3175,9203,68,2764,24320,5202,3333,1869,5202,74400,2019
01121,41.3,80387,50344,26022,1842,20868,41325,31395,22382,9013,31395,105300,2019
01123,44.7,40541,27922,10934,981,11183,45828,16205,12131,4074,16205,109300,2019
01125,33,207305,127593,66113,7702,46967,53326,72461,46191,26270,72461,170400,2019
01127,42.1,64110,57024,3953,1595,17166,43629,25019,19327,5692,25019,104300,2019
01129,43.7,16541,10743,3894,241,4208,41370,5990,4951,1039,5990,89100,2019
01131,40.5,10681,2867,7410,57,2284,31014,3854,2617,1237,3854,79400,2019
01133,45.2,23784,22285,174,750,6268,35788,9592,7617,1975,9592,86100,2019
02013,42.5,3385,447,109,305,550,69250,890,568,322,890,119900,2019
02016,38.6,5698,1358,191,801,732,87466,1187,335,852,1187,279200,2019
02020,33.6,293531,169960,15486,26927,68643,84928,106567,65367,41200,106567,314800,2019
02050,27.3,18134,1764,134,471,3415,53553,4489,2611,1878,4489,83600,2019
02060,42.9,875,445,5,32,194,79808,314,169,145,314,188800,2019
02068,42.1,2246,1892,26,7,321,81719,613,500,113,613,223000,2019
02070,30.2,4961,764,79,184,1041,56898,1427,885,542,1427,183500,2019
02090,31.3,99072,69282,4236,7972,23822,76992,36188,21322,14866,36188,240000,2019
02100,44.7,2518,1952,0,113,620,58059,1007,669,338,1007,254000,2019
02105,49.6,2139,937,65,146,478,59803,791,597,194,791,223600,2019
02110,38.1,32227,20844,316,2186,7773,88390,12676,8212,4464,12676,345900,2019
02122,40.8,58464,46726,313,2428,13603,66064,21630,15750,5880,21630,242200,2019
02130,39.7,13800,8827,104,727,3453,72728,5397,3322,2075,5397,289900,2019
02150,33.9,13451,6595,28,1198,2967,85839,4261,2326,1935,4261,282100,2019
02158,24.1,8250,295,8,93,1440,36754,1724,1236,488,1724,71500,2019
02164,34.8,1393,292,16,2,280,44135,421,301,120,421,114900,2019
02170,35.2,105369,83473,1207,5198,22093,75493,31217,24059,7158,31217,249000,2019
02180,28.3,9988,1464,83,274,2128,61048,2844,1720,1124,2844,154600,2019
02185,35.2,9792,3027,141,199,1523,79306,1979,1042,937,1979,152500,2019
02188,27.8,7715,831,83,112,1318,60906,1795,1009,786,1795,141400,2019
02195,42.8,3257,2133,33,381,766,69948,1187,817,370,1187,227400,2019
02198,41.3,6407,2900,29,247,1525,52379,2371,1725,646,2371,174900,2019
02220,39.5,8640,5320,61,584,2123,73682,3547,2102,1445,3547,358600,2019
02230,40.4,1107,909,37,63,200,73906,375,200,175,375,338500,2019
02240,36.8,6878,5066,22,417,1471,70056,2170,1595,575,2170,170900,2019
02261,38.1,9243,6406,35,484,1981,79867,3177,2371,806,3177,222200,2019
02275,49.4,2502,1548,1,126,654,53894,1027,697,330,1027,216200,2019
02282,36.9,649,281,5,50,127,71607,219,145,74,219,202300,2019
02290,35.2,5377,1159,4,143,1084,41413,1856,1344,512,1856,76500,2019
04001,35,71511,13022,373,4531,13816,32508,20867,16462,4405,20867,59900,2019
04003,41.1,125867,69216,4620,44626,32462,49260,50163,34577,15586,50163,146800,2019
04005,30.7,141274,76361,1576,19931,28849,59460,47447,28962,18485,47447,280900,2019
04007,50.2,53546,33334,348,10038,14112,43524,21945,16581,5364,21945,165800,2019
04009,33.6,37996,19324,693,12543,7786,51353,11017,7741,3276,11017,138700,2019
04011,34.5,9522,4439,195,4456,2339,63473,3132,1523,1609,3132,83800,2019
04012,56.5,20793,11935,183,5735,5930,34643,9346,6686,2660,9346,79200,2019
04013,36.4,4328810,2391279,230036,1341560,1018723,64468,1552096,965292,586804,1552096,260200,2019
04015,51.6,207695,160529,2069,34160,55462,45587,86889,60192,26697,86889,160500,2019
04017,37.3,109270,45109,808,12479,24355,40067,34990,24067,10923,34990,126100,2019
04019,38.5,1027207,531408,33479,382585,248813,53379,404739,255677,149062,404739,184100,2019
04021,39.3,432793,245773,17675,130511,99077,58174,141300,108402,32898,141300,183100,2019
04023,36.7,46480,6904,110,38793,12016,41259,15853,10725,5128,15853,151200,2019
04025,53.4,228067,183497,1424,33166,61412,52451,98386,70821,27565,98386,252000,2019
04027,34.6,209468,64877,3518,133549,54046,45243,73098,49048,24050,73098,127900,2019
05001,40.7,17914,12497,4636,572,4723,46696,7491,4883,2608,7491,88600,2019
05003,41.7,20270,13831,5123,1101,5454,44744,7757,6010,1747,7757,76400,2019
05005,52.2,41427,39235,67,987,11964,42260,18435,14038,4397,18435,133400,2019
05007,35.4,265759,194883,4385,44161,70386,66362,97249,64742,32507,97249,183400,2019
05009,42.3,37331,35043,125,931,10455,45374,15034,10793,4241,15034,124300,2019
05011,40.6,10874,6035,3132,1673,2827,43184,4419,2880,1539,4419,89800,2019
05013,44.5,5192,3762,1115,207,1302,46417,1850,1569,281,1850,70000,2019
05015,45,27965,22266,140,4183,7497,46110,11139,8436,2703,11139,136900,2019
05017,43.3,10615,4111,5719,584,2636,34147,4068,2513,1555,4068,69700,2019
05019,33.7,22386,15377,5426,1059,5253,41620,8446,4859,3587,8446,111600,2019
05021,42.8,14889,14195,100,307,4140,37233,6444,4344,2100,6444,77400,2019
05023,49.4,25100,23763,98,609,7230,44483,10783,8110,2673,10783,129900,2019
05025,42.9,8128,6874,1040,101,2254,46684,3217,2446,771,3217,97100,2019
05027,35.7,23776,14093,8540,645,5559,36193,8562,6029,2533,8562,81900,2019
05029,42.5,20858,17017,2140,818,5600,42802,8309,5590,2719,8309,107600,2019
05031,34.2,107345,81616,15565,5421,26764,47286,41375,23623,17752,41375,140700,2019
05033,38.6,62739,52869,873,4852,17082,46828,23958,18211,5747,23958,115200,2019
05035,35.2,48672,20435,23276,1246,11964,40161,19074,10956,8118,19074,114600,2019
05037,40.9,16824,12223,3141,167,4652,46787,6653,4447,2206,6653,86100,2019
05039,43.9,7279,3867,3146,98,1797,38072,2969,2010,959,2969,70400,2019
05041,40.1,11709,5296,5456,718,3545,31893,5204,3199,2005,5204,70300,2019
05043,37.4,18417,12206,5269,632,4651,46997,7157,4845,2312,7157,99800,2019
05045,32.8,123624,98945,14018,5060,28842,52827,44575,27776,16799,44575,161500,2019
05047,41.2,17738,16327,169,536,4537,38923,6723,4740,1983,6723,100900,2019
05049,48.4,12231,11608,58,196,3278,35405,4973,3965,1008,4973,86400,2019
05051,45,98555,80875,8055,5553,25250,44777,40209,27270,12939,40209,139900,2019
05053,41,18126,16779,465,498,5007,55388,6863,5499,1364,6863,124600,2019
05055,38,44937,41791,861,1281,12280,47056,17254,11561,5693,17254,118800,2019
05057,40.4,21842,11927,6548,2800,5711,42860,8094,5607,2487,8094,81100,2019
05059,41.3,33597,27729,3816,1176,8857,43889,12599,9809,2790,12599,96700,2019
05061,39.2,13311,8538,2779,1669,3503,36059,5142,3545,1597,5142,95900,2019
05063,39.3,37427,33201,678,2363,9929,44319,14322,10261,4061,14322,98900,2019
05065,47.9,13570,12611,248,314,3124,42876,4851,3690,1161,4851,82700,2019
05067,39.7,17027,13082,2078,492,3758,34109,6137,4257,1880,6137,66600,2019
05069,38.7,69282,26940,39135,1455,16294,40726,26801,16644,10157,26801,83500,2019
05071,38.4,26372,20881,411,3671,6650,38511,9682,6818,2864,9682,103500,2019
05073,47,6800,3984,2432,182,1801,32397,2784,2202,582,2784,64600,2019
05075,40.8,16549,15765,186,256,4466,39993,6463,4351,2112,6463,76800,2019
05077,42.5,9194,3773,5087,230,1994,29681,3206,1917,1289,3206,74000,2019
05079,39,13455,8638,4106,529,2711,46596,3773,2910,863,3773,76300,2019
05081,42.9,12347,9000,2710,189,3523,45113,5363,3836,1527,5363,77900,2019
05083,42,21668,19596,298,645,5839,41466,8417,6202,2215,8417,99000,2019
05085,36.2,72528,62375,4089,3241,19891,59094,26895,18624,8271,26895,142500,2019
05087,42.7,16211,14482,16,928,4318,41682,6279,4899,1380,6279,120400,2019
05089,52.2,16476,15504,80,379,4438,36719,6782,5348,1434,6782,120700,2019
05091,39.5,43572,29835,10738,1450,11108,43371,16426,10619,5807,16426,109100,2019
05093,36.6,42126,24550,14212,1740,10635,39962,16389,9237,7152,16389,84500,2019
05095,47.3,7050,3818,3030,45,1974,38468,3333,1996,1337,3333,61400,2019
05097,50.4,8950,8138,26,388,2563,35741,3754,3053,701,3754,102800,2019
05099,44.3,8351,5245,2884,2,2263,38042,3397,2274,1123,3397,66300,2019
05101,49,7812,7335,2,33,1800,38082,2936,2472,464,2936,114700,2019
05103,43,23830,13137,9866,558,6009,35425,9658,6676,2982,9658,75300,2019
05105,43.7,10355,9885,56,303,2824,48667,3668,2804,864,3668,106300,2019
05107,38.9,18606,6420,11750,350,4836,29320,7485,3607,3878,7485,70700,2019
05109,43.1,10756,9398,439,700,2969,40401,4280,3372,908,4280,84900,2019
05111,40.1,23896,20744,1093,727,6710,40921,9526,5994,3532,9526,78800,2019
05113,43.9,20094,17603,95,1324,5672,37974,8243,6321,1922,8243,99300,2019
05115,35.3,63761,53564,1866,5751,14881,43462,22579,15563,7016,22579,126400,2019
05117,47.2,8189,6932,1017,142,2495,42660,3776,2792,984,3776,67400,2019
05119,37.2,392967,205386,144099,24171,95813,51749,158051,92938,65113,158051,157200,2019
05121,41.1,17695,16616,192,367,4994,37218,7355,5275,2080,7355,87200,2019
05123,38.8,25900,10353,13764,1343,5867,35348,9388,5139,4249,9388,64600,2019
05125,39.6,119415,101010,8470,5688,31296,64412,44075,34419,9656,44075,156800,2019
05127,40.7,10376,8752,25,799,2569,36092,3944,2910,1034,3944,76300,2019
05129,47.9,7908,7365,48,191,2333,36438,3327,2460,867,3327,103500,2019
05131,37.6,127591,88754,8555,18144,32909,46228,51228,30130,21098,51228,123100,2019
05133,35.3,17081,9784,819,5711,4279,47704,5885,4201,1684,5885,84300,2019
05135,47.6,17139,16014,123,391,4420,34671,7447,5746,1701,7447,80700,2019
05137,50.1,12475,11808,11,243,3109,38188,4787,3573,1214,4787,121100,2019
05139,40.3,39449,23875,12883,1577,10562,44663,15726,11865,3861,15726,86500,2019
05141,48,16642,15556,78,520,4631,38499,6813,5352,1461,6813,101700,2019
05143,32,232289,164678,8306,38979,54999,50451,87325,45928,41397,87325,173400,2019
05145,36.9,78762,69364,3333,3422,19787,44029,29055,19195,9860,29055,120100,2019
05147,45.5,6533,4533,1839,30,1855,32845,2932,1917,1015,2932,66400,2019
05149,40.3,21464,16156,445,4326,5542,43923,7503,5363,2140,7503,109400,2019
06001,37.6,1656754,520447,171168,371019,384676,99406,577177,308891,268286,577177,769300,2019
06003,52.2,1039,551,9,130,231,63750,350,294,56,350,365300,2019
06005,50.5,38429,30035,848,5340,9872,62772,14594,11165,3429,14594,313700,2019
06007,37.1,225817,162537,3342,36916,51447,52537,85320,50331,34989,85320,271700,2019
06009,52,45514,36837,315,5489,11691,63158,16942,13173,3769,16942,319500,2019
06011,35.3,21454,7576,256,12738,5327,59401,7227,4410,2817,7227,265200,2019
06013,39.7,1142251,500592,95892,292298,284806,99716,394769,260244,134525,394769,625800,2019
06015,39.5,27495,17028,899,5429,6135,45283,9945,6273,3672,9945,218800,2019
06017,45.9,188563,146747,1426,24199,49749,83377,70974,53750,17224,70974,460900,2019
06019,32.2,984521,289650,44209,522364,222417,53969,307906,164124,143782,307906,255000,2019
06021,36.4,27976,14398,193,11680,7390,49633,10085,5988,4097,10085,233200,2019
06023,38.4,135940,101078,1336,15722,30179,48041,54679,31078,23601,54679,313200,2019
06025,32.4,180701,19228,3882,152172,34147,47622,44829,26156,18673,44829,195800,2019
06027,45.8,17977,11173,141,4020,4296,57316,7950,5204,2746,7950,269100,2019
06029,31.6,887641,303225,45761,473374,200426,53350,270282,157554,112728,270282,213900,2019
06031,31.8,150691,48537,8779,82116,33431,57848,43452,22733,20719,43452,215900,2019
06033,45.6,64195,45258,1331,13224,15203,47040,25660,17034,8626,25660,219400,2019
06035,36.6,30818,20164,2612,5844,6168,56352,9280,6270,3010,9280,203000,2019
06037,36.5,10081570,2641770,790252,4888434,2210939,68044,3316795,1519516,1797279,3316795,583200,2019
06039,34.1,155433,53053,4770,89798,35233,57585,44881,28772,16109,44881,251200,2019
06041,46.8,259943,184960,5527,41527,66052,115246,105432,67115,38317,105432,995800,2019
06043,51.7,17420,13935,253,1963,4801,48820,7643,5230,2413,7643,275700,2019
06045,43.1,87224,56857,626,21898,20910,51416,34408,20611,13797,34408,377500,2019
06047,31.1,271382,75037,7812,161814,61049,53672,80008,41795,38213,80008,252700,2019
06049,47.8,8907,6920,136,1291,2131,45507,3616,2708,908,3616,140600,2019
06051,37.7,14310,9308,59,3865,2503,62260,4765,3068,1697,4765,312500,2019
06053,34.4,433410,129738,10737,254294,91842,71015,127155,64900,62255,127155,516600,2019
06055,41.3,139623,73210,2780,47544,33113,88596,48705,31276,17429,48705,635900,2019
06057,50.5,99244,84513,478,9373,26148,66096,40855,30316,10539,40855,431000,2019
06059,38.1,3168044,1285855,51269,1078726,744011,90234,1037492,595272,442220,1037492,679300,2019
06061,42,385512,280105,6361,53969,100416,89691,142855,102650,40205,142855,471500,2019
06063,52.3,18660,15514,141,1670,5040,55359,8450,6156,2294,8450,242300,2019
06065,35.6,2411439,851702,147160,1179478,527085,67005,724893,480944,243949,724893,350100,2019
06067,36.2,1524553,681829,144695,353318,358544,67151,543025,306324,236701,543025,351900,2019
06069,35.7,60376,20703,454,36081,14588,86958,18135,11554,6581,18135,551500,2019
06071,33.3,2149031,613066,169340,1145874,486285,63362,636041,380281,255760,636041,328200,2019
06073,35.8,3316073,1510756,156084,1117517,756963,78980,1125286,600104,525182,1125286,563700,2019
06075,38.2,874961,354423,43782,133314,173658,112449,362354,136239,226115,362354,1097800,2019
06077,34.3,742603,236509,50030,307463,170529,64432,228567,129419,99148,228567,342100,2019
06079,39.2,282165,194375,4909,63534,67168,73518,105981,65248,40733,105981,574000,2019
06081,39.7,767423,301123,16718,187248,184628,122641,263543,158543,105000,263543,1089400,2019
06083,33.8,444829,197993,8409,201837,95941,74624,145856,75945,69911,145856,577400,2019
06085,37.1,1927470,607903,45259,490978,459738,124055,640215,361105,279110,640215,984000,2019
06087,37.8,273962,156897,2491,91980,60637,82234,95818,57561,38257,95818,756600,2019
06089,41.5,179212,143013,2030,17975,46340,54667,71181,45548,25633,71181,252300,2019
06091,54.8,3040,2662,2,324,837,52148,1319,994,325,1319,231400,2019
06093,47.8,43468,33081,684,5467,11396,45241,19240,12509,6731,19240,198900,2019
06095,38.1,441829,168060,59652,116869,107477,81472,149865,92149,57716,149865,406900,2019
06097,42.1,499772,316022,7399,133569,120441,81018,189374,116393,72981,189374,609600,2019
06099,34.1,543194,227369,15311,251259,128904,60704,173898,100576,73322,173898,291600,2019
06101,35.7,96109,44412,1684,29748,23837,59050,32636,18839,13797,32636,279400,2019
06103,41,63912,43679,472,15958,16119,44514,24189,15813,8376,24189,215900,2019
06105,52.5,12700,10427,127,927,3425,40846,5939,4093,1846,5939,287700,2019
06107,31,461898,131716,5785,298245,106450,49687,138238,78866,59372,138238,205000,2019
06109,48.4,54045,43341,948,6617,13757,60108,22502,16039,6463,22502,289200,2019
06111,38.1,847263,384818,14297,361601,196407,88131,271040,171174,99866,271040,588400,2019
06113,31,217352,101452,5279,68704,47117,70228,74296,38315,35981,74296,424900,2019
06115,32.8,76360,42145,2554,21563,18386,58054,26354,15948,10406,26354,257100,2019
08001,33.8,504108,252170,16139,201784,117036,71202,166450,110208,56242,166450,307600,2019
08003,31.8,16107,7672,79,7533,3766,37515,6162,3562,2600,6162,157500,2019
08005,36.6,644560,388556,67640,123960,157612,77469,240304,152635,87669,240304,358200,2019
08007,50.9,13253,10116,185,2435,3839,52221,5858,4230,1628,5858,314400,2019
08009,46,3561,3021,34,390,1076,35878,1662,1180,482,1662,83500,2019
08011,40.2,5787,3667,211,1855,1118,30900,1767,1053,714,1767,81000,2019
08013,36.6,322510,250174,2699,44740,73813,83019,127415,79273,48142,127415,497300,2019
08014,37.8,67886,52116,772,8404,17931,96416,27470,17917,9553,27470,413500,2019
08015,49.2,19557,16609,330,1963,5359,55771,8231,6405,1826,8231,357800,2019
08017,39.4,2026,1576,2,346,485,53977,774,553,221,774,108000,2019
08019,48.1,9495,8422,103,662,2555,67060,4395,3394,1001,4395,378300,2019
08021,38.8,8128,3622,40,4263,1981,36084,3183,2528,655,3183,120500,2019
08023,51.9,3745,1250,14,2317,1042,30965,1746,1205,541,1746,113000,2019
08025,35.4,5754,3540,203,1833,905,42135,1301,943,358,1301,79400,2019
08027,59.7,4776,4067,138,440,1503,53119,2214,1930,284,2214,281900,2019
08029,47.3,30565,24857,177,4649,7736,45269,11883,8751,3132,11883,241500,2019
08031,34.5,705576,382228,62754,210937,146070,68592,301501,150382,151119,301501,390600,2019
08033,48.8,1857,1667,0,131,491,45972,759,619,140,759,116600,2019
08035,38.7,336041,276316,4478,29211,93633,119730,120709,95344,25365,120709,468700,2019
08037,37,54681,36748,615,16179,12022,84790,18171,12680,5491,18171,562300,2019
08039,46.1,25717,22764,102,1799,7403,99199,9280,8354,926,9280,463600,2019
08041,34.2,698974,483009,41880,119545,175552,68779,257507,164677,92830,257507,275000,2019
08043,45.1,47321,37428,2096,6288,11444,49409,17136,12858,4278,17136,174000,2019
08045,36.5,59055,40239,286,16789,15240,75937,21498,14374,7124,21498,360600,2019
08047,49,6018,5133,20,503,1640,76429,2802,2230,572,2802,353400,2019
08049,42.9,15303,13358,157,1350,3600,71198,5884,4028,1856,5884,308200,2019
08051,34.5,16802,14607,67,1583,3381,56577,6616,4065,2551,6616,367300,2019
08053,56.1,857,771,0,49,255,56339,377,270,107,377,350000,2019
08055,55,6679,4083,10,2290,1863,38137,3225,2314,911,3225,161600,2019
08057,51.6,1261,1036,0,220,382,53300,558,446,112,558,196700,2019
08059,40.3,574798,449045,6132,88330,149418,82986,232284,164186,68098,232284,397700,2019
08061,42.5,1489,1365,6,72,386,41731,638,474,164,638,86500,2019
08063,38.3,7447,5731,186,1421,2005,49349,3004,1995,1009,3004,122400,2019
08065,36.7,7751,4948,9,2508,1936,50565,3392,2320,1072,3392,232100,2019
08067,40.4,55617,43686,245,7110,13079,68685,21794,15400,6394,21794,395600,2019
08069,36,344786,284755,3210,39686,84370,71881,137021,89118,47903,137021,363800,2019
08071,45.9,14266,7546,107,5921,3806,41817,6670,4494,2176,6670,151100,2019
08073,38,5585,3748,452,1259,918,47258,1518,1071,447,1518,147100,2019
08075,38.2,22380,17054,186,3749,5044,53318,8393,5476,2917,8393,157900,2019
08077,39.7,151218,123063,890,21988,39165,55379,61742,42093,19649,61742,227000,2019
08079,56.1,824,712,8,79,263,62188,367,318,49,367,308600,2019
08081,36.6,13127,10543,130,2044,3482,57229,5366,3475,1891,5366,182300,2019
08083,45.2,26031,18854,63,3260,7058,49470,10655,7683,2972,10655,222800,2019
08085,45.2,41686,31704,116,8596,11704,50489,17140,12455,4685,17140,224400,2019
08087,36.2,28517,16595,1038,10306,7665,53682,10928,6999,3929,10928,201200,2019
08089,39.9,18282,9711,113,7658,4652,38169,7722,4936,2786,7722,94900,2019
08091,54.1,4796,4590,15,97,1369,66417,2163,1564,599,2163,449000,2019
08093,50.7,17867,15892,26,1091,4771,73622,6931,5988,943,6931,327200,2019
08095,37.1,4290,3178,5,1027,1115,51155,1689,1214,475,1689,158500,2019
08097,41.8,17926,15296,165,1809,3850,78935,7467,4851,2616,7467,615900,2019
08099,38.3,12022,7080,95,4573,3163,41929,4888,3198,1690,4888,106100,2019
08101,39.3,165982,86404,2631,71356,40971,46783,64314,41589,22725,64314,164600,2019
08103,36.9,6384,5404,30,655,1465,54357,2301,1629,672,2301,197100,2019
08105,42.1,11305,5887,62,5020,2946,39123,4823,3049,1774,4823,172000,2019
08107,40.2,25072,22495,232,1743,5987,77443,9603,6837,2766,9603,535300,2019
08109,49,6592,3862,33,2394,1788,38571,2860,2045,815,2860,152700,2019
08111,51.2,589,523,0,50,133,54625,289,181,108,289,322400,2019
08113,41.8,8049,6909,1,859,1892,67038,3552,2166,1386,3552,479300,2019
08115,44.1,2322,1961,19,312,564,43150,967,690,277,967,97100,2019
08117,39.1,30649,25173,313,4382,5872,79277,10641,6970,3671,10641,579600,2019
08119,50,24524,21764,208,1614,7029,66592,10248,8451,1797,10248,292700,2019
08121,41.6,4868,4232,47,488,1436,50094,2087,1396,691,2087,151300,2019
08123,34.4,305345,200316,3475,89924,76512,74150,104671,76321,28350,104671,299000,2019
08125,37.8,10003,7473,47,2343,2831,52022,4028,2695,1333,4028,191800,2019
09001,40.6,943926,582819,100262,185996,236574,95645,340189,228111,112078,340189,428500,2019
09003,40.4,893561,545642,115637,161079,224364,75148,350408,224640,125768,350408,240600,2019
09005,47.3,182002,160930,2694,11436,48471,79906,74143,56714,17429,74143,251000,2019
09007,45.7,163053,136807,8055,10095,42574,85898,66971,49235,17736,66971,286800,2019
09009,40.3,857513,539298,107111,155335,206501,69905,330572,204451,126121,330572,248600,2019
09011,41.4,267390,202296,13883,28213,69614,73490,107827,71566,36261,107827,241700,2019
09013,37.7,151063,127817,4422,8332,35675,87069,55683,39960,15723,55683,253100,2019
09015,41.2,116566,96404,2056,13754,29665,66550,44953,31004,13949,44953,204400,2019
10001,37.7,176699,108834,44351,12485,45138,60910,65796,45436,20360,65796,220600,2019
10003,38.4,556165,319463,136551,55302,132214,73892,205829,139747,66082,205829,260800,2019
10005,49.6,224384,168200,26500,20577,62686,63162,91697,73597,18100,91697,258600,2019
11001,34,692683,253373,314774,76191,123683,86420,284386,118367,166019,284386,601500,2019
12001,31.6,265443,162040,52644,26242,50284,49689,97995,53913,44082,97995,186700,2019
12003,37.7,28211,22873,3758,721,6236,63275,8693,6544,2149,8693,138900,2019
12005,39.8,182161,138654,19737,11815,45815,54316,71422,46488,24934,71422,178400,2019
12007,39.7,27317,20089,5506,1137,5889,45921,9115,6316,2799,9115,110800,2019
12009,47.3,585507,435834,54358,60266,145323,56775,230417,171269,59148,230417,196400,2019
12011,40.4,1926205,698805,530990,574289,440676,59547,690050,428682,261368,690050,265000,2019
12013,41.6,14362,11080,1865,826,2731,38568,4501,3665,836,4501,85000,2019
12015,59.1,181067,151938,9690,13189,49030,51499,76891,61262,15629,76891,195400,2019
12017,56.5,145169,127751,4071,8263,39591,44237,63681,52144,11537,63681,131500,2019
12019,39.7,211405,153772,21738,21002,56543,65740,74333,55746,18587,74333,185400,2019
12021,50.8,371453,233370,24802,103692,97555,69653,142979,104852,38127,142979,360800,2019
12023,40.4,69968,50569,12449,4407,15745,46494,25133,17953,7180,25133,124200,2019
12027,40.9,36903,20207,4617,11649,8263,35438,12072,8418,3654,12072,87700,2019
12029,46.5,16589,13948,1453,674,4375,39828,6504,5111,1393,6504,78500,2019
12031,36.2,936186,495030,272958,91153,223195,55807,359544,203977,155567,359544,180700,2019
12033,37.2,313491,201691,68173,17808,71565,50915,120104,74504,45600,120104,146200,2019
12035,51.3,109801,81979,10885,11448,29328,54514,42121,32008,10113,42121,217500,2019
12037,46.4,11811,9107,1627,644,2729,46643,4444,3317,1127,4444,166000,2019
12039,40.8,45945,14849,25626,4778,11221,41401,17149,12509,4640,17149,96800,2019
12041,42.1,17953,15479,1019,1049,4348,43640,6464,5368,1096,6464,104800,2019
12043,47.9,13516,8075,1751,2873,3113,40977,4700,3743,957,4700,76700,2019
12045,44.9,15576,11886,2582,687,3901,47712,5757,4271,1486,5757,160700,2019
12047,40.9,14326,7838,4820,1351,3082,38569,4381,2976,1405,4381,80100,2019
12049,35.4,27131,12767,2019,11828,5612,38682,7863,5105,2758,7863,83400,2019
12051,34,40732,13050,4485,21888,8969,40820,12527,8185,4342,12527,94500,2019
12053,49,186313,144477,9112,25178,50951,48812,75348,58814,16534,75348,142500,2019
12055,53.5,103437,69397,9722,20775,27065,40942,41740,31436,10304,41740,108100,2019
12057,37.2,1422278,693874,221699,407736,331934,58884,526175,308217,217958,526175,216300,2019
12059,42.7,19432,16841,1335,546,4779,39102,7092,5418,1674,7092,92700,2019
12061,53.5,153989,115945,13587,19063,36632,54740,58612,46440,12172,58612,202300,2019
12063,41.7,47945,31317,12708,2328,11152,39872,17149,11975,5174,17149,99000,2019
12065,48,14161,8442,4865,584,3761,47240,5770,4443,1327,5770,133500,2019
12067,37.3,8637,5718,1373,1360,1535,50165,2175,1835,340,2175,104700,2019
12069,46.9,345867,241079,35154,53938,91078,54513,134317,100010,34307,134317,181400,2019
12071,48.5,737468,495480,60077,157681,181758,57832,275965,199589,76376,275965,224800,2019
12073,31,289770,163785,88586,18570,61714,53106,113658,60192,53466,113658,203100,2019
12075,46.9,40403,32222,3501,3388,10299,37326,16374,12717,3657,16374,105700,2019
12077,40.7,8345,6363,1302,392,1614,38015,2459,1855,604,2459,75100,2019
12079,43.5,18460,10047,7053,1018,4232,37037,6778,4986,1792,6778,89100,2019
12081,48.3,384213,273486,32690,63038,95723,59009,145356,105902,39454,145356,238500,2019
12083,48.7,353526,248645,44135,46675,91265,45371,139172,104381,34791,139172,139900,2019
12085,52.2,159065,124491,8437,21667,39461,61133,64528,50361,14167,64528,273700,2019
12086,39.9,2699428,356026,426336,1848925,606448,51347,883372,451932,431440,883372,289600,2019
12087,47.7,75798,50226,5081,18439,18798,70033,32068,19078,12990,32068,494100,2019
12089,45.3,83098,72351,4959,3579,23952,69943,32603,26081,6522,32603,230900,2019
12091,36.9,203794,150037,19338,18873,50321,63412,77962,49459,28503,77962,219100,2019
12093,41.1,41144,26004,3163,10497,9379,41760,13904,10033,3871,13904,106000,2019
12095,35.1,1349746,540187,267070,427125,304886,58254,461705,255793,205912,461705,235800,2019
12097,35.9,351955,111501,32629,190439,75564,52279,103141,63554,39587,103141,201000,2019
12099,44.8,1465027,799422,266676,327940,345298,63299,554095,381611,172484,554095,283600,2019
12101,44.5,524602,391110,28225,79843,135267,52828,204198,147225,56973,204198,162100,2019
12103,48.1,964666,713717,95936,93587,229043,54090,407546,273128,134418,407546,201200,2019
12105,40.2,686218,404039,100748,154628,161469,50584,235283,162088,73195,235283,150800,2019
12107,45.1,73252,52366,11730,7319,18056,37670,28943,20472,8471,28943,89100,2019
12109,43.7,244674,202180,12739,17012,64328,82252,88773,71338,17435,88773,304700,2019
12111,45.1,312947,179397,60482,59355,77488,52322,114761,84050,30711,114761,186900,2019
12113,39.9,174755,143940,10595,9730,46887,67949,63514,48252,15262,63514,199200,2019
12115,56.1,419496,348391,18124,38526,111945,62236,182842,137028,45814,182842,251600,2019
12117,39.2,461402,278310,50588,98697,116940,66768,173668,112228,61440,173668,242600,2019
12119,67.4,125044,106246,8443,7178,37209,57226,56230,50446,5784,56230,258600,2019
12121,43.3,44046,33259,5605,4103,10690,47839,14888,11062,3826,14888,101300,2019
12123,42,21870,15759,4345,1410,5197,40306,7405,5732,1673,7405,85100,2019
12125,39.3,15303,10637,3327,862,2810,44270,3960,2616,1344,3960,118400,2019
12127,46.6,536487,384521,55902,74629,132349,49494,216495,152225,64270,216495,175000,2019
12129,40.6,32321,25737,4833,1205,8063,61410,11200,9185,2015,11200,144000,2019
12131,44,68262,57524,3148,4252,18269,58093,27420,20467,6953,27420,229500,2019
12133,41.5,24764,19170,3706,915,5922,37022,8827,6861,1966,8827,113200,2019
13001,40.3,18440,12745,3555,1830,4875,40304,6656,5086,1570,6656,80200,2019
13003,36.4,8239,4657,1434,2050,1976,37197,2880,2112,768,2880,62700,2019
13005,36.7,11201,8234,1701,925,2706,37519,3874,2805,1069,3874,81100,2019
13007,46.1,3132,1586,1241,172,788,32917,1425,930,495,1425,81800,2019
13009,35.5,45111,23631,18995,1019,9568,43672,16191,9468,6723,16191,120300,2019
13011,41.1,18708,16425,486,1289,4875,47811,6740,5082,1658,6740,151100,2019
13013,35.7,78991,56356,9238,8613,19880,62345,26305,19895,6410,26305,159700,2019
13015,38.1,104919,81287,10825,9052,27420,57423,37627,24946,12681,37627,163900,2019
13017,39.9,17033,9511,6236,1041,4019,32229,6443,3791,2652,6443,83400,2019
13019,39.6,19152,15671,2030,971,5055,40415,7367,4731,2636,7367,88000,2019
13021,36.4,153200,58712,83170,4986,34899,41334,58116,30409,27707,58116,120200,2019
13023,35.8,12807,8781,3500,379,2727,48174,4176,3104,1072,4176,102300,2019
13025,41.1,18756,17285,619,419,4578,38857,6823,5482,1341,6823,72300,2019
13027,42,15590,8804,5587,920,4015,38285,6335,4685,1650,6335,107800,2019
13029,34.6,37063,27076,5133,2624,10140,72624,13048,9151,3897,13048,223900,2019
13031,28.8,76120,48323,21133,3034,16653,45550,27375,14758,12617,27375,140700,2019
13033,37.4,22520,10645,10824,728,5939,44151,8193,5800,2393,8193,88700,2019
13035,38.6,24090,15907,6966,782,5823,43471,8279,5782,2497,8279,132600,2019
13037,39.6,6365,2076,3839,302,1152,34167,1736,1139,597,1736,51500,2019
13039,32.8,53231,37155,9921,3583,14380,56951,19338,12095,7243,19338,165700,2019
13043,38.7,10812,6556,2717,1273,2775,33736,4013,2312,1701,4013,96100,2019
13045,34.8,117183,82322,22305,8075,29758,53737,41903,28032,13871,41903,137800,2019
13047,40.4,66700,60661,1369,2012,17428,56235,24778,18339,6439,24778,144300,2019
13049,41.2,13040,7973,3375,1091,2685,41961,3675,2622,1053,3675,83300,2019
13051,35.6,288496,139916,113750,18472,67085,56842,108568,59401,49167,108568,194500,2019
13053,24.5,10560,6080,2099,1675,1886,47096,2570,632,1938,2570,71300,2019
13055,39.4,24812,20536,2556,1278,5853,36807,9260,6315,2945,9260,72200,2019
13057,38.7,247515,194846,16601,26044,66160,82740,88137,67649,20488,88137,253500,2019
13059,28,126176,69418,34907,13626,24146,38623,48844,19062,29782,48844,170700,2019
13061,49.8,2951,1045,1841,11,708,22325,1242,906,336,1242,71400,2019
13063,32.5,283538,28559,193754,37475,62820,47864,94279,46678,47601,94279,108500,2019
13065,39.9,6686,4354,1900,280,1639,27658,2477,1855,622,2477,61000,2019
13067,36.7,751218,389948,200733,97481,189539,77932,280374,180919,99455,280374,253900,2019
13069,36.3,43021,25010,12230,5034,9913,40859,14438,9112,5326,14438,100600,2019
13071,36.8,45486,25418,10535,8737,10663,36435,15505,9763,5742,15505,85600,2019
13073,36.9,150705,103491,24995,10094,35036,82339,47215,37541,9674,47215,203400,2019
13075,37.3,17177,11116,4624,993,4243,41854,6217,4127,2090,6217,87500,2019
13077,39,143260,101717,25318,10040,38530,75913,52035,37896,14139,52035,211600,2019
13079,44.4,12325,9030,2708,407,3122,46283,4510,3515,995,4510,93400,2019
13081,38.5,22713,11330,10344,782,5712,36042,8585,4678,3907,8585,83100,2019
13083,42.6,16197,15116,106,370,4539,42581,6195,4429,1766,6195,123500,2019
13085,43.6,24536,22598,258,1153,6491,66281,9041,7371,1670,9041,230300,2019
13087,37.8,26682,13397,11219,1623,7113,41481,10084,5797,4287,10084,110900,2019
13089,35.8,749323,218260,400411,63947,163516,62399,282436,154322,128114,282436,215600,2019
13091,41.8,20829,13484,5987,736,5167,39302,7628,5174,2454,7628,76300,2019
13093,43.2,13736,5850,6741,953,3350,37340,5020,3493,1527,5020,83300,2019
13095,35.6,89703,22628,62245,2565,20710,39584,34087,15679,18408,34087,103500,2019
13097,36.5,143316,58078,65820,13848,34817,63835,49187,31638,17549,49187,161600,2019
13099,39.9,10312,4663,5383,84,2659,30640,4074,2606,1468,4074,86900,2019
13101,40.6,3981,2640,79,1086,1097,39494,1561,1058,503,1561,59100,2019
13103,36,60477,47339,7956,2686,15424,66822,21172,16076,5096,21172,163600,2019
13105,42.6,19166,12173,5674,1093,5065,38678,7559,5460,2099,7559,84700,2019
13107,36.9,22533,13355,7632,1015,5683,37453,8387,5354,3033,8387,73100,2019
13109,37.6,10687,6012,3168,1253,2747,42607,4020,2734,1286,4020,87900,2019
13111,52.1,25395,24098,63,600,7083,47997,10408,8226,2182,10408,197800,2019
13113,43.4,112303,69850,25282,8115,31120,90145,40285,33015,7270,40285,281400,2019
13115,38.3,97369,68902,13507,10776,24946,48336,35679,21780,13899,35679,132400,2019
13117,38.5,228383,163760,7577,21686,62720,107218,76753,64504,12249,76753,339700,2019
13119,41.2,22766,19001,2119,1044,6123,42488,8460,5620,2840,8460,108700,2019
13121,35.5,1036200,410771,451908,74764,220445,69673,410576,211868,198708,410576,313300,2019
13123,47.2,30414,26116,126,3523,8028,52625,12021,8950,3071,12021,177500,2019
13125,42.7,2996,2618,306,37,726,45000,1108,828,280,1108,81700,2019
13127,41.6,84470,53687,22022,5589,22255,52977,34119,21340,12779,34119,179000,2019
13129,38.4,57202,44341,2137,9060,15002,45865,20561,13394,7167,20561,136000,2019
13131,40.3,24828,14393,7167,2846,6320,43531,9136,5872,3264,9136,119800,2019
13133,50.2,17349,9979,6073,1049,4975,52129,7132,5324,1808,7132,210300,2019
13135,35.3,915046,341205,247238,193683,222097,71026,293330,194378,98952,293330,217900,2019
13137,39.7,44626,34493,1424,6599,10440,50563,15139,11848,3291,15139,150500,2019
13139,36.7,198667,120829,14059,56409,48149,62984,64352,44697,19655,64352,201300,2019
13141,45.6,8515,2070,6227,142,1755,31860,2974,2099,875,2974,85000,2019
13143,40.4,29227,26560,1481,498,7960,48550,11259,7699,3560,11259,124200,2019
13145,42.9,34105,26219,5486,1213,9581,76319,12156,10654,1502,12156,217000,2019
13147,44.1,25773,19280,4958,940,6743,43204,9853,7370,2483,9853,137700,2019
13149,41.9,11736,9948,1024,322,3254,51358,4502,3201,1301,4502,109000,2019
13151,36.9,225356,97850,97870,15374,58811,71288,75984,53461,22523,75984,175300,2019
13153,35.4,153507,86349,47122,10026,40562,61723,57056,36289,20767,57056,142600,2019
13155,39.7,9320,6224,2637,357,2090,37736,3329,2450,879,3329,79800,2019
13157,38.1,67885,55223,4501,5198,17847,65385,23166,18041,5125,23166,189700,2019
13159,43,13916,10327,2838,546,3807,51250,5171,3973,1198,5171,139400,2019
13161,36.6,15036,10653,2467,1822,3790,36669,5279,3437,1842,5279,79800,2019
13163,40,15618,6561,8294,600,3598,33944,5664,3579,2085,5664,72500,2019
13165,44.3,8793,4807,3070,718,2095,27375,3443,2459,984,3443,74500,2019
13167,41.8,9691,6047,3213,239,2208,42446,3393,2282,1111,3393,64100,2019
13169,40.4,28579,20415,7019,476,7670,56020,10701,8587,2114,10701,124100,2019
13171,37.8,18672,12167,5489,458,3746,44846,6494,4497,1997,6494,145600,2019
13173,35.6,10380,7122,2532,594,2536,40986,3714,2392,1322,3714,114900,2019
13175,38.9,47405,27124,17646,1286,11549,39120,17142,11005,6137,17142,94600,2019
13177,37.2,29502,21134,6108,878,7872,69280,10226,7440,2786,10226,152800,2019
13179,28.4,61349,23847,24602,7737,16657,48007,23485,10739,12746,23485,124500,2019
13181,47.1,7856,5199,2433,143,2142,39742,3475,2606,869,3475,127700,2019
13183,32.9,18692,10821,4639,2108,4146,54605,5695,3935,1760,5695,122100,2019
13185,30.5,115364,62042,41948,6535,25905,42441,41282,21597,19685,41282,140600,2019
13187,37,32402,29344,660,1569,7800,51790,11570,8176,3394,11570,185800,2019
13189,37.7,21455,11483,8561,656,5770,43468,8153,4995,3158,8153,109500,2019
13191,49.4,14174,8802,5020,40,4065,49504,6042,4819,1223,6042,128000,2019
13193,40.3,13305,4302,8178,571,3033,32161,4696,3005,1691,4696,63800,2019
13195,41.1,29218,23914,3108,1595,8153,52500,10744,8027,2717,10744,131300,2019
13197,44.6,8432,4994,2568,614,2396,44643,3408,2672,736,3408,90000,2019
13199,42.3,21106,11893,8388,464,5504,37121,8051,5514,2537,8051,103300,2019
13201,43.5,5787,3934,1754,25,1556,44542,2333,1528,805,2333,89400,2019
13205,39,22244,10199,10312,1019,5454,38116,7982,4964,3018,7982,85400,2019
13207,42.9,27171,19674,6304,631,6179,54754,9760,7725,2035,9760,166900,2019
13209,40,9058,5918,2332,597,2102,41996,3097,2142,955,3097,84000,2019
13211,44.6,18507,13316,4218,595,5250,66178,6942,5084,1858,6942,229000,2019
13213,38.2,39724,32789,413,5974,10557,48033,14385,10015,4370,14385,108300,2019
13215,34,195739,78974,89275,14903,44801,46408,72759,34936,37823,72759,141300,2019
13217,36.4,108079,50197,47914,6035,26621,56316,37018,25034,11984,37018,151800,2019
13219,40.4,38132,32083,1993,2017,10727,90751,13423,11132,2291,13423,286600,2019
13221,42.4,14931,11294,2624,682,3711,47120,5651,4362,1289,5651,118500,2019
13223,36,159825,113468,29547,10125,41482,68370,53299,40386,12913,53299,173600,2019
13225,37.9,27145,12424,12124,2092,6596,46636,10136,6628,3508,10136,135100,2019
13227,45.4,31387,27188,324,970,8539,67631,11868,9008,2860,11868,200200,2019
13229,39.4,19250,16176,1799,973,5319,42804,7048,5461,1587,7048,104400,2019
13231,40.4,18327,15928,1639,298,4525,64878,6143,5158,985,6143,173000,2019
13233,37,41908,30176,5002,5482,10151,44891,15038,9712,5326,15038,110700,2019
13235,43.1,11216,6437,4228,351,2479,45148,3687,2370,1317,3687,120100,2019
13237,46.2,21691,14248,5684,1378,6282,51606,8937,6883,2054,8937,160400,2019
13239,47.3,2289,848,1188,17,577,26667,842,591,251,842,59900,2019
13241,49.2,16645,14598,316,1334,4220,42500,6662,4947,1715,6662,174500,2019
13243,41,6973,2416,4351,98,1611,31699,2553,1460,1093,2553,71900,2019
13245,34.1,201852,69706,112183,9937,43345,42728,71400,37587,33813,71400,108000,2019
13247,38.1,89717,28460,48243,9173,22786,60189,31076,20622,10454,31076,163900,2019
13249,37.8,5221,3550,1312,340,1452,44448,1864,1333,531,1864,125300,2019
13251,41.4,13989,7618,5824,303,3395,39842,5098,3746,1352,5098,81200,2019
13253,44.9,8321,5118,2737,267,2162,33357,3363,2195,1168,3363,81100,2019
13255,39.2,65306,38215,22261,2978,16460,47111,24336,15204,9132,24336,122800,2019
13257,41.8,25750,21205,3064,896,6783,47164,9543,6661,2882,9543,105300,2019
13259,35.4,6293,1471,3299,1180,1138,29732,1816,1335,481,1816,49200,2019
13261,35.7,30064,11839,15670,1711,7256,36681,11510,6389,5121,11510,95700,2019
13263,50.1,6321,2572,3649,38,1849,38549,2809,2219,590,2809,86400,2019
13265,44.2,1611,528,1000,64,399,37446,593,409,184,593,80200,2019
13267,37.3,25382,14635,7404,2914,5875,40730,8241,5534,2707,8241,89200,2019
13269,45.2,8116,4652,3081,213,2208,33832,3473,2449,1024,3473,83600,2019
13271,41.5,16035,7848,6173,1829,3259,32405,4668,3127,1541,4668,64600,2019
13273,41.1,8737,3111,5077,246,2348,34768,3399,1870,1529,3399,92100,2019
13275,40.4,44630,25712,16172,1657,12161,43740,17595,10774,6821,17595,146800,2019
13277,36.2,40541,22644,11959,4776,10703,45639,15144,9087,6057,15144,118100,2019
13279,36.4,26972,16247,6891,3153,6537,40175,10030,6072,3958,10030,95300,2019
13281,54,11617,10930,147,318,3240,48219,4898,3833,1065,4898,230500,2019
13283,40.1,6795,4896,1792,90,1654,32241,2490,1666,824,2490,69400,2019
13285,36.4,69919,39347,25245,2572,16947,45649,24928,14304,10624,24928,136700,2019
13287,40.3,7943,4269,3200,379,2297,37039,3169,2191,978,3169,79700,2019
13289,45.7,8229,4530,3526,59,1838,34879,3044,2462,582,3044,65100,2019
13291,54.3,23288,21859,173,771,6957,50021,9743,7524,2219,9743,196500,2019
13293,42.1,26236,17634,7120,606,6100,37640,10154,6861,3293,10154,93300,2019
13295,41.4,69039,62742,2840,1531,18414,46157,25975,18660,7315,25975,120600,2019
13297,38.7,91442,68250,16120,4014,24427,61599,31670,23517,8153,31670,190300,2019
13299,39.5,35593,22547,10622,1461,8909,36869,13823,8791,5032,13823,83100,2019
13301,45.1,5297,1986,3237,25,1456,37203,2244,1494,750,2244,66200,2019
13303,41.5,20436,8691,10755,506,5315,38068,7503,4997,2506,7503,84800,2019
13305,38.9,29788,21200,6030,1866,7166,45483,10400,6605,3795,10400,105400,2019
13307,45.1,2610,1353,971,228,724,37297,1140,957,183,1140,65700,2019
13309,38.8,7928,4454,3440,11,1159,30192,1862,1178,684,1862,58800,2019
13311,46.1,29489,27218,430,958,8581,52493,11695,8872,2823,11695,176300,2019
13313,36,104237,60904,3918,36599,25719,48623,35629,23006,12623,35629,133400,2019
13315,39.8,8824,5163,3131,411,1807,36964,2575,1960,615,2575,61800,2019
13317,45.1,9844,5014,4193,498,2421,37838,3979,2684,1295,3979,87200,2019
13319,42.6,9010,5109,3509,259,2079,38996,3185,2396,789,3185,70700,2019
13321,41.6,20494,13793,5741,451,5896,45398,8002,5236,2766,8002,98700,2019
15001,42.7,199459,60447,1159,25386,46248,62409,69453,47047,22406,69453,350000,2019
15003,37.9,984821,180889,22158,96985,218918,85857,312795,175751,137044,312795,678200,2019
15005,57.4,66,15,2,2,9,69375,39,0,39,39,NA,2019
15007,42.6,71769,21189,290,7933,15924,83554,22658,14320,8338,22658,570700,2019
15009,41.2,165979,50182,768,18812,38249,80948,54479,33259,21220,54479,633500,2019
16001,37,456849,386787,5868,37469,110065,66293,173353,120145,53208,173353,270800,2019
16003,55.2,4097,3774,16,147,1204,48856,1757,1411,346,1757,215500,2019
16005,33.8,85765,71764,595,7381,20061,51734,31155,21042,10113,31155,160000,2019
16007,39.6,6000,5575,53,257,1808,54167,2424,1856,568,2424,149800,2019
16009,46.2,9138,7734,6,332,2308,47556,3418,2505,913,3418,167000,2019
16011,33.6,45839,33799,130,8247,11199,55472,14989,11510,3479,14989,160100,2019
16013,43.2,22373,16696,98,5062,4986,56694,7995,5601,2394,7995,428900,2019
16015,54,7378,6709,19,338,2242,59646,3205,2655,550,3205,232300,2019
16017,47.9,43611,40594,98,1354,11984,50256,17537,13269,4268,17537,254200,2019
16019,32.9,114392,94977,508,14916,28553,60615,39768,27689,12079,39768,181200,2019
16021,43.5,11845,10702,63,590,2877,43423,4653,3567,1086,4653,205000,2019
16023,45.2,2581,2445,4,132,647,42132,967,796,171,967,128900,2019
16025,44.5,1048,1028,0,17,240,39688,394,298,96,394,183300,2019
16027,33.6,217633,153011,887,55034,51078,52134,72807,50603,22204,72807,178300,2019
16029,36.9,6953,6377,0,405,1833,59053,2538,2013,525,2538,145900,2019
16031,32.9,23690,16546,52,6446,6047,52935,7711,5418,2293,7711,162100,2019
16033,33.2,913,421,7,443,190,46154,290,181,109,290,98100,2019
16035,50.4,8673,7827,46,367,2123,43915,3555,2775,780,3555,155900,2019
16037,53,4169,3719,5,175,1112,40875,1774,1395,379,1774,191600,2019
16039,32.3,26743,19426,695,4564,7050,46855,10606,6343,4263,10606,153800,2019
16041,32.8,13464,12263,35,909,3493,57215,4397,3574,823,4397,211900,2019
16043,37.6,13020,11047,20,1629,3579,58065,4347,3530,817,4347,169900,2019
16045,44.6,17331,15207,20,1451,4585,45492,6683,4999,1684,6683,168700,2019
16047,38.7,15148,10279,13,4403,3840,47204,5469,3854,1615,5469,157800,2019
16049,50.2,16411,14927,23,558,4354,41516,6407,4913,1494,6407,173200,2019
16051,31.5,28534,24750,0,3004,7026,63048,8791,7092,1699,8791,203700,2019
16053,32.7,23730,14593,36,8565,5705,52921,8022,5208,2814,8022,164600,2019
16055,40.2,157322,142577,465,7270,42425,57242,62304,43861,18443,62304,260300,2019
16057,28.7,39505,35040,458,1726,8473,49158,15422,8378,7044,15422,228200,2019
16059,52.1,7847,7320,3,268,2078,39324,3582,2781,801,3582,177000,2019
16061,48.6,3838,3217,5,175,919,41198,1646,1143,503,1646,132300,2019
16063,35.1,5350,3538,0,1644,1264,50053,1724,1176,548,1724,145600,2019
16065,23.5,39100,34525,65,2964,9077,39160,11016,4913,6103,11016,219100,2019
16067,35.2,20705,12839,32,7302,5483,53370,7250,5322,1928,7250,149600,2019
16069,40.8,40217,34974,143,1579,10734,58107,16384,11931,4453,16384,191500,2019
16071,38.6,4385,4096,5,197,1157,53841,1615,1290,325,1615,167100,2019
16073,38.9,11552,7913,61,3031,3113,43798,4321,3064,1257,4321,147800,2019
16075,40.4,23260,18241,19,4034,6017,50579,8876,6449,2427,8876,165600,2019
16077,38.3,7671,4704,6,2616,1782,48823,2633,1959,674,2633,151300,2019
16079,47.3,12609,11500,43,449,3473,39386,5466,3824,1642,5466,127900,2019
16081,37.2,11426,9274,0,1928,2468,74216,3707,2882,825,3707,346600,2019
16083,34.7,84869,67080,689,13890,21580,52919,31146,21447,9699,31146,166800,2019
16085,50.6,10709,10130,6,495,2765,64475,3869,3127,742,3869,314800,2019
16087,45.4,10057,7938,19,1713,2708,40992,4035,2927,1108,4035,148900,2019
17001,41.5,66085,60589,2682,1059,17606,52993,27112,19478,7634,27112,127800,2019
17003,45.3,6260,3929,2094,82,1357,36806,2154,1588,566,2154,56000,2019
17005,41.6,16589,14565,1250,584,4110,57289,6299,4778,1521,6299,119700,2019
17007,38.5,53537,39083,1121,11673,13898,69272,18571,15042,3529,18571,153400,2019
17009,38.9,6628,4895,1252,440,1302,61655,2055,1537,518,2055,96200,2019
17011,44.4,33122,29047,338,3029,9284,57436,13698,10494,3204,13698,111700,2019
17013,46.8,4830,4684,15,61,1154,63009,1664,1452,212,1664,121000,2019
17015,48.3,14466,13464,175,535,4023,52410,6508,4986,1522,6508,106100,2019
17017,40,12493,9430,538,2362,3336,52373,5043,3762,1281,5043,80800,2019
17019,30.1,209922,140989,28016,12518,42335,52797,82369,43636,38733,82369,162100,2019
17021,43.4,32931,31291,430,535,8580,52834,13901,10435,3466,13901,90900,2019
17023,42.3,15716,15170,105,248,4820,56531,6720,5147,1573,6720,92500,2019
17025,42.6,13287,12766,107,17,3818,48500,5696,4245,1451,5696,84500,2019
17027,40.6,37634,34412,1298,1175,9583,66639,14353,11432,2921,14353,146200,2019
17029,35.7,51353,46691,1986,1300,12001,46202,20926,12865,8061,20926,100500,2019
17031,36.8,5198275,2198122,1199175,1314796,1183272,64660,1972108,1122584,849524,1972108,246600,2019
17033,41.8,18972,16632,1215,621,4974,49779,7666,5954,1712,7666,87800,2019
17035,42.5,10836,10475,8,116,2947,56206,4299,3382,917,4299,105800,2019
17037,31.1,104366,80167,8094,11637,23164,63317,38150,21757,16393,38150,173100,2019
17039,43.6,15932,15074,85,436,4345,55587,6694,5270,1424,6694,99500,2019
17041,37.8,19623,17712,135,1425,5061,56714,7613,5633,1980,7613,111400,2019
17043,39.3,929060,621563,43661,132597,239160,92809,342791,251502,91289,342791,308500,2019
17045,45.2,17407,17087,31,210,5138,53647,7542,5770,1772,7542,82800,2019
17047,43.5,6455,6228,51,89,1803,51080,2773,2224,549,2773,79300,2019
17049,39.4,34137,32720,171,719,9177,56685,13877,10462,3415,13877,143600,2019
17051,41.9,21565,19868,1007,403,5297,46650,7737,6228,1509,7737,88300,2019
17053,43.4,13270,12406,150,443,3547,52092,5771,4167,1604,5771,98300,2019
17055,42.8,38923,37309,284,655,9861,42769,16235,12050,4185,16235,76100,2019
17057,43.2,35092,32209,1317,1061,8828,51643,13940,10913,3027,13940,88600,2019
17059,45.6,5064,4842,26,66,1506,44076,2293,1767,526,2293,73900,2019
17061,42.5,13132,12635,183,159,3272,49885,4949,3838,1111,4949,81000,2019
17063,37.9,50666,43718,589,5019,14016,77350,19676,14022,5654,19676,199300,2019
17065,43.6,8176,8070,33,61,2364,54046,3400,2721,679,3400,93500,2019
17067,46,17983,17291,109,269,4937,52561,7409,6030,1379,7409,85600,2019
17069,46.8,3939,3727,107,37,929,51250,1363,1117,246,1363,80500,2019
17071,50,6809,6533,9,123,2006,53676,2977,2447,530,2977,92000,2019
17073,43.1,49267,44555,938,2808,13474,59933,19856,15616,4240,19856,119200,2019
17075,44.4,27812,24984,227,1941,7657,52700,11741,8939,2802,11741,102800,2019
17077,31.9,57977,42915,8663,2567,12278,37241,23883,12292,11591,23883,108600,2019
17079,43.1,9594,9303,47,34,2423,54256,3711,2927,784,3711,99500,2019
17081,40.9,37985,32496,3169,1016,9810,49896,14985,10976,4009,14985,96700,2019
17083,42.9,21937,20979,96,309,5753,63028,8499,6963,1536,8499,147900,2019
17085,49.9,21588,20436,123,654,6265,57946,9970,7814,2156,9970,149100,2019
17087,43.7,12494,10618,1383,395,3042,52774,4303,3621,682,4303,109500,2019
17089,37.3,531376,303165,28109,169364,131759,79394,179637,132690,46947,179637,238300,2019
17091,37.7,110637,79624,16714,11504,26266,58902,39796,27072,12724,39796,147900,2019
17093,35.2,126054,87604,8815,23571,32061,96563,40721,34036,6685,40721,235600,2019
17095,42.1,50508,41855,4281,2909,11795,44129,20680,13797,6883,20680,83000,2019
17097,38.4,701473,432361,45923,152141,180068,89427,246122,179679,66443,246122,265100,2019
17099,41.9,109737,93764,2833,10658,29317,58142,45095,32379,12716,45095,127200,2019
17101,42.4,16033,13557,1323,615,4106,46636,6306,4677,1629,6306,78400,2019
17103,43.2,34389,29640,1875,2139,8379,58194,13788,9971,3817,13788,119900,2019
17105,42,36040,32131,1488,1647,9446,55160,14307,10417,3890,14307,109400,2019
17107,40.1,29003,25049,1984,985,6770,57308,10797,7854,2943,10797,103200,2019
17109,33,30479,26782,1422,844,5913,44471,11408,7569,3839,11408,91800,2019
17111,40.2,307714,249502,4231,40266,83380,86799,112453,89278,23175,112453,224500,2019
17113,33.1,172578,137144,14247,8495,40203,67675,65845,42551,23294,65845,167000,2019
17115,41.1,105528,80477,15490,2405,26102,50480,43912,30039,13873,43912,98400,2019
17117,43.7,45463,43670,434,560,12855,55159,18875,14484,4391,18875,100600,2019
17119,40.2,264776,225251,22602,8626,69986,60738,107659,76830,30829,107659,135600,2019
17121,42.2,37743,34411,1368,765,9980,47519,15946,11730,4216,15946,77900,2019
17123,46,11679,11040,31,352,3120,58465,4884,3997,887,4884,104900,2019
17125,45.2,13621,13138,103,153,3793,48417,5977,4653,1324,5977,83000,2019
17127,43.5,14219,12547,830,419,3906,47481,5822,4395,1427,5822,83600,2019
17129,43.2,12306,11763,54,188,3743,74684,5188,4051,1137,5188,146900,2019
17131,44.9,15589,14856,98,380,4384,59787,6516,5150,1366,6516,107600,2019
17133,42,34168,32900,60,525,10105,85747,13586,11334,2252,13586,211300,2019
17135,43.3,28828,26883,1078,510,7468,52748,11522,8799,2723,11522,84100,2019
17137,40.8,34247,30195,2319,849,8401,51437,13719,9400,4319,13719,110100,2019
17139,40.7,14641,14144,112,212,3942,61456,5959,4626,1333,5959,107400,2019
17141,42.4,51025,44283,520,5166,14112,60986,21021,15390,5631,21021,146900,2019
17143,37.5,182770,127756,32183,8787,43697,55842,73253,47687,25566,73253,129800,2019
17145,42.2,21251,18231,1925,662,5661,52428,8433,6360,2073,8433,86500,2019
17147,42.9,16401,15779,91,222,4722,70849,6692,5520,1172,6692,138600,2019
17149,42,15672,15021,185,202,4073,47492,6309,4957,1352,6309,85400,2019
17151,52.5,4203,3823,177,116,967,38056,1694,1398,296,1694,93000,2019
17153,44,5510,3507,1665,128,1289,34640,2095,1600,495,2095,61300,2019
17155,48.1,5721,5262,30,320,1629,63638,2413,1943,470,2413,126800,2019
17157,41.6,32295,27402,3252,1014,7785,53816,11883,8792,3091,11883,110200,2019
17159,42,15766,15008,125,270,4073,48894,6452,4595,1857,6452,89600,2019
17161,40.1,143873,103282,14156,18491,37525,54858,60546,41165,19381,60546,119400,2019
17163,38.6,262338,161693,78281,10748,65167,55179,104105,67869,36236,104105,128000,2019
17165,42.2,23994,21957,632,428,6654,44090,9972,7432,2540,9972,73800,2019
17167,40.3,196861,158154,24955,4532,50223,61912,83711,57673,26038,83711,141200,2019
17169,46.3,6953,6166,611,67,1681,52357,2775,2102,673,2775,86600,2019
17171,44.6,5005,4840,7,64,1383,57118,1939,1550,389,1939,89200,2019
17173,45.1,21737,21133,147,229,6185,52953,9189,7444,1745,9189,96500,2019
17175,45.1,5447,5198,53,95,1525,54907,2315,1817,498,2315,87700,2019
17177,45.3,45093,37180,4334,1787,12632,48805,19739,13801,5938,19739,97800,2019
17179,41,133195,125134,1645,3116,36136,63454,54291,41480,12811,54291,142000,2019
17181,43.7,16968,15452,273,880,4559,50625,6654,5141,1513,6654,109900,2019
17183,40.4,77563,60675,10837,3905,19415,46515,31151,21666,9485,31151,79900,2019
17185,43.8,11546,10839,76,308,3225,50770,4839,3774,1065,4839,82800,2019
17187,39.8,17146,14268,498,1640,4558,50310,6862,5099,1763,6862,83900,2019
17189,43.9,14058,13495,121,203,4060,61763,6020,4665,1355,6020,113500,2019
17191,43.4,16402,15777,248,102,4529,50251,7051,5401,1650,7051,86400,2019
17193,44.3,13868,13348,97,202,4003,49290,6041,4868,1173,6041,71500,2019
17195,43.4,56016,47374,861,6723,14963,54232,23084,17279,5805,23084,106700,2019
17197,37.9,689315,438965,76586,119765,171227,86961,229498,186528,42970,229498,232000,2019
17199,41.2,67102,60188,2749,1771,16953,50734,27029,18949,8080,27029,114900,2019
17201,39.7,284819,196571,35837,36371,73899,54489,114779,75592,39187,114779,120400,2019
17203,40.5,38700,36957,234,707,10491,72808,14499,11857,2642,14499,168700,2019
18001,33.5,35376,33071,399,1601,8791,52504,12481,9623,2858,12481,129300,2019
18003,35.9,372575,275145,42030,27818,93587,54857,145065,99264,45801,145065,129300,2019
18005,37.8,82481,67210,1267,5572,20689,63431,31452,22470,8982,31452,153500,2019
18007,40.5,8677,8025,43,452,2265,49488,3432,2541,891,3432,92500,2019
18009,44,12013,11475,4,196,3474,43505,5235,3911,1324,5235,70600,2019
18011,38.1,65544,59387,1137,1966,18514,83077,25485,19658,5827,25485,233700,2019
18013,50,15064,14410,98,259,4508,61030,6189,5224,965,6189,191700,2019
18015,42.9,20074,18853,233,814,5413,54806,8002,6457,1545,8002,131700,2019
18017,40.8,37880,30194,427,5817,9486,49415,14688,10863,3825,14688,89300,2019
18019,39.1,116507,96942,7794,6264,28767,55630,44200,31442,12758,44200,142800,2019
18021,41.5,26234,25221,220,142,7529,55637,10543,8177,2366,10543,101400,2019
18023,37.8,32273,26509,216,5118,8187,54286,12033,8492,3541,12033,111500,2019
18025,43,10569,10151,41,158,2552,41662,3835,3168,667,3835,91900,2019
18027,34.4,33120,30324,638,1646,8066,53629,11227,8250,2977,11227,130000,2019
18029,42.5,49479,47567,411,646,13710,68658,18870,15027,3843,18870,170400,2019
18031,39.2,26562,25241,173,533,6935,57949,10353,7230,3123,10353,134400,2019
18033,39.1,42927,40787,243,1202,11552,56421,16801,12781,4020,16801,124300,2019
18035,35.6,115020,99836,7885,2847,27126,43512,46026,29215,16811,46026,93600,2019
18037,40.3,42543,38378,276,3329,11205,60666,16893,13160,3733,16893,156500,2019
18039,35.6,204558,152973,11054,32583,50065,57021,71718,50067,21651,71718,144300,2019
18041,42.8,23194,22152,550,289,6441,46175,9584,6662,2922,9584,81900,2019
18043,39.8,77320,67904,3937,2535,19384,64468,29189,21295,7894,29189,171400,2019
18045,43.4,16430,15660,37,414,4694,52874,6974,5312,1662,6974,103000,2019
18047,42.2,22774,22053,33,183,6476,62462,8687,7293,1394,8687,160200,2019
18049,41.3,20096,18440,186,1045,5000,52034,7799,5822,1977,7799,103600,2019
18051,40.3,33656,31492,738,545,9353,55462,13340,10068,3272,13340,116100,2019
18053,40.3,66452,56430,4633,2846,16914,44356,26372,18046,8326,26372,92700,2019
18055,43.1,32159,31071,113,468,8648,51613,12781,10175,2606,12781,97600,2019
18057,37.1,323117,270351,12585,12928,88340,98173,119789,92174,27615,119789,263300,2019
18059,39.8,75164,69435,1780,1777,20239,74072,28740,22774,5966,28740,169300,2019
18061,42.3,39940,38089,238,769,10033,57712,14403,11953,2450,14403,151900,2019
18063,37.7,163799,138000,10993,6394,43470,81933,59015,46306,12709,59015,191700,2019
18065,42.1,48255,45115,1204,878,12307,49832,18304,13451,4853,18304,100400,2019
18067,41.7,82331,70047,6169,2769,22448,52373,34701,24376,10325,34701,109500,2019
18069,40.7,36359,34459,327,894,9907,53632,14742,11125,3617,14742,107200,2019
18071,38.5,44025,38802,473,3086,11744,51250,16753,12072,4681,16753,125300,2019
18073,40.3,33447,30626,199,2012,8741,63892,12533,9601,2932,12533,159700,2019
18075,39.7,20840,19773,76,647,5354,47658,8174,5968,2206,8174,91400,2019
18077,40.8,32201,29814,667,901,8240,52718,12632,9078,3554,12632,132900,2019
18079,39.8,27710,26332,395,683,7391,54191,10792,8390,2402,10792,109800,2019
18081,37.5,153716,136803,3664,5498,40455,72440,56628,41141,15487,56628,164600,2019
18083,37.9,37065,34360,1023,752,9577,47380,15038,9708,5330,15038,96800,2019
18085,38.5,79035,69428,589,6293,21851,61366,30997,23179,7818,30997,150000,2019
18087,31.1,39193,36890,75,1587,9530,64498,12325,10124,2201,12325,195900,2019
18089,39.1,485707,262879,113562,92189,122450,56128,186731,130138,56593,186731,149500,2019
18091,40.3,110154,87323,12027,7269,28012,53658,43039,31135,11904,43039,132600,2019
18093,43.1,45548,43582,180,761,12671,53610,18781,14457,4324,18781,117400,2019
18095,40.4,129455,109837,10037,5301,33277,49522,51003,35519,15484,51003,97300,2019
18097,34.3,951869,525866,263127,98928,202926,48316,372358,200544,171814,372358,136700,2019
18099,40,46461,40543,266,4688,11963,52658,17304,12929,4375,17304,138700,2019
18101,42.7,10212,9910,77,117,2513,52726,4187,3274,913,4187,117100,2019
18103,40.1,35815,31775,1926,1151,9159,50657,13611,9730,3881,13611,88700,2019
18105,29.6,146461,122315,4431,4998,29273,49839,55624,31106,24518,55624,175600,2019
18107,40.2,38287,35177,277,1836,10360,55522,15382,11005,4377,15382,125700,2019
18109,41.5,69922,67126,285,1102,18734,64335,26034,20084,5950,26034,160700,2019
18111,43.1,13992,13006,33,898,3835,55356,5573,4342,1231,5573,118400,2019
18113,38.7,47506,41360,228,4888,12569,56789,18276,14002,4274,18276,125800,2019
18115,47.4,5874,5663,23,74,1792,60128,2555,1948,607,2555,151200,2019
18117,42.4,19545,18586,500,125,5323,47917,7898,5874,2024,7898,94700,2019
18119,45.2,20835,20032,47,262,5823,49543,8776,6950,1826,8776,117600,2019
18121,43.2,16946,16013,99,274,4383,52618,6057,4770,1287,6057,88900,2019
18123,42,19102,17976,552,266,4965,52348,7615,5920,1695,7615,111500,2019
18125,43.7,12378,11923,109,115,3277,50194,5129,4224,905,5129,93400,2019
18127,39.5,168636,140304,5841,16813,44006,71152,64517,48434,16083,64517,185400,2019
18129,42.6,25560,24522,373,305,7259,64196,10155,8299,1856,10155,144200,2019
18131,41.6,12559,11821,24,378,3349,49580,5151,3911,1240,5151,102700,2019
18133,37.9,37384,34304,951,721,9244,61047,13543,9697,3846,13543,128800,2019
18135,42.6,24926,23125,147,863,6496,48036,10229,7803,2426,10229,81200,2019
18137,40.7,28391,27126,111,520,7486,56332,10992,8342,2650,10992,152100,2019
18139,41.7,16641,15923,271,275,4711,54346,6667,4758,1909,6667,112600,2019
18141,36.6,270216,196069,34235,23501,64005,52769,101872,69452,32420,101872,129000,2019
18143,41.5,23759,22658,48,541,6216,48700,8971,6456,2515,8971,103000,2019
18145,40.8,44438,41006,519,1873,11945,60404,17823,13064,4759,17823,133200,2019
18147,44,20447,19397,143,593,5681,57305,8127,6652,1475,8127,127700,2019
18149,41.5,22952,21628,198,869,5835,51190,8549,6852,1697,8549,115500,2019
18151,43.7,34453,32317,114,1220,9459,58279,14261,11091,3170,14261,148800,2019
18153,41,20730,19056,804,360,5316,50245,7644,5685,1959,7644,86000,2019
18155,40.5,10685,10191,102,211,3057,49383,4349,3255,1094,4349,116400,2019
18157,28.2,191553,145252,9951,15948,38810,53130,70526,38848,31678,70526,153000,2019
18159,45.1,15162,14387,16,425,4348,58118,6376,5210,1166,6376,116000,2019
18161,43.5,7113,6787,4,126,1868,50375,2823,2032,791,2823,116300,2019
18163,38.3,181291,151571,17223,4814,44743,49708,75607,48981,26626,75607,129000,2019
18165,42.9,15539,14984,178,137,4457,50243,6664,4874,1790,6664,79700,2019
18167,36.2,107459,91866,7163,2886,24691,45230,41994,25956,16038,41994,97500,2019
18169,42.3,31389,29611,331,819,8491,54259,12862,9516,3346,12862,100500,2019
18171,44.4,8237,7901,47,149,2514,60553,3357,2815,542,3357,122100,2019
18173,41.2,62280,57543,1028,1165,17831,73482,24514,19245,5269,24514,168200,2019
18175,41.6,27848,26947,26,374,7718,47983,10940,8513,2427,10940,118100,2019
18177,40.6,66342,58470,3163,1990,17220,46516,26644,17837,8807,26644,100500,2019
18179,40.3,28011,26429,224,861,7769,59237,10888,8586,2302,10888,127600,2019
18181,42,24149,21572,114,2021,6805,54576,9879,7661,2218,9879,113500,2019
18183,41.8,33730,32187,137,694,9606,61741,13742,11293,2449,13742,143100,2019
19001,45.4,7085,6801,39,146,2021,53363,3200,2378,822,3200,104600,2019
19003,47.3,3670,3598,2,49,1033,49255,1598,1306,292,1598,87500,2019
19005,44.4,13813,12496,176,914,3799,52216,5953,4723,1230,5953,130400,2019
19007,45.7,12452,11850,89,250,3188,40167,5353,3801,1552,5353,81400,2019
19009,48.1,5571,5380,2,32,1596,52055,2649,2034,615,2649,79500,2019
19011,42.6,25636,24618,133,386,7321,67729,10306,8538,1768,10306,157200,2019
19013,35.2,132393,107356,12444,5827,31430,53539,52905,34645,18260,52905,147500,2019
19015,41.8,26370,24878,168,695,7318,64000,10954,8558,2396,10954,132700,2019
19017,39.8,24864,23634,219,392,6739,70395,9676,8000,1676,9676,165700,2019
19019,39.1,21118,20295,36,333,5569,64837,8029,6368,1661,8029,142500,2019
19021,35,20058,11948,505,5112,5014,57125,7524,4861,2663,7524,115600,2019
19023,43.9,14628,14124,150,202,4250,57115,6254,4872,1382,6254,116700,2019
19025,44.6,9744,9183,150,190,2672,52323,4146,3268,878,4146,82000,2019
19027,42,20281,19661,19,506,5681,59212,8726,6617,2109,8726,138900,2019
19029,44.9,13091,12475,26,354,3369,50187,5921,4099,1822,5921,102100,2019
19031,42.7,18457,17635,260,377,4820,67795,7391,6003,1388,7391,156000,2019
19033,44.3,42834,38805,743,2086,11457,53963,19241,13297,5944,19241,128600,2019
19035,46.3,11343,10593,228,182,3168,56550,5319,3969,1350,5319,106700,2019
19037,44.5,12026,11516,119,304,3215,60034,5173,4173,1000,5173,119100,2019
19039,40.5,9360,7736,6,1337,2400,54427,3895,2743,1152,3895,110300,2019
19041,42.9,16211,15113,47,598,4502,50521,7212,4884,2328,7212,124100,2019
19043,47.3,17625,16907,170,339,4645,53152,7510,5597,1913,7510,121700,2019
19045,42.2,46909,42753,1290,1472,12291,51688,19635,14385,5250,19635,118100,2019
19047,38.7,17034,11212,464,4782,4484,55755,6437,4451,1986,6437,93400,2019
19049,35.4,87099,74403,1654,5334,23525,88479,34399,25363,9036,34399,248100,2019
19051,36.8,8920,8636,4,131,2285,63404,3176,2706,470,3176,115000,2019
19053,36.4,7979,7395,141,239,2019,44462,3200,2145,1055,3200,83200,2019
19055,43.8,17183,16594,36,267,4883,63750,6907,5827,1080,6907,136100,2019
19057,42.9,39386,34397,2235,1266,10366,51267,16891,11877,5014,16891,108500,2019
19059,48.4,17127,16390,77,344,5033,59969,8174,6489,1685,8174,194300,2019
19061,38.6,96982,88010,3404,2395,24858,63031,38210,28023,10187,38210,166800,2019
19063,42.9,9438,8218,187,920,2422,51563,4036,3152,884,4036,89300,2019
19065,43.8,19803,18546,428,484,5331,51128,8200,6279,1921,8200,104100,2019
19067,44.1,15786,14449,271,511,4203,50406,6903,4916,1987,6903,106200,2019
19069,42.7,10162,8817,25,1296,2957,56419,4192,3130,1062,4192,94100,2019
19071,46.2,6946,6578,53,193,1950,56750,2945,2248,697,2945,109300,2019
19073,44.5,8950,8467,38,260,2484,53050,3971,2915,1056,3971,94700,2019
19075,42.6,12299,11922,74,158,3559,68038,5155,4204,951,5155,130200,2019
19077,45.5,10669,10139,34,290,3090,61161,4452,3546,906,4452,117900,2019
19079,42.6,14997,13375,202,904,4132,60910,6259,4530,1729,6259,106100,2019
19081,44.2,10802,10064,172,476,3307,61761,4790,3692,1098,4790,102200,2019
19083,44.7,17061,15670,210,743,4424,54196,7148,5353,1795,7148,94300,2019
19085,44,14089,13554,27,245,4090,63854,6019,4558,1461,6019,120600,2019
19087,39.7,19941,17557,444,974,5327,53501,7743,5511,2232,7743,115500,2019
19089,41.5,9226,8904,29,148,2423,55060,3810,3035,775,3810,107100,2019
19091,42.9,9554,8926,38,420,2619,54575,4174,3099,1075,4174,103800,2019
19093,43.7,6901,6580,42,169,1889,58427,3011,2275,736,3011,100900,2019
19095,41.7,16189,15377,122,464,4634,61443,6780,5452,1328,6780,152500,2019
19097,44.3,19401,18523,92,285,5430,55967,8239,6510,1729,8239,128200,2019
19099,42.1,36971,34552,737,867,10036,58952,14574,10858,3716,14574,134200,2019
19101,42.9,18148,14614,1293,552,4073,47708,6754,4477,2277,6754,118300,2019
19103,30.3,148577,116441,10701,8345,32395,62542,59134,34589,24545,59134,227600,2019
19105,43.1,20559,19299,435,418,5343,57549,8130,6367,1763,8130,138400,2019
19107,43.7,10188,9818,46,178,2795,52881,4394,3445,949,4394,90400,2019
19109,45.5,14978,14194,106,402,4253,56073,6646,5031,1615,6646,102100,2019
19111,43.1,34227,31082,946,1237,9363,49564,14233,10591,3642,14233,94500,2019
19113,37.7,223861,192090,12076,7273,56139,64903,90877,67095,23782,90877,157000,2019
19115,41.9,11178,8735,120,1764,2972,56673,4335,3334,1001,4335,108800,2019
19117,44.2,8583,8368,7,172,2490,55205,3701,2892,809,3701,96400,2019
19119,38,11776,11239,10,312,3353,64982,4548,3882,666,4548,146900,2019
19121,40.7,16012,15263,38,327,4699,66316,6462,5069,1393,6462,177500,2019
19123,39.3,22164,20654,295,496,5970,54825,8927,6161,2766,8927,115300,2019
19125,39.4,33172,31380,349,639,8882,61038,13365,9463,3902,13365,157300,2019
19127,38.7,39964,28335,477,8771,9945,56437,15419,10868,4551,15419,106000,2019
19129,42.5,15034,14142,103,480,3913,72079,5554,4324,1230,5554,168900,2019
19131,43.6,10608,10230,32,157,2845,58302,4355,3517,838,4355,119400,2019
19133,46,8730,8261,27,175,2427,47605,4000,2894,1106,4000,86900,2019
19135,43,7807,7515,2,77,2170,58269,3294,2632,662,3294,100200,2019
19137,44.2,10053,9423,11,383,2899,51696,4554,3198,1356,4554,85700,2019
19139,38.1,42889,32910,1059,7677,11184,58453,16660,12234,4426,16660,130500,2019
19141,41.9,13835,12791,156,681,3650,53703,6169,4422,1747,6169,107000,2019
19143,44,6052,5392,76,490,1633,59725,2633,2064,569,2633,93700,2019
19145,44.1,15268,13900,300,532,3830,51867,6280,4493,1787,6280,94400,2019
19147,41.4,9003,8404,208,253,2323,52932,3702,2678,1024,3702,102200,2019
19149,40,25068,22989,232,1311,7300,67297,10250,7945,2305,10250,163500,2019
19151,47.6,6797,6312,40,260,1969,52448,3215,2484,731,3215,76000,2019
19153,35.5,479612,372714,31432,40165,117447,67637,187798,126008,61790,187798,179900,2019
19155,39.7,93393,81966,1583,7196,24117,60065,36799,25183,11616,36799,139800,2019
19157,40.5,18388,16852,354,589,4770,53852,7767,5327,2440,7767,141100,2019
19159,44,4964,4735,4,125,1323,55271,1971,1522,449,1971,98700,2019
19161,46.1,9802,9300,71,308,2880,58232,4313,3424,889,4313,95800,2019
19163,38.3,172446,137911,12852,11590,42098,61183,67021,46259,20762,67021,163200,2019
19165,46.4,11606,10974,88,345,3176,58000,5030,3896,1134,5030,121200,2019
19167,33.4,34827,30265,122,3743,9028,69844,12248,9840,2408,12248,167500,2019
19169,26.6,96941,81274,2149,3348,19278,56756,37811,20235,17576,37811,185800,2019
19171,42.6,17032,13753,157,1666,4432,56037,6767,5129,1638,6767,110400,2019
19173,42.3,6167,5574,1,475,1629,50431,2616,2047,569,2616,80600,2019
19175,40.3,12358,11617,62,369,3190,49900,5176,3644,1532,5176,104000,2019
19177,45.4,7150,6888,31,113,1924,48591,2894,2353,541,2894,92800,2019
19179,39.6,35141,28891,1165,3787,9420,46246,14481,10357,4124,14481,82100,2019
19181,38.3,50076,47171,233,1423,13881,77048,19258,15215,4043,19258,187200,2019
19183,40.3,22100,20116,172,1363,6168,62556,8832,6267,2565,8832,151600,2019
19185,43.2,6429,6177,19,102,1705,44768,2689,2181,508,2689,81100,2019
19187,39,36545,31849,1707,1838,8835,47466,15306,10408,4898,15306,99100,2019
19189,41.8,10534,9635,169,489,2721,49870,4577,3480,1097,4577,94800,2019
19191,41.5,20262,19251,308,455,5349,65263,8257,6551,1706,8257,177300,2019
19193,35.8,102586,74850,3311,17049,25772,59224,39016,25924,13092,39016,123300,2019
19195,43.9,7445,7018,115,222,2057,57130,3172,2461,711,3172,106700,2019
19197,43.5,12739,10880,49,1541,3553,53333,5718,4100,1618,5718,85500,2019
20001,41.9,12556,11311,125,446,3262,45333,5372,3801,1571,5372,79300,2019
20003,40.8,7835,7431,39,148,2165,50213,3101,2306,795,3101,95700,2019
20005,36.6,16268,14336,471,495,3861,50439,5958,4133,1825,5958,110400,2019
20007,43.6,4624,4137,37,254,1189,50174,1923,1380,543,1923,72300,2019
20009,39.9,26453,21572,279,3918,6756,49723,10624,7464,3160,10624,93300,2019
20011,39.1,14608,13159,412,390,3791,43917,5636,4024,1612,5636,82700,2019
20013,42.1,9626,7991,64,446,2578,48333,3872,2719,1153,3872,88500,2019
20015,38.6,66698,59238,1567,3256,17884,64782,24870,18523,6347,24870,148600,2019
20017,44.8,2637,2405,44,125,654,45353,1051,848,203,1051,103600,2019
20019,47.9,3323,2858,18,128,900,40298,1456,1131,325,1456,49500,2019
20021,41.3,20179,17760,120,516,5184,43175,7929,5765,2164,7929,82500,2019
20023,45.6,2665,2481,0,181,676,47639,1221,977,244,1221,78700,2019
20025,45.3,2026,1818,7,112,552,53348,873,649,224,873,75900,2019
20027,42.5,8082,7595,72,205,2272,53929,3514,2497,1017,3514,98000,2019
20029,40.8,8938,8314,168,283,2349,45373,3689,2690,999,3689,75800,2019
20031,43.8,8254,7700,66,222,2481,59583,3585,2720,865,3585,119100,2019
20033,48.1,1740,1671,0,66,458,54821,751,598,153,751,70300,2019
20035,38.8,35351,28155,1019,3839,8889,50102,13499,9102,4397,13499,89000,2019
20037,32.5,38968,33737,830,2225,9145,41004,15284,9076,6208,15284,93900,2019
20039,50.6,2860,2725,15,85,781,48125,1442,1063,379,1442,67900,2019
20041,41.3,18828,17102,256,881,4995,49991,7911,5586,2325,7911,114700,2019
20043,41,7684,6938,452,214,1897,49703,3046,2194,852,3046,100600,2019
20045,29.8,120290,94306,4959,7555,25355,59435,46936,24082,22854,46936,199400,2019
20047,45.7,2869,2185,10,594,840,50902,1308,1020,288,1308,61400,2019
20049,52.3,2523,2272,10,115,704,38750,1128,897,231,1128,54700,2019
20051,32.5,28775,25729,312,1648,6499,52883,11544,7061,4483,11544,169100,2019
20053,42.1,6231,5341,199,384,1523,54902,2388,1835,553,2388,99400,2019
20055,30.8,36750,15190,1007,18340,8879,60798,12519,8058,4461,12519,152500,2019
20057,32.2,34179,13577,652,18817,8183,51711,11344,6978,4366,11344,112500,2019
20059,40,25558,23256,204,1065,6790,56582,10118,7317,2801,10118,128000,2019
20061,26.4,34025,19259,6017,5506,9085,53133,12684,4809,7875,12684,148800,2019
20063,48.2,2644,2457,3,90,805,48317,1217,922,295,1217,89600,2019
20065,50.4,2519,2230,105,50,728,46375,1196,984,212,1196,72500,2019
20067,32.6,7467,3857,3,3554,1807,53413,2551,1900,651,2551,116100,2019
20069,36,6039,4941,0,964,1582,64930,2151,1681,470,2151,135500,2019
20071,42.2,1185,883,0,293,338,54112,519,327,192,519,111200,2019
20073,48.6,6081,5588,13,236,1746,41982,2769,2043,726,2769,66700,2019
20075,35.8,2591,1671,48,854,541,46944,890,638,252,890,81800,2019
20077,42.4,5594,5043,7,343,1486,49865,2265,1577,688,2265,74300,2019
20079,39.2,34503,28557,522,4101,9085,57982,13290,9513,3777,13290,126100,2019
20081,36.9,4018,2684,1,1230,999,55064,1320,1006,314,1320,107000,2019
20083,47.6,1876,1653,1,149,545,61211,767,625,142,767,84800,2019
20085,41.2,13266,11127,28,613,3789,57914,5465,4130,1335,5465,134700,2019
20087,43.3,18890,17677,137,517,5409,64864,7575,6368,1207,7575,150600,2019
20089,52.8,2885,2745,10,69,846,40676,1380,1122,258,1380,56100,2019
20091,37.6,591506,472754,27116,45285,156135,89087,228592,158251,70341,228592,259600,2019
20093,34.7,3907,2612,15,1239,899,52599,1201,914,287,1201,116700,2019
20095,45.4,7340,6836,34,263,2135,60469,3133,2461,672,3133,91500,2019
20097,41.6,2505,2221,16,160,644,53274,985,695,290,985,113900,2019
20099,41,20119,17186,949,911,5578,47643,8176,5683,2493,8176,76400,2019
20101,40.7,1564,1424,0,105,402,52125,757,572,185,757,90800,2019
20103,37.8,80745,63710,6611,5661,19569,73013,27253,18374,8879,27253,182900,2019
20105,46.5,3044,2884,5,102,740,45076,1248,972,276,1248,72700,2019
20107,44.4,9671,9047,53,261,2985,48778,4497,3485,1012,4497,110100,2019
20109,39.7,2805,2526,2,172,748,51740,1153,798,355,1153,86600,2019
20111,33.4,33251,23642,741,7059,7995,46338,13569,8143,5426,13569,106800,2019
20113,40.8,28567,26163,309,1205,8006,59089,12334,8573,3761,12334,151800,2019
20115,44.5,11964,11073,86,447,3198,52123,4846,3806,1040,4846,90800,2019
20117,42.8,9749,9224,30,246,2573,51895,4085,3215,870,4085,98900,2019
20119,37.9,4180,3154,26,856,1175,59316,1689,1169,520,1689,96800,2019
20121,42.1,33417,30976,497,1078,9139,71995,12835,10169,2666,12835,201400,2019
20123,43.1,6145,5833,44,150,1554,46203,2570,1832,738,2570,88900,2019
20125,40.3,32521,25832,1608,2197,8295,45157,13576,9337,4239,13576,76200,2019
20127,46.6,5566,5097,11,279,1603,55658,2280,1832,448,2280,103000,2019
20129,40.5,2754,1961,22,644,622,47750,1038,721,317,1038,88500,2019
20131,39.9,10121,9629,73,213,2738,63216,4007,3002,1005,4007,130500,2019
20133,40.2,16108,14461,195,897,4348,46291,6601,4644,1957,6601,82000,2019
20135,50,2876,2512,15,294,841,56492,1269,1058,211,1269,73300,2019
20137,42.7,5446,4847,151,283,1137,49038,1830,1467,363,1830,82900,2019
20139,43.8,15881,14807,94,516,4446,54090,6607,4935,1672,6607,115700,2019
20141,46.7,3530,3334,17,76,957,51286,1648,1232,416,1648,69000,2019
20143,43,5822,5478,57,158,1710,54784,2446,1947,499,2446,105700,2019
20145,43,6629,5577,292,511,1415,49917,2448,1617,831,2448,82400,2019
20147,44.3,5340,5001,33,180,1480,50093,2316,1754,562,2316,79600,2019
20149,35.4,23847,21433,311,1236,6354,66835,8698,6841,1857,8698,183100,2019
20151,38.5,9452,8350,239,676,2403,52327,3652,2474,1178,3652,91900,2019
20153,48.8,2502,2247,16,180,751,53207,1176,871,305,1176,101600,2019
20155,40.3,62765,52751,1704,5951,15541,49936,25014,17331,7683,25014,101300,2019
20157,50.7,4658,4444,53,95,1344,47976,2218,1617,601,2218,66000,2019
20159,38.9,9658,8029,163,1100,2578,53012,3917,2918,999,3917,74700,2019
20161,25.1,75056,57436,4571,6250,13807,51208,26490,11441,15049,26490,201000,2019
20163,44.7,5053,4756,88,127,1347,49415,2176,1675,501,2176,78800,2019
20165,46.6,3022,2793,6,98,763,47981,1421,1077,344,1421,70800,2019
20167,49.1,6948,6414,160,237,1879,44792,3015,2352,663,3015,93400,2019
20169,38.6,54701,43855,1521,6170,13358,52200,21959,14646,7313,21959,136800,2019
20171,39.7,4917,4004,0,766,1360,65417,1967,1376,591,1967,136200,2019
20173,35.4,513375,349470,44037,74791,125025,56524,197229,124155,73074,197229,140700,2019
20175,29.4,22349,6725,1007,13685,5231,49291,7321,4884,2437,7321,105300,2019
20177,39.1,177852,131504,14783,21961,44238,56762,72267,46560,25707,72267,132500,2019
20179,44.9,2506,2330,25,128,744,62885,1134,870,264,1134,113900,2019
20181,39.3,5938,4965,42,722,1624,54754,2544,1702,842,2544,111400,2019
20183,51.4,3627,3434,12,81,1112,43429,1701,1311,390,1701,70200,2019
20185,44.1,4181,3486,12,558,1193,49375,1771,1438,333,1771,65900,2019
20187,35.3,2052,1183,0,833,486,52054,733,545,188,733,92600,2019
20189,35.1,5603,3393,43,2040,1336,57806,1814,1274,540,1814,114900,2019
20191,41.2,23114,20704,221,1252,6171,55000,9416,6979,2437,9416,89800,2019
20193,36,7810,7032,167,510,2261,60124,3375,2282,1093,3375,129700,2019
20195,49.4,2840,2700,3,61,880,57966,1379,1033,346,1379,99300,2019
20197,43.8,6889,6349,37,265,1874,61178,2744,2345,399,2744,146700,2019
20199,41.8,1574,1441,3,74,452,63269,636,483,153,636,89400,2019
20201,45.4,5493,5259,6,197,1465,50588,2332,1817,515,2332,82000,2019
20203,42.3,2130,1315,20,750,628,57978,934,685,249,934,88900,2019
20205,43.7,8688,7995,40,279,2374,48341,3712,2721,991,3712,73500,2019
20207,47.4,3157,2926,14,12,866,39643,1434,1105,329,1434,73600,2019
20209,33.7,164861,67390,35794,47625,38219,46881,60128,34518,25610,60128,100300,2019
21001,41.8,19222,17930,595,376,4840,38021,6977,5311,1666,6977,96400,2019
21003,40.7,20944,19901,208,452,5522,44036,7605,5698,1907,7605,120600,2019
21005,41.4,22409,21018,627,403,5934,55334,8694,6612,2082,8694,149800,2019
21007,43.6,8032,7428,328,109,2119,45048,3065,2473,592,3065,102900,2019
21009,40.5,43884,39665,1521,1415,11375,41459,16931,11290,5641,16931,125400,2019
21011,40.6,12355,11745,188,206,3523,44898,4827,3479,1348,4827,89700,2019
21013,41.7,26791,25249,739,285,6959,26272,10624,7017,3607,10624,59800,2019
21015,37.5,130820,114783,3775,5546,34720,78327,46997,35015,11982,46997,189800,2019
21017,41.8,20058,17073,1389,1364,5445,49637,8106,5119,2987,8106,146700,2019
21019,42.3,47682,44393,1094,866,12253,48308,18210,12521,5689,18210,111200,2019
21021,40.3,29972,25597,2375,996,7011,46382,11023,7404,3619,11023,146400,2019
21023,41.4,8305,7979,30,68,2141,49158,3318,2456,862,3318,103100,2019
21025,42.2,12977,12530,171,123,3589,27344,5358,3805,1553,5358,54000,2019
21027,43.1,20176,19028,358,314,5158,47190,7598,6123,1475,7598,102900,2019
21029,40.4,80171,75689,805,1608,21743,63348,29690,23843,5847,29690,165500,2019
21031,41.3,12764,12089,70,419,3631,41763,4958,3572,1386,4958,92100,2019
21033,44,12702,11544,796,318,3549,44775,5163,3943,1220,5163,87900,2019
21035,35.6,38837,34816,1356,1055,8940,42273,14996,9364,5632,14996,137300,2019
21037,38.2,92861,85709,2967,1903,23305,63050,36746,25624,11122,36746,172000,2019
21039,42.8,4784,4482,38,112,1317,45109,1980,1618,362,1980,89300,2019
21041,38.5,10671,9460,299,723,2574,43524,4101,2638,1463,4101,115900,2019
21043,41.6,27159,26248,148,369,6604,34736,9606,7432,2174,9606,95000,2019
21045,42.6,15885,15034,126,466,3919,34819,6099,4714,1385,6099,87600,2019
21047,28.3,71414,46815,15392,5621,17363,43919,25721,12375,13346,25721,117400,2019
21049,42.3,35971,32429,1647,1045,9943,54953,14509,9773,4736,14509,145400,2019
21051,39.6,20368,18856,730,522,5511,26840,7622,5172,2450,7622,54100,2019
21053,41.9,10193,9686,37,289,2496,32184,3985,2770,1215,3985,72800,2019
21055,43.6,9000,8645,71,111,2394,45244,3567,2921,646,3567,89900,2019
21057,46,6697,6189,140,91,1647,35344,2616,1907,709,2616,89400,2019
21059,38.9,100474,88435,4325,3146,26743,51673,40179,27297,12882,40179,133600,2019
21061,44.3,12138,11542,181,91,3377,43401,4885,3927,958,4885,87300,2019
21063,41.4,7510,7182,268,36,1925,32306,2523,1901,622,2523,82700,2019
21065,43.5,14224,14085,16,15,3599,31688,5499,3967,1532,5499,76800,2019
21067,34.6,320601,227629,46338,23063,74761,57291,129784,70648,59136,129784,189800,2019
21069,41.4,14513,13902,318,157,4200,44612,5841,4277,1564,5841,89900,2019
21071,42.2,36456,35374,312,306,10325,32730,15000,10486,4514,15000,74400,2019
21073,40.9,50529,41219,4705,1702,12648,56274,21076,13236,7840,21076,142900,2019
21075,43.5,6130,4341,1472,120,1425,30114,2441,1497,944,2441,66100,2019
21077,38.8,8737,7955,176,460,2034,52167,3105,2236,869,3105,128100,2019
21079,43,17445,16431,338,387,4944,52631,6706,5526,1180,6706,140500,2019
21081,36.3,24951,23561,199,694,6757,48714,9141,6263,2878,9141,130200,2019
21083,39.7,37248,32232,1521,2491,8974,44043,14316,10805,3511,14316,104300,2019
21085,40.3,26247,24993,303,362,6801,38612,9758,7084,2674,9758,113900,2019
21087,44.6,10979,10353,285,94,2915,35899,4413,3258,1155,4413,79500,2019
21089,43.4,35555,34198,338,387,10146,51655,14056,10906,3150,14056,116700,2019
21091,39.9,8720,8327,78,134,2498,57217,3311,2622,689,3311,112300,2019
21093,37,108527,82502,12188,6150,28407,54367,41646,25605,16041,41646,156600,2019
21095,41.3,26699,25367,587,260,7447,26478,11134,7663,3471,11134,60300,2019
21097,42.2,18722,17534,322,452,5158,48438,7283,5022,2261,7283,140000,2019
21099,40.5,18729,17142,766,346,4779,38396,7351,5449,1902,7351,94400,2019
21101,41.2,45829,39674,3341,1170,12292,48926,18643,11431,7212,18643,128400,2019
21103,41.4,15911,14548,472,518,4259,53926,6044,4359,1685,6044,128700,2019
21105,48,4510,3899,377,83,1073,42929,1798,1489,309,1798,80600,2019
21107,41.8,45331,40115,2911,949,12398,47170,18588,12912,5676,18588,108700,2019
21109,42.2,13369,13087,42,33,3859,32138,5484,4123,1361,5484,87200,2019
21111,38.3,767419,517604,164679,41742,185937,56586,312679,193084,119595,312679,170100,2019
21113,37.8,53032,47112,2401,1837,13726,58245,18821,12155,6666,18821,172100,2019
21115,41.8,22634,22008,111,74,5707,37055,8488,6103,2385,8488,101300,2019
21117,37.1,165668,146656,7546,5352,40235,64339,63966,42303,21663,63966,161100,2019
21119,43.2,15260,14779,79,149,4310,31198,6388,4776,1612,6388,51500,2019
21121,40,31365,30037,255,379,7877,30181,11961,7834,4127,11961,86800,2019
21123,40.9,14204,12979,482,461,3882,47643,5741,4253,1488,5741,115600,2019
21125,40,60357,57796,444,940,15750,41526,22573,15788,6785,22573,112000,2019
21127,41.2,15671,15361,29,185,3946,32798,5784,4334,1450,5784,79400,2019
21129,43.6,6881,6582,52,30,1569,25275,2839,1956,883,2839,63000,2019
21131,42.3,10283,10030,15,51,2827,31627,4076,3317,759,4076,64100,2019
21133,42.4,22295,21728,83,179,6498,29886,9721,7210,2511,9721,58600,2019
21135,42.8,13417,13117,90,0,3561,31147,5268,3897,1371,5268,65500,2019
21137,41.3,24476,23068,466,403,6780,42919,9697,7596,2101,9697,106400,2019
21139,46,9235,8806,42,183,2511,50839,3857,3058,799,3857,102400,2019
21141,40.7,26902,23828,1802,767,7081,48014,10418,7261,3157,10418,111000,2019
21143,50.6,8271,7454,470,154,2024,52528,3333,2645,688,3333,141500,2019
21145,42.2,65268,54368,6843,1648,16241,46080,27854,18124,9730,27854,143400,2019
21147,39.4,17465,15619,989,432,4287,28105,6052,4245,1807,6052,69700,2019
21149,42.4,9283,8918,116,80,2753,51861,3809,2987,822,3809,104700,2019
21151,34.1,90802,81234,3710,2247,21182,50060,33359,19700,13659,33359,159300,2019
21153,42.3,12491,12337,4,133,3513,28147,5020,3641,1379,5020,66800,2019
21155,39.3,19244,16893,1401,515,4442,40107,7405,5434,1971,7405,105400,2019
21157,44.9,31192,30053,293,514,8980,55113,13121,10623,2498,13121,131100,2019
21159,39.5,11648,10749,590,231,2805,41013,4153,2926,1227,4153,84300,2019
21161,40.6,17112,15223,1082,328,4455,45377,6700,4531,2169,6700,132800,2019
21163,38.6,28182,25206,1004,1040,7674,56603,10685,7759,2926,10685,153500,2019
21165,44.6,6443,6258,10,73,1709,39325,2651,2116,535,2651,76800,2019
21167,43.2,21592,19610,900,636,5922,55093,8556,6183,2373,8556,147300,2019
21169,43.9,10036,9526,156,82,2924,37386,4074,3192,882,4074,77200,2019
21171,41.4,10627,9920,259,328,2841,34879,4491,3131,1360,4491,80500,2019
21173,39.7,27884,25872,770,768,7443,45516,10481,7112,3369,10481,116700,2019
21175,42,13288,12313,452,179,3268,36134,4865,3632,1233,4865,73100,2019
21177,42.4,30951,28489,1305,472,8047,43590,11351,9039,2312,11351,93900,2019
21179,39.8,45650,41252,2325,985,12243,60127,17853,13561,4292,17853,154700,2019
21181,41.1,7153,6848,90,103,1939,38149,2804,1931,873,2804,85600,2019
21183,40.3,24071,22689,208,835,6523,45564,9122,6940,2182,9122,92500,2019
21185,38.9,65967,58252,2349,2613,17195,99128,20911,17712,3199,20911,282100,2019
21187,42.8,10796,10627,62,41,2706,48801,3995,2987,1008,3995,116100,2019
21189,43.4,4442,4150,243,0,1159,30284,1704,1166,538,1704,70200,2019
21191,40.6,14572,14000,157,198,3775,54375,5253,3956,1297,5253,116400,2019
21193,41.2,26624,25342,495,278,7715,33640,11226,8515,2711,11226,75400,2019
21195,42.5,59497,57651,524,571,17583,34856,25702,18749,6953,25702,78600,2019
21197,38.6,12304,11780,44,206,3470,37469,4770,3293,1477,4770,89800,2019
21199,42,64350,60638,561,1603,16771,39998,25301,17453,7848,25301,116200,2019
21201,42.9,2123,1994,38,91,494,41902,861,645,216,861,114700,2019
21203,42.7,16820,16346,26,156,4614,35720,6544,4984,1560,6544,81900,2019
21205,30.6,24507,23163,375,421,5093,38230,8623,5160,3463,8623,124200,2019
21207,43.3,17778,16619,54,672,4522,38390,6922,5131,1791,6922,95000,2019
21209,36.2,54667,47541,2528,2366,15073,70817,20551,14391,6160,20551,189500,2019
21211,39.4,47325,37940,3155,4541,12029,67056,16624,11672,4952,16624,197300,2019
21213,39,18183,15486,1788,444,4969,48623,7028,4566,2462,7028,135200,2019
21215,42.1,18680,17572,347,445,5464,80166,6763,5758,1005,6763,213300,2019
21217,37.6,25571,22894,1095,618,6624,44522,9857,5940,3917,9857,120200,2019
21219,37.8,12316,10559,1006,491,3348,44005,4644,3133,1511,4644,106300,2019
21221,46.2,14449,12737,1076,325,3925,50536,5892,4770,1122,5892,129400,2019
21223,43.4,8558,8044,14,263,2290,53056,3498,2697,801,3498,124000,2019
21225,38.1,14638,12062,1927,288,3803,46673,5374,3804,1570,5374,92100,2019
21227,32.8,128652,100823,11382,6898,30597,52270,48224,28312,19912,48224,167600,2019
21229,40.7,12023,10544,644,511,3209,53743,4581,3434,1147,4581,128300,2019
21231,42.5,20546,19141,407,685,5278,34914,8231,6051,2180,8231,88800,2019
21233,41,13068,11547,438,715,3314,42119,4953,3557,1396,4953,75600,2019
21235,36.6,36131,34682,319,465,9037,39005,12620,8682,3938,12620,92500,2019
21237,41.8,7207,7074,4,26,1802,24623,2898,1837,1061,2898,64400,2019
21239,42.5,26318,22688,1187,1767,7295,63820,10355,7321,3034,10355,203000,2019
22001,36.7,62457,48329,10813,1595,15519,43396,22236,15806,6430,22236,118000,2019
22003,38.2,25618,18178,4723,1592,5566,46446,7925,5906,2019,7925,97500,2019
22005,35.7,123114,84233,26751,6900,31749,80527,43032,35079,7953,43032,207400,2019
22007,40.9,22478,14737,6724,684,5484,43759,8552,6683,1869,8552,118600,2019
22009,38.2,40669,26450,10892,786,9840,38565,15163,10537,4626,15163,104200,2019
22011,37.4,37043,29722,4577,1387,9219,53209,13520,10474,3046,13520,127500,2019
22013,41.9,13564,7366,5858,83,3586,30272,5812,4248,1564,5812,75900,2019
22015,35.3,126499,84427,28602,8392,33339,54268,49377,31315,18062,49377,172400,2019
22017,37.7,245831,110269,120330,6942,58934,41797,95864,57358,38506,95864,149200,2019
22019,36.1,201619,135937,50012,7279,50630,51148,77780,52468,25312,77780,156800,2019
22021,39.8,9992,7912,1638,320,2534,37691,3665,2804,861,3665,77300,2019
22023,44.1,6930,6118,234,408,2110,53423,2734,2308,426,2734,119500,2019
22025,38.1,9766,6457,3084,184,2421,40129,3364,2699,665,3364,89000,2019
22027,42,15985,7219,8304,242,3718,26776,5917,3901,2016,5917,78100,2019
22029,37.7,19778,11260,8127,307,4562,32500,7162,4737,2425,7162,80600,2019
22031,39.3,27289,16039,9643,785,7254,46006,10821,7716,3105,10821,117300,2019
22033,34,443763,198071,203920,18565,97944,54948,164346,98234,66112,164346,194000,2019
22035,33.9,7096,2056,4945,39,1193,22346,2037,1051,986,2037,76800,2019
22037,42.9,19371,10336,8385,323,4777,51803,6959,5605,1354,6959,139300,2019
22039,35.7,33589,22277,9109,1254,7739,31965,12172,7975,4197,12172,96600,2019
22041,38.4,20238,13180,6850,74,5130,35282,7423,5400,2023,7423,88000,2019
22043,38.1,22340,17095,3548,1125,4651,42505,6989,4803,2186,6989,103400,2019
22045,36.5,71887,42240,22677,3027,18467,46861,26184,17775,8409,26184,115600,2019
22047,38.4,32822,15648,15786,855,7372,50161,10903,8007,2896,10903,143700,2019
22049,40.9,15879,10686,4719,263,4015,39139,5971,4238,1733,5971,89500,2019
22051,39.4,434850,228933,114781,63104,107114,54032,169452,103702,65750,169452,188200,2019
22053,37.8,31441,24567,5149,772,8149,42105,11726,8550,3176,11726,114000,2019
22055,35.2,241973,158910,62564,11132,57652,56999,91543,59362,32181,91543,185300,2019
22057,37.8,98108,75378,13303,4280,25412,55506,36895,28219,8676,36895,158000,2019
22059,38.8,14936,12357,1656,422,3643,42104,4814,3687,1127,4814,93000,2019
22061,28.3,47246,25181,19177,1447,10407,35467,17712,9120,8592,17712,154500,2019
22063,36.6,138928,121824,8189,5195,35043,63389,48410,39618,8792,48410,167100,2019
22065,35.2,11306,3826,7184,239,2443,30350,3832,2038,1794,3832,78100,2019
22067,39.9,25610,12633,12570,146,6194,32929,9732,6498,3234,9732,91100,2019
22069,33.7,38769,20180,15912,918,7538,28567,14659,6424,8235,14659,137400,2019
22071,36.8,390845,119866,230066,21413,72247,41604,153819,74240,79579,153819,231500,2019
22073,35.7,155494,89942,58037,3446,35588,41121,56556,33023,23533,56556,146700,2019
22075,36.5,23338,14918,4648,1711,6719,57204,8919,6135,2784,8919,190600,2019
22077,43.1,22016,13281,7873,573,5625,41480,8960,6837,2123,8960,142600,2019
22079,37.4,130970,80178,41147,4123,32535,47269,48488,29922,18566,48488,143100,2019
22081,39.4,8565,4856,3350,204,1984,33816,3372,2483,889,3372,78700,2019
22083,38.8,20350,12326,7284,451,4972,34029,7459,4977,2482,7459,91900,2019
22085,41.1,23991,16213,3827,931,6057,40336,9158,6242,2916,9158,94300,2019
22087,34.2,46266,28844,10521,4655,10264,44661,15005,10160,4845,15005,151300,2019
22089,37.9,52773,34366,13893,3233,14463,69019,19212,15510,3702,19212,201700,2019
22091,39.4,10297,4546,5409,184,2767,43886,3857,3045,812,3857,100100,2019
22093,39.2,21308,10266,10565,355,5732,51603,7719,6098,1621,7719,158500,2019
22095,36.8,43242,14840,24278,2634,11104,57429,15270,11990,3280,15270,153900,2019
22097,36.7,83172,45215,34494,1837,20319,36403,30485,20808,9677,30485,108400,2019
22099,37.7,53732,34562,15610,1611,13960,48656,19749,15569,4180,19749,124900,2019
22101,39,50968,28581,15432,3585,11354,40485,19856,12056,7800,19856,106900,2019
22103,40.2,255155,200457,30529,14329,65378,68905,92962,72853,20109,92962,218500,2019
22105,35.3,132057,83496,38794,5642,31796,47832,47597,32840,14757,47597,162800,2019
22107,43.4,4561,1927,2525,94,1102,27500,1792,1210,582,1792,66400,2019
22109,35.8,112054,74703,21222,5773,27126,48747,39972,28586,11386,39972,152500,2019
22111,42.1,22353,15406,5533,1049,4899,44100,7582,6196,1386,7582,89200,2019
22113,38,59865,46883,8658,2102,15143,51945,22086,17045,5041,22086,122200,2019
22115,30.4,49646,34780,7125,4617,12375,49141,17696,9383,8313,17696,119300,2019
22117,39.4,46435,30434,13986,1058,11924,37570,17613,11875,5738,17613,101000,2019
22119,41.4,39242,24312,13331,761,10295,28951,16551,11074,5477,16551,81500,2019
22121,36.3,26101,14579,10365,818,7194,65385,9643,7045,2598,9643,200000,2019
22123,40.3,11041,8697,1778,425,2693,38500,4084,3140,944,4084,90300,2019
22125,41.4,15428,8079,6854,191,2497,59637,3869,2832,1037,3869,229500,2019
22127,41.1,14313,9303,4516,293,3661,38353,5483,3686,1797,5483,77700,2019
23001,41,107602,97498,2325,1998,28033,53509,45630,29359,16271,45630,158200,2019
23003,48,67809,63825,637,834,18287,41123,29516,21246,8270,29516,99600,2019
23005,42.2,292307,263921,8571,6061,72038,73072,120644,83578,37066,120644,278100,2019
23007,46.3,29982,28670,73,389,7246,51422,11848,9410,2438,11848,139800,2019
23009,48.8,54601,51722,466,794,14905,57178,23661,18056,5605,23661,212700,2019
23011,44.4,121753,115148,922,1900,31868,55365,52105,36752,15353,52105,159400,2019
23013,48.4,39759,37833,186,600,10593,57751,17020,13146,3874,17020,213400,2019
23015,51,34201,32798,128,426,9793,57720,15336,12148,3188,15336,215400,2019
23017,47,57550,54829,206,793,14006,49204,21338,17242,4096,21338,144100,2019
23019,42,151774,142101,1247,2061,37742,50808,62156,43123,19033,62156,144700,2019
23021,51.5,16836,15979,82,245,4404,40890,7025,5332,1693,7025,109500,2019
23023,46.9,35452,33521,278,609,10128,63694,15980,11909,4071,15980,213400,2019
23025,46.4,50520,48349,294,554,13468,44256,21321,16230,5091,21321,115700,2019
23027,46.2,39539,37630,196,586,11099,51931,17236,13649,3587,17236,163000,2019
23029,48.1,31491,28165,133,743,8528,41347,13791,10553,3238,13791,112400,2019
23031,45.2,204316,192542,1624,3507,54913,67830,85314,63026,22288,85314,252300,2019
24001,41.7,71445,62135,5692,1277,16584,45893,27399,18859,8540,27399,120700,2019
24003,38.3,571275,389750,93175,44621,146496,100798,209814,155617,54197,209814,361200,2019
24005,39.4,828018,474239,235778,44807,203595,76866,313519,207123,106396,313519,261500,2019
24009,40.7,91511,71522,10524,3641,24111,109313,31973,27070,4903,31973,358800,2019
24011,39.7,33049,24967,4475,2417,8566,58638,12024,8759,3265,12024,202500,2019
24013,42.4,167699,149333,5790,5921,45207,96769,60758,49823,10935,60758,339600,2019
24015,40.8,102552,87291,6546,4525,25966,76887,37058,27065,9993,37058,242700,2019
24017,38.4,159428,64027,72431,9212,41240,100003,56520,43436,13084,56520,313300,2019
24019,44.6,32138,20206,8287,1815,8541,52917,13183,8969,4214,13183,183300,2019
24021,39.1,251422,184756,23557,24101,66221,97730,92526,69614,22912,92526,331600,2019
24023,46.2,29235,28193,250,330,8235,52617,12425,9771,2654,12425,173900,2019
24025,40.9,252222,191893,33969,11489,67644,89147,93955,73899,20056,93955,293400,2019
24027,38.8,318855,165862,58978,22012,83831,121160,114170,83520,30650,114170,455700,2019
24029,48.1,19536,15187,2770,859,4847,58598,8025,5557,2468,8025,249900,2019
24031,39.2,1043530,457265,186964,203754,259246,108820,370950,242632,128318,370950,484900,2019
24033,37.1,908670,115436,560785,167498,203461,84920,311343,193263,118080,311343,302800,2019
24035,44.4,49632,42945,3289,1955,13528,97034,18577,15046,3531,18577,353100,2019
24037,36.7,112290,83197,16275,5819,28509,89845,40552,28811,11741,40552,301300,2019
24039,36.2,25729,13260,10668,930,5488,37803,8574,5575,2999,8574,139100,2019
24041,50.5,37167,28926,3738,2513,10979,73547,16826,11828,4998,16826,336800,2019
24043,40.5,150109,118474,15578,7616,37505,60860,56035,36952,19083,56035,210300,2019
24045,36.1,102539,64575,26301,5376,24192,56956,37793,21791,16002,37793,175700,2019
24047,50.4,51765,41494,6573,1811,13899,63499,22089,16582,5507,22089,262200,2019
24510,35.4,609032,167430,376203,32183,120275,50379,239116,113587,125529,239116,160100,2019
25001,53.3,213496,190593,6093,6616,59063,74336,94323,75287,19036,94323,393500,2019
25003,47.1,126425,111388,3315,5999,32054,59230,54813,37928,16885,54813,216100,2019
25005,41,561037,455995,22101,44846,143693,69095,217912,136508,81404,217912,299800,2019
25007,47.1,17312,14811,727,630,3993,71811,6765,4893,1872,6765,699500,2019
25009,40.9,783676,550875,25199,164027,196435,79263,294202,188804,105398,294202,409900,2019
25011,46.7,70577,64012,969,2835,17729,60950,30569,20979,9590,30569,232100,2019
25013,39,467871,293556,36142,117760,114187,55429,179423,109668,69755,179423,207800,2019
25015,36.5,161032,134786,4027,9047,34710,70876,58838,39341,19497,58838,283100,2019
25017,38.5,1600842,1150282,79953,127980,390925,102603,604384,376888,227496,604384,500700,2019
25019,40.3,11168,9513,736,465,2317,107717,3713,2619,1094,3713,1084700,2019
25021,40.9,700437,524697,47098,31734,175945,103291,265300,182847,82453,265300,470800,2019
25023,42.7,515303,415590,49456,20102,131643,89489,187460,143386,44074,187460,370300,2019
25025,32.8,796605,357453,160215,182360,153961,69669,309844,111811,198033,309844,496500,2019
25027,40.2,824772,629988,37150,94778,202645,74679,309951,201806,108145,309951,280600,2019
26001,58.2,10353,9916,41,155,3069,40484,4988,4430,558,4988,112000,2019
26003,49.5,9151,7650,702,144,1940,45570,3007,2527,480,3007,136200,2019
26005,39.8,116143,102709,1426,8532,31674,62965,43416,35849,7567,43416,165400,2019
26007,48.1,28520,27297,164,393,7663,43363,12752,9940,2812,12752,96500,2019
26009,51.3,23206,21970,100,543,6929,56165,9899,8621,1278,9899,160500,2019
26011,50,15070,14263,62,304,4151,42290,6571,5506,1065,6571,94400,2019
26013,45.5,8421,6116,783,134,1965,46065,3107,2494,613,3107,102200,2019
26015,42.5,60540,56987,306,1786,17201,64490,24296,20299,3997,24296,158400,2019
26017,43.4,104104,93760,1743,5548,28060,48819,44339,34037,10302,44339,102000,2019
26019,50.2,17615,16516,32,441,4526,57974,6792,6093,699,6792,185500,2019
26021,42.1,154133,115449,22368,8449,40858,50795,63665,45014,18651,63665,150700,2019
26023,41.2,43513,39338,1002,2071,11165,51947,16650,12358,4292,16650,109800,2019
26025,39.8,134212,104044,13919,7031,33771,48607,53991,37743,16248,53991,110000,2019
26027,45.2,51523,44376,2654,2002,14608,55107,21019,16819,4200,21019,142800,2019
26029,48.6,26188,24549,111,523,7451,55760,11503,9303,2200,11503,166300,2019
26031,51.1,25418,23399,200,366,7305,48044,11195,9222,1973,11195,130900,2019
26033,40.5,37629,26196,2231,709,8547,46486,13999,9442,4557,13999,119100,2019
26035,47.2,30651,29061,190,617,7885,39565,12199,10114,2085,12199,91100,2019
26037,40.6,78389,70467,1419,3554,20751,70390,29728,23779,5949,29728,172800,2019
26039,50.8,13892,13131,103,279,4043,47977,6141,4986,1155,6141,105000,2019
26041,47.4,36026,33456,121,493,10501,47434,16234,12565,3669,16234,114300,2019
26043,46.7,25439,24150,158,399,7243,51645,11231,8688,2543,11231,101800,2019
26045,40.9,109456,90672,7202,5901,28756,64348,44480,32148,12332,44480,155000,2019
26047,45.5,33104,30177,243,549,9127,55829,14463,10534,3929,14463,186900,2019
26049,40.5,407875,295468,79700,14027,106455,48588,167902,117587,50315,167902,111100,2019
26051,50.1,25279,24213,72,428,7085,44619,11047,9379,1668,11047,110000,2019
26053,49.3,15061,13570,582,220,3608,38839,6744,5224,1520,6744,67100,2019
26055,42.8,92181,85354,797,2639,24279,63575,37319,28480,8839,37319,212500,2019
26057,39.5,40916,35199,2238,2498,9893,47848,15035,11172,3863,15035,95400,2019
26059,42.3,45757,43312,311,1061,12036,49622,18107,13847,4260,18107,120100,2019
26061,33,36070,33211,265,589,7398,43183,13386,8954,4432,13386,108700,2019
26063,49.2,31349,29842,150,754,8672,48289,13847,11199,2648,13847,103900,2019
26065,32,290587,202303,32279,22675,60830,52872,112840,65979,46861,112840,135600,2019
26067,38.7,64300,56769,2919,3067,15986,57043,22964,17592,5372,22964,131800,2019
26069,52.9,25197,23634,184,570,7074,43678,11669,9329,2340,11669,92600,2019
26071,54.3,11152,10526,61,234,2988,41599,5225,4220,1005,5225,77700,2019
26073,28.1,70688,60355,1868,2799,14014,45116,24739,15372,9367,24739,134900,2019
26075,41.2,158636,134275,12204,5605,40251,53658,61805,45409,16396,61805,131600,2019
26077,34.4,262745,203326,27827,12975,61274,56511,103445,66214,37231,103445,159300,2019
26079,44.4,17585,16553,146,354,4837,46898,7145,5901,1244,7145,115900,2019
26081,35.3,648121,477967,59796,68519,160156,63053,241746,168688,73058,241746,173700,2019
26083,57.5,2111,2043,19,17,750,50292,1081,951,130,1081,121100,2019
26085,53.2,11852,10072,940,309,2724,37320,4631,3897,734,4631,88000,2019
26087,44.1,88038,80793,1108,4114,24286,62641,33700,28290,5410,33700,168800,2019
26089,54.1,21652,19488,94,945,6267,65249,9139,8071,1068,9139,268400,2019
26091,41.9,98381,85263,2236,7842,25209,55450,38345,29728,8617,38345,139400,2019
26093,43.5,189754,179018,1108,4630,52153,84221,72000,61489,10511,72000,247100,2019
26095,44.7,6338,4923,413,221,1427,45469,2231,1773,458,2231,87200,2019
26097,52.8,10780,7883,349,191,3172,47938,5269,3786,1483,5269,136600,2019
26099,40.9,870325,687817,101209,22781,227248,62855,346402,254008,92394,346402,166800,2019
26101,49.3,24457,21763,687,772,5956,50055,9426,7865,1561,9426,125400,2019
26103,39.1,66686,61408,1105,1016,15882,53970,26552,18791,7761,26552,153400,2019
26105,46.2,28954,26481,261,1322,7752,51725,12186,9366,2820,12186,141400,2019
26107,36.9,43251,39451,1275,992,9594,45018,15808,11594,4214,15808,121400,2019
26109,48.8,23074,21434,73,419,6341,46828,10627,8259,2368,10627,101600,2019
26111,41.8,83355,76250,1110,2289,23102,62625,34199,26197,8002,34199,141700,2019
26113,43.5,15028,14121,89,437,4163,47194,6055,4851,1204,6055,118700,2019
26115,42.6,149727,136707,3514,5359,40964,62203,59929,47778,12151,59929,161700,2019
26117,40.7,63413,58184,1321,2222,16534,49448,23913,18675,5238,23913,113900,2019
26119,56.1,9265,8881,22,122,2790,41772,4452,3742,710,4452,102700,2019
26121,39.3,173297,132344,23397,9809,43962,50854,65939,49270,16669,65939,117900,2019
26123,42.4,48366,43792,543,2803,13082,50326,19161,16074,3087,19161,121300,2019
26125,40.9,1253185,902331,169294,51653,323558,79698,504585,358384,146201,504585,242700,2019
26127,43.2,26416,21583,280,3934,7251,50104,10156,8386,1770,10156,118800,2019
26129,50.4,20898,19779,68,449,5867,40373,9184,7476,1708,9184,98200,2019
26131,58.6,5877,5578,29,89,1619,41546,2793,2464,329,2793,70000,2019
26133,43.8,23290,22013,257,454,6143,44032,9181,7406,1775,9181,98500,2019
26135,51.8,8248,7878,41,135,2331,42335,3806,3245,561,3806,90500,2019
26137,44.9,24490,23149,124,423,6837,54332,9944,7846,2098,9944,139500,2019
26139,35.2,286558,240269,4089,28112,73323,69314,102610,79724,22886,102610,191800,2019
26141,55,12714,12147,74,177,3862,47948,5797,5147,650,5797,105400,2019
26143,56.2,23851,22632,38,449,6804,42054,11139,9137,2002,11139,108200,2019
26145,40.9,191821,133043,35005,16218,49749,48000,78933,56249,22684,78933,101300,2019
26147,43.8,159247,145070,3478,5373,42869,56951,64850,50144,14706,64850,154300,2019
26149,39.6,60836,52623,1347,4822,16406,52086,24150,18018,6132,24150,122300,2019
26151,45.2,41295,38807,222,1522,11518,47672,17499,13775,3724,17499,111200,2019
26153,52.1,8048,6895,36,89,2164,45500,3468,2903,565,3468,109900,2019
26155,42.4,68340,64313,467,2011,18809,56032,27593,20858,6735,27593,122300,2019
26157,44.6,52939,49413,495,1808,14964,49988,21777,17950,3827,21777,104000,2019
26159,41.6,75358,61194,2394,8685,20380,54485,29411,22638,6773,29411,139400,2019
26161,33.6,367000,257368,43225,17329,81456,72586,141245,86332,54913,141245,263600,2019
26163,37.9,1757299,870241,677346,104419,413330,47301,682282,423147,259135,682282,113000,2019
26165,41.6,33256,31432,173,653,8818,47193,12963,9958,3005,12963,108300,2019
27001,55.5,15834,14873,71,221,4929,49351,7681,6310,1371,7681,183200,2019
27003,38.5,350253,284641,21506,15996,91202,82175,128198,102689,25509,128198,232400,2019
27005,41.9,34011,29332,167,716,9321,60284,13617,10691,2926,13617,198400,2019
27007,34,46403,33360,472,1130,10905,49160,17372,11650,5722,17372,162600,2019
27009,36,40129,36074,1601,981,10364,57715,16452,11085,5367,16452,174900,2019
27011,49,4996,4799,3,91,1406,53900,2298,1676,622,2298,97900,2019
27013,31,66795,58714,2578,2438,15024,57429,26091,16179,9912,26091,184800,2019
27015,42.3,25163,23499,171,1107,7004,61120,10764,8522,2242,10764,141900,2019
27017,41,35633,31399,667,634,9238,63098,13613,10865,2748,13613,171400,2019
27019,37.9,101949,90564,1780,4272,27566,101496,36754,30105,6649,36754,313200,2019
27021,48.9,29268,24264,122,658,8761,52204,13164,10728,2436,13164,194200,2019
27023,41.6,11953,10413,99,872,3247,55269,5209,3475,1734,5209,119700,2019
27025,41.3,55315,51660,723,1205,14878,83464,20242,17480,2762,20242,231500,2019
27027,32.6,63446,55305,2306,2872,15412,65269,24364,16444,7920,24364,197100,2019
27029,42.3,8821,7469,16,191,2238,50386,3405,2769,636,3405,137200,2019
27031,52.6,5376,4597,4,124,1725,57432,2691,2069,622,2691,240100,2019
27033,42.9,11299,9722,99,870,3127,52087,4846,3784,1062,4846,94200,2019
27035,44.5,64217,60939,512,958,17584,56549,26820,20528,6292,26820,198300,2019
27037,37.9,421453,330303,25657,30100,111831,86036,161488,119521,41967,161488,266000,2019
27039,38.4,20669,19048,69,1028,5678,74575,7756,6510,1246,7756,183900,2019
27041,44.2,37513,35982,143,620,10858,63819,16663,12380,4283,16663,214800,2019
27043,45.8,13801,12530,35,954,3802,53156,6137,4756,1381,6137,89500,2019
27045,42.3,20949,20169,107,344,5879,61207,8616,6963,1653,8616,153800,2019
27047,44,30463,25909,303,2967,8479,53631,13009,9975,3034,13009,113800,2019
27049,42.2,46246,42567,604,1547,12807,66800,19452,14644,4808,19452,204100,2019
27051,44.9,5935,5646,17,137,1734,55466,2612,2022,590,2612,118700,2019
27053,36.5,1245837,857475,162381,86179,291710,78167,508030,316847,191183,508030,276900,2019
27055,45.3,18648,17901,242,211,5403,60382,8253,6613,1640,8253,173700,2019
27057,48.7,21019,19509,118,448,5985,56709,8688,7054,1634,8688,193600,2019
27059,40,39430,36959,178,801,10179,74616,14903,12299,2604,14903,196800,2019
27061,46.3,45141,41415,220,674,12743,55139,19506,15853,3653,19506,164100,2019
27063,44.8,9954,9196,39,362,2862,58727,4419,3581,838,4419,124900,2019
27065,45,16089,15256,35,256,4358,57163,6439,5461,978,6439,163900,2019
27067,39.3,42841,34274,2285,5190,11396,60294,16889,12500,4389,16889,168900,2019
27069,48.1,4311,4110,64,40,1173,59643,1860,1498,362,1860,84200,2019
27071,49.5,12515,11665,73,168,3444,50870,5538,4363,1175,5538,108400,2019
27073,50.4,6719,6380,53,152,1941,53071,3090,2501,589,3090,88600,2019
27075,50.8,10560,10084,68,151,3302,61452,5192,4259,933,5192,174700,2019
27077,50.9,3771,3506,2,3,914,49967,1470,1189,281,1470,161900,2019
27079,41,28242,25716,238,1755,7744,71080,10939,8925,2014,10939,207400,2019
27081,45.4,5677,5453,25,118,1503,53077,2468,1945,523,2468,103100,2019
27083,35.8,25758,21581,862,1770,6581,57730,10018,6851,3167,10018,148900,2019
27085,40.7,35832,32575,209,2222,9483,62121,14714,11426,3288,14714,164700,2019
27087,35.7,5501,2495,29,239,1263,44688,1946,1324,622,1946,104800,2019
27089,43.7,9372,8736,33,424,2662,60118,3971,3279,692,3971,117000,2019
27091,45.3,19852,18446,92,888,5513,52798,8759,6466,2293,8759,118300,2019
27093,42.2,23105,21701,98,924,6204,63452,9209,7403,1806,9209,170200,2019
27095,40.5,25865,22977,120,640,6615,56135,10249,7696,2553,10249,163300,2019
27097,41.7,33064,31634,185,577,9021,57815,13371,10326,3045,13371,170100,2019
27099,38.8,39807,31277,1566,4611,9996,54295,15565,11359,4206,15565,123900,2019
27101,48.1,8296,7719,31,335,2359,60231,3645,2958,687,3645,120100,2019
27103,36.3,33954,30099,937,1548,8601,67399,12885,9519,3366,12885,191900,2019
27105,35.7,21734,12922,866,6047,5562,55304,8033,5677,2356,8033,127100,2019
27107,43.8,6520,5832,59,332,1709,55085,2746,2250,496,2746,100700,2019
27109,37.2,154809,123957,9280,7626,40461,76951,62108,45178,16930,62108,214600,2019
27111,46.8,58195,53870,806,2017,16436,58682,24687,19324,5363,24687,189100,2019
27113,39.6,14183,12859,143,537,3566,60122,5995,4366,1629,5995,155100,2019
27115,45,29223,26054,609,853,6804,53422,10760,8707,2053,10760,164500,2019
27117,42.1,9191,8088,43,636,2447,52917,3973,2976,997,3973,97500,2019
27119,38.7,31521,27394,665,2046,7797,59343,12584,9179,3405,12584,165000,2019
27121,45.8,11048,10601,46,173,3226,61275,4981,3862,1119,4981,174300,2019
27123,35,544442,337039,64535,40748,122262,64660,209043,124254,84789,209043,229600,2019
27125,42.7,4015,3696,18,155,1112,58576,1669,1395,274,1669,116000,2019
27127,42.6,15261,13278,119,534,4084,55404,6261,4914,1347,6261,106300,2019
27129,43.8,14652,12875,51,1253,3904,59028,6085,4744,1341,6085,106300,2019
27131,36.5,66185,54429,3756,5380,15420,68584,23005,17018,5987,23005,208600,2019
27133,40.8,9402,8793,87,299,2708,63005,3914,2954,960,3914,153000,2019
27135,41.6,15361,14121,136,202,4004,62202,5980,4877,1103,5980,132800,2019
27137,41.1,199759,182012,3107,3394,48518,55646,85807,61177,24630,85807,157900,2019
27139,36.5,145275,117891,6180,7466,37997,102152,49479,40993,8486,49479,299700,2019
27141,36,94463,86124,2327,2451,24187,89250,32206,26938,5268,32206,230500,2019
27143,41.7,14892,13160,157,1335,4096,63439,6031,4771,1260,6031,159200,2019
27145,34.4,158452,136299,10167,5342,38163,62789,59479,40493,18986,59479,184900,2019
27147,39,36683,31753,1153,2860,9799,64903,14692,11043,3649,14692,169300,2019
27149,33.1,9789,8541,132,631,2142,60559,3624,2481,1143,3624,160100,2019
27151,43.9,9359,8534,194,467,2676,51620,4263,2995,1268,4263,104100,2019
27153,43.9,24494,22323,170,1478,6686,53585,9819,8108,1711,9819,153400,2019
27155,47.5,3311,2937,17,103,1016,51957,1608,1280,328,1608,81400,2019
27157,45.2,21537,20387,119,630,6065,65226,9020,7092,1928,9020,183900,2019
27159,41.5,13654,12857,82,267,3541,46605,5666,4335,1331,5666,132000,2019
27161,40.5,18740,16720,444,1124,4905,56762,7425,5755,1670,7425,158900,2019
27163,39.5,255938,211647,11593,10716,68009,96671,94431,76614,17817,94431,289400,2019
27165,39.9,10972,7876,89,2797,2866,54065,4310,3314,996,4310,96900,2019
27167,43.3,6291,6176,25,22,1833,60595,2818,2201,617,2818,140000,2019
27169,35.2,50725,46224,651,1502,11330,59329,19442,13693,5749,19442,167300,2019
27171,37,134438,124159,1899,3953,35681,84974,48242,39350,8892,48242,238500,2019
27173,42.4,9814,8781,68,461,2788,59210,4087,3247,840,4087,110000,2019
28001,41.4,31266,11321,17561,1829,6650,29936,11237,7014,4223,11237,92100,2019
28003,39.7,37090,30735,4426,1179,9590,42086,14649,10064,4585,14649,102700,2019
28005,47.1,12412,7119,5202,0,3401,33981,5218,4430,788,5218,83600,2019
28007,39.8,18437,9883,7784,377,4735,33767,6941,5031,1910,6941,80700,2019
28009,41.5,8232,4977,2804,214,2082,36258,3149,2538,611,3149,78000,2019
28011,35.6,31848,10340,20383,687,7719,29854,12111,6491,5620,12111,96100,2019
28013,41.4,14499,9350,3968,873,3752,37263,5846,4358,1488,5846,70500,2019
28015,47.6,10070,6481,3493,24,2685,46052,3827,3106,721,3827,99000,2019
28017,37.8,17193,8525,7616,841,4278,36548,6476,4513,1963,6476,66500,2019
28019,44,8277,5577,2564,49,2010,36777,3228,2536,692,3228,81400,2019
28021,33.9,9089,1025,7928,8,1897,29338,2908,2020,888,2908,67500,2019
28023,42.2,15770,9974,5592,102,4397,43207,6237,5195,1042,6237,84900,2019
28025,39.5,19640,7622,11770,14,4841,31833,7618,5436,2182,7618,89900,2019
28027,34.8,23255,4834,18030,86,5637,29121,8782,4442,4340,8782,68300,2019
28029,38.5,28501,12509,14698,902,6609,42151,9414,7271,2143,9414,95200,2019
28031,37.3,18978,11470,6946,452,4965,38178,6759,5286,1473,6759,77100,2019
28033,36.8,178975,115053,48654,8836,45789,67038,62890,46531,16359,62890,168500,2019
28035,32.5,75224,42808,27945,2203,16991,39840,28086,15308,12778,28086,122700,2019
28037,42.5,7733,4884,2782,21,2096,40219,2928,2252,676,2928,76600,2019
28039,36.4,23917,20835,1920,683,5309,47292,7592,6210,1382,7592,110800,2019
28041,40.4,13645,9861,3538,163,2624,49677,3925,3249,676,3925,77700,2019
28043,39.2,21088,11528,9139,127,5362,40122,8391,5367,3024,8391,105000,2019
28045,44.4,46961,39769,3765,1794,13081,48119,20036,15131,4905,20036,147500,2019
28047,36.2,204502,130615,50506,11193,51580,47894,78104,44241,33863,78104,150500,2019
28049,34.8,238797,58497,172749,3676,55237,44625,88611,51408,37203,88611,118600,2019
28051,34.7,17737,2736,14897,30,3722,21504,6188,3791,2397,6188,60400,2019
28053,38.3,8389,1730,6346,278,2078,28962,3186,1971,1215,3186,69100,2019
28055,42.2,1361,504,839,18,274,24208,483,211,272,483,79200,2019
28057,39.9,23462,21120,1678,376,6207,44567,8653,6606,2047,8653,87600,2019
28059,38.8,142376,96260,29882,9242,34681,51657,52423,36586,15837,52423,135900,2019
28061,41,16505,7379,8889,75,4746,35872,6629,5637,992,6629,79000,2019
28063,40.5,7225,938,5705,522,1488,25019,2448,1649,799,2448,63400,2019
28065,44,11339,4275,6950,40,3003,32116,4713,3563,1150,4713,94600,2019
28067,37.5,68352,44132,20041,3073,16987,41775,24858,18059,6799,24858,98600,2019
28069,41.4,9943,3375,6134,58,2201,31103,3611,2659,952,3611,73600,2019
28071,30.5,53590,37539,12591,1407,11111,50272,18721,11616,7105,18721,199700,2019
28073,35.9,61969,45921,12446,1682,15584,60328,22116,14920,7196,22116,177700,2019
28075,37.8,76279,40059,33271,1723,19307,42534,29736,19169,10567,29736,96300,2019
28077,39.9,12633,8196,4109,116,3385,41914,4849,3646,1203,4849,94800,2019
28079,36.9,22792,10716,9504,1059,5591,37096,8105,5738,2367,8105,83300,2019
28081,37.5,85072,55681,24991,2249,21639,50559,32099,21784,10315,32099,133700,2019
28083,34,29222,6484,21683,773,6050,26735,9962,5042,4920,9962,81200,2019
28085,38.9,34320,23053,10945,152,9054,42606,12699,9568,3131,12699,99500,2019
28087,37.1,59150,30605,25868,1204,14654,50441,22436,14253,8183,22436,134200,2019
28089,37.2,104562,57866,39677,3133,28197,71824,39635,28411,11224,39635,219700,2019
28091,40.8,24990,16194,8140,402,5863,32090,9483,7800,1683,9483,89000,2019
28093,40.4,35599,16990,16992,1315,8832,42233,12772,9644,3128,12772,107900,2019
28095,41.1,35673,23903,11098,450,9122,42354,13966,10377,3589,13966,91700,2019
28097,41.6,10068,5250,4435,140,3064,39840,4539,3143,1396,4539,84800,2019
28099,37.3,29332,17093,6145,626,7184,37987,10657,7625,3032,10657,83000,2019
28101,37,21360,12869,6498,408,5697,35958,8037,6201,1836,8037,85600,2019
28103,37,10700,2766,7721,150,2592,33784,3986,2907,1079,3986,59700,2019
28105,26.1,49512,27946,18277,837,9263,40453,17798,9201,8597,17798,162900,2019
28107,38.3,34190,16042,16530,699,8512,38304,12488,8696,3792,12488,83300,2019
28109,40.9,55219,45177,7046,1709,15078,46901,21020,16354,4666,21020,138200,2019
28111,41.9,12006,9312,2379,181,3347,42469,4623,3802,821,4623,86700,2019
28113,37.2,39532,17150,21357,628,8528,31784,14404,9940,4464,14404,95500,2019
28115,36.6,31618,24171,4893,2171,7943,44759,10783,7685,3098,10783,106500,2019
28117,39.2,25255,20830,2533,380,6092,39256,9145,6651,2494,9145,92700,2019
28119,38.7,7187,1871,5176,88,1833,25283,3027,1776,1251,3027,50900,2019
28121,37.8,152677,112876,31635,4201,39770,65996,55909,42778,13131,55909,162500,2019
28123,36.4,28332,13977,10745,3197,7015,34943,10180,7545,2635,10180,71300,2019
28125,41.2,4404,1104,3284,5,1046,29394,1751,1122,629,1751,64400,2019
28127,39.5,26888,16560,9851,68,6617,43850,9486,7564,1922,9486,87900,2019
28129,41.5,16009,11852,3675,280,4109,43105,5820,4832,988,5820,102600,2019
28131,38.7,18276,13981,3323,369,4560,45483,6334,4720,1614,6334,112800,2019
28133,35.6,26168,6220,19332,474,5292,30838,8322,4458,3864,8322,78400,2019
28135,36.8,14158,4943,7587,1341,2775,29864,4369,3144,1225,4369,66400,2019
28137,38.2,28404,18349,8483,747,7580,51030,10324,7725,2599,10324,119200,2019
28139,38.8,22018,16953,3644,1051,5394,39246,7834,5664,2170,7834,86900,2019
28141,42.5,19441,18117,509,616,5035,37681,7635,5766,1869,7635,88100,2019
28143,33.6,9988,1897,7830,96,2347,39370,3930,1581,2349,3930,107100,2019
28145,37.9,28507,22292,4405,1248,6922,45754,9808,7174,2634,9808,100600,2019
28147,39.8,14477,7623,6706,119,3371,30961,5601,4922,679,5601,95800,2019
28149,39.1,46519,21897,22969,981,11480,45113,18235,12053,6182,18235,128400,2019
28151,37.2,46057,11577,33160,745,11232,29705,17988,9514,8474,17988,75600,2019
28153,40.2,20373,11695,8359,132,5390,37706,7683,6413,1270,7683,85800,2019
28155,40.5,9768,7639,1995,68,2687,45730,3782,2886,896,3782,84000,2019
28157,37.8,8875,2469,6294,19,1843,27313,3170,2534,636,3170,70300,2019
28159,42.3,18229,9103,8489,234,4737,34724,7269,5313,1956,7269,84900,2019
28161,42.5,12367,7175,4904,172,3350,41464,5181,3629,1552,5181,79700,2019
28163,36.1,28565,9903,16908,1312,5203,33279,8542,5395,3147,8542,88900,2019
29001,27.6,25369,22788,680,622,5004,41929,9258,5561,3697,9258,126800,2019
29003,42.4,17503,16536,240,438,4743,58772,6763,5406,1357,6763,147900,2019
29005,48.5,5229,5049,24,69,1428,50236,2562,1786,776,2562,84900,2019
29007,39.7,25644,22223,1464,797,6041,44261,9286,6360,2926,9286,97900,2019
29009,43.7,35530,30426,80,3321,9779,44403,13645,10062,3583,13645,120600,2019
29011,41.3,11797,10905,35,187,3191,44125,4895,3430,1465,4895,97500,2019
29013,41.6,16296,15341,246,360,4617,47625,6547,4761,1786,6547,114600,2019
29015,53.6,19107,18115,48,391,5014,40249,7872,6426,1446,7872,117500,2019
29017,44,12225,11735,50,137,3127,44158,4593,3712,881,4593,110800,2019
29019,31.2,177651,140135,15935,6086,40427,55328,70619,39269,31350,70619,185700,2019
29021,37.8,88460,73664,4522,5776,20522,51916,33501,20888,12613,33501,122200,2019
29023,41.3,42656,37775,2367,914,10997,39915,16390,10439,5951,16390,113500,2019
29025,42.3,9039,8540,52,147,2348,49839,3639,2770,869,3639,109300,2019
29027,38.6,44889,40487,1941,940,10825,56938,15973,11582,4391,15973,157400,2019
29029,51.5,45466,42853,335,1242,11274,53478,16031,12938,3093,16031,200800,2019
29031,36.5,78491,67460,5777,1827,18879,53732,29594,19229,10365,29594,160500,2019
29033,43.4,8781,8317,124,140,2444,50830,3503,2601,902,3503,88200,2019
29035,41.7,6147,5913,4,158,1562,39530,2333,1806,527,2333,101500,2019
29037,39.8,103597,91136,4122,4541,29273,69433,39770,30425,9345,39770,181000,2019
29039,44.7,14043,13278,7,317,3845,39365,5842,4131,1711,5842,98900,2019
29041,45.7,7483,7106,191,40,1819,46738,2686,2102,584,2686,87900,2019
29043,37.9,85658,79950,593,2525,22797,60645,31645,23496,8149,31645,169000,2019
29045,44,6779,6570,21,41,1750,48909,2657,1989,668,2657,90000,2019
29047,37.1,242516,196732,14447,16479,60781,70510,91238,62636,28602,91238,174900,2019
29049,41,20500,19213,310,439,5702,62701,8177,6249,1928,8177,159700,2019
29051,38.6,76723,62605,8943,2176,18869,60066,30154,19990,10164,30154,162300,2019
29053,38.7,17660,15502,1006,352,4178,52735,6397,4642,1755,6397,132900,2019
29055,41.9,24154,22986,90,485,6192,44438,9578,6842,2736,9578,124700,2019
29057,46.2,7578,7101,27,162,2113,40399,3068,2356,712,3068,83500,2019
29059,44,16617,15713,5,348,4188,43542,6209,4723,1486,6209,115000,2019
29061,41.1,8295,7957,50,130,2137,51679,3035,2407,628,3035,110400,2019
29063,40.4,12526,10498,1120,324,2419,55918,3807,2631,1176,3807,120100,2019
29065,44.7,15545,14661,64,274,4119,42100,6371,4683,1688,6371,102600,2019
29067,47.3,13306,13040,30,115,3692,37425,5137,4097,1040,5137,123100,2019
29069,40,30027,24134,3068,1991,7683,36380,12342,7657,4685,12342,76500,2019
29071,40.7,103191,98056,743,1799,28054,57214,40943,30507,10436,40943,165700,2019
29073,46.2,14711,14109,60,210,4187,54885,6076,4761,1315,6076,134200,2019
29075,40.4,6616,6348,39,107,1707,47790,2555,1880,675,2555,88200,2019
29077,36,289756,253625,9377,10786,72743,46086,125201,70172,55029,125201,146000,2019
29079,40.8,9992,9399,28,244,2390,45594,3936,2686,1250,3936,98400,2019
29081,43.3,8491,8078,44,195,2238,42917,3429,2493,936,3429,76000,2019
29083,44.1,21735,20327,273,535,5912,45795,9328,6738,2590,9328,110500,2019
29085,55,9404,8913,3,164,2360,34182,3976,3269,707,3976,83400,2019
29087,48.5,4432,4247,47,47,1250,49524,2022,1541,481,2022,88600,2019
29089,39.1,10058,9108,586,158,2383,52700,3471,2716,755,3471,130100,2019
29091,40.9,40104,37809,90,855,10668,38357,15878,10861,5017,15878,112200,2019
29093,45.7,10164,9591,113,181,2710,37435,4074,2885,1189,4074,83600,2019
29095,36.8,696216,433000,161124,62514,166893,55134,286601,166927,119674,286601,147400,2019
29097,36.2,119920,100935,2189,9644,30154,48357,45759,29096,16663,45759,118400,2019
29099,39.2,223951,211428,2105,4398,61615,65454,84444,67019,17425,84444,161800,2019
29101,30.5,53682,46037,2300,2356,13041,55273,19864,12114,7750,19864,156500,2019
29103,44.1,3947,3797,18,43,934,40000,1490,1231,259,1490,75500,2019
29105,40.3,35531,33083,205,872,10276,47257,14112,9807,4305,14112,113900,2019
29107,42.3,32597,29981,717,942,8940,58766,13050,9238,3812,13050,143500,2019
29109,39.4,38204,34040,184,2847,10328,44742,14787,10616,4171,14787,109600,2019
29111,40.6,9955,9220,419,47,2503,45988,3752,2856,896,3752,87900,2019
29113,37.1,56477,52543,1079,1401,14454,64196,19286,15137,4149,19286,163300,2019
29115,41.8,12113,11485,57,293,3437,45930,5106,3721,1385,5106,87200,2019
29117,40,15126,13971,382,278,3843,46992,5915,3940,1975,5915,111500,2019
29119,37.8,22782,17604,415,2639,6264,41643,8259,5666,2593,8259,110500,2019
29121,43.3,15199,14226,297,228,3616,42746,5845,4362,1483,5845,97200,2019
29123,42.2,12179,11526,92,288,3468,43636,5044,3622,1422,5044,106100,2019
29125,46,8803,8403,26,113,2450,47569,3762,2817,945,3762,133200,2019
29127,38.9,28608,25759,1070,509,7429,48784,11565,7563,4002,11565,123400,2019
29129,42.9,3644,3489,20,84,782,47298,1271,999,272,1271,88900,2019
29131,40.7,25201,23898,63,489,7035,47171,10111,7506,2605,10111,136800,2019
29133,41.4,13574,9701,3314,296,3637,35357,5026,3001,2025,5026,80200,2019
29135,38,16046,14701,438,782,3833,58010,5436,4187,1249,5436,124500,2019
29137,46.5,8629,8017,293,145,2411,43966,3702,2759,943,3702,105300,2019
29139,44.5,11487,10804,164,225,3204,46757,5014,3510,1504,5014,108100,2019
29141,46,20271,19081,178,458,4929,39003,7588,6126,1462,7588,125000,2019
29143,42,17560,14024,2689,330,4793,38679,7371,4677,2694,7371,74500,2019
29145,39.9,58180,50100,508,3093,15527,50813,22202,15877,6325,22202,131300,2019
29147,29.7,22359,20702,617,386,4842,44232,8395,4854,3541,8395,126400,2019
29149,46.4,10647,10012,16,195,2813,33601,4249,3137,1112,4249,93600,2019
29151,40.8,13615,13411,24,112,3733,61687,5120,4329,791,5120,151900,2019
29153,51.6,9207,8773,6,166,2390,31947,3958,3071,887,3958,97600,2019
29155,37.9,16663,11418,4527,435,4286,33859,6730,3644,3086,6730,82100,2019
29157,40.7,19191,18261,108,439,5327,55863,7576,5682,1894,7576,147700,2019
29159,37.8,42355,35969,1483,3670,10566,46157,16033,11029,5004,16033,119100,2019
29161,35.3,44630,39598,993,1137,11063,44154,17981,10725,7256,17981,135000,2019
29163,38.9,18455,16251,1338,415,4198,46385,6589,4723,1866,6589,97800,2019
29165,38.2,100682,81559,6732,6082,25985,80393,39305,25905,13400,39305,226500,2019
29167,37.6,31748,29759,294,775,8187,45660,11712,8081,3631,11712,132300,2019
29169,27.6,52425,36370,5586,5879,10338,53492,15154,7472,7682,15154,159200,2019
29171,45.8,4781,4588,5,23,1061,42849,1744,1346,398,1744,96600,2019
29173,45,10234,9769,128,128,2946,55377,4036,3360,676,4036,136200,2019
29175,39.4,24878,22013,1436,523,5667,47740,8626,6168,2458,8626,105000,2019
29177,42.2,22875,21425,302,564,6272,61957,8868,6965,1903,8868,133700,2019
29179,46.5,6290,5896,128,50,1804,40324,2596,2043,553,2596,96000,2019
29181,42.3,13567,12895,94,197,3379,34971,5059,3996,1063,5059,83800,2019
29183,38.6,394290,343580,17307,12981,105132,84978,146631,118222,28409,146631,219100,2019
29185,50.3,9370,8854,68,120,2542,38870,4139,3240,899,4139,91900,2019
29186,43.3,17848,17073,350,211,5163,60129,7121,5703,1418,7121,166200,2019
29187,39.4,66643,61158,2923,1049,16451,46466,24898,17043,7855,24898,121000,2019
29189,40.3,996919,658354,240128,28834,259104,67420,405984,278342,127642,405984,198800,2019
29195,37.9,22976,18442,1100,2341,5182,44720,8272,5754,2518,8272,106600,2019
29197,40.1,4555,4414,21,76,922,42694,1475,1022,453,1475,71200,2019
29199,37.3,4902,4866,0,0,1187,50085,1768,1371,397,1768,113000,2019
29201,40,38633,32159,4494,893,10359,44139,15230,10152,5078,15230,109200,2019
29203,45.8,8217,7713,14,154,2094,34265,3064,2248,816,3064,124900,2019
29205,42.3,6013,5725,97,103,1593,44083,2432,1796,636,2432,72200,2019
29207,41.4,29377,28022,437,514,7580,41062,11530,7845,3685,11530,104200,2019
29209,53.6,31615,29972,64,729,9097,49656,12783,10449,2334,12783,172600,2019
29211,42.1,6247,4797,142,1143,1334,46481,2128,1585,543,2128,77000,2019
29213,42.2,55114,48934,758,3260,15236,46031,22272,13740,8532,22272,139800,2019
29215,43.2,25604,23302,559,544,6517,35067,9728,7039,2689,9728,111700,2019
29217,40.8,20595,19342,111,445,5340,43276,8207,5884,2323,8207,98300,2019
29219,41,34453,31582,689,1173,9396,60125,12654,9980,2674,12654,180000,2019
29221,40.8,24860,23427,529,346,6593,41483,9231,7334,1897,9231,94400,2019
29223,47.5,13195,12514,73,238,3265,34316,5426,3988,1438,5426,85100,2019
29225,36.7,38655,36357,352,801,9889,50560,13575,10182,3393,13575,136200,2019
29227,48.1,2027,1954,11,31,593,53580,859,656,203,859,63800,2019
29229,41.7,18203,17293,97,344,4749,34776,7063,4941,2122,7063,103600,2019
29510,35.8,308174,134491,142471,12399,64324,43896,141952,61975,79977,141952,138700,2019
30001,43,9415,8502,7,465,2286,43201,3992,2705,1287,3992,215400,2019
30003,30.7,13387,3584,4,852,2729,49859,3609,2288,1321,3609,126100,2019
30005,33.8,6719,2994,27,238,1558,41279,2366,1373,993,2366,94300,2019
30007,47.3,5945,5612,5,166,1493,60594,2364,1951,413,2364,222200,2019
30009,50.5,10597,9989,43,261,2738,58707,4524,3456,1068,4524,247600,2019
30011,47.8,1331,1289,0,1,402,48000,628,452,176,628,110900,2019
30013,38.3,81625,69561,1055,3682,21478,49913,34329,22099,12230,34329,179900,2019
30015,41.9,5732,4409,14,151,1553,42298,2274,1450,824,2274,143200,2019
30017,41.4,11729,10767,74,401,2999,52965,4903,3371,1532,4903,170400,2019
30019,49.2,1730,1609,0,46,503,57440,857,672,185,857,126500,2019
30021,41,9017,8319,70,281,2339,58596,3930,2683,1247,3930,160600,2019
30023,48.6,9106,8206,68,315,2226,41820,3903,2645,1258,3903,131300,2019
30025,39.3,2921,2756,1,58,771,64545,1334,961,373,1334,169800,2019
30027,45.3,11221,10555,15,104,2971,50540,4912,3578,1334,4912,143000,2019
30029,42.2,99899,92665,342,2829,25268,56182,38773,28738,10035,38773,273600,2019
30031,33.4,108063,99001,425,4032,25156,66397,43777,26781,16996,43777,357100,2019
30033,45.8,1036,1028,7,1,304,42000,438,320,118,438,124100,2019
30035,31.9,13732,4112,39,451,2560,36045,4163,2447,1716,4163,107700,2019
30037,56.9,728,652,0,49,217,43875,351,270,81,351,106100,2019
30039,54.3,3311,3121,3,75,718,49881,1308,1035,273,1308,224000,2019
30041,34.3,16436,11370,52,623,4000,49321,6369,3939,2430,6369,143600,2019
30043,47.6,11917,11042,45,305,3255,69646,4484,3781,703,4484,282700,2019
30045,51.7,1954,1811,0,70,543,43661,906,686,220,906,138200,2019
30047,42.3,30013,19521,89,1374,8009,48829,11802,8495,3307,11802,253100,2019
30049,40.8,67805,61953,180,2255,17219,65791,27893,19371,8522,27893,243000,2019
30051,46.5,2351,2311,0,29,556,44875,895,564,331,895,101100,2019
30053,52.4,19537,18096,40,611,5112,40140,8122,6525,1597,8122,198200,2019
30055,46.6,1790,1589,0,67,484,49701,723,584,139,723,114800,2019
30057,53,8302,7676,2,372,2099,54107,3570,2748,822,3570,276500,2019
30059,48,1888,1749,1,88,423,46607,702,509,193,702,154100,2019
30061,51.7,4251,3886,34,56,1079,41705,1786,1321,465,1786,169200,2019
30063,36,117309,104688,708,3841,27817,54062,49313,29040,20273,49313,284000,2019
30065,50.1,4766,4343,0,147,1391,43274,2181,1570,611,2181,172700,2019
30067,46.3,16352,15263,73,505,4485,53068,7782,5333,2449,7782,271300,2019
30069,51.8,453,428,0,0,121,51250,204,152,52,204,181300,2019
30071,49,4077,3417,0,114,995,46212,1710,1318,392,1710,129200,2019
30073,40.7,5994,4866,8,122,1414,51151,2103,1569,534,2103,131900,2019
30075,53.4,1607,1495,0,51,484,54427,737,550,187,737,142600,2019
30077,45.5,6854,6126,64,119,1651,54667,2426,1627,799,2426,143100,2019
30079,48.7,1252,1224,0,16,346,43625,518,435,83,518,112900,2019
30081,49.1,42512,39514,48,1490,11937,53054,17354,13239,4115,17354,279300,2019
30083,38.6,11199,9947,0,608,2724,67205,4535,2992,1543,4535,230100,2019
30085,30.2,11175,3839,24,442,1981,43194,3150,1981,1169,3150,112400,2019
30087,36.8,9152,5018,16,473,2180,57992,3166,2190,976,3166,114900,2019
30089,53.9,11681,10526,36,352,3042,40823,5036,3906,1130,5036,228200,2019
30091,46.3,3483,3172,0,132,903,55521,1639,1291,348,1639,127500,2019
30093,40,34770,31446,191,1585,7990,45718,14960,10308,4652,14960,149800,2019
30095,46.8,9466,8783,8,374,2616,64645,3761,3036,725,3761,255500,2019
30097,52,3670,3454,0,83,1011,49886,1566,1133,433,1566,255100,2019
30099,44.4,6086,5697,32,99,1631,55000,2464,1722,742,2464,172700,2019
30101,43.1,4892,4260,23,196,1186,50721,1867,1109,758,1867,137900,2019
30103,56.8,668,630,0,4,219,43047,351,239,112,351,118200,2019
30105,44.3,7471,6313,29,203,2191,53162,3386,2536,850,3386,151400,2019
30107,41.1,2142,2000,0,67,489,39655,792,592,200,792,95400,2019
30109,47.1,1122,1046,0,55,349,53958,498,397,101,498,113500,2019
30111,38.4,159008,137320,764,8928,41347,61264,66385,45408,20977,66385,226000,2019
31001,37.7,31587,27129,188,3254,7792,53023,12712,8449,4263,12712,128500,2019
31003,44.9,6341,6031,58,210,1769,49912,2714,2050,664,2714,82000,2019
31005,45.5,427,409,0,2,105,42813,197,131,66,197,111300,2019
31007,48.9,722,652,0,44,231,51750,283,197,86,283,139900,2019
31009,53.2,477,477,0,0,144,51094,213,157,56,213,75700,2019
31011,44.8,5279,5087,17,115,1495,54979,2311,1760,551,2311,118400,2019
31013,39.4,10970,8930,149,1376,2923,54004,4743,3254,1489,4743,113600,2019
31015,54.3,1937,1840,11,18,579,47778,904,737,167,904,73000,2019
31017,49.4,3015,2881,1,54,807,43098,1387,1046,341,1387,79700,2019
31019,33.5,49209,42822,432,4429,11768,59431,19062,12388,6674,19062,174800,2019
31021,45.7,6510,6050,31,200,1892,54203,2856,2187,669,2856,100400,2019
31023,43.3,8029,7581,12,287,2171,58979,3363,2619,744,3363,117300,2019
31025,41.7,25888,24225,87,867,6985,71846,9945,8124,1821,9945,173800,2019
31027,42.7,8498,8195,13,175,2374,61869,3506,2824,682,3506,121300,2019
31029,43.5,3783,3293,2,465,1152,57009,1679,1270,409,1679,133300,2019
31031,43.1,5779,5080,1,145,1677,56651,2537,1554,983,2537,116000,2019
31033,40.4,9604,8596,80,671,2446,53871,4395,2928,1467,4395,103000,2019
31035,42.5,6203,5535,13,549,1676,57173,2539,2025,514,2539,91300,2019
31037,33.7,10714,5243,401,4869,2411,58872,3731,2699,1032,3731,101100,2019
31039,42.6,8952,7888,9,905,2414,56768,3727,2598,1129,3727,122200,2019
31041,43.1,10826,10238,17,347,3182,52184,4862,3382,1480,4862,108100,2019
31043,33.4,20173,9680,1023,7823,5384,59231,7404,4828,2576,7404,119600,2019
31045,34.9,8810,7498,350,472,2011,50750,3525,2278,1247,3525,125200,2019
31047,35.7,23733,13953,1459,7893,6292,53721,8965,6035,2930,8965,102600,2019
31049,48.7,1831,1608,3,156,552,47287,830,633,197,830,87300,2019
31051,40.8,5719,4818,25,786,1569,56905,2352,1847,505,2352,94700,2019
31053,38.9,36665,30679,278,4718,9812,54085,15261,9481,5780,15261,130200,2019
31055,34.7,560617,389094,61271,70367,134664,64629,218061,134569,83492,218061,169800,2019
31057,43.3,1913,1676,4,226,477,41716,872,629,243,872,75900,2019
31059,47,5547,5194,21,218,1519,60313,2510,1946,564,2510,80100,2019
31061,50.8,2987,2858,15,69,878,49282,1377,1110,267,1377,71300,2019
31063,45.2,2640,2537,15,33,761,54659,1135,797,338,1135,101200,2019
31065,46.9,4747,4432,6,204,1357,48838,2128,1588,540,2128,73000,2019
31067,43.8,21594,20399,130,548,5467,53110,8979,6247,2732,8979,116200,2019
31069,50.4,1864,1757,3,86,521,43750,868,640,228,868,81800,2019
31071,50.9,2001,1942,7,37,602,53000,884,688,196,884,105100,2019
31073,53.4,2013,1864,5,101,606,64053,942,664,278,942,127000,2019
31075,38.8,722,691,6,9,198,46500,288,203,85,288,58300,2019
31077,45.5,2382,2290,10,50,671,47869,1019,825,194,1019,72700,2019
31079,35.9,61265,40846,1514,16986,15712,57104,23096,14398,8698,23096,146000,2019
31081,41.9,9215,8725,17,325,2720,64210,3713,2860,853,3713,154300,2019
31083,45.3,3415,3258,18,89,915,49835,1521,1207,314,1521,102700,2019
31085,45.7,893,819,0,74,261,51726,403,303,100,403,80900,2019
31087,46.2,2815,2791,2,15,728,49962,1243,919,324,1243,66700,2019
31089,42.8,10177,9492,14,496,2804,60387,4487,3238,1249,4487,114100,2019
31091,53.3,693,637,7,45,182,41125,318,199,119,318,92200,2019
31093,43.1,6417,6128,10,163,1829,59348,2720,2081,639,2720,148800,2019
31095,46.5,7144,6677,45,305,1830,44510,3302,2352,950,3302,84000,2019
31097,40.9,5161,4149,313,527,1223,54712,1809,1328,481,1809,94400,2019
31099,39.6,6529,6013,7,410,1701,60266,2666,1950,716,2666,149700,2019
31101,49.3,8068,7236,98,584,2304,50735,3882,2671,1211,3882,128300,2019
31103,45.3,760,749,0,7,198,56500,304,221,83,304,78100,2019
31105,46.3,3633,3132,3,347,1022,53403,1577,1126,451,1577,82600,2019
31107,45.6,8426,7216,34,242,2347,52332,3586,2659,927,3586,95900,2019
31109,33.5,313158,254337,11941,22068,73722,60527,124324,74344,49980,124324,177400,2019
31111,41.1,35263,30936,438,3046,9688,59795,14856,9950,4906,14856,139400,2019
31113,38.6,927,875,0,44,234,52708,347,256,91,347,110300,2019
31115,53.2,605,592,0,11,198,51000,294,225,69,294,112500,2019
31117,54.8,395,389,0,6,116,48125,191,139,52,191,102700,2019
31119,36.6,35080,27970,442,5267,8939,53188,14205,9320,4885,14205,146400,2019
31121,43.6,7798,7212,36,349,2247,55649,3373,2514,859,3373,115400,2019
31123,42.3,4781,3909,37,737,1186,46194,1954,1398,556,1954,95600,2019
31125,44.8,3544,3418,14,99,981,49032,1546,1244,302,1546,78300,2019
31127,39.3,6973,6541,104,194,1825,51828,2977,2171,806,2977,106300,2019
31129,49.2,4244,4015,6,119,1117,43388,1867,1416,451,1867,68300,2019
31131,41.4,15949,14156,65,1288,4241,59167,6510,4544,1966,6510,143900,2019
31133,50,2649,2528,4,48,770,46452,1222,1019,203,1222,71100,2019
31135,42.9,2901,2761,4,122,840,65543,1228,956,272,1228,118400,2019
31137,42.4,9100,8389,33,519,2450,59040,3905,2803,1102,3905,134000,2019
31139,41.6,7144,6870,15,109,2001,64511,3022,2294,728,3022,132700,2019
31141,38.4,33174,25996,179,6297,8537,62305,12947,9381,3566,12947,149700,2019
31143,45.1,5225,4850,4,288,1449,67719,2052,1705,347,2052,107300,2019
31145,40.7,10768,9874,66,566,2818,48808,4519,3296,1223,4519,109000,2019
31147,47.7,7961,7339,16,155,2222,47917,3704,2811,893,3704,69200,2019
31149,46.2,1414,1365,21,17,417,56250,623,497,126,623,96200,2019
31151,35.5,14270,9847,322,3616,3530,51502,5157,3641,1516,5157,99300,2019
31153,34.6,181232,146729,6626,16896,48012,82032,66260,45679,20581,66260,195300,2019
31155,41.2,21165,20162,104,482,5851,68682,8501,6637,1864,8501,165600,2019
31157,39.5,36074,25975,266,8594,9308,49745,14732,9863,4869,14732,128100,2019
31159,38,17171,16258,94,452,4458,70389,6600,4734,1866,6600,168200,2019
31161,46.7,5231,4243,109,289,1372,45371,2273,1564,709,2273,72300,2019
31163,49.7,3033,2922,5,68,862,50781,1368,1056,312,1368,88700,2019
31165,44.1,1219,1129,5,41,371,48269,544,392,152,544,117700,2019
31167,42.1,5957,5469,87,330,1742,63986,2418,1984,434,2418,119500,2019
31169,46.5,5057,4799,25,131,1424,51821,2244,1763,481,2244,71400,2019
31171,41.8,645,613,0,0,191,59432,277,212,65,277,119300,2019
31173,27.5,7181,2566,14,427,1601,51034,2176,1324,852,2176,79800,2019
31175,46.2,4206,3985,20,143,1218,55324,1865,1385,480,1865,110400,2019
31177,41.2,20361,19241,176,593,5747,71430,8185,6405,1780,8185,196100,2019
31179,32,9332,8392,135,557,2254,56456,3708,2378,1330,3708,137200,2019
31181,45.1,3537,3237,10,181,961,46188,1507,1200,307,1507,78400,2019
31183,49.4,783,759,0,20,221,51591,346,232,114,346,97800,2019
31185,39.9,13745,12443,214,709,3677,60298,5656,4048,1608,5656,135200,2019
32001,39.7,24259,17762,593,3376,6571,57824,9940,6503,3437,9940,191500,2019
32003,37.3,2182004,933344,245063,679381,498594,59340,783524,421252,362272,783524,262700,2019
32005,52,48132,38877,357,6108,14208,66810,20741,14811,5930,20741,378800,2019
32007,34.1,52297,34901,257,12751,12661,81232,18065,12870,5195,18065,212500,2019
32009,55.4,969,774,25,153,202,37375,491,286,205,491,65000,2019
32011,47.7,1859,1671,1,81,558,67105,774,571,203,774,120100,2019
32013,36,16828,11000,109,4547,4305,67756,6500,4642,1858,6500,180600,2019
32015,37.4,5643,3616,4,1759,1568,88030,2198,1614,584,2198,179900,2019
32017,44.4,5180,4504,197,357,1227,58462,2018,1510,508,2018,140900,2019
32019,43.7,54380,40722,402,9306,13876,56875,21189,14985,6204,21189,214900,2019
32021,52.9,4460,2690,229,519,1013,35806,2048,1446,602,2048,98900,2019
32023,53.1,44380,33861,826,6513,11156,47300,19088,13517,5571,19088,163300,2019
32027,42.1,6615,4310,234,1617,1306,50491,1948,1301,647,1948,113000,2019
32029,50.9,3988,3374,67,129,1037,66292,1627,1470,157,1627,240700,2019
32031,38.4,456936,288214,9821,111653,113491,64791,182180,106255,75925,182180,334100,2019
32033,39.8,9679,6929,543,1565,2135,60827,3516,2657,859,3516,154100,2019
32510,42.4,54773,36688,1074,13226,14143,55718,22755,12915,9840,22755,273800,2019
33001,47.4,60887,57842,375,1018,16586,69447,25052,18918,6134,25052,226500,2019
33003,52.3,48138,46129,225,713,13746,63153,21456,17025,4431,21456,242800,2019
33005,43.1,76042,71552,555,1408,18359,64751,30141,20929,9212,30141,195300,2019
33007,48.2,31741,29216,770,935,8251,47117,13768,9728,4040,13768,128000,2019
33009,43.2,89777,81380,924,2150,21039,63389,34727,24081,10646,34727,220300,2019
33011,40.7,413035,348800,9655,27970,106169,81460,161086,106397,54689,161086,274800,2019
33013,42.8,149917,138560,2040,3233,38778,75737,58452,41953,16499,58452,237600,2019
33015,44.5,306359,283469,2299,9161,84172,93756,121045,94111,26934,121045,326300,2019
33017,36.9,129124,117027,1210,3231,31210,72960,48982,32335,16647,48982,235900,2019
33019,46.3,43104,40952,282,674,11357,61312,17328,12701,4627,17328,173600,2019
34001,41.7,266105,150070,37289,50150,65999,62110,99850,67025,32825,99850,217900,2019
34003,41.9,930390,526241,49249,185238,244319,101144,339856,220190,119666,339856,469500,2019
34005,41.6,445702,300533,71501,35855,116102,87416,166391,125494,40897,166391,251200,2019
34007,38.8,506738,287169,92537,84972,125240,70451,187383,125229,62154,187383,197800,2019
34009,49.6,93086,79373,4124,7153,26368,67074,40171,31189,8982,40171,300500,2019
34011,37.6,151906,70499,27490,46643,34513,54149,50729,33093,17636,50729,162500,2019
34013,37.6,795404,242965,305796,183182,184261,61510,285908,125777,160131,285908,386000,2019
34015,40.5,291165,228576,28452,18059,73736,87283,104908,84056,20852,104908,219700,2019
34017,35.3,670046,192880,70655,288647,160439,71189,258591,81934,176657,258591,378000,2019
34019,46.3,124823,106763,2995,8166,34540,115379,47175,39081,8094,47175,415100,2019
34021,38.8,367922,182882,73029,64504,87468,81057,129936,81925,48011,129936,291100,2019
34023,38.6,825920,355653,78707,174747,209243,89533,285005,180979,104026,285005,344100,2019
34025,43.3,621659,467752,41697,67168,162014,99733,235362,173580,61782,235362,421900,2019
34027,42.8,493379,352199,15675,65683,130138,115527,181884,134496,47388,181884,456200,2019
34029,42.7,596415,504971,16510,54932,149790,70909,226160,180844,45316,226160,279000,2019
34031,37.2,503637,208005,52523,209203,119849,69688,165429,87262,78167,165429,342600,2019
34033,42.1,62990,46772,8107,5676,15777,66842,23933,17019,6914,23933,184600,2019
34035,41.7,329838,185677,30428,48326,85315,113611,118193,89574,28619,118193,430700,2019
34037,44.7,141483,122081,2991,11617,38292,94520,53322,44328,8994,53322,267500,2019
34039,38.7,554033,218856,111174,174998,136977,80198,190101,111350,78751,190101,367200,2019
34041,44.4,105862,86463,4612,9817,27728,81307,41587,29815,11772,41587,264200,2019
35001,37.6,677858,262184,16747,338856,158809,53329,267699,168608,99091,267699,199300,2019
35003,58.1,3526,2853,0,671,791,41910,1325,1162,163,1325,175400,2019
35005,35.7,65144,25325,929,36967,15731,43359,23284,16040,7244,23284,108700,2019
35006,37.3,26891,5193,237,10316,5999,39413,8708,5981,2727,8708,84400,2019
35007,50.2,12168,5687,81,6011,3277,36302,5853,4157,1696,5853,104800,2019
35009,31.5,49732,23686,2463,20971,11946,45092,18548,10576,7972,18548,125000,2019
35011,35.4,2040,906,32,1091,332,31625,672,421,251,672,106300,2019
35013,33.1,216069,58848,3476,147491,52854,40973,77842,49113,28729,77842,147400,2019
35015,35.2,57732,27012,836,28363,15098,65328,21251,14768,6483,21251,155900,2019
35017,46.4,27669,12675,242,13969,6733,37843,11851,8067,3784,11851,125100,2019
35019,43.1,4353,844,25,3217,601,24798,1384,867,517,1384,85000,2019
35021,58.5,441,260,0,175,105,29375,211,138,73,211,102400,2019
35023,43.1,4297,1676,54,2497,1071,42526,1679,1186,493,1679,86000,2019
35025,31.8,70277,24885,2386,41230,16588,60546,22523,15045,7478,22523,133100,2019
35027,50.9,19461,12632,101,6458,4850,46216,7566,6096,1470,7566,193900,2019
35028,42.3,18625,13377,107,3346,4957,121324,7931,5878,2053,7931,302800,2019
35029,37.1,24083,7108,316,16151,5348,29360,8904,5422,3482,8904,86900,2019
35031,32.4,72438,6259,409,10320,14859,33834,20942,14852,6090,20942,64800,2019
35033,55.2,4536,713,2,3696,838,28446,1713,1465,248,1713,112300,2019
35035,35.8,66137,32314,2133,25315,14568,41988,23634,15172,8462,23634,112400,2019
35037,43.4,8326,4131,134,3771,1580,29035,3040,1869,1171,3040,72700,2019
35039,41.3,39159,4870,173,27896,7576,39952,12730,9784,2946,12730,167300,2019
35041,30,18888,9790,456,7956,4122,42702,6814,3984,2830,6814,118200,2019
35043,40.1,142704,62056,2959,55525,36002,63802,51001,40082,10919,51001,200900,2019
35045,35.4,126515,48320,853,25668,30649,50518,43387,30813,12574,43387,151200,2019
35047,44,27738,4945,259,21563,6429,30946,11609,8166,3443,11609,135000,2019
35049,46.3,149293,63865,1325,76446,36778,61200,61921,43900,18021,61921,291800,2019
35051,55.7,11031,7136,44,3348,2805,29755,5555,4106,1449,5555,117400,2019
35053,39.4,16858,5764,95,8388,2406,42083,4520,3316,1204,4520,124100,2019
35055,48.8,32786,11563,54,18652,6771,38329,12103,9249,2854,12103,239500,2019
35057,43.6,15519,8488,121,6687,3646,36120,5644,4697,947,5644,114300,2019
35059,39.8,4133,2120,59,1750,743,35884,1395,906,489,1395,88000,2019
35061,38.9,76027,24784,803,46056,18400,48945,27010,22010,5000,27010,142600,2019
36001,37.8,306968,221542,35311,18325,69542,66252,126540,71341,55199,126540,222500,2019
36003,39.1,46688,44075,665,761,11479,48412,17948,13678,4270,17948,76400,2019
36005,34.2,1435068,131140,419473,804018,325361,40088,503829,99212,404617,503829,404700,2019
36007,39.9,193188,161081,9958,8140,46045,52226,78549,51189,27360,78549,117000,2019
36009,42,77121,69857,1091,1620,19728,48703,31779,22778,9001,31779,88100,2019
36011,42.9,77425,69753,3175,2286,19529,58377,31221,22251,8970,31221,128000,2019
36013,42.6,128496,112354,3018,9608,32349,46820,53075,36755,16320,53075,88000,2019
36015,41.3,84895,73203,5011,2619,21271,54940,33989,23217,10772,33989,105800,2019
36017,44.9,47909,45389,420,1049,13227,52002,20697,15414,5283,20697,98400,2019
36019,39.5,80583,72468,3278,2344,19205,56365,31301,20810,10491,31301,134100,2019
36021,48.2,60371,52129,2600,2879,15728,66787,24966,18403,6563,24966,233600,2019
36023,36.4,47865,44332,908,1293,11394,56023,17745,11648,6097,17745,123800,2019
36025,47.9,44995,41434,690,1744,11389,49544,18968,14010,4958,18968,139300,2019
36027,42.2,293754,209941,28787,35812,72701,81219,108413,74540,33873,108413,282000,2019
36029,40.3,919355,694067,119638,50599,229105,58121,389585,251583,138002,389585,153400,2019
36031,47.7,37459,34447,1087,1129,10010,56763,15790,11903,3887,15790,153600,2019
36033,39.9,50477,41201,2839,1789,11975,50407,19015,13577,5438,19015,108700,2019
36035,43.9,53646,49727,1063,1662,14369,50482,22557,15942,6615,22557,109600,2019
36037,43.1,57808,52329,1166,1906,14899,60524,23759,17168,6591,23759,119800,2019
36039,45.9,47424,40445,2584,2804,10204,53601,17100,12796,4304,17100,176300,2019
36041,55.3,4515,4332,36,75,786,58675,1157,1003,154,1157,166000,2019
36043,44.2,62057,58651,641,1340,15617,54646,24524,18052,6472,24524,100000,2019
36045,32.5,112842,92121,6450,8489,28196,52685,42734,24135,18599,42734,149900,2019
36047,35.2,2589974,942865,776274,493232,589006,60231,958567,288632,669935,958567,706000,2019
36049,42.2,26572,25470,185,461,6967,54524,10247,8282,1965,10247,120200,2019
36051,41.3,63591,57714,1638,2328,15484,59510,24176,18054,6122,24176,129400,2019
36053,41.9,71205,66285,1189,1572,16627,61633,25877,20016,5861,25877,136800,2019
36055,38.9,743341,524588,107602,65176,182175,60075,301948,191783,110165,301948,148400,2019
36057,41,49302,40068,933,6950,12403,49462,19660,13455,6205,19660,105400,2019
36059,41.7,1356509,813683,151233,229281,342651,116100,446977,360578,86399,446977,493500,2019
36061,37.5,1631993,765627,203590,421540,322288,86553,759460,182796,576664,759460,987700,2019
36063,43.2,210820,180115,14534,6364,54848,55522,88519,62543,25976,88519,125600,2019
36065,41,229959,188592,13067,13276,56089,56027,89729,60547,29182,89729,127700,2019
36067,39.1,462872,355699,50189,22734,112099,61359,185324,119871,65453,185324,145400,2019
36069,43.7,109511,98384,2358,5195,28394,64944,44787,33054,11733,44787,161800,2019
36071,37,380085,244179,37989,77882,89693,79944,128016,85584,42432,128016,271200,2019
36073,43,40904,35328,2305,2012,10955,52620,16563,12520,4043,16563,98400,2019
36075,40.3,118339,111284,1137,3068,30445,55967,46079,33965,12114,46079,104600,2019
36077,42.3,59972,54652,1094,2211,14494,54028,23409,16892,6517,23409,146400,2019
36079,44.2,98787,77760,2698,14787,25483,104486,34854,28513,6341,34854,358500,2019
36081,39,2287388,572903,393740,641496,528487,68666,778932,348732,430200,778932,543800,2019
36083,39.8,159185,132458,9519,7842,39219,68991,64906,40771,24135,64906,188700,2019
36085,40.1,474893,289751,44472,87576,122875,82783,166246,115265,50981,166246,504800,2019
36087,36,324422,204815,36699,57447,74937,93024,100438,68591,31847,100438,443400,2019
36089,39,108913,100169,2424,2565,26463,50940,41933,30596,11337,41933,93600,2019
36091,42.8,228502,206462,3497,7337,62706,84291,94406,68158,26248,94406,258300,2019
36093,39.7,154859,112420,14623,10932,32715,65499,54302,35654,18648,54302,169600,2019
36095,45.4,31222,29089,422,998,7907,57714,12559,9522,3037,12559,144800,2019
36097,46.4,17920,17016,148,333,4618,52327,7324,5505,1819,7324,133100,2019
36099,42.1,34390,30611,1636,1199,8537,54545,13564,10022,3542,13564,107100,2019
36101,42.9,96422,90220,1510,1588,25556,53663,39861,28995,10866,39861,99600,2019
36103,41.5,1483832,1002590,107713,286577,356426,101031,489301,394236,95065,489301,397400,2019
36105,42.8,75116,53719,5560,12009,17810,57426,28184,19255,8929,28184,172800,2019
36107,44.5,48686,46251,300,948,13645,62999,20030,15409,4621,20030,119700,2019
36109,31.1,102642,79161,3575,5294,20450,60240,39618,21755,17863,39618,204600,2019
36111,44,178665,141235,9846,18237,42482,64304,69320,47321,21999,69320,230500,2019
36113,46.8,64276,60271,769,1646,16827,61024,28015,19820,8195,28015,196500,2019
36115,44.2,61616,56881,1718,1691,15701,57258,24014,17782,6232,24014,149000,2019
36117,43.8,90519,81402,2459,3992,24566,59449,36720,28071,8649,36720,123800,2019
36119,40.9,968890,518150,130137,239034,239808,96610,349292,214474,134818,349292,540600,2019
36121,42.2,40305,36239,1593,1326,10510,58052,15917,12241,3676,15917,115900,2019
36123,41,25011,23688,240,556,5834,56563,8919,7137,1782,8919,136300,2019
37001,39.1,163324,104623,31676,20511,41755,49688,64439,41994,22445,64439,154800,2019
37003,43.7,37213,32297,2173,1743,10232,48756,14169,10728,3441,14169,136500,2019
37005,50.1,11008,9564,260,1066,3390,37830,4920,3752,1168,4920,139800,2019
37007,40.9,24902,11106,12016,1005,5809,40213,9521,6297,3224,9521,91200,2019
37009,48.3,26863,24853,197,1330,7894,40962,11938,9056,2882,11938,153200,2019
37011,45.2,17506,15534,684,886,4319,40340,6551,4930,1621,6551,144000,2019
37013,46.2,47168,31047,11723,3658,12638,45212,19701,13765,5936,19701,132800,2019
37015,45.4,19380,6696,11849,413,4733,35527,7909,5887,2022,7909,82200,2019
37017,44.5,33407,18290,11493,2499,8691,36173,13636,9732,3904,13636,95300,2019
37019,53.8,131815,107968,12754,6339,38287,58236,56056,45223,10833,56056,212200,2019
37021,42.2,256886,214615,15988,16889,62607,52207,107479,68139,39340,107479,238200,2019
37023,44.1,89968,73375,5442,5498,23580,44557,35156,25993,9163,35156,120700,2019
37025,37.9,206615,135523,36048,21570,53103,67328,72238,51626,20612,72238,203100,2019
37027,44.6,81884,71489,3726,4488,22576,44511,32864,23819,9045,32864,118100,2019
37029,41,10551,8489,1460,308,3154,64572,3933,3221,712,3933,208800,2019
37031,48.6,69070,59661,3667,2966,19252,57194,29755,21590,8165,29755,214100,2019
37033,45.7,22684,13876,7421,915,6570,45733,9145,6990,2155,9145,112800,2019
37035,41.4,157613,119056,12697,15257,42088,52056,62319,43246,19073,62319,143600,2019
37037,46.7,71338,51146,7898,8707,20176,67031,29033,22167,6866,29033,281700,2019
37039,51.5,27969,25450,348,881,8465,41438,12471,9856,2615,12471,159100,2019
37041,46,14097,8449,4962,520,3986,46519,6133,4092,2041,6133,131100,2019
37043,52.2,10946,10224,228,364,3424,42222,4996,3895,1101,4996,180300,2019
37045,41.8,97282,70925,20350,3423,24112,42247,35638,24156,11482,35638,120100,2019
37047,41.9,56068,33257,16813,2983,14243,37628,21580,15637,5943,21580,88900,2019
37049,37,102491,67517,21907,7469,27788,52687,41226,25944,15282,41226,157900,2019
37051,31.3,332861,144661,119718,38555,78185,46875,125427,63624,61803,125427,135300,2019
37053,42.8,26363,22990,1457,1048,7467,69964,10522,8626,1896,10522,257200,2019
37055,46.5,36222,31609,919,2714,10281,59381,15529,11551,3978,15529,289000,2019
37057,42.5,165381,132598,15129,11754,46155,49546,66653,46531,20122,66653,142100,2019
37059,45.2,42257,35669,2094,2875,11586,60434,16405,13084,3321,16405,172600,2019
37061,40.5,58967,30404,13915,13072,14504,41764,21466,15106,6360,21466,90200,2019
37063,35.4,311848,132449,111903,42079,72782,60958,125953,68460,57493,125953,223000,2019
37065,41.7,52648,19065,30251,2415,14408,36866,21151,12436,8715,21151,85700,2019
37067,38.4,375195,212708,96298,48057,91385,51569,146816,90399,56417,146816,159300,2019
37069,41.4,66362,42120,16456,5587,18419,55193,25381,18729,6652,25381,150400,2019
37071,40.1,219271,158895,35454,15368,56401,52835,83735,54654,29081,83735,144200,2019
37073,46.5,11548,7305,3859,11,3205,50750,4638,3596,1042,4638,147700,2019
37075,46.2,8509,7368,17,178,2178,39571,3393,2817,576,3393,122300,2019
37077,42.7,59328,34408,17667,4715,15182,55856,21400,15440,5960,21400,156000,2019
37079,40.7,21033,9835,7289,3173,4750,39837,7164,5063,2101,7164,88600,2019
37081,37.1,527868,265781,177002,42071,129246,53261,203987,119903,84084,203987,167000,2019
37083,43.4,51190,19657,26931,1475,13680,35502,21017,13162,7855,21017,86300,2019
37085,34.4,132283,81138,27004,16889,31816,53554,45416,29688,15728,45416,154000,2019
37087,47.6,61053,56545,572,2425,17170,51659,26653,19465,7188,26653,179700,2019
37089,47.4,114913,95501,3859,11575,32049,55945,49221,36101,13120,49221,214000,2019
37091,42.2,24012,7984,14090,921,5419,41028,8845,5821,3024,8845,88600,2019
37093,32.8,53957,21519,17834,7198,12300,48072,17799,11936,5863,17799,139300,2019
37095,40.9,5213,3069,1547,539,1378,39663,1947,1320,627,1947,141500,2019
37097,40.6,175538,133370,20854,13386,47447,60955,66369,47962,18407,66369,190300,2019
37099,37.7,42938,34635,928,2552,9964,47252,16773,10785,5988,16773,196100,2019
37101,38.4,196870,133478,30421,26781,50487,59865,68968,50336,18632,68968,165100,2019
37103,48.5,9594,6003,2913,443,2644,38158,4045,2966,1079,4045,89000,2019
37105,38.6,60481,35156,11792,11584,15223,49994,21894,14601,7293,21894,144200,2019
37107,42.7,56756,27933,21943,4414,14863,39402,23148,13738,9410,23148,95500,2019
37109,43.3,82919,70326,4099,6014,23672,57536,32894,25132,7762,32894,172000,2019
37111,43.9,45227,39518,1616,2766,13065,43646,18173,13206,4967,18173,119200,2019
37113,50.1,34813,30998,541,2440,10250,45507,15921,11605,4316,15921,165600,2019
37115,44,21499,20218,335,523,5456,45873,8403,6227,2176,8403,194500,2019
37117,46.3,22849,11895,9605,911,6195,40090,9378,6375,3003,9378,92500,2019
37119,35.1,1074475,503210,333294,142472,251352,66641,411097,231784,179313,411097,238000,2019
37121,47,15004,13803,51,837,4031,46103,6344,4949,1395,6344,157400,2019
37123,43.6,27252,17241,4793,4184,6788,44146,10195,7626,2569,10195,117700,2019
37125,44.3,97294,74994,11970,6544,25901,59963,39821,30143,9678,39821,216500,2019
37127,41.7,94030,46906,36866,6569,24722,49537,37011,24181,12830,37011,128200,2019
37129,39.1,227938,175756,30666,12657,54111,54891,95638,55525,40113,95638,243600,2019
37131,49.6,19946,7726,11233,453,5610,37146,8547,5842,2705,8547,83300,2019
37133,26.4,195069,129013,25914,24543,45710,50278,64386,34160,30226,64386,156900,2019
37135,34.8,144836,100490,16186,12236,31994,71723,53376,33436,19940,53376,308800,2019
37137,52.4,12701,9426,2319,493,3589,46728,5416,4206,1210,5416,156000,2019
37139,38.6,39514,21636,14389,2123,9829,50558,14697,8764,5933,14697,163100,2019
37141,42.7,60399,45342,8612,4263,14676,57240,21740,17654,4086,21740,198700,2019
37143,49.8,13430,9709,3107,349,4023,47162,5936,4473,1463,5936,172300,2019
37145,43.7,39345,26124,10252,1691,10695,51020,15896,12152,3744,15896,123100,2019
37147,32.5,178433,97088,61407,11168,41115,47437,69799,36378,33421,69799,148600,2019
37149,52.7,20557,17608,995,1204,5550,48787,9071,6714,2357,9071,225700,2019
37151,41.7,143118,113095,8157,16361,38531,47288,56541,40599,15942,56541,124100,2019
37153,40.5,44997,25675,14306,2914,11783,36148,18380,12162,6218,18380,83200,2019
37155,36.6,132596,33332,31370,11774,30708,34976,45927,30128,15799,45927,75600,2019
37157,44.7,91077,65897,16592,5560,24750,43579,37388,26008,11380,37388,112800,2019
37159,40.2,140296,101067,22033,12381,35844,49842,52843,36621,16222,52843,136400,2019
37161,45,66599,55473,6338,2941,16968,42608,26683,19088,7595,26683,118300,2019
37163,40.3,63385,32319,15898,12445,15705,42151,23416,16228,7188,23416,89300,2019
37165,39.3,35076,15148,13627,1053,8593,37238,12922,7817,5105,12922,85500,2019
37167,42.2,61588,49777,6894,2590,16569,52623,23332,17355,5977,23332,138900,2019
37169,46.2,45781,41701,1909,1400,13348,48054,19578,15185,4393,19578,137000,2019
37171,44.1,71971,60359,2581,7632,19855,43597,29153,21416,7737,29153,126900,2019
37173,41.9,14260,8799,67,757,3615,39317,5620,4019,1601,5620,139100,2019
37175,51.1,33775,30528,1560,1124,9978,50212,14567,11072,3495,14567,221900,2019
37177,46.2,4095,2175,1510,284,1035,35300,1594,1088,506,1594,114800,2019
37179,38.2,231053,166677,25962,25731,61177,80033,76346,62093,14253,76346,241400,2019
37181,40.9,44479,17620,22103,3466,11163,40529,16875,9529,7346,16875,101400,2019
37183,36.2,1069079,641723,212353,108379,268042,80591,400172,255708,144464,400172,281700,2019
37185,48,19898,7629,9965,750,4589,36466,7786,5699,2087,7786,94600,2019
37187,46.1,11922,5290,5658,622,2655,35979,4977,3311,1666,4977,85400,2019
37189,31.9,54925,50357,954,2009,11452,47526,21077,12658,8419,21077,238000,2019
37191,37.8,123603,66033,37509,14525,32111,44416,48343,30032,18311,48343,123500,2019
37193,44.9,68469,59738,2635,4475,18909,44107,28753,21765,6988,28753,126300,2019
37195,40.5,81435,38248,31812,8430,20365,43877,32014,18918,13096,32014,123600,2019
37197,44.4,37602,31691,1243,4163,10789,44682,15425,11761,3664,15425,133100,2019
37199,47.6,17760,16427,119,917,5081,42222,7510,5507,2003,7510,157100,2019
38001,45.6,2311,2133,48,39,628,56681,1035,761,274,1035,121200,2019
38003,45.1,10706,9905,239,219,2908,58365,5074,3514,1560,5074,141400,2019
38005,30.5,6873,2783,3,64,1603,47667,2248,1506,742,2248,78100,2019
38007,43.7,922,895,0,27,271,75208,383,303,80,383,199400,2019
38009,45,6502,5939,39,150,1832,60381,2992,2376,616,2992,150100,2019
38011,41,3148,2917,1,172,870,62442,1350,1017,333,1350,148600,2019
38013,36.8,2182,2090,5,25,569,77232,905,714,191,905,114400,2019
38015,37,94793,84282,2090,2368,24585,71524,39507,27128,12379,39507,263600,2019
38017,32.5,176975,151212,9818,4769,42420,64482,75843,39536,36307,75843,223800,2019
38019,49.5,3803,3608,2,68,1117,64798,1737,1401,336,1737,104500,2019
38021,41.9,4938,4605,65,167,1332,65492,2119,1574,545,2119,118100,2019
38023,51.1,2335,2082,74,100,650,62865,1061,768,293,1061,151200,2019
38025,39,4395,3668,75,111,1115,76719,1692,1303,389,1692,192500,2019
38027,45.8,2301,2068,0,29,646,54868,1062,754,308,1062,87700,2019
38029,50.9,3310,3161,0,52,968,55902,1585,1361,224,1585,97000,2019
38031,44.8,3260,3104,0,35,856,61425,1423,1056,367,1423,143500,2019
38033,45,1845,1664,0,58,459,58690,842,589,253,842,116200,2019
38035,29.7,70224,58787,2590,3011,16169,54051,30502,14796,15706,30502,206500,2019
38037,50.1,2353,2250,2,25,641,50938,1074,931,143,1074,81800,2019
38039,51.1,2409,2296,0,20,671,53565,1089,829,260,1089,97600,2019
38041,46.5,2547,2317,10,79,686,60164,1073,866,207,1073,111200,2019
38043,47.8,2466,2321,5,89,748,54643,1092,822,270,1092,114400,2019
38045,47.9,4125,3960,25,80,1166,60806,1822,1401,421,1822,107700,2019
38047,52,1872,1817,0,16,525,59375,849,712,137,849,86800,2019
38049,43.2,5878,5598,21,127,1711,64179,2594,2151,443,2594,117100,2019
38051,53.5,2597,2465,14,72,751,52587,1291,948,343,1291,77100,2019
38053,30.1,13334,10332,214,1114,2618,77845,4302,2322,1980,4302,238600,2019
38055,46,9584,8540,63,237,2892,68529,4334,3518,816,4334,174400,2019
38057,44,8462,7737,73,249,2539,82181,3709,3066,643,3709,177800,2019
38059,37.8,30868,27717,306,1072,8674,70556,13565,9585,3980,13565,208600,2019
38061,33.2,10321,6259,146,838,2178,72147,3360,2289,1071,3360,165700,2019
38063,52.4,2894,2758,0,101,813,52039,1467,1060,407,1467,84300,2019
38065,47,1842,1662,0,52,583,78929,738,654,84,738,190600,2019
38067,48.1,6947,6314,23,241,1980,64549,3158,2432,726,3158,93300,2019
38069,45.8,4126,3857,25,18,1082,55660,1908,1404,504,1908,128600,2019
38071,40.7,11583,9617,12,341,2746,58910,4828,2911,1917,4828,164700,2019
38073,46.6,5314,5007,43,83,1434,63903,2371,1682,689,2371,121700,2019
38075,39,2442,2214,6,183,628,73182,950,785,165,950,134700,2019
38077,37.3,16254,14835,112,512,4283,61371,6777,4803,1974,6777,127900,2019
38079,31.4,14511,2633,93,80,3167,43158,4608,3286,1322,4608,84000,2019
38081,45.2,3872,3560,92,120,1161,63073,1864,1357,507,1864,110200,2019
38083,50.9,1409,1393,0,0,416,51055,731,583,148,731,84400,2019
38085,28.2,4373,552,7,203,820,38939,1112,483,629,1112,83800,2019
38087,47.7,742,715,13,0,232,63611,326,268,58,326,101800,2019
38089,34.2,31081,27146,609,1690,7442,72045,12524,7647,4877,12524,239000,2019
38091,50.3,1744,1701,13,30,494,70724,777,658,119,777,85300,2019
38093,40.5,20965,19319,305,524,5030,57674,8908,5842,3066,8908,155500,2019
38095,47.6,2224,1970,17,88,607,52300,1058,773,285,1058,70200,2019
38097,41.2,8008,7369,84,289,2116,64453,3383,2418,965,3383,150600,2019
38099,44.2,10751,9064,44,1240,2948,55700,4780,3651,1129,4780,91100,2019
38101,31.6,68812,56956,2587,4231,16829,68871,28277,16826,11451,28277,213100,2019
38103,51.6,3976,3828,0,100,1132,57582,1943,1529,414,1943,94800,2019
38105,31.3,35208,28003,1564,2709,8659,87161,14320,7533,6787,14320,247400,2019
39001,42,27776,27243,99,283,7411,39079,10673,7559,3114,10673,105300,2019
39003,39.2,103175,83272,12215,3221,26281,53131,40650,27263,13387,40650,118100,2019
39005,40.4,53536,51179,394,739,13456,52823,20417,15065,5352,20417,128400,2019
39007,42.5,97830,87554,3297,4134,24018,46700,37832,26680,11152,37832,112700,2019
39009,29.6,65917,59069,1908,1268,12390,40905,22557,13048,9509,22557,129600,2019
39011,41.1,45729,43736,291,770,13086,64074,18888,14304,4584,18888,147300,2019
39013,44.6,68024,63053,2642,674,16321,50904,25919,19807,6112,25919,100500,2019
39015,42.1,43572,42005,353,456,12336,54575,17829,12901,4928,17829,132400,2019
39017,36.7,380019,307838,30343,17914,95196,66117,139113,94762,44351,139113,172900,2019
39019,45.5,27332,26789,72,359,7631,55267,11298,8886,2412,11298,126500,2019
39021,41.9,38845,36240,712,617,10366,60112,15159,11091,4068,15159,132800,2019
39023,41.1,134726,113246,10832,4627,35459,50873,54696,36093,18603,54696,115500,2019
39025,40,204275,191037,2873,3964,54481,66968,78009,57854,20155,78009,170800,2019
39027,39.4,41957,39165,857,677,11108,52815,16528,10683,5845,16528,128400,2019
39029,44.1,103190,96921,2049,1833,27330,48345,41537,30536,11001,41537,109400,2019
39031,41.3,36585,35075,419,389,9876,46606,14476,10709,3767,14476,99200,2019
39033,43,41821,39837,415,700,11229,44971,17782,12390,5392,17782,88400,2019
39035,40.4,1247451,734951,364770,74024,301861,50366,540965,315059,225906,540965,132800,2019
39037,41.9,51513,49495,385,807,14336,55620,20861,15186,5675,20861,123300,2019
39039,40.4,38160,32969,541,3804,10682,59931,15297,11669,3628,15297,119900,2019
39041,38.8,201135,171054,6639,5253,53736,106908,69985,56957,13028,69985,308800,2019
39043,44.8,74780,62161,6453,3282,19965,54226,31183,21593,9590,31183,139900,2019
39045,39.2,154457,132876,11188,3398,40345,67609,56339,41654,14685,56339,185300,2019
39047,41.4,28620,26457,660,615,8070,47308,11773,7642,4131,11773,113500,2019
39049,34.1,1290360,813034,287759,71292,299983,61305,511447,273045,238402,511447,175100,2019
39051,41.1,42253,37605,164,3689,11741,63092,16506,13050,3456,16506,138200,2019
39053,40.7,30088,28024,655,408,7563,44858,11588,8631,2957,11588,110200,2019
39055,44.8,93843,89670,1269,1422,25922,82303,35298,30466,4832,35298,240900,2019
39057,38.3,166502,139552,11197,4735,42709,68720,65604,43356,22248,65604,173000,2019
39059,42.2,39111,36842,425,460,10359,45917,16220,11591,4629,16220,114700,2019
39061,36.8,813589,530525,206538,26867,197144,57212,341873,197984,143889,341873,155400,2019
39063,39.3,75837,67509,1178,4145,19941,58450,31937,21977,9960,31937,147600,2019
39065,35.9,31425,29824,230,546,7848,50506,11678,8297,3381,11678,105300,2019
39067,46.3,15211,14427,434,60,4210,49689,6223,4909,1314,6223,92700,2019
39069,41.1,27208,24434,235,2089,7665,59695,10992,8505,2487,10992,125200,2019
39071,40.8,43016,40908,610,476,11221,44169,16772,11478,5294,16772,117400,2019
39073,43.1,28390,27341,218,284,7933,52363,11286,8479,2807,11286,132800,2019
39075,31.5,43901,42956,60,423,9802,63753,12342,9318,3024,12342,208700,2019
39077,39.8,58339,52583,704,3826,15298,52560,22935,16263,6672,22935,124600,2019
39079,40.1,32450,31149,200,346,9211,47550,12780,8847,3933,12780,97400,2019
39081,44.8,66371,59955,3578,966,17171,46581,27428,18922,8506,27428,93000,2019
39083,39.4,61481,58635,532,923,16002,57749,23248,16740,6508,23248,155500,2019
39085,43.8,229954,202885,9524,10081,61441,64466,96361,71515,24846,96361,156200,2019
39087,41.8,60184,57035,1211,590,15249,45118,23221,16775,6446,23221,106500,2019
39089,39.7,173750,156495,6401,3337,45095,64589,64035,46688,17347,64035,170200,2019
39091,41.4,45316,42306,753,740,12696,56754,18677,13854,4823,18677,131900,2019
39093,41.8,307670,240640,24202,30628,79484,58427,120281,86989,33292,120281,150500,2019
39095,37.8,431102,295844,81000,30622,107113,48736,179930,107464,72466,179930,116600,2019
39097,40.8,44135,39056,2576,900,10414,68022,15013,10687,4326,15013,166500,2019
39099,43.5,229961,174662,33652,13804,59553,46042,98472,67633,30839,98472,105400,2019
39101,41.3,65299,57683,3501,1747,15844,47498,24737,16419,8318,24737,100800,2019
39103,42.2,177980,166999,2555,3760,48615,76600,69007,55128,13879,69007,196300,2019
39105,43.6,23078,22306,256,170,6116,44899,9045,7111,1934,9045,95000,2019
39107,39.6,40884,38994,335,788,11461,62952,16234,12503,3731,16234,153800,2019
39109,41.3,105371,97248,2128,1774,26572,61041,41043,29173,11870,41043,151400,2019
39111,46.5,13942,13543,53,168,3777,45289,5745,4496,1249,5745,110000,2019
39113,39.2,531670,376009,107827,15959,134264,51542,224328,136792,87536,224328,119800,2019
39115,44.5,14640,13485,721,58,4040,42341,6108,4685,1423,6108,99900,2019
39117,42.2,35043,33617,312,519,9485,59452,12922,10572,2350,12922,152800,2019
39119,40.3,86131,78726,2697,967,22060,47254,33878,23372,10506,33878,120200,2019
39121,50.4,14416,13331,807,124,3180,46897,5067,4152,915,5067,100500,2019
39123,49.3,40632,37501,497,2050,11912,59099,18051,14231,3820,18051,152000,2019
39125,42.1,18809,17400,147,896,5432,55330,7705,6086,1619,7705,97000,2019
39127,40.2,36022,34800,135,309,9639,50150,13500,9950,3550,13500,114100,2019
39129,39.7,57762,53505,1914,801,14252,63633,19710,14698,5012,19710,163300,2019
39131,40.8,28000,26651,468,126,7412,42832,10959,7100,3859,10959,117100,2019
39133,38,162511,145584,6449,2999,39516,57618,61817,42987,18830,61817,159200,2019
39135,42.7,41093,39601,201,368,11366,58957,16251,12733,3518,16251,125100,2019
39137,39.8,33911,31202,131,2103,9763,64822,13327,10873,2454,13327,155800,2019
39139,41.1,121100,103517,10657,2318,30945,49547,48449,32633,15816,48449,110600,2019
39141,41,76948,68949,3934,978,19818,51092,28802,20428,8374,28802,123800,2019
39143,42.2,59029,49816,1741,5858,15643,54089,23574,17144,6430,23574,115400,2019
39145,39.9,76040,70937,2100,1030,19472,41330,29858,20188,9670,29858,97800,2019
39147,39.9,55351,49701,1563,2836,14139,52500,21648,15642,6006,21648,106500,2019
39149,39.5,48749,45274,1230,758,12990,63806,18608,13246,5362,18608,145600,2019
39151,42.1,372404,321693,27646,7732,98786,53860,153460,104660,48800,153460,134300,2019
39153,41,541334,416687,77859,11598,137201,57181,224726,147876,76850,224726,146800,2019
39155,44.3,200367,174552,16234,3639,53637,47280,85621,60431,25190,85621,102600,2019
39157,41,92335,87235,551,2612,24373,53243,36631,25905,10726,36631,132100,2019
39159,38,56707,50769,1452,983,15144,86715,20212,15862,4350,20212,203800,2019
39161,41.2,28261,26541,371,960,8159,54254,11544,8899,2645,11544,104900,2019
39163,42.9,13083,12626,34,90,3456,45673,5140,3907,1233,5140,91500,2019
39165,39.4,229132,197434,7578,6321,62154,87125,82957,64425,18532,82957,222500,2019
39167,44.3,60426,57438,745,665,16397,50021,25197,18553,6644,25197,132400,2019
39169,38.7,116099,108752,1571,2335,30033,58300,43824,31974,11850,43824,148900,2019
39171,41.4,36816,34092,393,1661,9586,53183,15090,11620,3470,15090,105400,2019
39173,34.9,130150,114904,3346,7228,30671,62390,50589,33012,17577,50589,163600,2019
39175,42.1,22000,20895,36,660,6132,55767,9081,6726,2355,9081,122200,2019
40001,37.2,22220,8864,31,1518,5585,34695,7733,5356,2377,7733,87600,2019
40003,44.2,5847,4902,181,329,1312,61852,1870,1499,371,1870,85700,2019
40005,40.2,13823,9812,492,486,3656,39316,5284,3880,1404,5284,102900,2019
40007,39,5377,3880,31,1281,1449,52349,1971,1508,463,1971,101200,2019
40009,35.9,22268,16765,936,3241,5263,50721,7578,5020,2558,7578,128400,2019
40011,43.5,9556,6946,377,1063,2516,45792,3898,2861,1037,3898,85100,2019
40013,37.2,46457,32997,815,2773,11383,44212,17253,10733,6520,17253,117400,2019
40015,37.7,29242,16607,651,3778,7035,46592,10320,7355,2965,10320,84900,2019
40017,35.9,140455,106957,3902,12629,33216,72056,44906,33862,11044,44906,165500,2019
40019,38.2,48319,33831,3141,3520,12086,51419,18339,12521,5818,18339,113000,2019
40021,35.3,48664,23148,637,3482,10607,42774,16665,11391,5274,16665,118000,2019
40023,42,14807,8977,1604,649,3829,34489,5971,4136,1835,5971,96800,2019
40025,43.8,2174,1666,4,487,599,46328,977,712,265,977,56500,2019
40027,34.2,279274,200328,12927,24275,69358,64016,106172,67586,38586,106172,165600,2019
40029,42,5581,3817,11,260,1458,40938,2227,1649,578,2227,83800,2019
40031,33,121762,68419,18902,15954,27885,52161,42842,22762,20080,42842,124600,2019
40033,43.5,5858,4452,133,466,1608,50885,2195,1707,488,2195,76700,2019
40035,42.1,14390,9114,441,533,3683,43329,5422,3769,1653,5422,109000,2019
40037,40.3,71427,54258,1522,3015,18742,51318,26427,19438,6989,26427,122700,2019
40039,31.4,29152,19891,900,5322,6750,49900,10653,6668,3985,10653,142500,2019
40041,46.7,42433,27036,194,1618,11313,41696,16739,12662,4077,16739,117900,2019
40043,39.2,4922,4035,8,371,1208,52428,1689,1288,401,1689,97700,2019
40045,44.1,4015,3471,7,287,1005,53245,1614,1198,416,1614,89800,2019
40047,35.8,61898,46013,1485,7694,15503,54006,23541,15488,8053,23541,112600,2019
40049,39.3,27835,21018,609,2464,7123,47125,10447,7241,3206,10447,98500,2019
40051,39.2,55071,44864,1290,3207,14699,60875,19857,15313,4544,19857,134300,2019
40053,42.6,4397,3870,41,222,1143,57727,1736,1330,406,1736,81000,2019
40055,40.4,5861,4369,370,669,1286,41488,2054,1432,622,2054,76500,2019
40057,40.6,2710,1540,254,789,759,48344,1113,814,299,1113,66500,2019
40059,39.7,3760,2851,1,839,807,46154,1258,986,272,1258,77200,2019
40061,41,12687,8936,91,560,3496,42348,4931,3685,1246,4931,96100,2019
40063,39.4,13372,8382,761,749,2778,39365,4132,3010,1122,4132,73100,2019
40065,34.1,25063,15720,1640,6043,6456,49703,9762,5710,4052,9762,106500,2019
40067,41.5,6158,4788,85,651,1620,39895,2371,1710,661,2371,66400,2019
40069,40.1,11064,7692,204,599,2870,41332,4267,3137,1130,4267,80800,2019
40071,38.4,44402,33105,907,3554,11022,46809,17610,11879,5731,17610,92100,2019
40073,37.7,15694,11978,189,2501,3979,57777,5609,4280,1329,5609,144700,2019
40075,42.9,8886,6595,302,1049,2292,38019,3571,2576,995,3571,62900,2019
40077,41.3,10348,6698,113,392,2862,44214,4088,2854,1234,4088,87000,2019
40079,39.4,50026,35691,939,3511,12705,40677,18261,12966,5295,18261,90300,2019
40081,41.2,34895,28681,658,1199,8843,50671,12763,10166,2597,12763,110800,2019
40083,38.5,46683,36248,3808,2891,11329,65357,15512,12858,2654,15512,169500,2019
40085,39.4,10063,7141,263,1580,2267,49399,3268,2505,763,3268,111700,2019
40087,38.5,39247,31070,420,3151,11010,67662,14428,11455,2973,14428,177500,2019
40089,38.8,33016,20490,2599,2001,8795,37061,12646,8956,3690,12646,83300,2019
40091,47.8,19725,13389,528,552,5540,39084,8327,6531,1796,8327,100900,2019
40093,41.1,7692,6520,32,743,2210,54332,3123,2479,644,3123,101800,2019
40095,42.8,16505,10745,283,2921,4369,45746,6195,4499,1696,6195,89700,2019
40097,40.6,41044,26622,201,1479,11408,50345,15983,11651,4332,15983,112800,2019
40099,42.9,13946,10043,221,924,3454,52478,5238,3678,1560,5238,127000,2019
40101,37.9,68736,38425,7171,4285,17840,43078,26234,17133,9101,26234,104200,2019
40103,41.2,11335,9184,30,439,3243,56117,4515,3469,1046,4515,103500,2019
40105,42.4,10322,6887,253,318,2833,43145,4099,3023,1076,4099,87700,2019
40107,40.2,12067,7396,891,481,2742,38411,3976,2831,1145,3976,81400,2019
40109,34.6,787216,440742,116115,136829,186346,54520,301570,177555,124015,301570,153300,2019
40111,39,38749,24116,3127,1623,9711,42998,14724,10452,4272,14724,85400,2019
40113,42.5,47226,29932,5248,1704,12682,49103,18263,14304,3959,18263,118600,2019
40115,38,31454,20449,340,1798,7957,39872,11847,8170,3677,11847,86300,2019
40117,41.9,16412,12582,164,507,4462,48009,6179,4672,1507,6179,92900,2019
40119,27.3,81815,62937,3223,3858,16743,41603,30788,15910,14878,30788,161700,2019
40121,40.3,44146,30662,1241,2236,11776,46784,17816,12913,4903,17816,106800,2019
40123,35.7,38355,25083,930,2058,9338,50392,14278,9414,4864,14278,129300,2019
40125,37.7,72154,52233,2453,3730,17903,49250,25917,18006,7911,25917,120500,2019
40127,44.5,11128,7900,84,440,2966,37692,4477,3386,1091,4477,80500,2019
40129,40.6,3667,3066,9,264,893,51302,1377,1033,344,1377,109600,2019
40131,39.1,91353,65588,906,4345,25757,65434,34755,27177,7578,34755,162300,2019
40133,38.8,24832,15999,1163,1276,6368,39373,9317,6339,2978,9317,74400,2019
40135,40.8,41709,26051,740,1753,11073,40351,15474,11120,4354,15474,97800,2019
40137,40.7,43647,34982,743,3392,11269,47214,16720,12108,4612,16720,107700,2019
40139,33,20805,9147,509,9552,4522,52282,6768,4601,2167,6768,115100,2019
40141,42.7,7413,4386,555,2005,1879,42280,2807,2129,678,2807,56800,2019
40143,35.7,646419,400632,64101,82309,159488,55517,252661,148594,104067,252661,156400,2019
40145,38.8,78958,56445,2755,4895,21688,62795,29208,22966,6242,29208,159000,2019
40147,40.2,51886,37768,1400,3116,13749,54997,20455,14487,5968,20455,120600,2019
40149,39.1,11225,9359,142,1098,2941,53274,4224,2995,1229,4224,84700,2019
40151,33.4,9043,7499,246,661,1930,54282,3281,2245,1036,3281,107000,2019
40153,36.5,20727,16549,264,2663,5324,60147,7495,5340,2155,7495,124800,2019
41001,48,16019,14479,147,691,4229,45998,6921,4893,2028,6921,173100,2019
41003,33,91107,73083,937,6740,20530,62077,35718,20438,15280,35718,331300,2019
41005,41.5,410463,336220,3613,35666,108570,80484,157408,111885,45523,157408,395100,2019
41007,44.2,39102,33440,314,3329,9623,54886,15800,9826,5974,15800,283900,2019
41009,43.3,51375,45478,231,2652,13171,62257,19671,14832,4839,19671,264900,2019
41011,48.6,63686,54296,258,4139,16448,45051,27025,17798,9227,27025,198100,2019
41013,47.5,23011,20296,126,1753,6465,49006,9588,6925,2663,9588,246100,2019
41015,56.3,22650,19536,99,1612,6293,48440,10546,7526,3020,10546,265400,2019
41017,42.4,186251,162506,1082,14853,49987,67043,74397,49809,24588,74397,364600,2019
41019,47.1,109114,95842,462,6337,29998,47267,45456,30986,14470,45456,199200,2019
41021,50.1,1878,1652,0,115,493,47500,842,567,275,842,115900,2019
41023,52.9,7189,6575,7,272,1958,44712,3381,2404,977,3381,144800,2019
41025,45.9,7267,6325,35,371,2224,40735,3244,2342,902,3244,121300,2019
41027,39.3,23209,14790,136,7293,5722,65679,8600,5782,2818,8600,373600,2019
41029,42.6,216574,175058,1462,27778,56116,53412,88241,55792,32449,88241,280300,2019
41031,40.8,23607,14260,179,4715,5634,53277,8094,5510,2584,8094,224600,2019
41033,47.7,86251,74953,399,6408,23666,45616,36367,24116,12251,36367,265500,2019
41035,42.2,66921,52101,446,8740,17670,46491,27886,17924,9962,27886,170600,2019
41037,48.6,7837,6618,27,640,2213,37898,3515,2176,1339,3515,146800,2019
41039,39.4,373340,305453,3754,33109,89655,52426,152312,89359,62953,152312,263200,2019
41041,51.6,48547,40034,218,4447,12557,47882,21298,13977,7321,21298,251200,2019
41043,39.6,125048,106183,616,11393,32372,55893,47762,30748,17014,47762,221600,2019
41045,36.1,30412,18591,297,10257,6697,43313,10062,5865,4197,10062,135900,2019
41047,36.6,339641,222354,3596,90277,80330,59625,118038,71101,46937,118038,247100,2019
41049,38.9,11303,6698,26,4126,3125,54269,4108,2876,1232,4108,138100,2019
41051,37.2,804606,560762,42693,93276,176160,69176,326229,177889,148340,326229,386200,2019
41053,37,83037,64837,659,11545,20729,62691,30305,20081,10224,30305,265200,2019
41055,51.4,1642,1467,3,81,445,51071,748,483,265,748,159800,2019
41057,48.1,26389,22258,102,2727,6679,49895,10784,7469,3315,10784,254300,2019
41059,36.5,77129,50691,721,20665,18568,54699,26908,17678,9230,26908,170900,2019
41061,40.2,26337,23365,174,1276,7032,52171,10708,6911,3797,10708,185400,2019
41063,52.6,7004,6509,12,217,2079,51224,3214,2239,975,3214,239100,2019
41065,40.8,26130,19482,79,4755,6602,53105,10305,6408,3897,10305,212900,2019
41067,36.7,589481,387456,11469,98201,146612,82215,219053,135022,84031,219053,386600,2019
41069,59,1415,1235,0,122,396,40926,640,487,153,640,155300,2019
41071,38.3,104831,80959,853,16639,25718,63902,36808,25772,11036,36808,295900,2019
42001,43.9,102470,91205,1317,7267,27648,67253,39345,30692,8653,39345,205800,2019
42003,40.8,1221744,959267,154976,25777,303147,61043,541541,348130,193411,541541,154700,2019
42005,46.6,65867,63945,548,509,18818,51410,28137,21373,6764,28137,109400,2019
42007,45.1,165833,148374,9509,2661,45240,57807,71167,52043,19124,71167,141100,2019
42009,46.5,48337,46747,307,589,13176,50509,19882,15722,4160,19882,136700,2019
42011,39.9,418025,299730,17728,87914,106447,63728,154712,110655,44057,154712,178700,2019
42013,43.4,123157,116471,1971,1562,33394,49181,52126,36377,15749,52126,123600,2019
42015,44.5,60963,58337,308,901,16797,52358,25021,18520,6501,25021,150600,2019
42017,43.9,626806,526866,24216,33339,168793,89139,238830,183853,54977,238830,330600,2019
42019,43.3,186899,176984,1690,2790,51336,70668,76502,58061,18441,76502,205600,2019
42021,45.4,133009,123309,4211,2174,35280,46659,56674,42000,14674,56674,91900,2019
42023,52,4611,4414,2,51,1195,41165,2184,1572,612,2184,78500,2019
42025,46.2,63887,58585,1223,3035,16844,57006,26043,19753,6290,26043,146400,2019
42027,32.3,161960,138374,5805,4777,32870,60403,58201,35806,22395,58201,234900,2019
42029,40.4,519560,412720,29146,38522,135203,100214,190980,143192,47788,190980,357100,2019
42031,41.5,38715,37154,469,373,9999,46680,16021,11073,4948,16021,116900,2019
42033,45,79908,74325,2092,2363,20505,49015,31248,23992,7256,31248,96100,2019
42035,38.6,38915,37035,680,590,9296,50923,14690,10312,4378,14690,136600,2019
42037,41,65715,61253,1125,1810,16206,50550,26372,18259,8113,26372,151700,2019
42039,43.2,85665,81208,1342,1119,23096,50304,35164,25633,9531,35164,113200,2019
42041,40.6,249328,213638,9190,9815,64004,71269,99804,70210,29594,99804,202900,2019
42043,39.7,275632,181239,49695,25457,69605,60715,112212,70933,41279,112212,167900,2019
42045,39,564554,377160,119143,21472,139045,74477,207257,142562,64695,207257,244400,2019
42047,47.4,30340,29535,261,247,8671,53440,14020,11014,3006,14020,103200,2019
42049,39.7,273835,230646,18700,11532,68493,51529,110318,72878,37440,110318,134100,2019
42051,45,131302,120483,5443,1611,34500,47364,54837,40804,14033,54837,101500,2019
42053,43.3,7313,4899,1854,405,1079,39717,1839,1543,296,1839,95900,2019
42055,41.6,154147,135774,5389,8694,42070,63379,60438,43021,17417,60438,180400,2019
42057,45.4,14506,13931,195,174,4020,53476,5989,4638,1351,5989,161000,2019
42059,42.2,36870,34442,1058,563,9432,54776,14230,10650,3580,14230,122900,2019
42061,43.7,45369,41075,2386,896,11555,51678,16779,12695,4084,16779,136400,2019
42063,40.2,85032,79858,1839,1101,21122,49320,33246,23660,9586,33246,121100,2019
42065,43.9,43846,42600,206,403,12151,47603,18427,13689,4738,18427,103900,2019
42067,42.9,24624,23195,270,941,6410,53879,9372,6985,2387,9372,148900,2019
42069,42.1,210652,179465,5430,15845,53355,52821,87161,56028,31133,87161,152400,2019
42071,38.6,540999,443533,18900,56715,141098,66056,201620,137217,64403,201620,209400,2019
42073,45.2,86727,79771,3104,1261,24327,50204,37055,27624,9431,37055,111300,2019
42075,41,139729,114872,2914,18328,36591,60281,53579,37479,16100,53579,171300,2019
42077,39.1,365052,235175,20346,89367,93934,63897,138714,89359,49355,138714,208200,2019
42079,42.8,317663,259005,11813,37790,81052,53473,128660,87431,41229,128660,127000,2019
42081,41.5,114330,103616,5579,2290,29740,54241,45608,31581,14027,45608,155800,2019
42083,43.2,41401,38700,975,868,10860,48647,17147,12699,4448,17147,80400,2019
42085,44.7,111518,100566,6257,1670,29355,50696,46340,33597,12743,46340,121100,2019
42087,44,46276,44369,241,724,13229,50219,19043,13580,5463,19043,117900,2019
42089,42.9,168032,111011,22699,26701,40412,63934,57098,43960,13138,57098,168000,2019
42091,41.2,823823,624278,74027,42350,217701,91546,316206,226985,89221,316206,316100,2019
42093,43.3,18259,16677,328,504,4683,58333,7404,4972,2432,7404,185100,2019
42095,42.2,302809,232123,15287,40088,77981,70471,114185,81503,32682,114185,219800,2019
42097,44.5,91761,84864,2208,3192,25075,48671,39075,27654,11421,39075,117400,2019
42099,43.3,46053,43898,424,939,12884,63718,18231,14399,3832,18231,169300,2019
42101,34.4,1579075,544434,644723,231858,325916,45927,601337,318872,282465,601337,163000,2019
42103,48.2,55453,44597,2983,6052,15468,65928,22119,18411,3708,22119,185700,2019
42105,47.2,16806,16217,67,229,4286,45419,6480,4939,1541,6480,109600,2019
42107,44.4,142674,129831,4134,6284,38361,52280,58749,44446,14303,58749,102100,2019
42109,40.2,40483,38493,373,867,10528,58997,14794,10676,4118,14794,166100,2019
42111,46.1,74361,70096,1820,1115,19941,49089,29644,23143,6501,29644,107000,2019
42113,53.7,6135,5833,146,112,1590,47407,2723,2232,491,2723,154400,2019
42115,48.4,40970,39438,260,704,11556,54966,17235,13281,3954,17235,167700,2019
42117,44.6,40944,39340,283,518,10800,51324,16310,11877,4433,16310,142100,2019
42119,39.5,45111,38014,2802,2654,9490,59399,14533,10521,4012,14533,189500,2019
42121,46.9,51818,49645,368,567,14351,49945,22050,16549,5501,22050,89400,2019
42123,47.4,39756,38471,186,432,11079,50250,17115,13157,3958,17115,98000,2019
42125,44.5,207212,191012,6298,3540,55365,63543,84948,64232,20716,84948,167900,2019
42127,48.2,51422,46533,1489,2297,12572,56096,18841,15259,3582,18841,181300,2019
42129,47,352590,330692,8085,4187,99160,60471,152283,117573,34710,152283,153100,2019
42131,44.7,27327,26125,279,513,7188,59415,10790,8333,2457,10790,167900,2019
42133,41,445565,371691,23921,33221,118977,66457,172421,129109,43312,172421,177100,2019
44001,44.3,48764,44582,615,1486,12526,83092,19217,13592,5625,19217,358100,2019
44003,43.9,163869,144749,2640,8157,43399,73521,69422,48692,20730,69422,236300,2019
44005,45.2,82801,71016,2899,4718,21718,79454,34777,21993,12784,34777,387900,2019
44007,37.4,635737,386474,52674,144826,144416,58974,237971,128897,109074,237971,233500,2019
44009,44.6,126060,114611,1587,4039,32830,85531,49102,36318,12784,49102,343000,2019
45001,44.3,24627,16956,6804,367,6248,38741,9660,7248,2412,9660,90800,2019
45003,41,168301,111410,41371,9622,45626,51399,67598,49051,18547,67598,147300,2019
45005,41.9,9024,1993,6644,302,2011,27185,3365,2295,1070,3365,49200,2019
45007,40.8,198064,153211,30865,7432,52231,50865,76798,55081,21717,76798,145800,2019
45009,41.7,14376,5171,8769,300,3355,31422,5334,3768,1566,5334,75400,2019
45011,41.3,21346,10756,9721,524,5260,35803,8360,5815,2545,8360,81900,2019
45013,45.5,186095,126401,32593,20635,49408,68377,71477,52424,19053,71477,298100,2019
45015,36.1,215044,136645,51286,14206,55155,63309,76881,55295,21586,76881,185500,2019
45017,45.5,14663,7915,5988,553,3910,46339,6179,4963,1216,6179,107200,2019
45019,37.8,401165,258868,106449,20591,92380,64022,159195,97986,61209,159195,315600,2019
45021,39.3,56895,41408,11394,2479,11592,36883,20699,14270,6429,20699,101500,2019
45023,42,32311,18954,11948,653,8042,42442,12653,9628,3025,12653,95600,2019
45025,42.4,45953,27707,14596,1985,12399,41505,17900,12723,5177,17900,81500,2019
45027,45.1,33957,16205,16038,1054,8817,40900,13161,10133,3028,13161,102000,2019
45029,42.5,37585,21273,14375,1205,9565,36324,15075,11298,3777,15075,90400,2019
45031,41.4,67027,36690,27510,1368,17095,38448,26484,18425,8059,26484,92600,2019
45033,37.7,30689,13992,14630,848,7016,30812,11029,6547,4482,11029,79300,2019
45035,37,158299,101637,39291,8516,38377,63080,55351,39667,15684,55351,198800,2019
45037,42.9,26927,15265,9443,1606,6471,49127,9176,6797,2379,9176,129300,2019
45039,46.4,22565,8613,13180,494,5921,38213,9191,6917,2274,9191,103000,2019
45041,39.2,138475,71793,58893,3657,34733,47058,52188,34292,17896,52188,131900,2019
45043,49.5,61952,39733,19115,1902,17334,48456,25498,20099,5399,25498,188800,2019
45045,38.2,507003,346500,88511,46399,127503,60351,192975,130228,62747,192975,183800,2019
45047,39.5,70411,42022,22196,4238,18135,42336,27612,17681,9931,27612,122800,2019
45049,40,19564,8000,10424,787,4148,33429,6993,5313,1680,6993,72300,2019
45051,45.9,332172,256746,43641,20050,84740,50704,131143,94163,36980,131143,181500,2019
45053,40.3,28657,12263,11909,3851,7298,45601,10269,7366,2903,10269,166200,2019
45055,41.1,65112,44783,15176,2886,17053,51479,24980,20509,4471,24980,131100,2019
45057,42.1,92308,64758,19187,4968,23575,58849,33899,27019,6880,33899,199800,2019
45059,40.7,66846,45364,16032,3263,17582,43304,25563,17848,7715,25563,101200,2019
45061,41.8,17365,5633,11080,426,3971,32371,6423,4798,1625,6423,78800,2019
45063,39.1,290278,217279,42548,17438,76748,61173,113104,83972,29132,113104,157000,2019
45065,55.2,9531,4845,4271,79,2513,43633,3957,3030,927,3957,116500,2019
45067,40.7,31308,12077,17692,884,7532,32063,11600,7659,3941,11600,76700,2019
45069,40.3,26753,10456,13472,887,6069,33586,9613,6042,3571,9613,67500,2019
45071,42,38194,22883,11860,2854,9705,44226,14810,10849,3961,14810,116300,2019
45073,45.7,77528,65463,5288,4235,21632,49134,31978,23253,8725,31978,159800,2019
45075,40.3,87687,29184,53787,1950,20057,37955,33060,22257,10803,33060,92700,2019
45077,36.2,124029,106292,8392,4557,30276,49573,47934,32153,15781,47934,147700,2019
45079,33.4,411357,174065,191067,21238,91505,54767,151853,90427,61426,151853,163100,2019
45081,41.8,20303,11831,5061,3137,5132,45714,7094,5257,1837,7094,108600,2019
45083,38.2,307617,210222,62269,21033,79127,52332,116645,82396,34249,116645,141400,2019
45085,36.4,106757,48219,49757,4225,28134,45661,41776,26982,14794,41776,115700,2019
45087,44,27490,17757,8345,427,7701,41186,11432,7803,3629,11432,80000,2019
45089,43,31324,9785,20150,709,8066,32485,12686,9255,3431,12686,68300,2019
45091,38.7,265872,187398,50858,14638,70483,65361,101211,72857,28354,101211,201100,2019
46003,37.8,2763,2439,46,202,750,64083,1182,890,292,1182,85800,2019
46005,38.1,18346,14112,215,1845,4590,52313,7557,4968,2589,7557,109700,2019
46007,28.6,3425,1138,2,95,728,47500,984,595,389,984,75900,2019
46009,42.3,6929,6017,102,189,1490,54737,2536,1864,672,2536,89600,2019
46011,27,34601,31219,452,1063,6872,58136,12896,7628,5268,12896,179000,2019
46013,37,38915,33904,843,1143,9882,58216,16305,10435,5870,16305,166800,2019
46015,40.9,5258,4417,26,147,1441,57196,2231,1376,855,2231,152600,2019
46017,25.8,2026,277,3,84,422,34808,564,261,303,564,49000,2019
46019,40.1,10225,9325,68,371,2554,46508,4164,3211,953,4164,139000,2019
46021,50.9,1485,1457,0,3,431,54449,673,582,91,673,68800,2019
46023,35.8,9349,5848,8,334,2087,50481,3166,2244,922,3166,116700,2019
46025,41.4,3685,3449,3,120,940,48980,1546,1227,319,1546,102400,2019
46027,24.9,13957,12184,232,419,2716,50724,5233,2811,2422,5233,168300,2019
46029,39.1,28026,25997,219,657,7451,56376,12075,7881,4194,12075,174500,2019
46031,28.7,4150,1198,14,19,879,35759,1195,643,552,1195,58500,2019
46033,54.8,8719,7832,22,336,2874,58522,3876,3256,620,3876,214400,2019
46035,38.6,19871,18001,273,620,5265,50570,8660,5170,3490,8660,154700,2019
46037,47.7,5486,4714,0,124,1617,46679,2574,1938,636,2574,100500,2019
46039,42.8,4318,4151,1,148,1243,65437,1798,1421,377,1798,133500,2019
46041,26.9,5833,1157,5,59,1194,47475,1651,1008,643,1651,64400,2019
46043,46.7,2929,2764,0,19,884,58684,1220,974,246,1220,94400,2019
46045,42.4,3909,3756,7,96,1068,71324,1544,1266,278,1544,118400,2019
46047,53.6,6747,5710,0,272,1827,50588,2986,2331,655,2986,129400,2019
46049,47,2312,2221,1,8,547,55096,895,719,176,895,85100,2019
46051,42.9,7149,6619,33,325,2118,58158,3218,2612,606,3218,133700,2019
46053,45.4,4186,3672,0,37,1119,43438,1840,1318,522,1840,83400,2019
46055,44.1,2018,1800,1,13,602,42250,822,634,188,822,105400,2019
46057,35,6025,5634,26,259,1680,67105,2256,1817,439,2256,157100,2019
46059,47.4,3256,3140,4,54,976,54155,1508,1030,478,1508,128400,2019
46061,36.7,3399,3383,0,0,763,64696,1045,919,126,1045,130800,2019
46063,42.3,1306,1203,27,31,387,59655,532,357,175,532,101100,2019
46065,38,17608,14477,24,563,4415,64783,7460,5129,2331,7460,177500,2019
46067,43,7308,6920,0,158,1894,57089,2903,2242,661,2903,94100,2019
46069,53.3,1319,1160,32,9,387,57788,597,448,149,597,88800,2019
46071,32.2,3290,1282,10,9,627,33295,858,500,358,858,52500,2019
46073,51.6,2018,1907,0,61,572,49632,921,669,252,921,81900,2019
46075,53.5,793,737,9,0,238,46149,408,306,102,408,77100,2019
46077,45.1,4944,4786,0,110,1420,61699,2279,1812,467,2279,109900,2019
46079,43.2,12717,11855,41,140,3071,61846,4700,3504,1196,4700,168400,2019
46081,42.1,25478,23148,227,831,6202,52641,11048,7147,3901,11048,207900,2019
46083,34.9,56826,52836,752,1212,14554,82473,19749,15153,4596,19749,228800,2019
46085,35.5,3848,2138,4,49,968,53862,1397,939,458,1397,102800,2019
46087,39.3,5548,5181,39,225,1466,61507,2228,1692,536,2228,137800,2019
46089,50.2,2297,2183,48,30,596,44574,1030,794,236,1030,58900,2019
46091,39.8,4891,4059,31,408,1229,63723,1873,1382,491,1873,118900,2019
46093,36.5,27717,24272,513,1176,7580,60578,11027,8199,2828,11027,190500,2019
46095,32.9,2052,791,3,91,482,30650,661,459,202,661,32100,2019
46097,44,2211,2102,6,45,584,52910,948,727,221,948,77000,2019
46099,34.9,188674,155670,10607,9417,47605,61772,76819,48546,28273,76819,186800,2019
46101,39.9,6507,4998,32,288,1765,61538,2640,1886,754,2640,133700,2019
46102,25.8,14335,637,11,585,2177,31997,2729,1370,1359,2729,27400,2019
46103,39,110685,88441,1297,5730,27364,57039,44074,30252,13822,44074,187800,2019
46105,47.5,2897,2730,0,29,821,57981,1284,932,352,1284,102000,2019
46107,49.2,2315,2119,0,37,629,54583,982,774,208,982,102300,2019
46109,38.1,10287,5811,62,357,2574,50348,3873,2574,1299,3873,103600,2019
46111,42.6,2379,2237,0,89,711,56875,1010,740,270,1010,87600,2019
46115,43.5,6483,6075,14,201,1667,54423,2624,1947,677,2624,82800,2019
46117,44.5,3017,2657,0,88,973,71382,1344,1060,284,1344,163300,2019
46119,46.8,1305,1253,0,17,377,62153,569,489,80,569,144100,2019
46121,23.8,10195,809,6,118,1914,24331,2700,1180,1520,2700,26000,2019
46123,45.1,5458,4415,0,11,1604,57720,2356,1796,560,2356,101200,2019
46125,42,8300,7907,38,203,2352,59242,3498,2739,759,3498,122400,2019
46127,40,15368,14154,124,490,4304,70378,6619,4579,2040,6619,179300,2019
46129,42.8,5457,4314,275,120,1358,55583,2258,1668,590,2258,88200,2019
46135,41.8,22717,20090,353,1026,5922,58342,9445,6156,3289,9445,148300,2019
46137,33.1,2791,657,0,9,608,37400,754,431,323,754,57700,2019
47001,43.3,76061,67777,2671,2215,20550,50392,30541,20746,9795,30541,146200,2019
47003,37.9,48292,37090,3822,5987,12704,50415,17029,11673,5356,17029,151100,2019
47005,47.9,16140,14967,487,392,3832,37512,6762,5214,1548,6762,85600,2019
47007,44.1,14836,13048,491,368,3473,44122,4894,3612,1282,4894,134600,2019
47009,43.7,129927,118159,3417,4378,34805,56667,50557,38128,12429,50557,182100,2019
47011,39.5,105749,90403,5054,6541,27316,51331,40192,26342,13850,40192,161000,2019
47013,44.1,39797,38328,127,556,11127,39803,16192,11026,5166,16192,104400,2019
47015,42,14178,13344,265,317,3903,55330,5488,4103,1385,5488,164600,2019
47017,42.5,27886,23583,2844,741,7451,42637,10962,8012,2950,10962,88300,2019
47019,45.4,56433,53491,957,1055,15256,38092,23784,16838,6946,23784,122600,2019
47021,40.3,40181,37184,637,1204,11022,61913,15089,11612,3477,15089,187400,2019
47023,37.7,17190,14691,1535,452,4471,51946,6060,4672,1388,6060,121900,2019
47025,43.1,31732,30206,314,419,8683,36835,13281,9411,3870,13281,110000,2019
47027,47.3,7654,7226,183,200,2002,32167,3039,2380,659,3039,98200,2019
47029,45.2,35552,33154,494,837,9196,36716,14060,9431,4629,14060,112900,2019
47031,39.7,55209,48792,2092,2382,14777,50351,21646,14747,6899,21646,141900,2019
47033,40.7,14399,10645,1871,1521,3700,44717,5491,3930,1561,5491,99600,2019
47035,51,59216,55916,396,1770,17692,45958,25801,20011,5790,25801,153200,2019
47037,34.3,687488,386383,185114,70319,156571,60388,282366,153439,128927,282366,241700,2019
47039,46.4,11686,10683,518,169,3059,42031,4440,3596,844,4440,98800,2019
47041,41.1,19847,17463,337,1639,5401,45511,7704,5266,2438,7704,148600,2019
47043,39.1,52680,47135,2196,1885,13030,53076,19198,14412,4786,19198,164700,2019
47045,40.5,37416,29934,4731,1274,10566,44185,15120,9300,5820,15120,103800,2019
47047,45.8,40164,27319,10961,1086,11567,60711,15596,12464,3132,15596,206700,2019
47049,45.2,18213,17579,59,278,4929,36520,7443,5592,1851,7443,110400,2019
47051,42.2,41725,36877,1885,1415,11197,51585,16326,12160,4166,16326,139200,2019
47053,39.9,49228,37731,8420,1339,12987,43171,19320,13187,6133,19320,98600,2019
47055,43.9,29285,24637,2831,741,7807,49614,11904,8285,3619,11904,129700,2019
47057,45,23101,21703,104,772,6510,44064,8959,7087,1872,8959,119100,2019
47059,44.7,68834,64048,1475,1989,18310,42595,27396,20270,7126,27396,122400,2019
47061,43.4,13344,11595,96,167,3320,40516,4820,3760,1060,4820,87200,2019
47063,40.7,64132,52249,2383,7508,16391,43619,24456,16349,8107,24456,137900,2019
47065,39.7,360919,256573,68280,20391,88001,55070,145213,92887,52326,145213,180900,2019
47067,44.5,6587,6371,33,105,1729,30136,2742,2184,558,2742,102600,2019
47069,40.3,25443,13794,10630,447,5816,40304,8891,6332,2559,8891,90200,2019
47071,45.3,25715,23604,1001,657,7203,40682,10137,7349,2788,10137,124300,2019
47073,44.9,56611,53811,747,878,15917,41924,23135,17010,6125,23135,124100,2019
47075,42,17623,7754,8950,762,4727,37905,7181,4177,3004,7181,100700,2019
47077,41.5,27977,24452,2192,678,7113,43305,10711,7793,2918,10711,102000,2019
47079,45.8,32284,28185,2637,839,9024,40502,13394,10211,3183,13394,103300,2019
47081,41.1,24813,22430,1299,611,5611,43596,8636,6936,1700,8636,116200,2019
47083,43.9,8164,7511,441,31,1750,42711,2878,2201,677,2878,103700,2019
47085,42,18435,17046,380,455,4375,45667,6763,5261,1502,6763,113800,2019
47087,46.8,11682,11135,37,244,2745,35207,4566,3519,1047,4566,126100,2019
47089,43.9,53679,49508,910,1928,13998,49139,20154,15164,4990,20154,146300,2019
47091,46,17753,16385,613,361,4635,36004,6794,5136,1658,6794,133100,2019
47093,37.4,461104,379329,39908,19707,116035,57470,187319,120390,66929,187319,183200,2019
47095,41.5,7401,4935,2100,172,1498,35191,2243,1227,1016,2243,81300,2019
47097,38.3,25989,15757,8769,661,6753,39896,9675,5428,4247,9675,84100,2019
47099,39.3,43390,40462,724,969,11028,43614,15960,12025,3935,15960,112500,2019
47101,43.3,12027,11223,219,276,3175,37277,4715,3676,1039,4715,95600,2019
47103,42.6,33924,29456,2405,1192,9264,49485,13548,10170,3378,13548,135700,2019
47105,47.6,52340,45899,482,4595,14615,58065,20669,16076,4593,20669,222500,2019
47107,42.6,53053,47330,1923,2130,13685,43285,20804,15283,5521,20804,133200,2019
47109,43.5,25844,23210,1427,545,6724,39161,10022,7286,2736,10022,98100,2019
47111,39.4,23842,21903,44,1231,6215,37430,9170,6821,2349,9170,115000,2019
47113,38.7,97625,54430,36091,3765,25119,48161,37944,23651,14293,37944,131500,2019
47115,43.4,28538,26174,734,517,8114,49432,11477,8602,2875,11477,125700,2019
47117,38.9,32965,27973,2491,1778,8624,53197,12324,8843,3481,12324,136400,2019
47119,39.1,91976,72928,10553,5354,24626,57170,34688,24236,10452,34688,184800,2019
47121,46,12104,11390,230,255,3331,49167,4938,3887,1051,4938,136600,2019
47123,43.9,46064,41940,920,2029,12847,42429,17987,13797,4190,17987,133700,2019
47125,30.8,200180,126782,38611,20036,51167,57541,72617,43243,29374,72617,165800,2019
47127,45,6378,5905,140,14,1862,57708,2592,2198,394,2592,187100,2019
47129,41.6,21545,19833,1226,287,5659,41333,7625,6223,1402,7625,102000,2019
47131,42.6,30365,25171,3108,1339,8389,39615,12717,8254,4463,12717,91500,2019
47133,43,22068,21208,144,327,6220,37197,9140,7289,1851,9140,124900,2019
47135,43.2,7962,7314,218,108,2068,41034,3073,2533,540,3073,88100,2019
47137,50.1,5079,5049,9,19,1600,39554,2281,1864,417,2281,144400,2019
47139,45.6,16814,15939,56,353,5239,43306,7383,5443,1940,7383,112700,2019
47141,36.4,77447,68481,1673,4838,19675,44259,31424,19317,12107,31424,159600,2019
47143,38.9,32719,29620,741,1620,8235,42206,12177,8672,3505,12177,122600,2019
47145,46.4,53075,49220,1227,980,13948,53367,20901,16143,4758,20901,150300,2019
47147,39,70280,58516,5056,4873,20040,63307,25713,19022,6691,25713,194800,2019
47149,33.5,315815,223482,45871,25329,78080,67429,111676,72860,38816,111676,213200,2019
47151,39.4,21969,21341,126,212,6059,38864,8664,6061,2603,8664,99000,2019
47153,44.1,14816,13857,33,525,4192,49370,5528,4132,1396,5528,142500,2019
47155,42.9,97068,87347,877,5818,26176,49610,37210,25815,11395,37210,175500,2019
47157,35.6,936374,334839,500339,59571,218520,51657,351194,193347,157847,351194,150400,2019
47159,40.3,19740,18279,394,537,5409,48068,7603,5618,1985,7603,146900,2019
47161,44.2,13427,12324,124,406,3355,45809,5178,3884,1294,5178,123100,2019
47163,45.1,157050,146687,2884,2978,42837,46684,66511,47784,18727,66511,141300,2019
47165,39.8,183437,154313,13330,8949,48495,67204,67089,49394,17695,67089,234200,2019
47167,37.5,61447,46509,11279,1708,16419,61291,21452,15305,6147,21452,150000,2019
47169,35.1,10231,8610,1042,110,2083,56321,3189,2514,675,3189,155700,2019
47171,46.5,17811,16589,60,873,4953,41890,7658,5508,2150,7658,129500,2019
47173,43,19488,18755,98,326,5471,44671,7405,5584,1821,7405,124700,2019
47175,46.9,5760,5513,16,41,1545,42724,2141,1744,397,2141,98000,2019
47177,40,40702,34697,838,3697,10167,41125,15727,10926,4801,15727,112500,2019
47179,40.2,127805,113269,5095,4386,33030,48334,53859,34682,19177,53859,163000,2019
47181,43,16693,14974,1143,348,4016,41427,5764,4463,1301,5764,95200,2019
47183,38.6,33510,29078,2831,865,8677,39937,13640,8904,4736,13640,97800,2019
47185,43.2,26800,25053,568,690,6904,41998,10048,8039,2009,10048,117000,2019
47187,39.1,225389,190642,9239,10748,62728,112962,77855,62713,15142,77855,449000,2019
47189,40.4,136666,116124,9735,5784,37850,75991,49664,38156,11508,49664,264600,2019
48001,39.3,57810,34069,12111,10283,11602,43455,16677,11606,5071,16677,101900,2019
48003,30.8,18036,7246,122,10151,4273,76158,5573,4130,1443,5573,143900,2019
48005,37.5,87322,52832,12747,19326,22700,50453,31035,20531,10504,31035,107600,2019
48007,50.6,24462,16486,337,6721,6132,45137,9548,7657,1891,9548,156800,2019
48009,44.5,8716,7700,76,722,2402,63835,3452,2888,564,3452,146200,2019
48011,46,1973,1763,5,149,555,72500,694,611,83,694,139700,2019
48013,35.4,49528,16487,135,31855,11842,55366,15546,11711,3835,15546,97900,2019
48015,40.7,29764,18515,2600,7989,8434,66206,11301,8613,2688,11301,196300,2019
48017,33.3,7100,2519,33,4411,1439,52273,2054,1532,522,2054,69700,2019
48019,52.2,22215,17289,154,4175,5852,58661,8399,7141,1258,8399,174200,2019
48021,38.4,84522,44228,5977,31852,18606,64597,25571,19862,5709,25571,172000,2019
48023,45.9,3577,3098,110,305,938,40739,1530,1107,423,1530,62000,2019
48025,35.3,32611,10234,2228,19194,5752,44578,8269,5185,3084,8269,90600,2019
48027,31,348574,159545,74996,86533,84974,54884,122689,66632,56057,122689,147700,2019
48029,33.6,1952843,540436,138727,1175975,421257,57157,636245,372372,263873,636245,161800,2019
48031,50.4,11478,8837,3,2224,3139,66390,4343,3413,930,4343,246400,2019
48033,41.7,613,514,0,84,166,72188,227,172,55,227,153300,2019
48035,46.6,18296,14239,295,3356,5347,52148,7211,5579,1632,7211,121700,2019
48037,38,93373,59562,22768,7098,23034,50164,34076,21624,12452,34076,119400,2019
48039,35.8,360677,170272,49226,110463,88881,81447,121523,87645,33878,121523,197700,2019
48041,26.5,222981,124411,22923,56995,44793,49181,79412,37425,41987,79412,201800,2019
48043,43.7,9231,4642,19,4133,2233,47080,4088,2363,1725,4088,151400,2019
48045,46.4,1457,845,12,519,374,40227,602,417,185,602,66000,2019
48047,29.7,7141,478,0,6646,1426,28333,2120,1300,820,2120,67800,2019
48049,41.5,37855,27115,1337,8422,9572,48365,14409,10441,3968,14409,102500,2019
48051,43.3,18058,11688,2370,3736,4752,57731,6810,5323,1487,6810,121900,2019
48053,44.6,46530,34246,815,10342,12281,59492,16743,12924,3819,16743,192000,2019
48055,35.9,42144,16718,2360,21993,9619,54152,13460,9071,4389,13460,144800,2019
48057,37.7,21668,9163,505,10589,5135,58776,7582,5518,2064,7582,120200,2019
48059,44.2,13856,11916,126,1334,3408,48651,5367,4406,961,5367,94900,2019
48061,31.7,421666,37770,1683,378081,97748,38758,124605,82097,42508,124605,85800,2019
48063,37.6,12878,7183,2036,3215,3314,48207,4605,3335,1270,4605,101600,2019
48065,40.6,6009,5151,48,596,1602,74872,2288,1854,434,2288,114300,2019
48067,43.3,30059,22938,5133,1352,8256,44848,11934,9469,2465,11934,87100,2019
48069,34.8,7673,2452,163,4957,1738,50142,2532,1632,900,2532,81900,2019
48071,35.2,41305,27661,2997,9267,11307,91141,14069,11669,2400,14069,200400,2019
48073,37.9,52118,31628,7035,12058,13250,48186,18138,13034,5104,18138,102900,2019
48075,34.5,7253,4240,583,2249,1547,43181,2407,1441,966,2407,85500,2019
48077,46.6,10403,9339,47,653,2855,55989,4105,3463,642,4105,101000,2019
48079,35.1,2887,1041,111,1695,687,40962,998,782,216,998,38800,2019
48081,48.1,3303,2517,32,711,1007,45000,1644,1219,425,1644,69100,2019
48083,47.2,8334,6403,134,1460,2127,46743,3423,2553,870,3423,76500,2019
48085,36.9,973977,554789,93804,148696,252724,96913,341163,221828,119335,341163,315300,2019
48087,39.6,2969,1784,248,854,758,39120,1035,779,256,1035,52200,2019
48089,42.9,21224,11871,2683,6310,5034,52559,7450,6142,1308,7450,124400,2019
48091,42.2,141642,95622,2828,38756,38230,79936,51367,38463,12904,51367,282300,2019
48093,44.8,13529,9397,81,3777,3763,53516,5487,4389,1098,5487,105000,2019
48095,45.3,3266,1726,38,1474,614,47500,912,686,226,912,101500,2019
48097,40.7,40041,30166,1121,7269,10820,60202,15351,10642,4709,15351,161100,2019
48099,31.8,75280,44173,9617,13761,15975,52893,22322,12931,9391,22322,114300,2019
48101,37.1,1642,850,238,380,420,32305,707,397,310,707,46600,2019
48103,32.7,4802,1495,111,3091,1134,65969,1421,1217,204,1421,100400,2019
48105,38.8,3484,1304,24,2156,948,47386,1354,1001,353,1354,89600,2019
48107,38.4,5836,2299,183,3269,1459,40759,2061,1552,509,2061,60800,2019
48109,34.4,2214,562,3,1573,411,37900,580,387,193,580,62400,2019
48111,31.7,7304,3626,56,3347,1711,58811,2364,1523,841,2364,89200,2019
48113,33.4,2606868,759485,580189,1047434,599542,59607,928341,464220,464121,928341,174900,2019
48115,33.5,12813,4265,985,7363,2889,43239,4322,2995,1327,4322,73400,2019
48117,31.9,18736,4626,119,13646,4522,49701,6145,3935,2210,6145,91100,2019
48119,44.3,5249,4239,461,408,1416,51038,1999,1563,436,1999,87700,2019
48121,35.5,833822,494029,79871,160933,204075,86913,290229,188842,101387,290229,277800,2019
48123,41,20340,11143,1888,7192,4995,55357,7048,5129,1919,7048,117100,2019
48125,46,2203,1476,59,657,502,42540,845,648,197,845,51100,2019
48127,34.3,10438,1143,4,9072,2254,27161,3148,2085,1063,3148,72800,2019
48129,41.4,3342,2702,183,370,812,42961,1335,938,397,1335,68700,2019
48131,36.1,11268,1053,148,10066,2451,41186,3511,2298,1213,3511,49400,2019
48133,41.2,18273,14494,522,2989,3864,37276,6492,4973,1519,6492,73900,2019
48135,30.4,160579,51855,7109,97439,36317,62973,52530,34087,18443,52530,140500,2019
48137,49.1,1918,830,0,1086,445,40766,789,675,114,789,69200,2019
48139,36.2,173772,105705,17028,45577,45214,76871,57307,42622,14685,57307,191400,2019
48141,32.2,836062,100109,24770,690273,195343,46871,268310,164018,104292,268310,121500,2019
48143,30.4,41841,31197,776,8821,8690,52742,13595,8623,4972,13595,159900,2019
48145,39,17272,8851,4164,4000,3337,39497,5199,3764,1435,5199,75300,2019
48147,41.3,34537,27211,1944,3900,8658,54648,12453,9117,3336,12453,123100,2019
48149,47,25141,17907,1645,5276,6536,60189,9135,7460,1675,9135,182100,2019
48151,44.6,3856,2382,102,1261,992,46146,1601,1179,422,1601,66900,2019
48153,37.2,5803,2136,167,3405,1595,50580,2271,1700,571,2271,64300,2019
48155,51.2,1275,919,29,284,346,43625,533,443,90,533,46400,2019
48157,36.3,765394,253263,153972,187500,195729,97743,237883,183583,54300,237883,265900,2019
48159,43.2,10716,8430,468,1550,2817,53783,3965,3121,844,3965,126200,2019
48161,41.5,19714,13130,2973,3055,4677,49471,6758,5234,1524,6758,111800,2019
48163,31.2,19871,3233,631,15753,3372,46729,4542,3136,1406,4542,82200,2019
48165,27.8,20706,11493,450,8591,4545,63054,5812,4493,1319,5812,150900,2019
48167,37.7,332885,190948,41105,82003,84986,73330,121438,81995,39443,121438,199200,2019
48169,41.1,6070,2407,342,3170,1177,49627,1543,1088,455,1543,78800,2019
48171,50,26459,19765,21,6132,7197,59155,10694,7747,2947,10694,286900,2019
48173,30.8,1510,849,0,661,356,78456,403,265,138,403,229200,2019
48175,46.1,7565,4408,372,2712,1922,60690,2727,2182,545,2727,137800,2019
48177,36.3,20731,8635,1341,10518,5414,53577,7364,4956,2408,7364,121300,2019
48179,36.5,22410,14189,965,6498,5166,47952,7884,5798,2086,7884,77600,2019
48181,39.9,131014,98801,6871,17577,32615,54815,48454,32756,15698,48454,137400,2019
48183,35.6,123443,70988,24425,23100,29627,50180,45460,26886,18574,45460,136700,2019
48185,40.4,27984,16371,4164,6761,6460,52913,9011,6892,2119,9011,148500,2019
48187,37,158966,80056,12055,60278,41367,74496,54110,41499,12611,54110,196000,2019
48189,33.4,33826,11443,1535,20109,7877,48384,10933,6810,4123,10933,82700,2019
48191,44.6,3048,1695,188,1060,803,34673,1267,827,440,1267,52800,2019
48193,45.8,8332,7003,66,1062,2094,50825,2989,2447,542,2989,130800,2019
48195,35.1,5520,2849,5,2650,1360,38000,1838,1295,543,1838,95300,2019
48197,43.5,3945,2828,232,749,1054,41859,1596,1084,512,1596,43100,2019
48199,39.2,56765,49096,3153,3230,14985,60339,20626,16752,3874,20626,124100,2019
48201,33.5,4646630,1374905,863044,1995115,1096660,61705,1605368,876454,728914,1605368,175700,2019
48203,38.7,66580,42336,13760,8727,17064,52220,23292,16840,6452,23292,130900,2019
48205,38.1,5669,3400,420,1515,1208,58298,1678,1052,626,1678,167200,2019
48207,43.5,5726,3702,217,1636,1423,40313,2146,1622,524,2146,53900,2019
48209,32,213366,114727,8207,83069,48306,68717,73437,45739,27698,73437,238700,2019
48211,36.4,3994,2519,39,1391,1035,70625,1298,925,373,1298,151700,2019
48213,43.9,81070,63378,5150,10347,21483,47355,30757,23133,7624,30757,108500,2019
48215,29.2,855176,52492,3612,788282,193034,40014,238345,162163,76182,238345,87100,2019
48217,42.1,35689,25196,2239,7354,9098,53307,12992,9429,3563,12992,103800,2019
48219,33.8,23064,10824,738,11023,5637,48248,7997,5640,2357,7997,93600,2019
48221,47,58318,49117,441,7232,15880,64041,22152,17134,5018,22152,193500,2019
48223,39.2,36486,26738,2555,6157,9753,52078,13424,9343,4081,13424,114900,2019
48225,44.5,22954,14192,5717,2544,5419,37904,8252,5774,2478,8252,100700,2019
48227,36.5,36349,17684,1888,15452,7191,54208,11064,7235,3829,11064,99000,2019
48229,37,4415,766,72,3435,730,31677,978,703,275,978,50900,2019
48231,38,94162,67443,7350,15396,22761,54959,33189,22860,10329,33189,123300,2019
48233,38,21344,15018,307,4964,4797,52524,6929,5566,1363,6929,78800,2019
48235,42.7,1620,1132,66,414,445,47500,682,529,153,682,118300,2019
48237,39.6,8852,6830,420,1494,2246,52045,3168,2575,593,3168,86300,2019
48239,37.7,14816,8665,960,4905,3561,62806,4917,3422,1495,4917,114000,2019
48241,40.5,35506,26460,5869,2386,8819,44370,12936,10035,2901,12936,100900,2019
48243,55.8,2241,1308,23,893,608,53088,1054,860,194,1054,111900,2019
48245,36.2,254340,103229,85092,52708,59839,51248,92988,56792,36196,92988,112800,2019
48247,32.4,5231,423,2,4778,1179,33382,1626,1165,461,1626,65000,2019
48249,34.6,40972,7357,255,32893,9256,41505,12987,9170,3817,12987,76200,2019
48251,36.8,167212,120380,5794,35714,43539,64359,57310,42032,15278,57310,155400,2019
48253,38.2,19943,10799,2790,5494,4019,50344,5696,4249,1447,5696,82400,2019
48255,35.4,15545,5572,997,8506,2815,56127,4282,3190,1092,4282,102300,2019
48257,35.5,123804,78847,14504,26524,29787,70107,38015,29123,8892,38015,178300,2019
48259,41.4,43769,31664,214,10450,11030,84747,14253,10563,3690,14253,348500,2019
48261,39.7,568,30,0,538,153,38021,197,46,151,197,24400,2019
48263,51,647,542,6,91,162,44688,273,190,83,273,35000,2019
48265,47.4,51843,35627,742,13964,14551,55990,21403,15136,6267,21403,180600,2019
48267,52.1,4373,3309,48,953,1271,43328,1783,1359,424,1783,149700,2019
48269,40,237,159,0,78,47,52083,77,26,51,77,36700,2019
48271,49.8,3659,1485,5,2169,662,26738,1337,1024,313,1337,68800,2019
48273,28.3,30974,6255,910,22574,6979,43730,10955,5781,5174,10955,91900,2019
48275,39.5,3705,2157,174,1272,962,48798,1375,1140,235,1375,45000,2019
48277,40.7,49611,36920,6324,3902,13201,45117,19793,12760,7033,19793,99100,2019
48279,36.4,13123,5158,392,7291,3265,45111,4728,3380,1348,4728,65500,2019
48281,43.1,20862,15143,904,4052,5770,60772,7807,6039,1768,7807,161600,2019
48283,36.5,7416,982,108,6236,1629,50151,2269,1559,710,2269,82300,2019
48285,43.4,20021,14717,1234,3785,5609,54403,7826,5811,2015,7826,162400,2019
48287,41.1,17058,10804,1899,4040,4485,54744,6036,4862,1174,6036,138700,2019
48289,44.3,17225,13113,1155,2509,4363,43045,6443,4985,1458,6443,111000,2019
48291,35.5,83702,52983,8239,20788,19314,51494,26873,20302,6571,26873,111600,2019
48293,39.9,23417,13735,3945,5130,5852,44418,8377,6204,2173,8377,95400,2019
48295,34.7,3398,2124,18,1086,889,59091,1192,880,312,1192,100900,2019
48297,42.2,12139,6804,269,4854,2447,53848,3752,3075,677,3752,104100,2019
48299,57.4,21047,18192,140,2187,5741,53411,8678,6775,1903,8678,194800,2019
48301,55.2,98,83,0,12,20,83750,30,19,11,30,NA,2019
48303,30.8,304808,162989,20125,107993,69992,52429,113488,62673,50815,113488,140600,2019
48305,37.3,5830,2874,41,2753,1535,43382,2154,1471,683,2154,84000,2019
48307,44.6,8057,4875,87,2603,2068,47707,3143,2270,873,3143,93700,2019
48309,33.3,251089,140429,35807,66148,59833,49778,90054,53341,36713,90054,142800,2019
48311,38.2,774,380,0,385,210,62000,270,205,65,270,110900,2019
48313,35.2,14197,7809,2310,3290,2816,52664,4269,3166,1103,4269,113100,2019
48315,50.6,10017,7097,2294,415,2912,37662,4715,3645,1070,4715,96500,2019
48317,32.7,5649,3047,48,2540,1245,66610,1694,1251,443,1694,148000,2019
48319,46.3,4186,3105,2,929,1075,42276,1696,1198,498,1696,172800,2019
48321,38.2,36774,16045,3785,15612,9262,48913,13848,9787,4061,13848,114800,2019
48323,29.6,58174,1452,187,55368,13446,39625,16286,10702,5584,16286,97900,2019
48325,39,50057,21808,1237,26016,11623,62599,15682,12608,3074,15682,137800,2019
48327,51.8,2119,1162,0,883,581,36395,1014,701,313,1014,59300,2019
48329,31.7,168167,76360,10456,75224,39004,79421,56998,38145,18853,56998,213100,2019
48331,41.7,24770,15447,2279,6546,6217,47902,9228,6591,2637,9228,107400,2019
48333,52.1,4889,3824,19,1026,1160,49306,1790,1523,267,1790,140200,2019
48335,33.9,8523,4082,769,3399,1514,51492,2382,1881,501,2382,69000,2019
48337,44.6,19489,16720,131,2138,5179,51765,7800,5647,2153,7800,115400,2019
48339,37.1,571949,377623,27435,138081,148464,80902,198649,141137,57512,198649,235800,2019
48341,30.8,21399,6946,687,11996,5068,54871,6733,4433,2300,6733,121900,2019
48343,43,12373,7968,2857,1220,3379,41359,5117,3734,1383,5117,90400,2019
48345,41.3,1252,932,19,246,313,43859,489,334,155,489,56500,2019
48347,30.9,65339,38888,11279,12690,15146,44847,23757,13439,10318,23757,130100,2019
48349,38.1,48995,27461,5977,13354,12347,48529,17338,11947,5391,17338,97600,2019
48351,44.3,13914,10223,2823,504,3885,40101,5315,4497,818,5315,81200,2019
48353,37.5,14904,8276,829,5616,3654,45537,5407,3635,1772,5407,75500,2019
48355,35.5,361540,106563,13101,230450,87543,55919,129451,75017,54434,129451,138700,2019
48357,32.3,10131,4367,9,5489,2616,50464,3483,2556,927,3483,102700,2019
48359,35.9,2094,1615,64,319,431,64545,594,466,128,594,91400,2019
48361,37.9,84069,67807,7302,6456,22168,59399,31694,23864,7830,31694,113500,2019
48363,40.6,28540,21419,715,5674,6896,50154,10255,7456,2799,10255,107000,2019
48365,39.2,23327,17071,4032,2034,6232,52982,8637,6626,2011,8637,102200,2019
48367,39.7,133811,111688,1663,16443,33826,77503,44263,34897,9366,44263,214200,2019
48369,33.4,9718,3314,116,6151,2312,55359,3203,2144,1059,3203,97600,2019
48371,35.9,15815,3983,543,10877,3339,52397,4656,3363,1293,4656,87300,2019
48373,43.7,48913,34672,4742,7471,12586,49279,18033,13711,4322,18033,110200,2019
48375,33.9,119674,52742,11718,45859,28534,42528,44380,24484,19896,44380,92500,2019
48377,41.9,6975,904,0,5841,1375,25098,2543,1471,1072,2543,75100,2019
48379,48.4,11766,10040,415,1073,3062,51579,4330,3366,964,4330,127900,2019
48381,35.9,134026,96033,3374,28991,33768,68261,49389,34978,14411,49389,167800,2019
48383,30,3766,1121,32,2592,826,74868,1084,731,353,1084,98800,2019
48385,47.4,3408,2491,19,895,675,35862,1126,861,265,1126,113200,2019
48387,45.9,12171,8932,2039,886,3284,39142,4963,3800,1163,4963,71100,2019
48389,35.8,15492,3451,208,11571,2555,53311,3518,2549,969,3518,64800,2019
48391,43.3,7145,2975,463,3604,1741,50076,2547,1853,694,2547,85600,2019
48393,43.2,805,675,0,107,234,68750,301,240,61,301,133000,2019
48395,41.5,16990,9718,3437,3564,4573,52928,6444,4902,1542,6444,108600,2019
48397,37.5,97175,68827,6042,17138,26595,100920,33032,27016,6016,33032,266200,2019
48399,40.8,10277,6317,309,3511,2691,44940,3896,2772,1124,3896,81400,2019
48401,38.2,53755,34267,9015,9042,13070,55234,18108,14097,4011,18108,124900,2019
48403,53,10471,8956,591,477,2940,34992,4311,3804,507,4311,116300,2019
48405,49.3,8286,5725,1768,597,2486,40353,3451,2674,777,3451,88000,2019
48407,44.9,28180,21043,2517,3693,6680,41614,10043,8098,1945,10043,114100,2019
48409,35.5,67008,25725,975,38724,16848,56556,22898,15645,7253,22898,122100,2019
48411,42.4,5991,3847,121,1803,1329,45083,2082,1425,657,2082,109400,2019
48413,36.2,2983,1376,16,1580,669,53229,1075,848,227,1075,77800,2019
48415,36.4,17096,9020,792,6904,4004,54326,5941,4467,1474,5941,85500,2019
48417,43,3296,2816,7,380,870,46935,1317,1048,269,1317,91400,2019
48419,38,25349,15611,4803,4644,6756,42522,9293,6844,2449,9293,78100,2019
48421,40.1,3059,1635,35,1364,754,51926,1019,740,279,1019,99800,2019
48423,36.6,227449,135850,39165,44360,53919,56810,77678,51589,26089,77678,158600,2019
48425,41,8860,7010,105,1646,2545,60632,3123,2508,615,3123,219000,2019
48427,28.8,64078,444,24,63549,12969,30387,16188,12160,4028,16188,71900,2019
48429,39.4,9364,6657,265,2223,2283,46232,3247,2665,582,3247,74300,2019
48431,40.8,1231,578,0,641,357,59868,458,392,66,458,59000,2019
48433,47.1,1476,1120,30,314,374,51250,580,438,142,580,55600,2019
48435,38.6,3824,1304,3,2510,996,54306,1412,977,435,1412,91800,2019
48437,35.9,7432,3432,438,3272,1717,39771,2505,1778,727,2505,80600,2019
48439,34.4,2049770,957676,330853,590485,495825,67700,708252,428630,279622,708252,188500,2019
48441,32.5,136870,86841,10576,33404,32740,53143,49868,29101,20767,49868,124500,2019
48443,55.2,896,353,10,508,253,43208,418,389,29,418,76400,2019
48445,34.6,12528,4947,578,6891,2875,44627,4061,2828,1233,4061,76500,2019
48447,52.3,1436,1218,14,190,424,40000,668,487,181,668,56300,2019
48449,34.1,32640,14745,2914,14048,8437,50196,10893,7296,3597,10893,105100,2019
48451,34.1,117986,62852,4706,47064,27669,53903,43314,27500,15814,43314,141500,2019
48453,34.2,1226805,600694,96367,414745,269295,75887,472361,247351,225010,472361,324800,2019
48455,48.6,14620,11457,1454,1460,4118,41357,6030,4666,1364,6030,83700,2019
48457,42.4,21518,17004,2289,1656,4774,44497,7100,5961,1139,7100,88100,2019
48459,41.4,41018,32971,3337,3524,10041,52162,14108,11115,2993,14108,141200,2019
48461,39.6,3659,1432,214,1966,863,52171,1332,973,359,1332,66900,2019
48463,33.7,26920,7042,88,19306,6163,41679,8841,6482,2359,8841,89000,2019
48465,31.8,48969,7469,635,40131,11704,46147,15779,10021,5758,15779,103400,2019
48467,42.8,55103,46127,1543,6010,14699,54654,20156,15722,4434,20156,132300,2019
48469,35.9,92109,41147,5163,43175,22412,56834,32255,21347,10908,32255,142800,2019
48471,35.3,72321,40789,16656,12973,13125,43742,21963,11290,10673,21963,152300,2019
48473,28.9,51832,22222,12831,15581,10851,59642,15171,10367,4804,15171,197400,2019
48475,33.9,11658,4663,469,6256,2822,62986,3978,2846,1132,3978,86800,2019
48477,41.5,35163,22508,5763,5646,8599,54971,12625,9358,3267,12625,179100,2019
48479,28.8,273526,9657,787,261132,59936,46475,74789,46513,28276,74789,125900,2019
48481,37.3,41577,18484,5623,17208,10555,48310,15199,10178,5021,15199,128100,2019
48483,39.6,5338,3655,158,1388,1518,49315,2183,1454,729,2183,84000,2019
48485,34.5,131596,85899,13104,25258,30464,48650,48356,29164,19192,48356,100000,2019
48487,39.4,12833,7460,1231,3736,3252,45302,5180,3146,2034,5180,68300,2019
48489,33,21588,2427,119,19039,4524,35521,5782,4078,1704,5782,55300,2019
48491,36.3,547604,325160,33561,133872,129957,87337,180160,123208,56952,180160,262300,2019
48493,40.2,49173,28045,600,19513,12511,76692,15733,13275,2458,15733,199600,2019
48495,33.1,7867,2763,177,4796,1852,60366,2619,2085,534,2619,62700,2019
48497,38.3,66290,50878,845,12822,16853,64536,22369,17434,4935,22369,170300,2019
48499,47.9,44366,36584,2184,4435,11642,53394,16510,13243,3267,16510,137500,2019
48501,30.3,8631,2741,38,5736,1985,70005,2617,2042,575,2617,116400,2019
48503,41.1,18036,14052,379,3366,5178,50635,7307,5521,1786,7307,96800,2019
48505,29.5,14304,658,0,13501,3284,33952,4503,3366,1137,4503,77800,2019
48507,32.9,12039,611,40,11304,2881,34459,3571,2570,1001,3571,50000,2019
49001,33,6517,5496,0,780,1679,55221,2282,1692,590,2282,177600,2019
49003,32.6,53946,46930,311,5093,13775,62233,17569,13665,3904,17569,203600,2019
49005,25.2,124165,103848,920,13316,28857,59038,38393,24180,14213,38393,236500,2019
49007,37.5,20308,17365,86,2700,5334,51158,7829,5773,2056,7829,140800,2019
49009,42.5,613,597,1,13,126,75417,163,142,21,163,170800,2019
49011,31.1,345767,289872,4353,33434,84662,83310,104551,80518,24033,104551,290300,2019
49013,31.5,20148,17162,83,1650,5327,63224,6868,5161,1707,6868,185800,2019
49015,36.2,10117,9212,2,642,2736,55554,3665,2818,847,3665,140200,2019
49017,41.9,4998,4436,3,306,1287,54565,1760,1399,361,1760,188900,2019
49019,40.2,9640,7941,31,994,2700,51557,4191,2730,1461,4191,247800,2019
49021,29.1,51213,43966,269,4463,12353,51807,17015,10884,6131,17015,213600,2019
49023,30.1,11301,10348,26,590,2818,61463,3464,2721,743,3464,223000,2019
49025,41.9,7484,6827,1,350,1503,47044,2643,2046,597,2643,204900,2019
49027,35.4,12854,10669,21,1662,3419,62242,4337,3231,1106,4337,155000,2019
49029,32.2,11664,11076,90,338,2976,91341,3365,2871,494,3365,374800,2019
49031,44.5,1866,1805,3,47,379,42813,532,445,87,532,179500,2019
49033,34.3,2389,2133,0,256,497,57902,635,455,180,635,202500,2019
49035,32.8,1133646,805475,20448,208061,261996,74865,374820,251555,123265,374820,305700,2019
49037,32.2,15302,6705,23,870,3212,45394,4311,3476,835,4311,129700,2019
49039,32.6,29850,25657,215,2854,6628,53838,8643,6716,1927,8643,189000,2019
49041,35.4,21280,19514,129,1100,5566,54799,7364,5754,1610,7364,164800,2019
49043,39.5,41103,34656,326,4705,10695,102958,14220,11004,3216,14220,641900,2019
49045,31.4,67397,56030,286,8332,16412,74562,20478,16576,3902,20478,223400,2019
49047,30.6,36084,29455,143,3038,7655,65264,10569,8023,2546,10569,197000,2019
49049,24.8,605490,498471,3195,71315,134951,74665,165991,112291,53700,165991,305500,2019
49051,34,31708,26495,45,4232,7552,85166,9879,7209,2670,9879,419900,2019
49053,37.1,165811,139792,1081,17364,42374,59839,57144,40230,16914,57144,283800,2019
49055,40.4,2689,2440,6,168,674,44245,1000,739,261,1000,205700,2019
49057,32.7,251498,191274,2474,46159,61040,67244,83632,61395,22237,83632,220600,2019
50001,43.5,36882,34133,446,852,9250,68825,14584,11084,3500,14584,249700,2019
50003,46.7,35746,33643,198,717,9009,56183,14581,10794,3787,14581,207600,2019
50005,44.7,30234,28674,240,483,7658,50563,12434,9086,3348,12434,169500,2019
50007,36.5,162646,143961,4206,3813,37467,73647,66160,41263,24897,66160,297900,2019
50009,50.9,6200,5912,61,86,1714,44349,2740,2226,514,2740,136600,2019
50011,40.4,49116,46109,261,774,12476,65485,18563,13998,4565,18563,216200,2019
50013,48.2,7022,6517,58,140,2015,71587,2956,2484,472,2956,274800,2019
50015,40.8,25318,23931,221,455,6597,64003,10546,7715,2831,10546,225600,2019
50017,46.6,28908,27627,200,386,7676,60925,12279,9882,2397,12279,192700,2019
50019,45.8,26901,25575,150,405,7517,49168,11779,9209,2570,11779,162000,2019
50021,46.5,58892,56122,504,864,14737,56139,25338,18100,7238,25338,177400,2019
50023,43.7,58350,54957,494,1135,14934,62791,24828,17489,7339,24828,226900,2019
50025,47.6,42823,39863,467,999,10721,51985,18943,12742,6201,18943,214200,2019
50027,48,55275,52316,395,929,14613,60987,24298,17927,6371,24298,224500,2019
51001,45.9,32673,19613,9331,2929,8922,46073,13438,8977,4461,13438,171800,2019
51003,39.1,107405,82656,10170,6200,25969,79880,41496,26265,15231,41496,356100,2019
51005,48.1,15157,13863,881,225,4233,47673,6600,5032,1568,6600,119700,2019
51007,45.1,12953,9533,2745,390,3454,57946,4954,4181,773,4954,201400,2019
51009,44.8,31775,23733,5692,766,8301,52888,12160,9378,2782,12160,155600,2019
51011,42.6,15707,12052,3095,260,4526,58696,6091,4737,1354,6091,158800,2019
51013,34.7,233464,143563,20740,36375,49266,120071,107032,45752,61280,107032,705400,2019
51015,45.1,75079,68122,3107,2118,20957,62711,29539,23430,6109,29539,214000,2019
51017,47.8,4307,3841,130,159,1100,49738,1801,1357,444,1801,165300,2019
51019,46.3,78376,68746,5384,1720,22598,64199,31317,25712,5605,31317,201900,2019
51021,46.4,6388,5996,238,81,1729,48531,2367,1927,440,2367,113200,2019
51023,47.2,33343,30970,988,568,9638,71110,13264,11447,1817,13264,227700,2019
51025,43.3,16520,6731,8945,370,3752,44434,6037,4268,1769,6037,112200,2019
51027,46.8,21788,20666,588,106,5773,31956,8569,6625,1944,8569,72300,2019
51029,43.5,17059,10438,5829,411,3944,49025,5826,4381,1445,5826,130300,2019
51031,43,55225,43941,7728,1394,15226,49664,23071,17242,5829,23071,157000,2019
51033,40.1,30381,19206,8138,1466,7829,65103,10946,8669,2277,10946,206000,2019
51035,47.6,29801,28163,163,1053,8159,44835,12357,9674,2683,12357,112900,2019
51036,50.8,7014,2970,3166,131,1882,57198,2896,2430,466,2896,167900,2019
51037,46.2,12040,8172,3371,260,2934,40573,4661,3322,1339,4661,111900,2019
51041,38.9,343551,212269,78119,30350,91182,82599,124971,94698,30273,124971,241200,2019
51043,47,14423,12422,774,803,3895,80026,5612,4209,1403,5612,347200,2019
51045,46.3,5110,5040,5,2,1439,55708,2297,1756,541,2297,165800,2019
51047,39.2,51101,35903,7084,5476,12650,77935,17071,12412,4659,17071,298900,2019
51049,45.6,9824,6223,2945,92,2591,47469,3975,2936,1039,3975,146000,2019
51051,44.7,14756,14401,84,134,3819,29932,5778,4374,1404,5778,81000,2019
51053,43.2,28485,17619,9064,991,7064,60346,10401,8027,2374,10401,168300,2019
51057,46.3,10998,6032,4319,396,2974,51954,4555,3056,1499,4555,202800,2019
51059,38,1145862,581418,108685,187160,283315,124831,396501,269528,126973,396501,563100,2019
51061,41.3,69728,55749,5125,5791,18018,100783,24562,19229,5333,24562,395500,2019
51063,47.2,15704,14640,240,462,4481,51521,6493,5267,1226,6493,170700,2019
51065,43.4,26594,20789,3780,937,7099,76873,9923,8432,1491,9923,234700,2019
51067,47.2,56187,48995,4184,1566,16312,56254,22997,18798,4199,22997,178100,2019
51069,40.7,86415,72104,3348,7428,23602,78002,31503,24450,7053,31503,251200,2019
51071,44.7,16772,15921,361,293,4463,54520,6910,5187,1723,6910,123200,2019
51073,44.9,37222,31586,3280,1330,10466,70537,14786,11569,3217,14786,230000,2019
51075,48.3,22865,17776,3627,651,6132,93994,8506,7220,1286,8506,375200,2019
51077,48.1,15742,14117,866,543,4144,36544,6498,5282,1216,6498,102900,2019
51079,39.6,19519,16130,1022,1142,5321,67398,7548,5857,1691,7548,236400,2019
51081,40.7,11525,4192,6765,292,2367,50300,3647,2673,974,3647,117700,2019
51083,46.5,34552,20637,11942,714,9229,42669,14158,10494,3664,14158,116100,2019
51085,42.7,105537,88462,9424,3144,29128,89390,38987,32174,6813,38987,282900,2019
51087,38.8,327535,173865,96465,18496,80847,70307,128464,80489,47975,128464,242600,2019
51089,47.6,51308,35831,11395,2823,12944,37952,21218,15262,5956,21218,93900,2019
51091,60.9,2204,2189,0,0,713,48587,1078,894,184,1078,173900,2019
51093,44.3,36627,25885,8126,1118,10289,73991,14587,11055,3532,14587,266800,2019
51095,46.5,74916,56627,9664,4316,20700,87678,28920,22093,6827,28920,340500,2019
51097,46.7,7042,4659,1843,226,1693,63982,2707,2261,446,2707,183200,2019
51099,37.4,26229,19258,4261,1406,6933,94274,9202,7247,1955,9202,307900,2019
51101,40.3,16688,12811,2682,442,4714,66987,6078,5310,768,6078,204300,2019
51103,57.3,10724,7237,3305,67,3189,53711,5062,3840,1222,5062,257200,2019
51105,44.9,23948,22247,933,473,5849,32888,9149,6477,2672,9149,88100,2019
51107,36.2,395134,221708,28667,53812,100405,142299,128637,100400,28237,128637,508100,2019
51109,44.8,36040,28126,5304,1059,9686,60975,13871,11103,2768,13871,223100,2019
51111,45.3,12282,7296,3820,609,3031,44303,4293,3082,1211,4293,119500,2019
51113,45.6,13170,11148,1087,381,3530,57895,4949,3685,1264,4949,257900,2019
51115,54.5,8788,7532,777,222,2451,64237,3920,3331,589,3920,226300,2019
51117,48.4,30728,18439,10869,911,7706,43207,12075,8580,3495,12075,132600,2019
51119,53.9,10675,8278,1485,133,2810,57438,4603,3621,982,4603,261900,2019
51121,29,98140,81718,4286,3182,19622,57977,35685,19758,15927,35685,227100,2019
51125,51.4,14831,12025,1902,618,4521,64313,6419,4904,1515,6419,235000,2019
51127,43.3,21686,17121,2598,716,6123,87904,7961,6886,1075,7961,281100,2019
51131,49,11885,6445,3932,1043,3111,47227,5148,3356,1792,5148,176800,2019
51133,58.9,12190,8499,3331,106,3711,62632,5584,4981,603,5584,292600,2019
51135,40.6,15433,8383,6185,681,3672,45535,5446,3522,1924,5446,151400,2019
51137,42,36010,28117,4577,1801,9483,71548,13679,10777,2902,13679,244400,2019
51139,45.4,23788,22376,327,479,6378,51792,9286,6600,2686,9286,169200,2019
51141,49.9,17748,15921,1051,542,5022,43073,7755,6124,1631,7755,120000,2019
51143,47.2,61256,45367,12244,1612,18470,47690,26267,19800,6467,26267,123900,2019
51145,45.1,28815,24704,2895,631,8027,89090,10265,9253,1012,10265,279200,2019
51147,31.5,22905,14074,7046,954,4357,47202,7185,4625,2560,7185,159700,2019
51149,37,38114,20912,11821,3096,8324,71912,11507,7774,3733,11507,213300,2019
51153,35.2,461423,198161,93876,108408,109629,107132,142000,104061,37939,142000,382400,2019
51155,47,34182,31029,1485,604,9489,53866,14533,10370,4163,14533,149500,2019
51157,50.1,7378,6525,335,287,1918,74284,2913,2162,751,2913,377700,2019
51159,47.3,8884,5380,2356,633,2123,49517,3069,2146,923,3069,180300,2019
51161,43.8,93823,80507,5553,2907,25821,68948,38222,28591,9631,38222,199800,2019
51163,49,22570,20805,737,430,6217,54600,9248,6958,2290,9248,199600,2019
51165,41.5,80284,71197,1869,5567,22059,61864,30994,23080,7914,30994,211500,2019
51167,45.7,27141,26248,274,317,7045,39758,10812,8232,2580,10812,98000,2019
51169,47.3,21902,21163,127,302,5494,39820,8773,6787,1986,8773,94800,2019
51171,44.5,43224,37870,770,3120,11350,57252,17402,12344,5058,17402,213200,2019
51173,45,30767,28960,645,612,8416,40932,12686,9070,3616,12686,95800,2019
51175,46.9,17880,10913,5703,301,4719,61348,6562,4910,1652,6562,178500,2019
51177,38.2,132833,90457,20816,12965,33791,88628,44436,34700,9736,44436,284000,2019
51179,35.5,146773,90361,25263,19008,37946,111108,47075,36427,10648,47075,346100,2019
51181,49.8,6523,3432,2897,41,1911,57962,2730,2028,702,2730,197800,2019
51183,41,11377,4360,6248,344,2510,49487,3794,2624,1170,3794,125800,2019
51185,45.2,41603,39081,1286,424,11106,42099,16531,12320,4211,16531,99700,2019
51187,41.3,39492,34266,1669,1811,10025,69116,14651,11243,3408,14651,244800,2019
51191,46.3,54071,51546,700,821,14844,48495,22321,16780,5541,22321,151800,2019
51193,48.6,17751,11346,4598,1147,4757,53853,7923,5796,2127,7923,199100,2019
51195,41.4,38486,35201,2035,477,9910,38888,14925,9946,4979,14925,85500,2019
51197,45.3,28844,27055,837,361,7953,49364,11983,9343,2640,11983,128400,2019
51199,39.6,67982,48071,8735,4372,18922,92069,25103,17896,7207,25103,327100,2019
51510,36.8,157613,81852,33334,26309,34502,100939,70598,30553,40045,70598,572900,2019
51520,42.2,16912,14908,964,391,4232,37500,7334,4429,2905,7334,111700,2019
51530,35.5,6484,5714,472,117,1751,32455,2517,1711,806,2517,126600,2019
51540,31.6,47096,30961,8793,2589,8467,59471,18617,7977,10640,18617,299600,2019
51550,36.9,239982,137813,70328,14824,63243,78640,84849,60540,24309,84849,273700,2019
51570,40.6,17428,12604,2552,1023,4444,54550,7036,4426,2610,7036,171700,2019
51580,42.4,5598,4534,699,133,1460,40655,2384,1775,609,2384,72900,2019
51590,40.9,41070,17409,20026,1773,10402,37203,18293,9420,8873,18293,90500,2019
51595,35.4,5442,1331,3420,370,1333,27063,2086,837,1249,2086,116800,2019
51600,38.2,23531,13228,1157,4043,5916,116979,8577,6004,2573,8577,560400,2019
51610,38.7,14128,10135,656,1507,3606,127610,5493,3204,2289,5493,789300,2019
51620,39.4,8147,3003,4618,90,2147,40417,3522,1816,1706,3522,164100,2019
51630,30.4,28622,17006,5911,3056,5626,65641,10762,3817,6945,10762,367200,2019
51640,45,6517,5154,324,945,1696,33575,2663,1814,849,2663,96600,2019
51650,36.2,135041,51544,66430,7783,32261,56287,54050,30123,23927,54050,186700,2019
51660,25.4,53273,35233,3453,10518,9007,46679,16723,6621,10102,16723,203600,2019
51670,36.2,22456,10434,9478,1781,5767,39030,9224,4312,4912,9224,122900,2019
51678,22.3,7241,5729,628,443,869,42632,2158,1131,1027,2158,235700,2019
51680,28.3,80569,50230,22848,3361,16201,46409,28273,13774,14499,28273,160100,2019
51683,34.2,41174,16810,5438,15086,9469,81493,12898,8530,4368,12898,324600,2019
51685,34.7,16986,5621,2170,6749,3277,88046,4641,3059,1582,4641,308000,2019
51690,40.9,12852,5654,5714,727,3275,34371,5532,3093,2439,5532,87700,2019
51700,33.5,179673,77111,71803,16142,42203,53215,69835,34160,35675,69835,194000,2019
51710,30.7,244601,106261,99087,19672,50487,51590,88353,38339,50014,88353,206700,2019
51720,37.5,3970,3517,122,48,968,29000,1628,815,813,1628,93800,2019
51730,38.1,31362,4726,23926,1536,6644,38679,13165,5112,8053,13165,108100,2019
51735,42.4,12090,11055,136,338,3481,97118,4593,3740,853,4593,323100,2019
51740,35.3,95097,35818,49678,4242,21208,52175,36370,19999,16371,36370,170900,2019
51750,23.4,17691,14735,1734,513,2359,36297,5573,2596,2977,5573,170800,2019
51760,34,226622,92454,105557,15661,39981,47250,90301,38494,51807,90301,230500,2019
51770,38.5,99229,58052,27844,6223,22495,44230,41740,21479,20261,41740,135100,2019
51775,41.2,25317,21593,1661,834,6152,57165,9912,6302,3610,9912,181900,2019
51790,42.8,24432,19805,2677,760,6038,52611,10597,6072,4525,10597,169000,2019
51800,38,90093,44415,36981,3937,24732,74884,33774,23218,10556,33774,254400,2019
51810,36.2,450201,277823,82934,36785,116809,76610,170798,108815,61983,170798,280800,2019
51820,39.2,22140,16635,2970,1788,5064,45011,9193,5304,3889,9193,174100,2019
51830,24.9,14927,10109,2246,1053,2196,57463,4706,2320,2386,4706,306000,2019
51840,38.1,27897,18421,2793,4958,6017,58818,10490,4642,5848,10490,244900,2019
53001,27.9,19594,6626,83,12458,4571,48294,5973,3771,2202,5973,154500,2019
53003,45,22421,20262,113,900,5638,53715,9101,6433,2668,9101,198100,2019
53005,35.8,197518,139090,2808,42849,49394,69023,72121,49637,22484,72121,235800,2019
53007,40.1,76229,51816,418,21297,18695,58795,28384,18286,10098,28384,292900,2019
53009,50.8,75392,62409,739,4781,20311,52192,32958,23198,9760,32958,253800,2019
53011,38.4,473252,371450,7874,45528,121925,75253,174661,116975,57686,174661,327000,2019
53013,50.2,3992,3409,36,311,1083,53423,1795,1219,576,1795,179400,2019
53015,41.3,106778,89301,758,9583,27470,54506,41952,27719,14233,41952,219300,2019
53017,37.1,42023,26961,189,13281,11191,62951,15263,10486,4777,15263,271500,2019
53019,50.3,7578,5548,10,359,1947,41939,3060,2203,857,3060,169600,2019
53021,30.3,92009,37140,1693,48843,20450,63584,26723,18295,8428,26723,202400,2019
53023,46.1,2230,1995,0,42,654,55900,984,704,280,984,149400,2019
53025,32.9,95502,51547,806,39700,22082,55556,30818,19264,11554,30818,177500,2019
53027,44,72779,57795,813,7246,18114,51240,28722,19254,9468,28722,178800,2019
53029,44.2,82866,65595,2520,6413,23642,68604,34768,24847,9921,34768,358800,2019
53031,58.3,31285,27651,178,1147,8897,55127,14705,10919,3786,14705,338000,2019
53033,37,2195502,1308660,137919,212241,529563,94974,882028,502293,379735,882028,549200,2019
53035,39.1,265882,203899,6821,20652,69823,75411,103913,70456,33457,103913,329900,2019
53037,33.8,45897,38591,410,4045,9929,56004,18347,10849,7498,18347,286900,2019
53039,46.9,21721,17847,159,2605,5640,55773,8877,6037,2840,8877,261000,2019
53041,43.1,78145,65164,349,8000,20037,53484,30618,21630,8988,30618,209600,2019
53043,48.4,10574,9657,78,357,3194,54631,4525,3528,997,4525,162800,2019
53045,45.6,63804,51382,660,6365,15821,57634,24278,18787,5491,24278,226500,2019
53047,42.6,41842,27152,170,8413,11878,47240,17675,11623,6052,17675,182700,2019
53049,53.6,21688,17754,76,2122,5720,46733,9279,7420,1859,9279,176800,2019
53051,51,13377,11832,49,515,3871,50591,5727,4461,1266,5727,216700,2019
53053,36.1,877013,585478,57136,95327,216606,72113,323296,200836,122460,323296,303200,2019
53055,56.6,16788,14848,119,1082,5021,63622,8252,6154,2098,8252,488800,2019
53057,41.5,125612,93444,874,23097,32797,67028,48493,33255,15238,48493,306000,2019
53059,46.6,11753,10307,58,745,3398,65181,4816,3588,1228,4816,296700,2019
53061,38,798808,555736,23452,81495,203116,86691,293823,197136,96687,293823,403000,2019
53063,37.6,505505,427467,8207,28970,127598,56904,202811,126536,76275,202811,224800,2019
53065,46.9,44655,38672,182,1658,11941,51775,17554,13715,3839,17554,199200,2019
53067,39,279711,209670,8418,25004,72966,72003,109983,71908,38075,109983,287900,2019
53069,55.1,4268,3702,54,294,1324,53227,1897,1645,252,1897,218800,2019
53071,37.5,60365,43265,1028,12874,14678,57858,22646,14677,7969,22646,224800,2019
53073,37.3,220821,174278,2051,20805,52114,62984,86523,53580,32943,86523,345700,2019
53075,24.7,49231,38688,1052,3106,8731,42745,17999,7853,10146,17999,217600,2019
53077,33,249697,107857,2344,123069,60124,51637,83048,52062,30986,83048,175900,2019
54001,41.7,16633,15879,146,155,4059,38459,6324,4556,1768,6324,110300,2019
54003,38.8,115329,96756,8533,5078,30145,62515,44221,33000,11221,44221,182200,2019
54005,43.5,22368,21841,218,89,6147,40739,8932,6841,2091,8932,71500,2019
54007,45.9,14190,13742,106,31,4077,41466,5624,4537,1087,5624,86400,2019
54009,46.6,22459,21467,372,201,6277,51496,9805,7469,2336,9805,93200,2019
54011,38.8,94339,84759,4587,1324,21469,40028,39064,24143,14921,39064,124500,2019
54013,48.1,7295,7087,3,136,1955,38382,2826,2229,597,2826,83500,2019
54015,44.1,8709,8643,1,15,2288,35024,3274,2666,608,3274,80200,2019
54017,45.3,8560,8148,126,49,1914,45545,2685,2354,331,2685,117300,2019
54019,44.3,43576,40285,2274,505,11707,41394,17441,13476,3965,17441,91300,2019
54021,39.2,8041,6553,966,330,1671,42636,2587,1783,804,2587,93300,2019
54023,46.2,11616,11215,181,86,2884,42216,4607,3757,850,4607,140000,2019
54025,45.5,35155,32426,991,697,9368,40200,15188,11010,4178,15188,124000,2019
54027,47.2,23309,22313,245,340,6139,47857,9288,7087,2201,9288,153100,2019
54029,46.8,29383,27548,548,460,7526,45763,12678,9216,3462,12678,93000,2019
54031,45.7,13805,12420,768,216,4112,47438,5674,4189,1485,5674,137700,2019
54033,42.2,67908,63951,1047,1123,17751,53022,27098,20035,7063,27098,117900,2019
54035,43.7,28907,28022,109,197,7781,47837,11334,8697,2637,11334,130600,2019
54037,41.1,56506,47020,3460,3242,14775,80430,20891,15968,4923,20891,252300,2019
54039,43.4,183279,160768,13069,2037,48498,46639,79070,54611,24459,79070,112500,2019
54041,43.8,16166,15571,29,200,4375,39908,6574,4701,1873,6574,104200,2019
54043,43.2,20850,20383,39,145,5921,42345,8208,6387,1821,8208,84200,2019
54045,43.8,33154,31805,556,311,9623,36168,13816,10037,3779,13816,89100,2019
54047,45,18661,16552,1551,271,5216,27682,7607,5985,1622,7607,35000,2019
54049,41.1,56355,52118,1968,733,15017,50305,22926,17108,5818,22926,116800,2019
54051,45.7,31308,30266,270,312,8021,48557,12308,9860,2448,12308,109300,2019
54053,44.2,26820,25912,112,194,7612,46078,11034,8768,2266,11034,87600,2019
54055,43.1,59919,54103,3710,706,16346,40784,25216,17529,7687,25216,96700,2019
54057,44.5,27167,25534,907,250,7263,49936,10916,8299,2617,10916,148200,2019
54059,42.8,24290,23258,568,0,6950,32764,10501,7723,2778,10501,78100,2019
54061,31.7,105474,92744,3781,2246,20735,52455,39466,22404,17062,39466,204400,2019
54063,48,13401,12903,125,124,3645,38540,5718,4499,1219,5718,107900,2019
54065,47.9,17709,16871,193,69,4910,51745,7185,5983,1202,7185,183200,2019
54067,45.1,25078,24311,170,205,7064,40086,10069,7998,2071,10069,95100,2019
54069,43.6,42143,38819,1641,487,9862,50584,17193,12002,5191,17193,123900,2019
54071,50.8,7001,6632,233,57,2100,42312,3174,2555,619,3174,122800,2019
54073,43.6,7482,7171,21,220,2057,56838,2835,2339,496,2835,106600,2019
54075,49.1,8450,8290,37,49,2181,41882,3530,2881,649,3530,121700,2019
54077,42.7,33683,30509,1675,849,8589,51888,12429,10301,2128,12429,115300,2019
54079,41.8,56610,54038,789,662,15754,60097,21613,17690,3923,21613,167300,2019
54081,42.2,75252,65521,5772,1235,21135,43748,31203,22893,8310,31203,108700,2019
54083,43.7,28930,27710,616,279,6923,43320,11135,7965,3170,11135,110300,2019
54085,46.8,9844,9535,27,70,2802,43577,4049,3232,817,4049,96700,2019
54087,45.8,14020,13577,9,160,3670,37373,5562,4409,1153,5562,98900,2019
54089,49.1,12848,11805,576,190,3686,38187,5566,4243,1323,5566,92200,2019
54091,44.1,16864,16102,217,171,4364,48578,6614,5156,1458,6614,107000,2019
54093,49.3,6982,6791,17,24,2041,49118,3142,2467,675,3142,121600,2019
54095,47,8811,8588,32,31,2046,43087,3207,2653,554,3207,96300,2019
54097,41.7,24502,23500,452,334,6357,40322,9713,7157,2556,9713,119000,2019
54099,44.1,40303,39218,347,264,9959,37988,15124,11110,4014,15124,99100,2019
54101,47.2,8386,8352,2,5,2546,34927,3781,2744,1037,3781,69500,2019
54103,46,15436,14961,164,132,3685,43107,5762,4577,1185,5762,103600,2019
54105,45.4,5798,5735,26,27,1630,46048,2505,2096,409,2505,95800,2019
54107,43.5,84960,80844,1204,978,22613,47321,35488,25366,10122,35488,124200,2019
54109,44.6,21281,20674,262,67,6615,42332,8805,7412,1393,8805,71500,2019
55001,53.8,20094,18174,552,791,5624,46369,9062,7548,1514,9062,131100,2019
55003,42,15617,12863,116,450,3860,42510,6565,4483,2082,6565,113100,2019
55005,44.2,45229,42199,688,1129,12200,52703,18907,14130,4777,18907,153200,2019
55007,52.2,14993,12679,124,300,4598,56096,7057,5872,1185,7057,170200,2019
55009,37.4,261368,211283,6193,22502,67225,62340,105271,68260,37011,105271,173900,2019
55011,46.6,13126,12562,95,283,3811,57829,5772,4407,1365,5772,159700,2019
55013,52.8,15289,13816,85,285,4755,52672,7305,6005,1300,7305,158800,2019
55015,40.6,49928,45391,420,2144,14659,75814,19807,15973,3834,19807,178900,2019
55017,41.2,63892,59777,1001,1140,17210,59742,25601,18717,6884,25601,167400,2019
55019,37.4,34579,32179,98,1622,8724,54012,12791,10030,2761,12791,127200,2019
55021,42.4,57133,52927,763,1941,15944,68005,24112,17933,6179,24112,192900,2019
55023,46.3,16235,15322,310,250,4197,50595,6654,5038,1616,6654,134200,2019
55025,35.1,536078,426331,27162,34059,126193,73893,222929,129740,93189,222929,265600,2019
55027,42.5,87715,78853,2441,4202,23038,60652,34980,24396,10584,34980,162100,2019
55029,53,27472,25777,177,859,9081,61560,13191,10538,2653,13191,214100,2019
55031,42.2,43295,39667,605,697,11470,53986,19011,12837,6174,19011,145800,2019
55033,34.7,44759,41508,278,848,10369,58783,16859,11491,5368,16859,165200,2019
55035,34.5,103514,93151,1228,2572,23610,59476,40981,26419,14562,40981,169400,2019
55037,53.6,4314,4187,13,59,1287,52181,1948,1680,268,1948,129600,2019
55039,41.6,102597,91936,1441,5284,27231,62391,41542,29192,12350,41542,157800,2019
55041,46.7,8995,7107,77,225,2545,45536,4008,3053,955,4008,132300,2019
55043,36,51733,49170,766,868,12039,54800,19583,13779,5804,19583,147700,2019
55045,43.2,36896,34795,214,1127,9873,64502,15047,11300,3747,15047,171400,2019
55047,45.3,18755,17305,107,923,5116,55075,7979,6073,1906,7979,146600,2019
55049,42.8,23618,22503,211,424,6485,64124,9850,7274,2576,9850,183200,2019
55051,54.9,5687,5426,7,78,1660,43798,2898,2247,651,2898,119000,2019
55053,41.7,20522,17666,417,709,5083,53650,8199,6059,2140,8199,135900,2019
55055,41.1,84701,75897,621,5992,22598,66291,32965,23126,9839,32965,190400,2019
55057,45.4,26478,24244,600,817,6737,53490,10752,8197,2555,10752,125800,2019
55059,38.5,168524,127788,12174,22028,41856,63733,64111,42370,21741,64111,177400,2019
55061,44.3,20387,19255,148,618,5713,66192,8341,6615,1726,8341,164900,2019
55063,35.9,117894,105928,1803,2265,27502,57882,47518,29949,17569,47518,173300,2019
55065,41.8,16715,15728,101,652,4549,60691,6722,5138,1584,6722,140000,2019
55067,48.7,19146,17965,240,378,5428,49491,8612,6639,1973,8612,113900,2019
55069,47.7,27744,26467,200,439,8117,58541,12625,9858,2767,12625,139700,2019
55071,44.9,79185,71684,772,3178,21542,56612,34563,26046,8517,34563,130100,2019
55073,40.7,135396,120059,769,3777,37129,62633,55466,40048,15418,55466,156300,2019
55075,48.7,40391,38477,297,706,11254,50330,18473,13800,4673,18473,123800,2019
55077,50,15304,14276,104,520,4156,52288,6648,5412,1236,6648,155300,2019
55078,32,4558,459,13,276,1039,40921,1408,958,450,1408,101800,2019
55079,34.9,951226,487394,247854,142731,213613,50606,382175,189054,193121,382175,158300,2019
55081,39.9,45771,41425,802,2102,11528,59587,17915,12487,5428,17915,155000,2019
55083,46.9,37646,35748,161,673,10881,60908,16036,13263,2773,16036,157000,2019
55085,51.3,35381,33560,227,546,9606,56852,15421,12831,2590,15421,174100,2019
55087,38.3,185700,162546,2589,7997,48425,65572,73648,52389,21259,73648,169400,2019
55089,44,88597,81042,1068,2606,25228,85215,35807,27162,8645,35807,282500,2019
55091,46.4,7265,7003,21,135,2003,54583,3070,2450,620,3070,151600,2019
55093,36.8,41977,39502,212,902,10156,72323,15593,11260,4333,15593,208700,2019
55095,45.6,43438,41263,176,825,12303,59994,18450,14556,3894,18450,169700,2019
55097,37,70632,64303,562,2272,17382,58853,28675,19794,8881,28675,168100,2019
55099,51.6,13416,12620,112,238,4077,47956,6688,5206,1482,6688,122500,2019
55101,40.2,195602,140742,21610,25637,51944,61336,76974,52019,24955,76974,176000,2019
55103,45.3,17459,16515,153,405,4807,51947,7538,5633,1905,7538,139900,2019
55105,39.5,162152,134318,6996,14107,41435,57875,64739,44254,20485,64739,146200,2019
55107,49,14132,13386,90,270,3995,47532,6376,5046,1330,6376,113400,2019
55109,38.9,88732,83326,710,2134,24389,84756,34182,26243,7939,34182,244500,2019
55111,41.1,63922,58075,522,3281,17152,59943,26222,18063,8159,26222,182200,2019
55113,50.3,16399,12576,42,449,5129,47714,7796,5769,2027,7796,168400,2019
55115,45.2,40904,35442,164,1146,11147,56531,17004,13137,3867,17004,136700,2019
55117,41.5,115178,97016,2216,7334,30705,60696,47738,33398,14340,47738,159700,2019
55119,43.7,20325,19486,50,422,5862,53020,8614,6601,2013,8614,137800,2019
55121,40.5,29499,26409,150,2479,7688,58548,12005,8762,3243,12005,156000,2019
55123,41.7,30633,29485,96,484,8062,52459,12071,9387,2684,12071,157200,2019
55125,54.6,21751,18445,70,566,6898,47072,10921,8482,2439,10921,202900,2019
55127,40,103074,88064,908,11431,26902,63776,40874,28044,12830,40874,203400,2019
55129,51.2,15688,14774,45,289,4683,50280,7236,5791,1445,7236,157400,2019
55131,43.2,134925,125286,1766,4270,37957,77663,54302,42104,12198,54302,236200,2019
55133,43.2,400475,354614,6286,18901,110423,87277,158808,121146,37662,158808,282300,2019
55135,45.5,51245,48307,307,1606,13966,58693,22305,16430,5875,22305,149900,2019
55137,49.2,24193,21631,342,1541,6725,52810,9934,8110,1824,9934,146100,2019
55139,38.3,170411,151076,3809,7017,41769,58543,70594,46039,24555,70594,152500,2019
55141,44.1,73112,67439,513,2179,19866,54913,32332,23399,8933,32332,131900,2019
56001,27.6,38390,31665,575,3658,7578,49322,15944,8138,7806,15944,235000,2019
56003,41.6,11882,10426,52,1066,3006,52804,4475,3276,1199,4475,163400,2019
56005,34,47409,41384,169,4110,12381,82659,17574,12900,4674,17574,222700,2019
56007,38.6,15247,11774,163,2778,4056,60161,6204,4317,1887,6204,174900,2019
56009,40,13921,12346,0,1128,3769,69647,5378,3964,1414,5378,206700,2019
56011,42.7,7472,7045,10,105,2006,65132,2919,2387,532,2919,225300,2019
56013,38.7,39812,27759,213,2758,9658,55896,14907,10503,4404,14907,196400,2019
56015,44.1,13342,11453,41,1413,3572,54289,5207,3836,1371,5207,174000,2019
56017,46.6,4607,4265,0,175,1364,51413,2118,1593,525,2118,147300,2019
56019,45.4,8487,7762,49,232,2499,58132,3845,2687,1158,3845,252900,2019
56021,37,98320,77521,1953,14379,26272,66910,39683,27692,11991,39683,227900,2019
56023,39.7,19274,17766,9,881,4695,66964,6908,5693,1215,6908,246400,2019
56025,36.9,80333,69640,864,6787,20529,62772,32799,22363,10436,32799,208700,2019
56027,45.5,2422,2195,14,95,601,39150,964,747,217,964,156300,2019
56029,44.5,29148,26539,196,1586,8166,63582,12160,8897,3263,12160,268500,2019
56031,49.2,8582,7595,1,698,2635,50903,4030,3013,1017,4030,188500,2019
56033,42.3,30140,27633,65,1272,8118,60807,13251,9117,4134,13251,272400,2019
56035,39.4,9880,8820,0,721,2281,77403,3340,2741,599,3340,275100,2019
56037,35.3,43521,34624,488,6913,10794,74843,15523,11832,3691,15523,205600,2019
56039,39.3,23280,18935,289,3498,5190,84678,9019,5448,3571,9019,866600,2019
56041,35.8,20479,17923,23,1870,5313,63403,7597,5854,1743,7597,175000,2019
56043,42.9,8027,6574,3,1142,2191,54158,3365,2574,791,3365,165800,2019
56045,43.1,7049,6793,16,76,1978,57031,2891,2400,491,2891,166300,2019
72001,42.1,17891,53,0,17830,4171,14012,5771,3425,2346,5771,83700,2019
72003,42.9,37954,2551,18,35100,9406,16738,12830,9593,3237,12830,85300,2019
72005,42,52803,825,87,51527,14666,16269,21635,12933,8702,21635,118200,2019
72007,42.2,25748,89,0,25659,6206,19279,8488,5600,2888,8488,116200,2019
72009,42.5,22988,41,0,22904,6181,20521,8592,6710,1882,8592,112600,2019
72011,42.6,26934,1173,0,25616,6309,19919,8848,6811,2037,8848,87600,2019
72013,42.8,85390,516,40,84707,21988,18647,31910,21134,10776,31910,95300,2019
72015,40.3,17805,27,0,17778,4175,17570,5908,4640,1268,5908,89400,2019
72017,40.6,24079,65,0,23959,5649,17154,7989,5721,2268,7989,104600,2019
72019,36.7,28393,34,0,28359,6599,17036,8720,6411,2309,8720,98900,2019
72021,42.1,178192,1193,253,176310,46245,26420,67476,45993,21483,67476,131700,2019
72023,44.1,48487,136,0,48301,10242,16708,15473,10007,5466,15473,107500,2019
72025,41.3,128937,1381,87,127119,32586,25136,48184,32936,15248,48184,127800,2019
72027,42.2,31598,326,23,31249,8209,17000,11394,8254,3140,11394,94400,2019
72029,40.2,45588,30,16,45490,10397,21267,14643,10792,3851,14643,107500,2019
72031,42.8,153779,1080,250,151965,40435,29059,61909,43391,18518,61909,139900,2019
72033,40.3,24271,218,0,24026,6014,17448,8706,5243,3463,8706,117700,2019
72035,42.8,43785,148,0,43521,11437,22518,16213,10290,5923,16213,117200,2019
72037,42.9,11515,136,13,11330,2772,18309,4224,3027,1197,4224,92000,2019
72039,42.3,16513,142,0,16371,4430,16867,5831,4075,1756,5831,88600,2019
72041,40.9,39607,136,61,39346,9339,19726,12942,8596,4346,12942,117100,2019
72043,41.7,38906,244,11,38650,9004,19692,13104,10121,2983,13104,90700,2019
72045,38.9,19224,100,0,19109,3759,13733,5565,3106,2459,5565,93500,2019
72047,39.6,33500,315,0,33153,7971,15140,10535,7992,2543,10535,92100,2019
72049,43.1,1311,97,0,1198,248,23333,482,295,187,482,143800,2019
72051,41.1,36803,773,0,35994,8409,30732,11602,8973,2629,11602,135500,2019
72053,41.8,31111,108,61,30812,8229,19430,12298,8080,4218,12298,101900,2019
72054,39.9,11697,133,0,11564,3314,20442,4271,3098,1173,4271,92900,2019
72055,42.5,16293,133,0,16127,3425,12995,5515,3916,1599,5515,88100,2019
72057,39.1,40889,315,79,40469,9115,17261,14022,10223,3799,14022,86300,2019
72059,41.3,18514,82,0,18403,4816,17379,6510,4676,1834,6510,79700,2019
72061,44.2,86937,1104,111,85548,20290,35928,30758,22029,8729,30758,178200,2019
72063,39,46910,915,256,45436,10706,35018,14529,11952,2577,14529,141200,2019
72065,42.1,39950,78,31,39803,10415,17715,14160,10516,3644,14160,93000,2019
72067,47.2,15943,21,6,15916,4028,19030,6255,4580,1675,6255,98700,2019
72069,43.3,52507,342,23,51960,11896,20434,17615,12709,4906,17615,96000,2019
72071,42.2,41707,355,77,41122,10334,16540,14670,9337,5333,14670,102200,2019
72073,38.6,14539,48,0,14491,3680,14808,4837,2798,2039,4837,94100,2019
72075,38.8,46152,81,6,46057,11457,20657,15408,11033,4375,15408,91600,2019
72077,38.6,38780,240,0,38519,8880,19605,12558,8961,3597,12558,104300,2019
72079,45,22835,121,0,22552,5152,13992,7665,4602,3063,7665,86900,2019
72081,43,25696,64,0,25560,7448,16532,9967,6318,3649,9967,86000,2019
72083,42.4,8370,35,0,8335,1903,14135,2708,1940,768,2708,84800,2019
72085,40,37499,25,43,37395,9166,21667,12376,9677,2699,12376,114200,2019
72087,40.2,25778,14,20,25704,6044,17852,8508,6000,2508,8508,100800,2019
72089,41.9,18224,165,8,17992,4553,21850,6582,4684,1898,6582,111200,2019
72091,42.1,38836,541,124,37985,10584,18502,14825,10877,3948,14825,106100,2019
72093,44,6075,54,0,6021,1347,12441,1846,1370,476,1846,79700,2019
72095,44.4,10776,125,0,10651,2804,20844,3833,2851,982,3833,87900,2019
72097,41.4,75232,406,67,74610,17837,14236,29682,16931,12751,29682,96700,2019
72099,40,36161,113,51,35896,9569,15037,13374,8516,4858,13374,93800,2019
72101,38.7,30962,94,18,30833,7451,20941,9645,6679,2966,9645,105700,2019
72103,38.4,26075,165,0,25875,5408,19432,8058,6246,1812,8058,92500,2019
72105,41.1,28112,7,0,28105,6161,18883,8424,6317,2107,8424,88100,2019
72107,40.1,20982,53,25,20904,5029,15099,6759,4479,2280,6759,84800,2019
72109,44.9,16929,33,0,16896,3963,16007,6144,4025,2119,6144,90200,2019
72111,38.8,20383,77,0,20281,5167,16718,6863,5093,1770,6863,75700,2019
72113,41,139671,888,93,138570,34793,17069,52042,34454,17588,52042,97400,2019
72115,41.2,23629,216,93,23255,5651,17473,8083,5602,2481,8083,102700,2019
72117,46,14056,1398,17,12417,2930,19907,5018,3562,1456,5018,122000,2019
72119,41.2,49613,334,46,49182,11251,22669,15635,11772,3863,15635,113800,2019
72121,42.3,22560,58,2,22487,4823,17319,7061,5364,1697,7061,95800,2019
72123,40.9,28109,16,18,28038,6868,18189,10036,8049,1987,10036,83100,2019
72125,44,31442,151,0,31269,7449,16486,11722,8312,3410,11722,82300,2019
72127,43.2,335468,5053,615,328580,81117,22710,142699,76855,65844,142699,153500,2019
72129,42.4,37209,18,17,37125,9435,19380,13772,10395,3377,13772,110100,2019
72131,44.1,37120,1005,0,35846,9682,15331,13313,8582,4731,13313,98400,2019
72133,38.8,21757,97,0,21660,4957,19827,7367,5714,1653,7367,93500,2019
72135,38.4,72864,594,101,71860,17256,28834,22138,18421,3717,22138,133500,2019
72137,40.7,77810,879,92,76770,18488,25105,27400,20235,7165,27400,122300,2019
72139,40.5,66338,507,16,65772,17195,32545,23800,16131,7669,23800,146200,2019
72141,43.5,28676,152,22,28458,6693,15399,9593,5810,3783,9593,90000,2019
72143,39.6,37106,325,139,36521,8969,20048,11918,8192,3726,11918,114300,2019
72145,41.5,52192,1547,9,50491,13216,19617,18721,14917,3804,18721,106600,2019
72147,47,8642,438,0,8204,1203,14936,2258,1560,698,2258,111200,2019
72149,40.1,22403,38,18,22346,5873,19877,7908,5493,2415,7908,92600,2019
72151,42.9,33499,16,0,33472,7576,16295,11541,8306,3235,11541,87200,2019
72153,43.9,35428,117,16,35203,6885,14743,10990,8317,2673,10990,91100,2019
01001,38.6,55639,41160,10849,1601,15103,57982,21559,16088,5471,21559,161200,2020
01003,43.2,218289,180955,19027,9947,56092,61756,84047,64716,19331,84047,211600,2020
01005,40.1,25026,11332,11889,1110,6083,34990,9322,5775,3547,9322,86500,2020
01007,39.9,22374,16650,4971,600,5276,51721,7259,5428,1831,7259,96400,2020
01009,41,57755,50065,771,5362,15035,48922,21205,16132,5073,21205,135300,2020
01011,39.7,10173,2162,6980,824,2158,33866,3429,2531,898,3429,74800,2020
01013,41.2,19726,10125,8773,290,4574,44850,6649,4872,1777,6649,98100,2020
01015,39.5,114324,82049,23669,4406,29120,50128,44572,31370,13202,44572,121600,2020
01017,41.9,33427,18413,13372,843,9121,43875,13582,9133,4449,13582,103800,2020
01019,46.8,26035,23779,1250,432,7385,42509,10836,8477,2359,10836,138500,2020
01021,39.5,44147,35283,4268,3423,12047,52141,17140,12878,4262,17140,104500,2020
01023,46.6,12755,7200,5393,69,3453,36634,5330,4350,980,5330,75900,2020
01025,42.9,23866,12471,10909,140,5870,37345,9323,6761,2562,9323,106600,2020
01027,43.4,13285,10683,2035,410,3678,42678,5153,3947,1206,5153,116100,2020
01029,43.1,14952,13845,394,380,3790,46320,5835,4515,1320,5835,118700,2020
01031,39.5,52238,36368,8538,4011,13601,56799,19951,13527,6424,19951,153700,2020
01033,42.5,54957,42876,8817,1591,14207,47962,21797,15609,6188,21797,125400,2020
01035,45.2,12219,6117,5872,59,3009,35444,4585,3426,1159,4585,83900,2020
01037,49,10696,6924,3451,137,2604,43571,4016,3256,760,4016,89200,2020
01039,43.3,37096,30835,4674,657,9708,42566,14995,11137,3858,14995,99600,2020
01041,42.3,13826,9774,3173,305,3350,42611,5011,3842,1169,5011,84400,2020
01043,41.2,83345,76163,942,3676,21920,48388,31733,23734,7999,31733,135200,2020
01045,37.8,49293,33598,9955,3285,12548,45644,19405,11380,8025,19405,113800,2020
01047,39.6,38184,10334,27253,108,9116,33317,15409,8731,6678,15409,84100,2020
01049,39.6,71430,57324,1089,10530,19318,42267,26365,19275,7090,26365,113600,2020
01051,38.7,81526,59611,17112,2427,21745,62324,29794,22400,7394,29794,171100,2020
01053,39.4,36775,22091,11751,888,7780,35558,12931,8593,4338,12931,100800,2020
01055,41.3,102721,79697,16056,4187,25383,44934,38765,28285,10480,38765,124400,2020
01057,43.9,16406,13821,2003,89,4728,41469,6805,5119,1686,6805,92400,2020
01059,39.2,31587,24112,1204,5584,7570,41174,11017,7828,3189,11017,103000,2020
01061,43.6,26383,21955,2581,1075,7214,41569,10572,7955,2617,10572,108400,2020
01063,44.6,8221,1418,6484,221,1565,26688,3178,2179,999,3178,76200,2020
01065,40.8,14754,5668,8722,10,3336,30793,5490,4154,1336,5490,91500,2020
01067,44.7,17123,11859,4534,453,4495,51715,6556,5471,1085,6556,119000,2020
01069,40.2,105319,69340,28542,3551,26249,49069,39784,26229,13555,39784,141800,2020
01071,43,51765,46198,1883,1541,14371,42578,20367,15731,4636,20367,107900,2020
01073,37.9,658615,326618,281862,25757,163328,55088,263801,166849,96952,263801,165000,2020
01075,44.3,13854,11911,1525,240,3617,42688,5631,4100,1531,5631,95400,2020
01077,41.3,92870,78084,9289,2562,24314,48428,38513,26209,12304,38513,149500,2020
01079,42.6,32969,25224,3516,745,8903,47125,12551,9842,2709,12551,113800,2020
01081,32.4,163461,109707,36529,6093,37681,52930,60731,38483,22248,60731,173700,2020
01083,40,96921,73499,13020,5840,22926,64270,32725,25128,7597,32725,167800,2020
01085,42.5,9936,2450,7417,40,2763,33634,4213,3163,1050,4213,66500,2020
01087,38.7,18437,2973,15109,80,4447,35450,7592,4917,2675,7592,82400,2020
01089,38.5,367686,236781,89454,18412,96331,66887,151628,102658,48970,151628,190200,2020
01091,41.8,19138,8567,9905,495,3842,33029,7499,5232,2267,7499,82200,2020
01093,44.5,29818,27233,1128,766,7551,40978,11780,8936,2844,11780,87700,2020
01095,39.2,96137,77368,2677,13596,24498,50216,35115,25598,9517,35115,141300,2020
01097,38.1,413977,233970,148460,11994,102767,49625,157557,100955,56602,157557,138400,2020
01099,43.5,21006,11373,8918,74,4918,31969,8050,5463,2587,8050,100900,2020
01101,36.7,226451,75147,130779,7997,54225,51963,89511,51588,37923,89511,130000,2020
01103,40.5,119352,89837,14945,10060,30703,52923,46388,33496,12892,46388,143900,2020
01105,38.5,9104,2685,6218,178,1509,23875,3140,2458,682,3140,80100,2020
01107,42.5,20049,10752,8005,989,5246,40362,7731,5870,1861,7731,100000,2020
01109,30.8,33274,18591,12395,764,6227,39218,11700,7431,4269,11700,131600,2020
01111,43.6,22732,17067,4327,663,6129,45141,8655,6856,1799,8655,119500,2020
01113,36.7,57938,26096,25711,3268,15032,42208,23694,14324,9370,23694,126300,2020
01115,40.5,88929,76137,8391,2177,23999,62531,32765,26355,6410,32765,165900,2020
01117,39.5,216350,167380,25973,12354,57268,78889,80756,64906,15850,80756,220700,2020
01119,35.7,12595,3131,8977,146,3016,26150,5355,3367,1988,5355,67300,2020
01121,41.4,80244,50005,25734,1901,20893,43969,31741,22692,9049,31741,112300,2020
01123,45,40450,27819,10979,983,11038,48160,16359,12248,4111,16359,108300,2020
01125,33.2,208854,127502,67100,7966,47980,54283,74713,47018,27695,74713,179000,2020
01127,42,63802,56327,3849,1657,17553,45833,25440,19824,5616,25440,109600,2020
01129,43.8,16336,10653,3961,141,4141,42331,5830,5215,615,5830,88100,2020
01131,40.9,10552,2824,7418,48,2563,35063,3961,2770,1191,3961,67200,2020
01133,46.1,23712,22181,193,743,6542,40991,9612,7720,1892,9612,87300,2020
02013,44.1,3389,450,96,296,593,75833,988,607,381,988,136700,2020
02016,39.7,5708,1323,167,789,760,87443,1306,362,944,1306,316700,2020
02020,33.9,292090,165727,14856,27411,69571,84813,106970,66562,40408,106970,320100,2020
02050,28.1,18263,1719,144,354,3356,54400,4499,2510,1989,4499,88700,2020
02060,44.8,739,354,4,75,178,79808,284,146,138,284,222200,2020
02063,39.2,6495,4764,72,365,1577,90776,2310,1690,620,2310,234300,2020
02066,39.7,2894,1645,5,124,709,64745,1063,807,256,1063,234500,2020
02068,43.8,2502,2025,54,37,333,76364,726,602,124,726,233700,2020
02070,30.2,4934,736,74,149,1063,57436,1430,864,566,1430,156000,2020
02090,31.5,98455,67691,4415,8056,23871,76464,36199,21315,14884,36199,240300,2020
02100,40.9,2547,1837,0,132,533,65014,917,555,362,917,263900,2020
02105,52.1,2135,973,68,198,437,59926,755,553,202,755,221600,2020
02110,38.5,32099,20366,274,2223,7488,88077,12878,8319,4559,12878,355100,2020
02122,40.9,58809,46564,323,2497,13691,69245,21781,16409,5372,21781,245400,2020
02130,40,13833,8739,91,758,3501,74678,5299,3385,1914,5299,299500,2020
02150,34.7,13383,6395,54,1211,2900,79173,4231,2102,2129,4231,295100,2020
02158,24.1,8298,270,6,94,1448,37358,1750,1255,495,1750,72800,2020
02164,32.9,1156,279,80,3,255,48750,366,236,130,366,120500,2020
02170,35.5,107360,84183,1362,5602,22681,76118,31964,24545,7419,31964,257900,2020
02180,28.4,10009,1434,71,195,2055,62843,2777,1716,1061,2777,159600,2020
02185,34.2,9375,2627,147,381,1468,79083,1991,932,1059,1991,162500,2020
02188,28.5,7709,808,71,191,1313,63750,1795,1021,774,1795,125800,2020
02195,48.8,3278,1983,66,254,790,68667,1204,850,354,1204,228400,2020
02198,42.1,6338,2848,35,243,1497,54018,2353,1731,622,2353,191600,2020
02220,39.1,8569,5266,37,592,2214,81708,3572,2171,1401,3572,365800,2020
02230,40.9,1300,996,47,52,196,71875,411,263,148,411,397200,2020
02240,36.8,6911,5037,54,453,1470,66941,2287,1669,618,2287,179300,2020
02275,47.8,2510,1615,8,99,644,58438,989,705,284,989,221700,2020
02282,36.3,597,193,34,93,144,59517,221,114,107,221,171200,2020
02290,35.3,5305,1132,5,132,1079,41728,1857,1380,477,1857,74700,2020
04001,35.4,71714,12993,544,4751,14395,33967,21505,17134,4371,21505,61800,2020
04003,41,126442,69095,4512,44858,31657,51505,50917,35181,15736,50917,150100,2020
04005,31,142254,76544,1829,20441,29108,59000,49016,29789,19227,49016,299100,2020
04007,50.4,53846,33305,352,10252,14072,46907,22523,16934,5589,22523,174300,2020
04009,33.7,38304,19492,673,12683,8058,55693,11348,8113,3235,11348,146600,2020
04011,35.7,9465,4362,175,4474,2379,66368,3295,1682,1613,3295,91800,2020
04012,57.4,21035,12028,187,5825,6066,34956,9928,7129,2799,9928,84600,2020
04013,36.6,4412779,2407398,236764,1374312,1047899,67799,1596784,1008487,588297,1596784,278700,2020
04015,52.3,210998,161829,1895,35276,56530,47686,90413,63681,26732,90413,172100,2020
04017,38.2,110271,45785,965,12881,25548,43140,36406,25372,11034,36406,135800,2020
04019,38.7,1038476,531144,33644,389875,250845,55023,410942,263142,147800,410942,199400,2020
04021,39.8,447559,251708,19162,136381,105986,60968,148435,114923,33512,148435,200200,2020
04023,37.2,46594,7015,138,38792,11762,41424,16049,10883,5166,16049,152700,2020
04025,54.1,232396,186181,1523,34110,62119,53329,101245,73506,27739,101245,273300,2020
04027,34.8,211931,64843,3610,135779,54312,48790,74624,51220,23404,74624,139200,2020
05001,41,17761,12246,4461,598,4689,51000,7416,4885,2531,7416,98600,2020
05003,42.3,20000,13581,4948,1122,5244,43601,7716,5958,1758,7716,76200,2020
05005,52.3,41673,38865,79,1010,12112,43504,18727,14346,4381,18727,134500,2020
05007,35.5,273510,192131,4103,45827,73075,71556,99661,65702,33959,99661,192900,2020
05009,42.9,37525,35174,80,961,10084,46392,15043,10835,4208,15043,127200,2020
05011,40.3,10805,5981,2970,1662,2593,41808,4233,2671,1562,4233,87600,2020
05013,45.3,5160,3721,1133,216,1250,50441,1754,1465,289,1754,73100,2020
05015,44.8,28062,21984,70,4237,7435,48249,11079,8320,2759,11079,143600,2020
05017,43.4,10433,4051,5605,599,2587,33523,4052,2702,1350,4052,68000,2020
05019,32.6,22341,15238,5399,1079,5151,39500,8336,4920,3416,8336,116100,2020
05021,42.7,14710,13943,72,325,4211,37933,6476,4363,2113,6476,79600,2020
05023,49.5,25063,23523,227,606,7095,45563,10882,8504,2378,10882,126400,2020
05025,42.5,8063,6807,1087,0,2156,46349,3170,2470,700,3170,90400,2020
05027,35.5,23620,14003,8542,650,5480,37609,8456,5820,2636,8456,87700,2020
05029,42.7,20895,17008,2078,844,5562,44456,8491,5966,2525,8491,113500,2020
05031,34.4,109081,81539,16525,5604,27829,49730,42203,24055,18148,42203,149700,2020
05033,39.2,63118,52859,957,5027,17238,48980,24065,18205,5860,24065,123800,2020
05035,35.3,48381,19947,23398,1311,11955,42384,19021,10806,8215,19021,122700,2020
05037,40.7,16576,11973,2949,341,4585,44379,6568,4363,2205,6568,83800,2020
05039,45.1,7114,3760,3060,117,1863,35134,2992,2112,880,2992,78200,2020
05041,40.8,11538,5145,5471,734,3286,31855,5059,3137,1922,5059,82500,2020
05043,37.3,18263,12082,5186,653,4306,42924,7207,4840,2367,7207,102300,2020
05045,33.3,124800,99457,14252,5192,29431,54191,45091,28115,16976,45091,163900,2020
05047,41.8,17785,16243,173,568,4298,37561,6671,4842,1829,6671,96900,2020
05049,48.7,12301,11620,41,77,3200,35274,5014,4139,875,5014,84400,2020
05051,45.1,99043,80691,8258,5699,26071,48150,40906,27468,13438,40906,142100,2020
05053,40.1,18229,16850,458,525,4926,59051,7049,5377,1672,7049,122600,2020
05055,37.7,45197,41415,1043,1306,12750,50083,17587,11771,5816,17587,124800,2020
05057,40.8,21695,11782,6504,2789,5616,45484,8100,5548,2552,8100,87700,2020
05059,40.9,33667,27692,3785,1187,8507,46390,12515,9946,2569,12515,102400,2020
05061,39.6,13267,8462,2722,1680,3549,38038,5271,3553,1718,5271,101000,2020
05063,39.4,37585,33044,677,2489,9763,48972,14325,10417,3908,14325,97900,2020
05065,48,13596,12157,142,326,3050,42818,4911,3836,1075,4911,81900,2020
05067,40,16908,12927,1949,501,3858,37885,6241,4371,1870,6241,71300,2020
05069,39.5,68123,26092,37989,1482,16505,40402,26630,16490,10140,26630,84900,2020
05071,38.4,26475,20890,405,3700,6646,39346,9792,7098,2694,9792,107600,2020
05073,48,6728,3931,2391,198,1848,33763,2898,2265,633,2898,60800,2020
05075,40.4,16511,15474,232,268,4564,40587,6584,4534,2050,6584,75400,2020
05077,42.3,8963,3663,4974,245,1948,27902,3202,1858,1344,3202,76400,2020
05079,38.7,13278,8516,4016,543,2628,46554,3598,2801,797,3598,90600,2020
05081,42.8,12345,8982,2382,455,3391,48966,5292,4124,1168,5292,77400,2020
05083,43,21619,19165,321,662,5791,44232,8359,6283,2076,8359,100500,2020
05085,36.7,73163,62525,3998,3332,19447,59278,27218,19350,7868,27218,145000,2020
05087,41,16393,14472,17,955,4296,41446,6045,4855,1190,6045,116000,2020
05089,52.1,16586,15537,114,392,4439,38426,6918,5500,1418,6918,132200,2020
05091,39.7,43515,29560,10865,1499,10815,45391,16237,10676,5561,16237,113400,2020
05093,36.8,41396,23906,14460,1805,11213,42986,16623,9581,7042,16623,93000,2020
05095,46,6879,3708,2907,75,1764,38438,3234,1997,1237,3234,73500,2020
05097,50.6,8964,8153,28,386,2752,41165,3706,3122,584,3706,111600,2020
05099,44.6,8249,5159,2872,1,2143,39946,3188,2215,973,3188,66400,2020
05101,49.1,7753,7213,3,72,2012,39542,2996,2511,485,2996,127100,2020
05103,44.4,23597,12953,9958,567,6249,38279,9487,6729,2758,9487,76900,2020
05105,44,10342,9463,265,317,2836,44926,3700,2950,750,3700,115000,2020
05107,39.5,18151,6183,11519,355,4699,33724,7561,3484,4077,7561,80800,2020
05109,43.7,10714,9242,408,699,2928,42983,4215,3138,1077,4215,86100,2020
05111,39.9,23747,20364,888,762,6393,40700,9567,6006,3561,9567,81200,2020
05113,44.4,19999,17451,104,1311,5429,39084,8114,6150,1964,8114,103700,2020
05115,35.6,63926,53502,1645,5882,15220,46004,22863,16554,6309,22863,129000,2020
05117,46,8138,6873,946,149,2370,42754,3755,2813,942,3755,71800,2020
05119,37.4,393078,202791,145000,24214,95195,52930,161652,93882,67770,161652,161000,2020
05121,40,17934,16549,165,395,4889,42844,7294,5425,1869,7294,92500,2020
05123,38.7,25477,10039,13429,1356,5926,36053,9313,5105,4208,9313,65200,2020
05125,39.6,120990,100891,9211,6017,31958,66876,45098,35499,9599,45098,159300,2020
05127,41.2,10269,8639,222,808,2748,42635,4114,3013,1101,4114,81900,2020
05129,48.4,7898,7169,41,209,2262,35077,3235,2423,812,3235,99000,2020
05131,37.9,127670,88206,7849,18397,33629,47878,52026,30866,21160,52026,129300,2020
05133,35.2,16947,9647,786,5686,4292,47872,5690,3808,1882,5690,95000,2020
05135,47.9,17217,15831,176,412,4626,35573,7315,5757,1558,7315,75200,2020
05137,50,12582,11680,12,245,3231,36067,4866,3607,1259,4866,135800,2020
05139,41.3,39089,23703,12878,1571,10192,45293,15855,11797,4058,15855,89700,2020
05141,48.6,16578,15360,65,538,4837,40442,7220,5589,1631,7220,105500,2020
05143,32.2,236198,164022,7915,39898,55809,52380,89094,47656,41438,89094,184300,2020
05145,37.1,78725,69159,3352,3497,19809,44000,28903,19553,9350,28903,125300,2020
05147,46.1,6477,4505,1893,15,1910,40331,3002,2035,967,3002,74300,2020
05149,40,21425,16030,380,4397,5667,47981,7797,5550,2247,7797,110300,2020
06001,37.8,1661584,508583,167316,369546,381210,104888,573174,307281,265893,573174,825300,2020
06003,47.6,1159,595,10,183,291,85750,397,321,76,397,372500,2020
06005,49.9,39023,29961,867,5591,9863,65187,14844,11396,3448,14844,329300,2020
06007,36.9,223344,158924,3778,37585,50847,54972,83879,49887,33992,83879,304700,2020
06009,52.8,45828,36780,450,5710,12191,67054,16958,13492,3466,16958,340000,2020
06011,35.4,21491,7482,263,12840,4942,59427,7329,4651,2678,7329,274100,2020
06013,39.9,1147788,489135,94463,295791,286311,103997,398299,266238,132061,398299,655500,2020
06015,40,27692,16928,723,5552,6347,49981,9805,6706,3099,9805,227500,2020
06017,46.3,190345,146919,1439,24773,50713,83710,73078,55193,17885,73078,479800,2020
06019,32.4,990204,284169,43660,528293,224051,57109,310097,166420,143677,310097,271000,2020
06021,35.9,28060,14298,181,11828,7335,51682,10216,5970,4246,10216,242200,2020
06023,38.9,136101,99861,1314,16228,29287,49235,54120,30761,23359,54120,331300,2020
06025,32.5,180580,18393,4317,152880,34175,46222,45768,26589,19179,45768,206700,2020
06027,45.3,17930,10950,85,4115,4444,59296,7954,5170,2784,7954,258200,2020
06029,31.9,892458,296505,45312,480700,201939,54851,273556,161113,112443,273556,226600,2020
06031,32,151090,47717,8878,82954,34155,61556,43604,23368,20236,43604,227400,2020
06033,45.3,64276,44490,1509,13667,14893,49254,25508,17276,8232,25508,238000,2020
06035,36.8,30600,19873,2605,5893,6151,56971,9172,6291,2881,9172,207800,2020
06037,36.7,10040682,2603280,779166,4851344,2211342,71358,3332504,1534472,1798032,3332504,615500,2020
06039,34.1,155925,52109,4768,90958,34966,61924,44479,29270,15209,44479,268500,2020
06041,47.1,259441,183259,5565,41737,66101,121671,104900,66719,38181,104900,1053600,2020
06043,51.8,17319,13666,266,2041,4762,50960,7846,5520,2326,7846,290200,2020
06045,43.4,87110,55847,424,22354,21035,52915,34164,20611,13553,34164,388500,2020
06047,31.2,273661,73587,7626,164836,62032,56330,81306,42480,38826,81306,268800,2020
06049,47.6,8853,6830,123,1317,2338,51250,3594,2752,842,3594,153600,2020
06051,39.5,14395,9338,32,3893,2808,64924,5196,3535,1661,5196,385500,2020
06053,34.7,432977,127632,10471,255512,92948,76943,128003,66346,61657,128003,559400,2020
06055,41.8,138572,71817,2738,47300,33181,92219,48484,31424,17060,48484,666900,2020
06057,50.5,99417,84317,347,9480,26377,68333,40917,30605,10312,40917,446100,2020
06059,38.3,3170345,1262640,49452,1071393,742140,94441,1040001,595228,444773,1040001,703800,2020
06061,42.2,391799,280266,6080,55932,102730,93677,145714,106894,38820,145714,495900,2020
06063,51.9,18844,15501,254,1749,5040,57233,8332,6077,2255,8332,259300,2020
06065,35.8,2437864,837847,148003,1204521,539458,70732,736413,497259,239154,736413,368100,2020
06067,36.4,1537948,671965,142796,360204,363107,70684,547519,314234,233285,547519,373000,2020
06069,35.7,61547,20567,475,37015,14769,85808,18389,12013,6376,18389,588500,2020
06071,33.6,2162532,596262,166814,1163038,489851,65761,640090,384774,255316,640090,348500,2020
06073,36.1,3323970,1492165,153310,1126266,759418,82426,1130703,609350,521353,1130703,595600,2020
06075,38.3,874784,348449,42803,132865,170665,119136,362141,137679,224462,362141,1152300,2020
06077,34.4,751615,230857,50920,313385,172583,68628,231092,133381,97711,231092,367900,2020
06079,39.5,282517,192959,4476,64275,67187,77948,106244,66635,39609,106244,605200,2020
06081,39.8,765623,295172,16772,184490,184019,128091,263351,157703,105648,263351,1163100,2020
06083,33.8,444895,195329,7910,203207,97397,78925,148309,77504,70805,148309,610300,2020
06085,37.2,1924379,589644,44917,482101,454149,130890,635314,358228,277086,635314,1061900,2020
06087,38.2,273170,155409,2610,91876,60870,89986,96275,58094,38181,96275,787000,2020
06089,41.7,179267,141585,1871,18566,46938,57139,70845,46238,24607,70845,261000,2020
06091,54,2898,2561,3,293,826,52103,1250,917,333,1250,229400,2020
06093,47.7,43516,32878,641,5605,11400,47403,19195,12659,6536,19195,214300,2020
06095,38.3,444538,165326,59249,119294,109255,84638,151191,93839,57352,151191,437900,2020
06097,42.4,496801,310607,7380,134024,120232,86173,188958,115845,73113,188958,640000,2020
06099,34.3,546235,222962,15869,256424,130057,62873,174826,102675,72151,174826,314100,2020
06101,35.8,96315,43635,1734,30101,23728,63502,32586,19267,13319,32586,306000,2020
06103,40.6,64176,43273,378,16435,16236,48895,24661,16282,8379,24661,231500,2020
06105,52.4,12541,10073,65,933,3306,41780,5896,4041,1855,5896,285700,2020
06107,31.2,463955,128751,5923,301919,108328,52534,139044,79353,59691,139044,223600,2020
06109,48.7,54147,43139,979,6810,13464,60509,22937,16886,6051,22937,314300,2020
06111,38.5,845599,379971,14321,361648,196312,89295,271639,172037,99602,271639,609200,2020
06113,31.1,218774,100258,5137,69341,47949,73746,74614,38280,36334,74614,456800,2020
06115,33,77524,41849,2533,22318,18217,59424,26434,16089,10345,26434,273600,2020
08001,34,509844,250340,16280,205729,116615,73817,167290,112065,55225,167290,335800,2020
08003,32.3,16153,7642,53,7605,3846,41121,6240,3431,2809,6240,153700,2020
08005,36.8,649980,386914,69066,126436,157885,80291,241889,155364,86525,241889,385100,2020
08007,50.3,13588,10360,124,2500,3928,55658,5736,4252,1484,5736,331900,2020
08009,45.9,3570,3005,33,404,1050,34655,1728,1232,496,1728,98800,2020
08011,40.6,5677,3220,231,1831,1168,38083,1879,1133,746,1879,82500,2020
08013,36.9,324682,250714,2615,44800,73244,87476,127365,81061,46304,127365,539100,2020
08014,38.4,69444,53076,866,8751,17411,101206,27199,18041,9158,27199,450600,2020
08015,49,19977,17003,410,1995,5584,55176,8650,6154,2496,8650,387300,2020
08017,41.1,1999,1666,3,208,551,67763,804,598,206,804,141700,2020
08019,48.6,9533,8407,71,689,2348,71919,4378,3432,946,4378,399000,2020
08021,38.5,8130,3639,23,4241,1714,33611,3222,2578,644,3222,123000,2020
08023,49.6,3810,1280,13,2338,977,34732,1620,1192,428,1620,123600,2020
08025,38.8,5733,3080,285,1830,884,40785,1421,1042,379,1421,82900,2020
08027,60.1,4941,4230,84,577,1515,60361,2310,2038,272,2310,249900,2020
08029,47.7,30758,24855,199,4683,7967,47968,12277,8985,3292,12277,253500,2020
08031,34.6,715878,387855,63132,211409,138396,72661,287756,145172,142584,287756,427600,2020
08033,57.5,1896,1503,0,268,565,56786,930,737,193,930,167700,2020
08035,39,344280,280073,4772,30725,93084,121393,121492,96172,25320,121492,493500,2020
08037,36.8,54960,36508,531,16103,11944,85877,18667,13016,5651,18667,617200,2020
08039,46.2,26230,22839,70,1943,7105,104231,8816,8048,768,8816,492300,2020
08041,34.4,710499,486202,42116,124227,178757,71517,262780,171408,91372,262780,300200,2020
08043,45.2,47725,37671,2221,6393,11489,52364,17449,13211,4238,17449,197500,2020
08045,36.6,59605,40435,310,17069,15431,75435,21586,14576,7010,21586,375600,2020
08047,49.1,6108,5243,34,532,1681,90547,2860,2450,410,2860,387000,2020
08049,43.5,15536,13342,113,1433,3734,71769,6315,4412,1903,6315,347400,2020
08051,34.8,17119,14811,39,1636,3553,60557,6824,4466,2358,6824,381900,2020
08053,55.5,781,675,13,75,231,39038,376,297,79,376,325000,2020
08055,55.6,6769,4177,8,2280,1826,40255,3057,2228,829,3057,183100,2020
08057,53.9,1316,1152,8,145,396,46157,635,457,178,635,211500,2020
08059,40.2,578795,449495,6081,89639,147357,87793,229007,164108,64899,229007,433100,2020
08061,39.8,1463,1377,5,66,380,39503,615,458,157,615,85900,2020
08063,38.4,7246,5633,28,1360,1898,50411,3020,2039,981,3020,127800,2020
08065,37.8,7845,5246,5,2044,1647,65858,3275,2536,739,3275,258200,2020
08067,40.8,56138,43681,286,7259,13283,69291,21370,15182,6188,21370,415900,2020
08069,36.2,350523,287326,3314,41082,83921,76366,134185,88959,45226,134185,390600,2020
08071,46.2,14323,7573,155,5886,3883,44159,6750,4624,2126,6750,158600,2020
08073,37.7,5608,3890,406,1227,889,47042,1513,1095,418,1513,157500,2020
08075,38.9,22282,16926,326,3782,4992,49560,8301,5518,2783,8301,161800,2020
08077,40,152962,123784,1062,22479,37528,57157,59750,41270,18480,59750,245000,2020
08079,51,853,703,10,34,252,53571,394,288,106,394,329300,2020
08081,36.7,13150,10476,79,2093,3443,54583,5218,3334,1884,5218,190600,2020
08083,45.2,26266,18917,268,3359,7019,50717,10521,7424,3097,10521,238200,2020
08085,45.5,42280,32094,59,8702,12133,54611,17483,12914,4569,17483,242300,2020
08087,36.2,28617,16606,883,10329,7452,58468,10863,6836,4027,10863,217200,2020
08089,40.4,18284,9588,144,7710,4651,43075,7761,5190,2571,7761,101000,2020
08091,53.5,4890,4557,76,133,1426,68893,2259,1619,640,2259,486200,2020
08093,51.9,18345,16104,46,1175,5178,76611,6987,6357,630,6987,367400,2020
08095,37.5,4343,2992,0,1328,1194,50426,1737,1255,482,1737,191200,2020
08097,43.3,17980,15186,81,1850,3907,82455,7424,5002,2422,7424,599000,2020
08099,38.5,12035,7019,95,4626,3150,42648,4900,3092,1808,4900,108800,2020
08101,39.7,167412,86274,2748,72313,40227,49979,65206,42440,22766,65206,172500,2020
08103,37.6,6369,5339,22,658,1620,54247,2513,1866,647,2513,218500,2020
08105,41.2,11300,5844,8,5012,2924,43570,4737,3260,1477,4737,186700,2020
08107,40.5,25317,22270,257,1768,6267,76198,10100,7533,2567,10100,534100,2020
08109,49.1,6730,3966,74,2418,1775,45231,2803,2040,763,2803,152400,2020
08111,45.1,646,484,0,155,147,56875,297,165,132,297,348700,2020
08113,42.1,8110,6933,1,885,1992,66898,3604,2161,1443,3604,448900,2020
08115,39.7,2306,1814,10,441,571,43875,954,645,309,954,111300,2020
08117,38.2,30735,24863,68,4417,6460,80709,11609,7986,3623,11609,596300,2020
08119,50.2,24981,21537,163,1750,6955,61463,10460,8489,1971,10460,304800,2020
08121,41.3,4869,4206,48,509,1452,51181,2081,1453,628,2081,162200,2020
08123,34.6,315389,205413,3618,93385,75120,74332,102046,76049,25997,102046,326100,2020
08125,38.9,10013,7417,41,2397,2931,54393,4108,2889,1219,4108,190400,2020
09001,40.8,944306,576391,99724,189215,239503,97539,345070,230123,114947,345070,433000,2020
09003,40.4,892153,536165,114203,163969,225570,76259,353653,226863,126790,353653,242900,2020
09005,47.5,181143,158675,2742,12023,48798,81590,74902,57002,17900,74902,258300,2020
09007,45.8,162742,135279,7970,10426,42858,84907,67765,49826,17939,67765,293300,2020
09009,40.5,855733,529955,107033,159144,208171,71370,332765,206810,125955,332765,252300,2020
09011,41.4,266868,199587,13792,29560,71500,75831,109616,73565,36051,109616,246800,2020
09013,37.6,150947,126330,4272,8669,36676,87809,56077,40181,15896,56077,259700,2020
09015,41.2,116657,95560,2300,14206,29920,67365,45589,31038,14551,45589,210300,2020
10001,38.1,179124,108483,44790,13091,45506,60117,67299,46326,20973,67299,226600,2020
10003,38.7,558306,314898,137633,57030,133007,75275,209431,142188,67243,209431,266500,2020
10005,50.3,230249,171855,25703,21229,64499,64905,94223,76401,17822,94223,269700,2020
11001,34.1,701974,257792,312661,77981,123496,90842,288307,122648,165659,288307,618100,2020
12001,31.7,268105,162097,53194,27241,50803,50089,101979,55696,46283,101979,201600,2020
12003,37.8,28679,22615,4107,771,6448,62299,8828,6756,2072,8828,158000,2020
12005,40.6,180076,136521,19093,11947,47432,56483,73536,49474,24062,73536,195000,2020
12007,39.8,27723,20240,5630,1205,5882,43580,9318,6147,3171,9318,118900,2020
12009,47.2,594001,438314,55296,63063,148934,59359,236005,178469,57536,236005,220000,2020
12011,40.5,1942273,689773,536564,586236,447453,60922,704942,442633,262309,704942,282400,2020
12013,41.9,14324,11070,1904,854,2753,38037,4510,3528,982,4510,91100,2020
12015,59.5,185926,155318,9856,14004,51016,52724,79789,65110,14679,79789,209500,2020
12017,56.7,147938,129540,3815,8677,40063,45689,64621,53954,10667,64621,144100,2020
12019,39.8,215294,154754,22644,21945,57587,68657,75360,58016,17344,75360,195900,2020
12021,51.3,379345,237479,25294,106230,98121,70217,147977,110083,37894,147977,366600,2020
12023,40.6,70898,50813,12671,4553,15740,44818,25205,18301,6904,25205,128800,2020
12027,40.7,37371,20416,4493,11783,8306,36360,12421,8555,3866,12421,103600,2020
12029,46.2,16740,14037,1372,699,4320,41674,6233,5151,1082,6233,85000,2020
12031,36.3,948651,491340,276288,96743,225060,56769,369704,211163,158541,369704,195600,2020
12033,37.3,316691,202168,68996,18403,74083,53023,122169,76772,45397,122169,157200,2020
12035,51.8,112854,83656,10959,12004,31591,57536,44040,33681,10359,44040,232700,2020
12037,47.3,11914,9090,1612,669,2926,48814,4691,3557,1134,4691,193800,2020
12039,41.4,45787,14770,25327,4776,11268,41135,17307,12643,4664,17307,98100,2020
12041,41.7,18245,15710,960,1091,4463,47381,6701,5529,1172,6701,125900,2020
12043,47.9,13777,8255,1793,2924,3247,39709,4859,3894,965,4859,72100,2020
12045,46.3,15073,11737,2216,677,3940,50640,5897,4460,1437,5897,170700,2020
12047,40,14397,7818,4819,1411,3127,38300,4385,3168,1217,4385,85900,2020
12049,35.4,27027,12598,1666,11863,5838,40165,7991,5354,2637,7991,94100,2020
12051,35,41472,13005,4505,22518,9378,36978,12878,9058,3820,12878,105900,2020
12053,48.8,190700,146288,9140,26964,51765,50280,76708,60806,15902,76708,158400,2020
12055,54.1,104574,69153,9677,21365,27169,43708,42721,32883,9838,42721,120500,2020
12057,37.4,1451358,695575,225431,421930,338683,60566,539919,320042,219877,539919,233200,2020
12059,42.2,19530,16858,1344,586,4939,39215,7137,5421,1716,7137,86400,2020
12061,54,156964,117635,13013,19675,37647,57945,60959,48767,12192,60959,220700,2020
12063,42.2,47409,30954,12456,2346,11459,40754,17533,12553,4980,17533,101300,2020
12065,47.3,14278,8543,4766,600,3796,49081,5643,4234,1409,5643,137300,2020
12067,38.6,8576,5649,1344,1389,1655,51734,2315,1802,513,2315,100600,2020
12069,47,356115,245615,35791,57268,94332,55792,137446,103269,34177,137446,202500,2020
12071,48.8,756570,501531,60045,165318,187877,59608,288916,209905,79011,288916,235300,2020
12073,31.3,291863,163405,90134,19142,61961,54675,116530,61283,55247,116530,212900,2020
12075,47,40979,32344,3340,3517,10747,38951,16971,13482,3489,16971,119000,2020
12077,40.6,8333,6251,1145,381,1602,39121,2513,1977,536,2513,83700,2020
12079,44.2,18557,9972,6926,1099,4075,35240,6891,4997,1894,6891,89100,2020
12081,48.8,393847,279267,32567,64617,99157,59963,150345,110989,39356,150345,250700,2020
12083,48.7,360210,250938,44232,49391,94676,46587,145863,109169,36694,145863,151700,2020
12085,52.7,160420,125077,8405,21987,40162,65821,64870,51489,13381,64870,293000,2020
12086,40.2,2705528,365906,421305,1843676,619475,53975,902200,465833,436367,902200,310700,2020
12087,47.9,75137,49109,5278,18478,19513,72012,32794,19388,13406,32794,558100,2020
12089,45.8,85762,74050,4834,3884,24357,72998,33475,27444,6031,33475,243700,2020
12091,36.9,207430,151136,19636,19758,51719,64373,79235,52273,26962,79235,234600,2020
12093,40.9,41611,26036,3373,10755,9837,46097,14601,10921,3680,14601,116500,2020
12095,35.3,1373784,538872,271021,441234,309344,61416,468075,262241,205834,468075,257800,2020
12097,36,363666,112114,32324,198952,81168,55538,109642,70613,39029,109642,221600,2020
12099,45,1482057,799163,269684,334207,351887,65015,565598,391273,174325,565598,301000,2020
12101,44.5,539885,395754,29541,85695,139278,53431,209483,153406,56077,209483,173900,2020
12103,48.4,970985,713630,96860,96064,232884,56419,413239,281412,131827,413239,219800,2020
12105,40.2,705735,406349,102750,166076,165183,51535,240879,167295,73584,240879,162400,2020
12107,45,73784,52447,11861,7483,18179,40068,29822,21286,8536,29822,103400,2020
12109,43.7,255410,209101,13464,18550,67548,83803,91253,74318,16935,91253,326300,2020
12111,45.5,320914,181092,62954,62070,81648,55237,118527,89045,29482,118527,209700,2020
12113,40,179587,146703,10520,10333,47876,70663,65697,50670,15027,65697,214900,2020
12115,56.6,427766,353394,18351,40134,117532,64644,189228,144135,45093,189228,269300,2020
12117,39.3,466695,276415,51577,102310,120049,70297,178094,117211,60883,178094,263700,2020
12119,68,129938,110297,8804,7554,39605,59618,59076,52354,6722,59076,267100,2020
12121,43.5,44290,33287,5861,4244,10655,46280,15149,11641,3508,15149,107100,2020
12123,43.2,21709,15508,4700,920,5117,38295,7172,5598,1574,7172,81900,2020
12125,39.8,15282,10587,3060,878,2873,55139,4008,2826,1182,4008,112600,2020
12127,46.5,546107,387044,57068,79015,136510,52407,220386,156968,63418,220386,194900,2020
12129,42.3,32855,26005,4463,1265,8362,67480,11382,9603,1779,11382,171200,2020
12131,44.1,71049,59689,3269,4461,20034,67390,28635,21774,6861,28635,245400,2020
12133,41.3,25094,19345,3720,968,5945,37260,9037,7130,1907,9037,120800,2020
13001,39.9,18428,12695,3637,1834,4866,37924,6650,4976,1674,6650,87100,2020
13003,35.9,8311,4636,1287,2157,2054,35703,2953,2109,844,2953,63400,2020
13005,36.5,11140,8159,1832,933,2436,36692,3743,2792,951,3743,82300,2020
13007,52.2,3090,1549,1173,141,852,34034,1448,990,458,1448,108100,2020
13009,35.8,45072,23548,18827,1063,10219,46250,16698,9920,6778,16698,128800,2020
13011,41.5,18900,16558,408,1325,5230,50912,6941,5144,1797,6941,164500,2020
13013,36,81294,56583,9735,9351,20634,62990,27268,20915,6353,27268,169900,2020
13015,38.2,106456,80700,10465,9459,27822,61226,37905,25704,12201,37905,178500,2020
13017,39.5,16889,9338,6238,1052,4189,32077,6612,3806,2806,6612,85500,2020
13019,39.8,19206,15674,1920,1015,4941,42089,7391,4862,2529,7391,95200,2020
13021,36.3,153026,57550,82882,5211,34635,41317,58154,30091,28063,58154,125300,2020
13023,36,12870,8769,3634,406,3064,46992,4250,3093,1157,4250,101900,2020
13025,40.8,18924,17397,627,432,4253,34679,6763,5326,1437,6763,92800,2020
13027,43.6,15548,8627,5519,918,4118,37516,6392,4470,1922,6392,94200,2020
13029,34.1,38321,27632,5354,2887,10415,76121,13503,9561,3942,13503,227400,2020
13031,29.2,77719,49141,21718,3232,17002,48786,27967,15193,12774,27967,147100,2020
13033,38.1,22567,10697,10685,727,5530,45699,7953,5810,2143,7953,89900,2020
13035,38.9,24463,16105,6906,820,6142,48282,8342,5950,2392,8342,156700,2020
13037,39.6,6301,2046,3791,314,1216,41962,1726,1174,552,1726,48700,2020
13039,33.3,53960,37558,9624,3768,14275,60594,19746,12227,7519,19746,171400,2020
13043,40.2,10834,6512,2699,1272,2722,36955,4042,2329,1713,4042,89800,2020
13045,35,118692,82470,23025,8327,30239,59197,42196,29043,13153,42196,147400,2020
13047,40.8,67181,60840,1313,2046,18119,58932,25151,18721,6430,25151,151300,2020
13049,40.5,13032,7983,3388,938,2623,42743,3826,2725,1101,3826,87200,2020
13051,35.9,289649,138639,114920,18872,66947,57739,109868,61038,48830,109868,209200,2020
13053,24,10470,5921,2129,1699,1941,45700,2550,619,1931,2550,82000,2020
13055,40,24826,20500,2376,1325,5712,37351,9106,6262,2844,9106,77200,2020
13057,39,253780,198415,16862,27044,68321,84817,90372,69011,21361,90372,271300,2020
13059,28.3,126952,69710,35570,13671,24265,40363,50284,20388,29896,50284,186800,2020
13061,53.1,2931,1241,1632,10,671,32434,1313,999,314,1313,70500,2020
13063,32.5,287560,27546,197902,37854,64979,49460,96826,48667,48159,96826,122100,2020
13065,38.8,6648,4321,1672,402,1668,38844,2387,1880,507,2387,71800,2020
13067,36.8,756653,386108,202994,98637,190378,80830,283359,186378,96981,283359,273900,2020
13069,36.9,43070,24878,12314,5060,10103,42526,14832,9644,5188,14832,106400,2020
13071,37.3,45510,25171,10637,8850,10212,36799,15865,9884,5981,15865,92600,2020
13073,37.1,154257,104687,25783,10644,36301,82251,48233,38345,9888,48233,215200,2020
13075,37.5,17217,11087,4699,1002,4284,40943,6202,4068,2134,6202,93400,2020
13077,39,145839,102999,25309,10360,39651,79795,53104,39875,13229,53104,225000,2020
13079,44.6,12267,8986,2709,424,3259,47917,4573,3540,1033,4573,121500,2020
13081,40.2,22509,11160,10303,792,5948,38272,8479,4818,3661,8479,83100,2020
13083,42.7,16183,14992,152,376,4390,40384,6155,4370,1785,6155,128500,2020
13085,43.8,25277,22982,187,1238,7015,72260,9521,7757,1764,9521,241900,2020
13087,38,26595,13259,11090,1636,6710,40567,9684,5932,3752,9684,115000,2020
13089,35.9,755287,219695,399058,63726,164226,65116,283799,158102,125697,283799,235300,2020
13091,41.9,20725,13333,6166,766,5240,42211,7530,5259,2271,7530,86600,2020
13093,42.7,13571,5748,6708,953,3471,48039,4979,3530,1449,4979,81400,2020
13095,35.8,88696,21907,61493,2604,20147,40947,34233,15709,18524,34233,106200,2020
13097,36.6,145063,56389,67925,14344,35358,67651,49788,32604,17184,49788,171300,2020
13099,40.1,10218,4556,5133,237,2754,34811,4196,2831,1365,4196,120700,2020
13101,40.3,3944,2331,140,1108,1097,44454,1497,1067,430,1497,76000,2020
13103,36,62241,47976,8352,2941,15810,67050,21828,16880,4948,21828,170600,2020
13105,43.3,19164,12115,5619,1112,5133,39323,7695,5511,2184,7695,87400,2020
13107,36.9,22525,13309,7525,1033,5645,38423,8273,4874,3399,8273,74700,2020
13109,37.4,10671,6001,3041,1257,2790,46392,4006,2397,1609,4006,97700,2020
13111,52.3,25797,24332,45,645,7725,46028,11174,8689,2485,11174,206900,2020
13113,43.4,113544,68739,26541,8322,31765,93777,40792,33230,7562,40792,293400,2020
13115,38.4,97805,68886,13437,11049,25405,50657,36192,22616,13576,36192,137600,2020
13117,38.8,236605,165009,8109,22294,65025,112834,80319,67620,12699,80319,362300,2020
13119,41.2,23015,19129,2045,1120,6170,47821,8425,5902,2523,8425,120500,2020
13121,35.7,1051550,413234,453572,75345,229604,72741,427379,225903,201476,427379,326700,2020
13123,47.9,30986,26558,50,3637,8448,57376,12423,9115,3308,12423,205800,2020
13125,43.2,2984,2603,290,49,727,46500,1118,820,298,1118,82600,2020
13127,42.2,85008,53783,21423,5616,22560,56952,34191,22228,11963,34191,194300,2020
13129,38.4,57756,44586,2188,9302,14905,48662,20446,13633,6813,20446,148300,2020
13131,39.4,24693,14335,7117,2811,6446,48047,9116,6002,3114,9116,121700,2020
13133,50.7,17808,10331,6125,1091,5031,57880,7371,5662,1709,7371,241300,2020
13135,35.5,926414,334658,252635,196654,225267,72787,299683,199187,100496,299683,235700,2020
13137,39.3,45204,34504,1185,7037,10272,54147,15258,12171,3087,15258,155200,2020
13139,37.2,201434,121398,13964,57471,49002,63651,65555,45199,20356,65555,212700,2020
13141,47.6,8500,2075,6130,130,1930,32914,3072,2254,818,3072,80400,2020
13143,40.4,29608,26781,1287,562,8312,52021,11454,7874,3580,11454,144200,2020
13145,43.3,34676,26540,5545,1309,9948,79860,12429,11093,1336,12429,230400,2020
13147,44.3,25981,19372,5073,958,6767,45874,10271,7537,2734,10271,149100,2020
13149,42.4,11785,9991,998,325,3245,50583,4649,3159,1490,4649,114500,2020
13151,37.1,229994,94427,103550,16247,58925,71110,78204,55411,22793,78204,189600,2020
13153,35.6,155317,86277,47955,10203,40727,65870,58042,38595,19447,58042,157200,2020
13155,39.7,9379,6231,2674,385,2261,41484,3477,2411,1066,3477,83200,2020
13157,38.4,70467,56965,4853,5708,19184,68307,24268,19171,5097,24268,210100,2020
13159,43.2,14074,10454,2772,548,4175,52409,5326,4261,1065,5326,145000,2020
13161,36.8,15063,10688,2432,1848,3855,36987,5139,3363,1776,5139,85900,2020
13163,40,15489,6528,8179,603,3787,37009,5583,3565,2018,5583,85600,2020
13165,41.9,8787,4863,3127,556,2066,25712,3392,2557,835,3392,61300,2020
13167,41.6,9717,6022,3290,251,2243,42421,3483,2470,1013,3483,68900,2020
13169,40.4,28622,20268,6986,508,7969,63046,10914,8764,2150,10914,149700,2020
13171,38.5,18834,12258,5348,478,3730,50088,6658,4779,1879,6658,145800,2020
13173,37,10534,7175,2426,669,2540,32158,3825,2397,1428,3825,117800,2020
13175,39.4,47404,26874,17802,1297,11513,39476,17159,10809,6350,17159,99600,2020
13177,37.1,29735,21104,6437,905,8288,68338,10550,8091,2459,10550,166900,2020
13179,28.8,62039,23763,24800,7849,16734,50411,24053,11059,12994,24053,133700,2020
13181,47,7929,5270,2382,160,2225,42036,3277,2374,903,3277,132300,2020
13183,31.6,19236,10919,4793,2189,4182,52099,6006,3768,2238,6006,129800,2020
13185,30.6,116436,61865,42880,6803,26870,46113,42755,22454,20301,42755,145900,2020
13187,36.3,33009,29874,681,1629,7780,52872,11866,8612,3254,11866,199100,2020
13189,38.2,21404,11379,8547,684,5773,47327,8238,5603,2635,8238,115100,2020
13191,51,14217,8815,4920,59,4323,56262,6343,5207,1136,6343,152700,2020
13193,40,13107,4115,8111,563,2916,31910,4648,2855,1793,4648,68600,2020
13195,40.5,29624,23751,2614,1716,8078,51142,10622,7789,2833,10622,143200,2020
13197,44.8,8450,4967,2547,653,2525,52450,3423,2597,826,3423,109400,2020
13199,42.2,21080,11899,8463,488,5618,40769,8255,5455,2800,8255,112500,2020
13201,42.8,5725,3869,1764,31,1592,49771,2339,1556,783,2339,99400,2020
13205,39.1,22072,10094,10139,1029,5273,39404,8018,5038,2980,8018,94200,2020
13207,42.9,27455,19871,6254,649,6865,60491,10177,8333,1844,10177,175000,2020
13209,40,9069,5903,2322,623,2216,45230,3061,2304,757,3061,92200,2020
13211,44.1,18832,13606,4302,591,5390,68669,7040,5213,1827,7040,230400,2020
13213,38.8,39789,32507,341,6037,10939,51133,14520,10218,4302,14520,122100,2020
13215,34.4,195418,77771,89196,15127,44873,47418,73648,36142,37506,73648,142900,2020
13217,36.5,109835,49375,49725,6331,27747,59178,37543,26713,10830,37543,159200,2020
13219,40.1,39194,32790,1927,2135,11270,95064,13773,11374,2399,13773,304400,2020
13221,42.7,15040,11335,2578,736,3762,52816,5477,4230,1247,5477,133200,2020
13223,36.3,164440,113618,31841,10969,43048,74154,54993,42675,12318,54993,184000,2020
13225,38,27502,12519,12187,2128,6639,50267,10215,6456,3759,10215,140100,2020
13227,46.1,32002,27431,523,1002,8791,68365,12129,9522,2607,12129,196400,2020
13229,39,19336,16256,1953,960,4927,48969,7178,5453,1725,7178,101700,2020
13231,40.6,18565,16129,1643,315,4494,68138,6163,5223,940,6163,181700,2020
13233,37.3,42251,30334,4756,5594,10716,46846,15425,10003,5422,15425,121900,2020
13235,41,11185,6450,4266,322,2448,42213,3803,2442,1361,3803,109500,2020
13237,47.8,21906,14360,5711,1371,6261,52910,9457,7084,2373,9457,165800,2020
13239,56.9,2290,963,1076,29,566,34394,958,752,206,958,70200,2020
13241,49.8,16859,14828,242,1331,4442,44871,7022,5186,1836,7022,185500,2020
13243,39.9,6888,2205,4358,237,1690,29400,2704,1351,1353,2704,76100,2020
13245,34.4,202178,68407,112551,10287,42892,43882,72526,37427,35099,72526,115300,2020
13247,38.5,90155,27147,49581,9153,22677,62505,31465,20936,10529,31465,170100,2020
13249,39.1,5215,3388,1410,330,1481,49105,1861,1435,426,1861,134800,2020
13251,41.9,13977,7623,5702,334,3187,39852,4939,3480,1459,4939,85700,2020
13253,45.1,8218,5038,2885,101,2166,35286,3364,2219,1145,3364,92100,2020
13255,39,66043,38196,22567,3121,17683,48970,25693,16438,9255,25693,134800,2020
13257,41.6,25934,21215,2920,958,6609,46766,9977,7274,2703,9977,123800,2020
13259,39.2,6446,1459,3674,1017,1099,34028,1845,1300,545,1845,44100,2020
13261,35.7,29714,11603,15703,1727,7109,37174,11419,6588,4831,11419,122000,2020
13263,50.3,6245,2522,3538,49,1927,40020,2891,2269,622,2891,98800,2020
13265,45.2,1596,582,934,70,442,37717,662,506,156,662,63500,2020
13267,37.7,25392,14454,7332,3012,5773,44053,8345,5607,2738,8345,89800,2020
13269,44,8126,4671,3090,59,2315,28550,3623,2181,1442,3623,87100,2020
13271,42.1,15871,7777,6188,1815,3121,32764,4481,3149,1332,4481,69300,2020
13273,40.3,8654,3091,5002,252,2222,35335,3355,1878,1477,3355,93400,2020
13275,39.5,44545,25639,16396,1669,12289,47133,17750,11054,6696,17750,150300,2020
13277,36.1,40590,22363,11914,4890,9828,44827,14868,9166,5702,14868,123000,2020
13279,36.9,26947,16114,6899,3125,6458,41244,9792,6135,3657,9792,97800,2020
13281,53.5,11815,11072,155,339,3403,51257,5006,4027,979,5006,241900,2020
13283,39.1,6787,4684,1967,126,1584,32072,2395,1501,894,2395,71900,2020
13285,36.7,70095,39107,25613,2578,17080,46796,24982,14978,10004,24982,138300,2020
13287,39.7,7920,4225,3113,385,2179,34514,3208,2067,1141,3208,73600,2020
13289,47.2,8195,4499,3439,128,1998,43477,3080,2654,426,3080,71800,2020
13291,55.2,23999,22483,181,833,6946,49703,10231,8016,2215,10231,199000,2020
13293,42.2,26329,17657,7231,618,5968,39221,10399,6779,3620,10399,102800,2020
13295,41.7,69398,62876,2669,1646,18599,46601,26306,19193,7113,26306,121600,2020
13297,39.1,93284,68838,16920,4343,24301,65491,32094,24420,7674,32094,210500,2020
13299,39.3,35745,22430,10880,1477,8317,37041,13657,8693,4964,13657,86800,2020
13301,45.2,5259,1985,3202,0,1519,38250,2261,1502,759,2261,64600,2020
13303,41,20316,8578,10736,526,5225,36402,7719,5147,2572,7719,92500,2020
13305,38.2,29959,21298,6085,1922,7242,45773,10479,6586,3893,10479,116000,2020
13307,43.9,2587,1372,850,322,649,31629,1115,972,143,1115,69700,2020
13309,27.8,7897,4408,3073,397,1036,28864,1774,1231,543,1774,55500,2020
13311,46.7,29962,27651,735,979,8733,55788,11727,8933,2794,11727,182700,2020
13313,36.2,104122,60444,3512,36952,26056,50055,36412,23988,12424,36412,142800,2020
13315,40.7,8701,5117,3095,414,1754,39216,2542,1946,596,2542,62000,2020
13317,45.8,9797,5019,4104,509,2531,36486,4115,2635,1480,4115,79000,2020
13319,43,8945,5068,3492,262,2028,36896,3301,2548,753,3301,70100,2020
13321,42.6,20346,13651,5724,454,5995,50913,7982,5552,2430,7982,93400,2020
15001,42.8,201350,60094,1214,26579,48192,65401,71747,49721,22026,71747,364100,2020
15003,38.2,979682,175756,22604,98422,220102,87722,316928,182360,134568,316928,702300,2020
15005,43.8,436,57,3,2,164,76465,306,0,306,306,NA,2020
15007,42.3,71949,21036,327,8181,16392,82818,23331,15178,8153,23331,606900,2020
15009,41.8,166657,49417,982,19382,39632,84363,55620,34778,20842,55620,657400,2020
16001,37.2,469473,395230,5342,39526,116415,69952,179708,126138,53570,179708,298600,2020
16003,55.3,4200,3852,14,158,1170,50309,1726,1421,305,1726,228500,2020
16005,34.1,86742,71994,496,7707,20266,51977,31669,21681,9988,31669,167300,2020
16007,39.4,6054,5615,18,261,1844,52829,2455,1927,528,2455,154500,2020
16009,46,9231,7808,36,365,2423,47983,3564,2627,937,3564,177500,2020
16011,34.1,46246,34129,89,8401,11617,58260,15612,12216,3396,15612,168200,2020
16013,43.7,22729,16820,137,5210,5379,64627,8318,6039,2279,8318,458100,2020
16015,54.4,7625,6865,24,373,2273,51760,3351,2771,580,3351,234900,2020
16017,47.9,44688,41309,103,1483,12359,51594,17998,13706,4292,17998,275700,2020
16019,33,116970,96597,432,15543,28782,61435,40946,28568,12378,40946,202100,2020
16021,43.8,12156,10895,36,624,3050,45319,4596,3505,1091,4596,235000,2020
16023,46.8,2603,2489,3,102,620,37404,966,762,204,966,146600,2020
16025,44.5,1069,1011,0,28,229,36908,391,295,96,391,164900,2020
16027,33.8,223890,156398,775,56751,53809,56916,75494,54415,21079,75494,211600,2020
16029,37.9,7028,6414,0,446,1910,58099,2562,2000,562,2562,151100,2020
16031,33.3,23847,16352,50,6519,6092,52256,7832,5414,2418,7832,168400,2020
16033,37.7,885,489,8,347,179,36429,332,181,151,332,122900,2020
16035,50.8,8735,7860,39,369,1967,42413,3547,2694,853,3547,167700,2020
16037,53,4193,3571,6,299,1194,44757,1889,1506,383,1889,216700,2020
16039,31.8,27043,19474,679,4696,6849,45656,10885,6635,4250,10885,164400,2020
16041,33.5,13736,12406,16,927,3534,59934,4432,3713,719,4432,222200,2020
16043,37.8,13111,11167,29,1600,3555,56825,4464,3627,837,4464,168400,2020
16045,45,17771,15494,15,1526,4906,53720,6822,5149,1673,6822,198700,2020
16047,38.6,15280,10304,5,4490,3840,50057,5615,3912,1703,5615,156500,2020
16049,50.5,16511,14995,34,568,4472,44951,6462,5008,1454,6462,197200,2020
16051,31.9,29238,25327,4,3077,7060,65577,8825,7162,1663,8825,223900,2020
16053,32.8,24074,14640,33,8831,6017,55521,8004,5449,2555,8004,178300,2020
16055,40.3,161676,144254,568,7776,44873,60903,64475,45958,18517,64475,294100,2020
16057,29.5,40052,35093,482,1777,8601,51312,15737,8720,7017,15737,245200,2020
16059,53.4,7929,7408,2,264,2137,38819,3717,2931,786,3717,192100,2020
16061,48.7,3850,3151,21,185,924,42370,1649,1230,419,1649,150000,2020
16063,35.8,5342,3510,0,1653,1237,52363,1804,1250,554,1804,152500,2020
16065,23.5,39725,35023,100,3066,9703,44419,11858,4944,6914,11858,229800,2020
16067,35.2,20817,12856,29,7331,5412,53011,7456,5292,2164,7456,155600,2020
16069,40.4,40468,35052,23,1721,10804,57099,16548,12077,4471,16548,205600,2020
16071,39.5,4429,4104,4,195,1183,54484,1715,1406,309,1715,182700,2020
16073,40.4,11724,8066,63,3050,3169,48601,4429,3185,1244,4429,160900,2020
16075,39.4,23705,18330,14,4145,6275,52788,9086,6423,2663,9086,183600,2020
16077,38.8,7635,4682,2,2596,1767,51014,2693,1780,913,2693,149100,2020
16079,46.8,12700,11574,110,469,3207,40483,5436,3909,1527,5436,133000,2020
16081,37.1,11776,9549,0,1936,2744,73274,4290,3350,940,4290,358100,2020
16083,35,86198,66949,703,14344,21932,53363,31758,22107,9651,31758,182100,2020
16085,50.4,11085,10424,9,520,2879,63115,3920,3248,672,3920,306900,2020
16087,45,10128,7999,5,1712,2733,42126,4263,3097,1166,4263,163000,2020
17001,41.4,65670,59988,2641,1079,17398,55052,27199,19474,7725,27199,130500,2020
17003,46.6,6011,3769,2107,62,1335,34709,2252,1685,567,2252,56100,2020
17005,42.5,16520,14471,1106,593,4033,53568,6359,4662,1697,6359,116900,2020
17007,38.7,53293,38646,1319,11825,13580,70396,18799,15499,3300,18799,160600,2020
17009,38.9,6599,4874,1184,441,1227,60694,2090,1601,489,2090,99800,2020
17011,44.2,32878,28659,262,3067,9160,55549,13801,10393,3408,13801,103900,2020
17013,46.8,4782,4601,29,61,1214,66602,1661,1473,188,1661,131800,2020
17015,48,14398,13380,300,546,3985,52813,6511,4935,1576,6511,102200,2020
17017,39.4,12324,9230,464,2368,3298,53899,5068,3820,1248,5068,81700,2020
17019,30.4,210006,139664,27967,12770,42618,53936,83059,44088,38971,83059,166600,2020
17021,43.7,32705,31048,504,528,8212,52120,13977,10329,3648,13977,93200,2020
17023,41.9,15602,15069,83,245,4931,59481,6726,5243,1483,6726,94900,2020
17025,42.1,13217,12687,58,33,3615,52167,5607,4164,1443,5607,84400,2020
17027,40.6,37549,34219,1215,1189,9644,67179,14596,11621,2975,14596,145700,2020
17029,36.6,51065,46330,1980,1371,11903,46411,20972,12596,8376,20972,105100,2020
17031,37,5169517,2168964,1184373,1308432,1183425,67886,1991474,1139938,851536,1991474,255500,2020
17033,42.2,18833,17110,1079,430,5037,50968,7704,5914,1790,7704,94100,2020
17035,42.2,10787,10410,11,103,2874,59271,4229,3432,797,4229,106300,2020
17037,31.3,104588,79607,7573,11947,22994,62353,38616,22375,16241,38616,182300,2020
17039,44.2,15764,14887,150,445,4153,57727,6732,5129,1603,6732,103600,2020
17041,38.2,19551,17593,154,1432,5141,59620,7600,5767,1833,7600,120500,2020
17043,39.5,926005,612736,44091,132736,240761,94930,344314,251301,93013,344314,315600,2020
17045,45.8,17272,16713,106,217,5151,48543,7851,5838,2013,7851,82800,2020
17047,44.1,6431,6203,28,88,1779,53801,2756,2212,544,2756,81000,2020
17049,39.5,34151,32646,184,723,9191,59932,13856,10623,3233,13856,151700,2020
17051,42,21418,19723,944,384,5298,45634,7918,6440,1478,7918,93200,2020
17053,43.2,13155,12225,124,466,3575,50582,5824,4321,1503,5824,98600,2020
17055,43,38688,36988,216,677,9923,43671,16207,12155,4052,16207,77000,2020
17057,43.9,34654,31747,1272,1066,8650,52243,14072,11093,2979,14072,92600,2020
17059,45.9,4983,4757,18,54,1456,43092,2274,1752,522,2274,76400,2020
17061,42.5,12988,12506,193,156,3320,51746,4984,3865,1119,4984,83400,2020
17063,38.1,50798,43546,575,5178,14250,75767,20071,14619,5452,20071,199800,2020
17065,44.3,8151,7811,26,123,2355,55977,3366,2616,750,3366,104900,2020
17067,45.7,17820,17051,85,280,4885,55818,7542,6152,1390,7542,88500,2020
17069,48.8,3890,3737,97,30,949,50847,1515,1194,321,1515,77500,2020
17071,50.8,6737,6434,11,123,2038,55759,3028,2517,511,3028,85800,2020
17073,43.4,49032,44176,859,2868,13611,60000,19996,15761,4235,19996,122200,2020
17075,44.5,27437,24577,216,1943,7803,54445,11845,9041,2804,11845,107300,2020
17077,32.1,57517,42522,8599,2541,12369,39689,24208,12202,12006,24208,114300,2020
17079,44.1,9547,9277,34,60,2667,55911,3791,3156,635,3791,99900,2020
17081,41.2,37774,32041,2972,1069,9898,51662,14792,10623,4169,14792,97100,2020
17083,43,21776,20787,98,319,5439,67845,8158,6695,1463,8158,148800,2020
17085,50.4,21429,20255,119,662,6529,59223,10069,7718,2351,10069,156300,2020
17087,43.8,12391,10597,1277,382,3036,55363,4174,3478,696,4174,117500,2020
17089,37.7,531756,301506,27625,169901,133017,83374,181845,135623,46222,181845,245500,2020
17091,38.2,109924,78444,16291,11681,26494,59370,40297,27022,13275,40297,152800,2020
17093,35.5,127583,86955,9529,24737,32731,96854,41398,34563,6835,41398,243700,2020
17095,42,50052,41226,4369,2993,11420,44464,20428,13584,6844,20428,83700,2020
17097,38.5,699682,425678,45535,153498,180333,92654,248684,182892,65792,248684,271700,2020
17099,42.1,108998,92632,2858,10751,29344,60069,45089,32605,12484,45089,130600,2020
17101,41.6,15830,13398,1514,446,3886,53087,6166,4406,1760,6166,80500,2020
17103,43.5,34204,29391,1818,2192,8047,59986,13634,9485,4149,13634,122600,2020
17105,41.6,35757,31792,1388,1707,9467,58676,14366,10333,4033,14366,114000,2020
17107,40,28818,24807,2124,997,6967,58122,10958,7815,3143,10958,107600,2020
17109,33.7,30107,26341,1453,860,5755,43591,11573,7323,4250,11573,91700,2020
17111,40.2,307291,246788,4194,41218,84557,90014,113269,90779,22490,113269,234000,2020
17113,33.3,172164,136202,14099,8690,39665,68037,66225,43005,23220,66225,166400,2020
17115,41.1,104688,79270,16470,2451,26176,53725,43810,30265,13545,43810,103100,2020
17117,43.9,45243,43319,449,572,12528,56264,18577,13986,4591,18577,102900,2020
17119,40.3,264403,223418,22590,8885,70774,64045,108429,78424,30005,108429,138500,2020
17121,42.4,37524,34013,1266,795,9854,49925,16126,12022,4104,16126,81600,2020
17123,46.4,11562,10885,37,349,3156,57303,4922,3967,955,4922,105700,2020
17125,45.4,13486,13002,59,157,3815,50883,5917,4587,1330,5917,87600,2020
17127,43.7,14041,12282,777,426,3811,51195,5619,4330,1289,5619,88500,2020
17129,43.4,12261,11702,78,191,3814,77550,5211,4098,1113,5211,151900,2020
17131,44.8,15503,14708,70,394,4401,57182,6477,5098,1379,6477,111000,2020
17133,42.3,34444,33156,91,550,10249,89648,13576,11526,2050,13576,220600,2020
17135,43,28598,26502,1049,519,7164,54886,11619,8875,2744,11619,90300,2020
17137,40.9,34012,29872,2256,878,8248,53002,13560,9422,4138,13560,109700,2020
17139,40.6,14557,14045,121,219,4068,64033,6043,4604,1439,6043,108300,2020
17141,42.5,50793,43613,529,5258,13816,63643,20967,15070,5897,20967,150400,2020
17143,37.6,181111,125366,32055,8939,43566,55729,73519,47855,25664,73519,130700,2020
17145,41.9,21092,18099,1803,666,5680,51616,8504,6271,2233,8504,85700,2020
17147,42.1,16412,15746,177,231,4772,73668,6755,5561,1194,6755,143000,2020
17149,42.2,15571,14865,135,203,3916,46605,6258,4968,1290,6258,83500,2020
17151,56.8,4177,3736,239,125,1034,43140,1618,1286,332,1618,114600,2020
17153,45.5,5414,3447,1651,132,1223,37308,2050,1529,521,2050,61300,2020
17155,47.3,5720,5246,27,333,1668,64694,2435,1976,459,2435,134800,2020
17157,42.2,31973,27063,3378,1032,7875,55319,12047,8848,3199,12047,110900,2020
17159,42.5,15677,14843,100,272,4281,55032,6527,4776,1751,6527,88800,2020
17161,40.1,142801,101660,14017,18650,37282,55980,60607,41169,19438,60607,123100,2020
17163,39.1,261186,159367,77583,11025,66258,57473,104631,68919,35712,104631,134800,2020
17165,42.2,23735,21724,521,418,6621,43928,10140,7529,2611,10140,77900,2020
17167,40.6,195963,156480,24746,4622,50068,61743,84093,58861,25232,84093,144100,2020
17169,48,6897,6393,349,59,1557,51376,2730,2099,631,2730,96900,2020
17171,45,4982,4806,21,58,1427,59352,1973,1628,345,1973,91800,2020
17173,45.1,21623,20992,135,241,6251,59134,9158,7350,1808,9158,105500,2020
17175,45.1,5393,5094,32,106,1505,53828,2304,1849,455,2304,87500,2020
17177,45.5,44683,36541,4271,1858,12669,50466,19741,13792,5949,19741,99600,2020
17179,41.3,132524,124138,1547,3201,35377,66220,53997,41235,12762,53997,142300,2020
17181,43.8,16829,15299,221,888,4441,51655,6813,5314,1499,6813,110500,2020
17183,40.8,76704,59737,10835,3956,19041,46842,31013,21964,9049,31013,80900,2020
17185,44.3,11390,10717,21,255,3072,48878,4780,3847,933,4780,80900,2020
17187,39.8,16981,14097,680,1657,4532,54291,6789,5120,1669,6789,86900,2020
17189,44.5,13967,13410,89,203,4084,64390,6020,4747,1273,6020,117400,2020
17191,43.6,16309,15683,152,256,4613,50205,7114,5459,1655,7114,89000,2020
17193,44.8,13712,13195,120,207,3899,48303,6040,4825,1215,6040,75400,2020
17195,43.6,55583,46737,680,6809,14817,57172,23225,17264,5961,23225,107800,2020
17197,38.1,689704,434072,76490,122209,174356,90800,232395,189122,43273,232395,239400,2020
17199,41,66929,59825,2635,1807,17434,52076,27937,19712,8225,27937,120900,2020
17201,39.8,283635,193136,36301,37130,74245,55310,115768,75877,39891,115768,121400,2020
17203,40.3,38503,36737,233,721,10584,74777,14652,11807,2845,14652,170800,2020
18001,33.2,35544,33161,352,1626,8769,52712,12512,9739,2773,12512,142100,2020
18003,36,375520,274722,41860,28676,93168,57104,147043,100935,46108,147043,136700,2020
18005,38,83280,67114,1259,6018,20849,66978,31772,22529,9243,31772,163400,2020
18007,40.8,8695,8014,50,473,2244,52656,3435,2546,889,3435,98900,2020
18009,44.5,11926,11374,52,207,3311,44341,5105,3676,1429,5105,73500,2020
18011,38.1,66875,60151,1177,2108,18826,89444,25822,20293,5529,25822,245200,2020
18013,49.3,15093,14400,184,272,4950,66833,6372,5439,933,6372,206600,2020
18015,43.2,20137,18837,115,867,5371,56159,8123,6437,1686,8123,133600,2020
18017,40.6,37727,29809,428,5922,9466,49020,14950,10978,3972,14950,91500,2020
18019,39.1,117410,96756,7386,6450,29502,57111,45024,32683,12341,45024,152000,2020
18021,42.1,26231,25089,151,393,7529,59398,10454,8190,2264,10454,104200,2020
18023,37.6,32186,26332,185,5174,7838,53750,12144,8511,3633,12144,119000,2020
18025,42.7,10582,10140,40,169,2682,41761,4117,3384,733,4117,89500,2020
18027,34.4,33277,29795,571,1777,7804,53800,11354,7985,3369,11354,139800,2020
18029,42.6,49612,47702,333,667,13877,70779,19279,15684,3595,19279,174500,2020
18031,39.6,26587,25159,39,550,6677,60794,10241,7211,3030,10241,139500,2020
18033,38.5,43193,41013,165,1240,11778,58415,16904,13388,3516,16904,129100,2020
18035,35.7,114461,99008,7651,2873,27219,45910,46632,30058,16574,46632,96600,2020
18037,40.3,42534,38271,230,3380,10752,62846,16691,13124,3567,16691,162400,2020
18039,35.6,205184,152461,10798,33339,50204,58509,72362,50964,21398,72362,149300,2020
18041,42.9,23068,21709,577,297,6556,47465,9686,6686,3000,9686,84000,2020
18043,39.9,77879,68157,3987,2664,19447,67603,29264,21752,7512,29264,179100,2020
18045,43,16456,15653,65,427,4585,52334,6982,5178,1804,6982,107600,2020
18047,42,22750,21988,32,267,6361,68180,8867,7224,1643,8867,167200,2020
18049,41.6,20069,18375,135,1060,5037,50597,7840,5978,1862,7840,109200,2020
18051,40.6,33711,31305,782,568,9401,56638,13551,10223,3328,13551,123900,2020
18053,40.2,66055,55888,4622,2938,17402,46900,26896,18713,8183,26896,96300,2020
18055,43.1,32174,30935,110,531,8828,51777,12988,10187,2801,12988,101300,2020
18057,37.6,330455,274357,12736,13662,92017,98880,123066,94391,28675,123066,282700,2020
18059,40.1,76614,70403,2088,1931,21243,75647,29627,23731,5896,29627,179300,2020
18061,42.6,40164,38173,219,805,9862,59169,14534,12082,2452,14534,159500,2020
18063,37.9,166806,138805,11643,6831,45201,84754,60307,47287,13020,60307,205300,2020
18065,42,48158,44984,1199,916,12111,51104,18387,13686,4701,18387,101800,2020
18067,41.4,82486,69694,6523,2877,22017,56387,34632,24980,9652,34632,113900,2020
18069,41.4,36351,34318,318,905,9647,54286,14790,11161,3629,14790,109200,2020
18071,39.2,44077,38454,596,3238,11830,55097,16923,12001,4922,16923,131000,2020
18073,40.5,33433,30095,289,2050,8690,61889,12676,9853,2823,12676,158300,2020
18075,40.2,20697,19604,64,666,5399,45864,8293,6238,2055,8293,90800,2020
18077,41.1,32167,29727,691,918,8024,51981,12833,8889,3944,12833,139000,2020
18079,39.4,27639,26205,277,728,7610,61610,10776,8357,2419,10776,111000,2020
18081,37.6,156148,137744,3995,5711,41004,72928,57872,42131,15741,57872,178500,2020
18083,39.2,36833,33787,1056,834,9784,47394,15186,9549,5637,15186,97900,2020
18085,38.9,79156,69253,518,6386,21310,62789,31462,23504,7958,31462,153500,2020
18087,31.8,39537,37181,63,1639,9894,69331,12547,10596,1951,12547,194600,2020
18089,39.1,485983,259931,113673,94064,123664,57530,188646,132172,56474,188646,156100,2020
18091,40.3,110026,86458,11588,7510,27650,57010,42725,31297,11428,42725,139900,2020
18093,43.5,45552,43292,197,766,12657,57740,18968,15110,3858,18968,126200,2020
18095,40.5,129486,109125,10229,5492,33183,51476,51276,35418,15858,51276,103800,2020
18097,34.4,957337,519576,267142,100911,207416,51219,377695,206070,171625,377695,145200,2020
18099,39.7,46336,40358,278,4731,12176,54207,17430,13061,4369,17430,144400,2020
18101,41.8,10169,9570,82,247,2508,55378,4095,3226,869,4095,125400,2020
18103,39.8,35684,31534,1583,1225,9000,50616,13531,9789,3742,13531,91100,2020
18105,29.9,147318,122700,4807,5169,29601,52229,56399,31146,25253,56399,189900,2020
18107,40.6,38295,35084,323,1872,10135,56408,15618,11632,3986,15618,132200,2020
18109,41.4,70141,66924,201,1176,19281,67680,26460,20965,5495,26460,165300,2020
18111,44.1,13981,12674,181,953,3877,57866,5599,4511,1088,5599,116000,2020
18113,38.9,47640,41363,301,4974,12486,58947,18133,13852,4281,18133,132400,2020
18115,47.8,5890,5614,31,80,1772,63649,2623,2000,623,2623,146500,2020
18117,42.3,19552,18526,494,145,5441,52164,7988,6011,1977,7988,102400,2020
18119,45.3,20854,20027,6,271,5767,52204,8830,6853,1977,8830,125200,2020
18121,43.2,16912,15986,225,265,4431,55853,6005,4751,1254,6005,96400,2020
18123,42.2,19091,17931,511,281,4816,51496,7713,5777,1936,7713,114600,2020
18125,44.3,12364,11897,94,181,3291,55022,5294,4460,834,5294,109400,2020
18127,39.4,169482,139571,6273,17335,43927,72255,65153,48788,16365,65153,193500,2020
18129,42.7,25480,24323,411,314,7391,64983,10361,8343,2018,10361,150900,2020
18131,41.4,12482,11715,21,391,3223,49140,5113,3779,1334,5113,114100,2020
18133,38,37419,34253,943,753,9593,61505,13651,10108,3543,13651,144900,2020
18135,42.9,24694,22782,109,899,6755,53322,10358,8135,2223,10358,83700,2020
18137,40.6,28457,27089,96,526,7886,60055,11243,8546,2697,11243,156400,2020
18139,42.5,16632,15896,312,283,4543,56814,6648,4559,2089,6648,115900,2020
18141,36.7,270881,194591,34034,24153,63705,54433,104380,70887,33493,104380,134800,2020
18143,41.8,23785,22517,42,574,5857,45123,9228,6205,3023,9228,107800,2020
18145,40.6,44559,40965,465,1984,11666,59712,17902,13100,4802,17902,139300,2020
18147,44.3,20364,19233,131,604,5673,56919,8321,6625,1696,8321,133200,2020
18149,41.6,22996,21544,166,919,5772,49705,8490,6958,1532,8490,111100,2020
18151,43.6,34591,32354,130,1288,9401,58905,14449,11377,3072,14449,154300,2020
18153,41.3,20647,18864,771,368,5389,49449,7806,5909,1897,7806,89400,2020
18155,40.7,10727,10216,63,211,2811,51270,4430,3448,982,4430,116000,2020
18157,28.4,193302,145249,10618,16372,40436,51926,71686,39564,32122,71686,160900,2020
18159,44.9,15154,14330,8,458,4601,68707,6360,5202,1158,6360,123900,2020
18161,44,7140,6777,6,155,2038,55278,2848,2174,674,2848,128200,2020
18163,38.6,181548,150944,17189,5034,45548,51179,76094,49328,26766,76094,136100,2020
18165,42.8,15485,14937,106,208,4699,54361,6557,4939,1618,6557,83900,2020
18167,36.4,107305,91459,7702,2971,24795,47261,42657,27045,15612,42657,105200,2020
18169,42.5,31198,29356,309,832,8608,56573,12705,9653,3052,12705,109600,2020
18171,44.9,8219,7852,52,166,2564,65614,3383,2763,620,3383,120300,2020
18173,41.5,62608,57108,1147,1213,18114,79079,24607,20046,4561,24607,173900,2020
18175,41.2,27942,27012,18,374,7502,50459,10820,8699,2121,10820,120100,2020
18177,40.5,66176,58010,3133,2065,17552,47756,27435,18320,9115,27435,102400,2020
18179,40.7,28010,26248,228,873,7766,57565,11122,8613,2509,11122,132500,2020
18181,42.8,24163,21485,149,2083,6661,53865,9792,7690,2102,9792,119200,2020
18183,41.8,33899,32101,128,726,9688,64992,13822,11258,2564,13822,151900,2020
19001,45.2,7048,6717,34,157,2018,55700,3217,2250,967,3217,111100,2020
19003,47.2,3633,3496,4,53,1009,52287,1627,1315,312,1627,81400,2020
19005,44.2,13761,12371,164,945,3655,55523,5947,4764,1183,5947,133400,2020
19007,45.8,12462,11828,77,264,3259,39693,5196,3762,1434,5196,85000,2020
19009,48.5,5528,5315,2,45,1572,49245,2691,2019,672,2691,84300,2020
19011,43.1,25558,24439,84,394,7261,66046,10306,8433,1873,10306,158700,2020
19013,35.4,131813,105929,12513,5952,31329,54774,53321,34990,18331,53321,150200,2020
19015,42.1,26381,24858,299,719,7076,67442,10801,8444,2357,10801,141000,2020
19017,39.2,25032,23735,251,407,6745,72209,9680,8046,1634,9680,169000,2020
19019,39,21141,20272,30,344,5628,67252,8027,6422,1605,8027,143200,2020
19021,35,19950,11556,450,5179,4607,54014,7584,4893,2691,7584,120300,2020
19023,43.9,14508,13988,116,210,4219,56473,6153,4756,1397,6153,120100,2020
19025,44.5,9656,9068,153,196,2675,55285,4103,3229,874,4103,85600,2020
19027,42.5,20150,18989,103,525,5402,59198,8651,6590,2061,8651,138700,2020
19029,45.2,12990,12332,79,381,3529,52005,5901,4289,1612,5901,107200,2020
19031,42.8,18475,17612,150,398,4969,69259,7472,6008,1464,7472,163100,2020
19033,44.2,42672,38368,756,2143,11532,56082,19452,13534,5918,19452,130400,2020
19035,45.9,11281,10401,344,94,3125,56302,5297,3906,1391,5297,117400,2020
19037,43.7,11970,11408,63,338,3321,61239,5107,4191,916,5107,122000,2020
19039,39.9,9383,7663,11,1425,2437,55078,3950,2736,1214,3950,115400,2020
19041,41.6,16138,15014,19,622,4373,51259,7381,4983,2398,7381,129700,2020
19043,48.2,17527,16808,138,352,4720,56456,7563,5550,2013,7563,131600,2020
19045,42.8,46734,42459,1323,1491,12047,52221,19477,14441,5036,19477,120200,2020
19047,36.4,16998,11050,512,4847,4515,54849,6388,4433,1955,6388,101100,2020
19049,35.4,90418,76148,1720,5583,23507,88368,35383,25550,9833,35383,258300,2020
19051,36.5,8977,8680,0,137,2399,67627,3182,2693,489,3182,117900,2020
19053,36,7908,7256,96,252,2033,48154,3242,2095,1147,3242,82800,2020
19055,43.7,17107,16400,40,266,4750,63877,6915,5735,1180,6915,141300,2020
19057,42.7,39227,34066,2343,1318,10504,51784,16850,11739,5111,16850,111600,2020
19059,48.2,17260,16438,31,375,5002,60975,8479,6602,1877,8479,199800,2020
19061,38.5,97193,87721,3007,2511,25188,64493,38655,28382,10273,38655,175300,2020
19063,42.8,9322,8064,187,907,2327,56708,4023,3172,851,4023,90000,2020
19065,43.8,19604,18230,288,511,5032,49834,8215,6094,2121,8215,106200,2020
19067,44.3,15713,14171,241,574,4136,51768,6899,5051,1848,6899,107700,2020
19069,43.5,10091,8548,133,1305,2858,55630,4195,2956,1239,4195,93200,2020
19071,46.1,6895,6511,57,201,1908,59688,2952,2264,688,2952,113200,2020
19073,44.2,8923,8413,16,264,2485,51098,4037,2942,1095,4037,93500,2020
19075,42.4,12262,11858,85,164,3594,71760,5164,4236,928,5164,138100,2020
19077,45.8,10702,10144,26,295,3108,62644,4478,3639,839,4478,129000,2020
19079,42.6,14905,13252,184,922,3988,60248,6122,4569,1553,6122,105200,2020
19081,44.5,10709,9872,143,499,3312,61957,4787,3806,981,4787,100900,2020
19083,44.5,16924,15493,212,760,4436,54930,7185,5322,1863,7185,95100,2020
19085,43.5,14043,13450,41,267,4230,64154,6094,4495,1599,6094,124000,2020
19087,40.3,19889,17454,446,989,5101,54490,7591,5536,2055,7591,118500,2020
19089,40.9,9201,8864,33,153,2555,56709,3754,2898,856,3754,105800,2020
19091,41.9,9518,8851,26,433,2584,55707,4195,3140,1055,4195,109200,2020
19093,42.7,6862,6499,109,191,1902,54219,2972,2248,724,2972,102400,2020
19095,42.6,16155,15197,54,483,4500,62660,6646,5342,1304,6646,156000,2020
19097,43.6,19348,18404,138,296,5475,59042,8183,6619,1564,8183,127600,2020
19099,41.8,37032,34495,553,899,10010,59481,14644,10950,3694,14644,137200,2020
19101,42.9,18153,14702,420,573,3834,47401,6855,4771,2084,6855,120600,2020
19103,30.4,150819,117015,11409,8634,32700,63062,60430,35412,25018,60430,238600,2020
19105,43.2,20575,19151,453,422,5231,57134,8186,6433,1753,8186,140000,2020
19107,43.4,10163,9768,40,205,2651,52012,4330,3389,941,4330,95800,2020
19109,44.8,14864,13995,169,469,4019,56156,6575,4889,1686,6575,109400,2020
19111,43.3,33946,30765,1015,1241,9388,52072,14338,10612,3726,14338,98400,2020
19113,37.7,225601,191912,12292,7647,57087,67301,91304,67843,23461,91304,161600,2020
19115,41.5,11125,8656,126,1774,3060,63034,4343,3321,1022,4343,107900,2020
19117,44.2,8556,8268,23,189,2540,53967,3718,2843,875,3718,94200,2020
19119,37.8,11800,11223,12,335,3364,65959,4593,3922,671,4593,160700,2020
19121,40.8,16148,15319,80,354,4929,71811,6619,5254,1365,6619,186700,2020
19123,38.8,22351,20718,342,510,5909,56417,8947,6087,2860,8947,113100,2020
19125,39.6,33193,31293,350,676,9331,64136,13532,9976,3556,13532,160100,2020
19127,38.3,39804,27719,372,9050,10013,58735,15388,11062,4326,15388,104400,2020
19129,42.9,15023,14115,72,500,3675,75137,5442,4300,1142,5442,178500,2020
19131,42.5,10588,10239,46,163,2948,60260,4472,3584,888,4472,120400,2020
19133,47.1,8675,8184,28,191,2395,51866,3988,2941,1047,3988,90000,2020
19135,42,7761,7354,2,178,1997,59489,3243,2543,700,3243,113800,2020
19137,44.7,10016,9335,15,403,2837,55761,4479,3237,1242,4479,85300,2020
19139,38.2,42703,32611,1001,7742,11115,60435,16543,12304,4239,16543,135400,2020
19141,41.8,13796,12710,213,711,3613,57200,5976,4456,1520,5976,116300,2020
19143,44.5,6016,5304,55,499,1641,61167,2664,2052,612,2664,96600,2020
19145,44.4,15205,13788,332,554,3881,51196,6414,4507,1907,6414,96400,2020
19147,42.5,8941,8232,125,268,2178,56437,3712,2808,904,3712,107300,2020
19149,40.5,25141,22929,361,1353,7446,71147,10298,7899,2399,10298,172600,2020
19151,46.2,6725,6231,28,273,1858,53573,3127,2386,741,3127,81900,2020
19153,35.7,485418,373665,32954,41226,117120,69747,191125,128152,62973,191125,190400,2020
19155,39.6,93478,81397,1501,7470,23655,59901,36875,25369,11506,36875,141300,2020
19157,41.2,18391,16832,245,604,4701,53925,7827,5190,2637,7827,148200,2020
19159,44.3,4922,4680,5,129,1235,55970,1843,1380,463,1843,113000,2020
19161,46.2,9711,9177,70,337,2776,57446,4344,3442,902,4344,101200,2020
19163,38.4,172938,136920,12644,12031,42744,63876,67437,47289,20148,67437,167900,2020
19165,46.5,11544,10875,115,353,3213,60139,5066,3794,1272,5066,120700,2020
19167,33.6,34900,30260,143,3805,8966,73260,12379,10000,2379,12379,182500,2020
19169,26.8,97355,81016,2099,3487,18911,58302,37997,20703,17294,37997,195200,2020
19171,41.7,16962,13559,106,1790,4394,54749,6736,5125,1611,6736,114400,2020
19173,43.6,6160,5549,1,492,1591,57768,2567,2092,475,2567,84100,2020
19175,40.6,12303,11524,21,378,3139,50375,5199,3759,1440,5199,109600,2020
19177,45.6,7104,6823,21,117,1929,49898,2969,2399,570,2969,91200,2020
19179,39.6,35102,28586,1222,3844,9333,46433,14404,9752,4652,14404,87400,2020
19181,38.5,50867,47769,287,1503,13363,80309,19320,15526,3794,19320,196100,2020
19183,40.5,22100,19998,147,1432,6283,63532,8876,6100,2776,8876,158600,2020
19185,41.8,6426,6096,12,105,1683,47543,2620,2109,511,2620,79900,2020
19187,39.3,36348,31309,1551,1978,8886,51909,15605,10662,4943,15605,107900,2020
19189,41.9,10474,9549,148,520,2627,51581,4533,3525,1008,4533,96200,2020
19191,41.9,20090,19072,183,463,5269,63162,8265,6444,1821,8265,183300,2020
19193,35.8,102687,73746,3494,17583,25810,60768,39523,26638,12885,39523,131300,2020
19195,43.6,7422,6988,59,226,2100,60442,3199,2545,654,3199,107600,2020
19197,42.3,12644,10865,19,1584,3423,51221,5582,4082,1500,5582,86100,2020
20001,42,12503,11235,77,466,3255,47983,5125,3609,1516,5125,80300,2020
20003,39.7,7877,7415,46,172,2194,52995,3154,2284,870,3154,100300,2020
20005,37.1,16210,14266,492,499,3926,50683,6039,4311,1728,6039,108700,2020
20007,43.1,4493,4052,22,253,1217,49668,1931,1432,499,1931,74400,2020
20009,39.5,26209,21208,249,3947,6837,48863,10628,7160,3468,10628,97100,2020
20011,39.7,14539,13032,423,405,3831,46369,5921,4331,1590,5921,83900,2020
20013,41.7,9575,7895,71,482,2492,50649,3757,2663,1094,3757,87000,2020
20015,38.7,66890,58904,1565,3376,17839,66405,24833,18603,6230,24833,150300,2020
20017,45.2,2604,2347,34,134,714,48906,1082,848,234,1082,102500,2020
20019,47.4,3280,2796,38,135,950,39500,1418,1076,342,1418,51700,2020
20021,42.1,20017,17537,63,562,4914,41936,7954,5666,2288,7954,80700,2020
20023,46.1,2639,2436,0,183,651,42802,1263,1003,260,1263,84200,2020
20025,47.7,2006,1784,12,73,539,52500,890,686,204,890,74300,2020
20027,44.1,8030,7518,81,213,2373,47880,3741,2695,1046,3741,105500,2020
20029,39.8,8831,8177,136,298,2279,48295,3641,2637,1004,3641,77800,2020
20031,44.9,8218,7652,78,238,2468,59405,3648,2782,866,3648,124300,2020
20033,50.7,1759,1629,0,83,458,48125,818,569,249,818,72500,2020
20035,38.7,35090,27745,832,3904,8657,50786,13800,9435,4365,13800,88600,2020
20037,33.6,38874,33486,810,2302,9581,42615,15603,9340,6263,15603,96900,2020
20039,50.6,2826,2693,10,92,768,44125,1414,1052,362,1414,68400,2020
20041,41.5,18614,16834,216,914,4967,53864,7933,5814,2119,7933,116400,2020
20043,41.8,7616,6839,376,216,1927,51953,3003,2303,700,3003,100000,2020
20045,30.2,121304,94090,4812,7762,26281,61020,47972,24333,23639,47972,212400,2020
20047,44.9,2822,2140,11,584,808,50028,1285,1005,280,1285,60700,2020
20049,52.3,2502,2227,2,113,776,42564,1150,936,214,1150,49400,2020
20051,33.2,28747,25655,252,1718,6874,57053,11686,7338,4348,11686,172700,2020
20053,43.6,6176,5277,178,393,1578,56306,2390,1898,492,2390,110100,2020
20055,31.7,36451,14830,1137,18275,8829,60498,12494,8057,4437,12494,159300,2020
20057,32.5,33718,13352,630,18621,7842,53743,11237,7093,4144,11237,109800,2020
20059,40,25643,23246,159,1118,6815,55873,10190,7454,2736,10190,138500,2020
20061,26.6,33309,18445,5778,5560,9035,52019,12866,5362,7504,12866,143100,2020
20063,44.7,2650,2489,7,58,759,53906,1260,924,336,1260,99800,2020
20065,49.3,2464,2173,126,82,696,40890,1252,967,285,1252,77500,2020
20067,32.5,7324,3652,3,3520,1603,60625,2561,1751,810,2561,137000,2020
20069,36.1,6020,4910,0,969,1626,70457,2150,1740,410,2150,142600,2020
20071,40.3,1156,885,0,269,336,53750,491,313,178,491,112100,2020
20073,48.6,6010,5508,12,240,1703,43320,2695,2069,626,2695,64500,2020
20075,36.2,2552,1515,51,944,481,44894,818,633,185,818,75000,2020
20077,42.5,5506,4948,10,342,1492,49283,2367,1692,675,2367,75200,2020
20079,39.2,34434,28205,475,4199,9358,58782,13396,9367,4029,13396,131000,2020
20081,36.9,3990,2649,1,1236,1000,54638,1401,1093,308,1401,96300,2020
20083,48.7,1872,1642,2,175,536,60703,790,622,168,790,93400,2020
20085,40.9,13249,11050,19,667,3742,59686,5429,4046,1383,5429,139400,2020
20087,43.9,18974,17718,129,550,5469,67429,7619,6514,1105,7619,163400,2020
20089,52.8,2854,2680,11,69,861,38188,1386,1147,239,1386,56300,2020
20091,37.8,597574,474054,27388,46561,158351,91650,233599,161108,72491,233599,277500,2020
20093,35.5,3863,2544,50,1224,836,46464,1270,906,364,1270,91200,2020
20095,45.6,7173,6669,40,265,2066,57304,3253,2420,833,3253,92500,2020
20097,41.3,2483,2198,19,150,578,53107,975,678,297,975,132500,2020
20099,41.2,19938,16971,898,945,5323,47922,8270,5872,2398,8270,76500,2020
20101,44.4,1523,1318,0,158,406,41318,737,532,205,737,75100,2020
20103,37.9,81499,63999,6577,5806,19914,76307,27645,18563,9082,27645,195000,2020
20105,45.9,3013,2817,8,66,782,46523,1305,1024,281,1305,75400,2020
20107,44.5,9687,9035,25,278,3145,48325,4509,3577,932,4509,112000,2020
20109,39.7,2789,2515,2,170,777,51136,1144,755,389,1144,89600,2020
20111,33.8,33237,23577,706,7149,7630,50141,13561,7829,5732,13561,113700,2020
20113,40.7,28557,26027,438,1241,8236,59928,12479,8651,3828,12479,154700,2020
20115,44.8,11865,10959,118,450,3109,50816,4838,3850,988,4838,96600,2020
20117,42.8,9713,9167,37,251,2558,52293,4128,3240,888,4128,101600,2020
20119,37.3,4120,3050,38,908,1136,56817,1715,1138,577,1715,101800,2020
20121,42.9,33740,31115,372,1118,9475,75635,13000,10396,2604,13000,212500,2020
20123,43.1,6053,5745,35,154,1584,47375,2593,1802,791,2593,92100,2020
20125,40.3,32114,25368,1686,2231,8434,45288,13767,9571,4196,13767,78900,2020
20127,46.7,5551,5058,8,297,1679,52792,2344,1810,534,2344,94400,2020
20129,39.8,2656,1884,2,629,595,41866,1036,664,372,1036,90300,2020
20131,40.7,10109,9574,57,220,2706,61382,4069,2977,1092,4069,150400,2020
20133,40.5,16008,14280,210,948,4257,49493,6462,4751,1711,6462,83800,2020
20135,49.7,2838,2490,10,308,836,57222,1260,1074,186,1260,74100,2020
20137,41.9,5416,4787,178,285,1172,48486,1865,1430,435,1865,79100,2020
20139,43.6,15855,14754,98,543,4463,58927,6624,5020,1604,6624,123600,2020
20141,46.5,3494,3284,30,79,972,50774,1687,1306,381,1687,66100,2020
20143,42.8,5776,5419,38,170,1734,59607,2433,1918,515,2433,117300,2020
20145,46.2,6539,5493,354,505,1380,46559,2447,1515,932,2447,78800,2020
20147,44.2,5297,4943,31,183,1388,51820,2406,1712,694,2406,82700,2020
20149,35.4,24203,21668,404,1260,6421,70064,8883,6789,2094,8883,176700,2020
20151,39,9324,8194,173,662,2320,54644,3733,2514,1219,3733,107500,2020
20153,48,2490,2224,14,187,767,57281,1169,840,329,1169,101000,2020
20155,40.9,62421,52182,1464,6034,15565,51520,24970,17465,7505,24970,106100,2020
20157,49.5,4607,4369,44,97,1331,50411,2176,1563,613,2176,67100,2020
20159,39.1,9532,7878,177,1099,2591,49688,3939,2887,1052,3939,79500,2020
20161,25.4,74059,56389,4581,6188,14323,51098,26878,11709,15169,26878,205900,2020
20163,44.4,4985,4682,92,129,1389,51362,2167,1590,577,2167,77300,2020
20165,46.8,2953,2712,8,90,723,46333,1448,1058,390,1448,70100,2020
20167,45.3,6896,6339,125,255,1807,50630,3005,2353,652,3005,99900,2020
20169,39.1,54384,43454,1447,6288,13345,51830,22251,14536,7715,22251,141300,2020
20171,39.7,4893,3828,0,903,1430,55625,2062,1253,809,2062,134000,2020
20173,35.5,515416,348133,42040,76702,126223,57540,199320,124213,75107,199320,146300,2020
20175,29.9,21902,6426,864,13607,4979,49395,7183,4480,2703,7183,111200,2020
20177,39.4,177293,129505,14157,22414,45339,58652,72962,48363,24599,72962,135100,2020
20179,43.6,2515,2325,21,138,668,62105,1080,861,219,1080,119000,2020
20181,39.7,5904,4928,24,718,1705,57005,2569,1690,879,2569,107500,2020
20183,51.4,3594,3386,10,89,1107,42098,1664,1289,375,1664,75300,2020
20185,44.2,4125,3437,4,548,1149,51857,1758,1390,368,1758,73900,2020
20187,36.9,2030,1193,0,741,497,57741,850,653,197,850,63200,2020
20189,35.4,5498,3368,34,2021,1316,59044,1770,1208,562,1770,104200,2020
20191,42.1,22928,20457,170,1282,6225,53578,9462,6730,2732,9462,94800,2020
20193,36.7,7748,6911,170,540,2138,68313,3294,2406,888,3294,129600,2020
20195,47,2802,2717,4,66,891,59420,1353,1045,308,1353,103600,2020
20197,44.3,6877,6330,41,281,1919,65742,2722,2260,462,2722,153700,2020
20199,42,1583,1422,4,94,448,49632,651,442,209,651,84500,2020
20201,45.8,5474,5121,6,214,1443,52172,2412,1868,544,2412,84100,2020
20203,41.5,2112,1438,22,619,568,58299,935,697,238,935,101500,2020
20205,43.6,8600,7890,64,289,2483,49682,3627,2670,957,3627,82200,2020
20207,51,3117,2882,5,11,836,42692,1390,1176,214,1390,68700,2020
20209,33.9,165447,66340,34739,48333,38806,48093,60400,35569,24831,60400,107000,2020
21001,40.4,19366,17911,546,402,4693,43026,6991,5404,1587,6991,105400,2020
21003,39.9,21065,20007,116,447,5678,44180,7816,5898,1918,7816,123300,2020
21005,41.7,22580,21066,678,431,5919,54413,8757,6610,2147,8757,158100,2020
21007,44,7914,7307,389,108,2085,45517,3052,2403,649,3052,103800,2020
21009,40.4,44026,39678,1495,1470,11531,41674,17392,11403,5989,17392,127100,2020
21011,40.7,12421,11808,162,209,3489,44893,4885,3496,1389,4885,83900,2020
21013,41.2,26426,24866,654,315,7087,28442,10504,6628,3876,10504,62800,2020
21015,38,132368,115319,4302,5660,34413,82838,47391,35954,11437,47391,194700,2020
21017,41.8,19998,16970,1307,1371,5173,47024,7990,5029,2961,7990,155300,2020
21019,42.1,47361,43898,945,886,11989,51019,18213,12319,5894,18213,110000,2020
21021,40.1,30090,25547,2403,1005,7349,51562,11079,7636,3443,11079,144000,2020
21023,41.7,8308,7968,79,46,2186,60053,3197,2426,771,3197,102700,2020
21025,42.3,12802,12360,185,156,3551,29538,5281,3789,1492,5281,53000,2020
21027,42.4,20283,19065,338,334,5079,47236,7731,6325,1406,7731,104500,2020
21029,40.8,80921,76071,814,1771,22194,65531,29940,24372,5568,29940,171300,2020
21031,41.3,12756,12067,46,433,3449,45955,4823,3482,1341,4823,92000,2020
21033,42.9,12679,11515,925,213,3576,48281,5215,3876,1339,5215,89600,2020
21035,36.3,38991,34882,1351,1076,9046,41841,15492,9730,5762,15492,141200,2020
21037,38.1,93608,86141,2833,1953,23018,63152,37197,26204,10993,37197,173400,2020
21039,42.3,4738,4427,60,113,1302,41222,1925,1573,352,1925,83200,2020
21041,38.7,10691,9460,312,718,2815,41014,4176,2749,1427,4176,105800,2020
21043,41.6,26976,25926,99,298,6675,39492,9624,7577,2047,9624,109500,2020
21045,42.6,15968,15103,125,465,3979,33004,6048,4632,1416,6048,97600,2020
21047,28.3,71470,46513,14698,5812,17471,44279,26097,12240,13857,26097,121000,2020
21049,42.3,36152,32409,1583,1112,10008,54871,14576,10057,4519,14576,151300,2020
21051,40,20110,18359,938,268,5481,27479,7432,5122,2310,7432,61300,2020
21053,42.8,10175,9658,35,294,2481,33092,4023,2811,1212,4023,77900,2020
21055,43.5,8940,8582,58,121,2411,46354,3588,2967,621,3588,97200,2020
21057,46.1,6660,6149,159,92,1502,35030,2642,1910,732,2642,110000,2020
21059,38.9,101001,88298,4608,3304,26822,54881,40229,26792,13437,40229,143500,2020
21061,44,12195,11559,213,172,3462,44229,5028,4243,785,5028,91900,2020
21063,42.4,7461,7120,263,67,1752,36950,2412,1872,540,2412,76600,2020
21065,44.3,14187,13728,14,173,3685,32800,5640,3926,1714,5640,78200,2020
21067,34.8,322200,226571,46635,23242,74500,58954,130926,71547,59379,130926,200900,2020
21069,41.8,14519,13899,323,117,4202,42087,5890,4293,1597,5890,91100,2020
21071,42.6,35931,34855,352,321,10210,35096,14700,10497,4203,14700,74000,2020
21073,40.4,50744,41288,4947,1821,13383,59056,21278,13270,8008,21278,149900,2020
21075,42.7,6064,4281,1381,101,1578,31587,2550,1680,870,2550,63800,2020
21077,38.5,8760,7843,179,457,2059,55113,3088,2260,828,3088,135100,2020
21079,43.5,17554,16476,369,384,4896,55369,6779,5763,1016,6779,144900,2020
21081,36.8,25107,23417,149,724,6612,56746,9210,6447,2763,9210,141600,2020
21083,39.6,37125,31995,1350,2575,9337,45614,14402,10690,3712,14402,109000,2020
21085,40.8,26313,25177,192,368,6460,38262,9753,7183,2570,9753,118100,2020
21087,43.8,11000,10359,195,183,2987,33846,4440,3204,1236,4440,80600,2020
21089,43.5,35359,33991,320,384,9798,52337,14314,11172,3142,14314,114900,2020
21091,40.5,8748,8331,61,43,2478,56265,3364,2725,639,3364,113600,2020
21093,37,109627,82997,12616,6326,28523,57101,42059,25661,16398,42059,157700,2020
21095,41.3,26307,24969,515,267,7439,28261,10745,7460,3285,10745,64100,2020
21097,42.7,18763,17589,411,458,5310,50270,7474,5261,2213,7474,146800,2020
21099,40.5,18833,17234,861,356,4596,39834,7256,5378,1878,7256,93000,2020
21101,41.1,45550,38977,3370,1200,12517,50471,18762,11925,6837,18762,133200,2020
21103,41.6,15999,14576,429,538,4206,52550,6154,4347,1807,6154,134100,2020
21105,46.4,4461,3837,394,92,1091,44063,1724,1383,341,1724,85000,2020
21107,41.5,45044,39738,2957,974,12181,47014,18619,12679,5940,18619,107100,2020
21109,40.9,13368,13082,34,28,3740,31515,5417,4198,1219,5417,83100,2020
21111,38.4,768419,511897,166174,43892,186716,58196,316411,194638,121773,316411,178100,2020
21113,38.1,53476,47238,2327,1949,13583,64855,18888,12704,6184,18888,186400,2020
21115,41.4,22427,21778,81,148,6050,38333,8528,6044,2484,8528,115800,2020
21117,37.3,166552,146765,7499,5589,40446,66541,64544,43693,20851,64544,167100,2020
21119,43.7,15041,14564,124,152,4194,32531,6319,4623,1696,6319,52300,2020
21121,40,31288,29939,248,409,8129,30257,12075,8042,4033,12075,87000,2020
21123,41.5,14269,12972,472,469,3871,48495,5779,4403,1376,5779,125100,2020
21125,40.2,60631,58011,384,936,16115,43745,22665,15976,6689,22665,116300,2020
21127,42,15604,15073,53,205,3809,32856,5583,4206,1377,5583,91800,2020
21129,44.2,7088,6721,58,32,1575,24699,2884,1981,903,2884,65800,2020
21131,43,10081,9778,16,11,2875,36038,4156,3544,612,4156,69000,2020
21133,42.6,21936,21317,83,189,6495,33181,9599,7096,2503,9599,54700,2020
21135,42.8,13345,13030,51,7,3486,29844,5226,4012,1214,5226,68300,2020
21137,41.1,24493,23027,620,421,6762,42231,9677,7573,2104,9677,106100,2020
21139,46,9172,8727,69,192,2471,52795,3803,3218,585,3803,90600,2020
21141,41.1,27049,23969,1784,777,7039,48912,10459,7423,3036,10459,108900,2020
21143,50.3,8226,7380,464,195,1963,49286,3266,2732,534,3266,149100,2020
21145,42.3,65485,54250,6665,1694,16862,47011,27787,17930,9857,27787,145200,2020
21147,39.7,17333,15416,1053,426,4074,29499,6187,4179,2008,6187,76700,2020
21149,43.7,9202,8821,123,134,2663,54181,3747,2933,814,3747,111800,2020
21151,34.1,92090,82311,3919,2330,21681,51649,33876,20518,13358,33876,161400,2020
21153,41.8,12346,12077,0,138,3468,27807,4989,3706,1283,4989,71100,2020
21155,40,19257,16908,1412,528,4551,43587,7433,5446,1987,7433,112900,2020
21157,45,31225,30071,187,534,9153,57348,13119,10926,2193,13119,138000,2020
21159,39.7,11421,10493,521,270,2750,42894,4045,3121,924,4045,78100,2020
21161,41,17122,15164,1081,359,4345,46241,6523,4510,2013,6523,144200,2020
21163,38.9,28379,25325,994,1068,7629,61500,10690,7965,2725,10690,154200,2020
21165,44,6463,6151,9,178,1592,46746,2464,1858,606,2464,83200,2020
21167,43.2,21690,19678,733,662,5503,52312,8718,6394,2324,8718,148900,2020
21169,43.6,10062,9534,217,145,3011,40391,4187,3278,909,4187,76900,2020
21171,41.4,10616,9912,244,329,2976,35078,4533,3167,1366,4533,97000,2020
21173,40.2,28042,26012,806,803,7726,46998,10653,7195,3458,10653,124600,2020
21175,42.6,13270,12188,487,222,3233,37399,4796,3677,1119,4796,79900,2020
21177,42.5,30815,28345,1072,490,7937,45937,11539,9360,2179,11539,96000,2020
21179,39.9,45915,41482,2347,1022,12304,63032,17991,14043,3948,17991,164200,2020
21181,40.9,7189,6883,54,108,1875,47665,2714,1893,821,2714,86500,2020
21183,40.6,24081,22701,277,825,6443,45773,9226,7177,2049,9226,90400,2020
21185,39.3,66508,58456,2532,2654,17662,103761,21259,18376,2883,21259,299300,2020
21187,42.3,10847,10283,150,78,2849,50553,4246,3431,815,4246,116300,2020
21189,47.2,4416,4092,190,0,1094,29406,1655,1051,604,1655,67400,2020
21191,40.8,14587,13828,109,204,3780,56000,5250,3719,1531,5250,130100,2020
21193,41.3,26266,24854,528,288,7833,39594,11334,8783,2551,11334,78900,2020
21195,42.5,58595,56766,468,562,17255,34700,25506,18448,7058,25506,82700,2020
21197,39.3,12283,11737,18,233,3331,41071,4698,3292,1406,4698,105000,2020
21199,41.9,64789,60733,601,1660,16366,40658,25572,18015,7557,25572,113900,2020
21201,40.6,2139,2076,22,38,535,53074,859,624,235,859,101900,2020
21203,42.6,16795,16275,18,167,4582,38744,6609,5059,1550,6609,88500,2020
21205,30.4,24534,23172,504,441,5147,42754,8747,5285,3462,8747,126900,2020
21207,43.4,17846,16708,93,679,4647,41731,7122,5345,1777,7122,99000,2020
21209,36,55961,48541,2538,2438,15628,71750,21186,15326,5860,21186,197900,2020
21211,39.3,48100,38196,2940,4601,12203,72564,16801,11904,4897,16801,202000,2020
21213,38.7,18319,15607,1641,466,4778,50159,7181,4599,2582,7181,141400,2020
21215,42.9,18945,17767,281,466,5641,85488,6899,5994,905,6899,227000,2020
21217,37.5,25572,22804,1145,632,6580,50266,9659,6139,3520,9659,122800,2020
21219,37.2,12334,10599,1011,540,3330,47229,4655,3124,1531,4655,112500,2020
21221,45.8,14569,12817,1000,334,3965,50980,5916,4673,1243,5916,156000,2020
21223,42.2,8528,7842,29,280,2220,57589,3398,2641,757,3398,129700,2020
21225,38,14582,11994,2201,181,3767,49812,5176,3683,1493,5176,90900,2020
21227,32.9,130836,101743,11392,7047,31053,54325,49880,28754,21126,49880,180000,2020
21229,41.6,12044,10579,895,181,3008,55321,4702,3538,1164,4702,123600,2020
21231,44,20447,19044,370,699,5539,37678,8298,6133,2165,8298,90300,2020
21233,40.8,13021,11497,510,729,3327,44540,5001,3641,1360,5001,76200,2020
21235,36.7,36252,34752,334,496,8986,39258,12685,8680,4005,12685,104200,2020
21237,41.4,7188,7019,3,2,1791,22292,2991,1879,1112,2991,66300,2020
21239,42.4,26486,22830,1044,1761,7410,66442,10399,7223,3176,10399,212100,2020
22001,37,62371,48176,9900,1685,15966,44412,22598,15624,6974,22598,130300,2020
22003,38.3,25572,18026,4586,1708,5871,48328,8137,6159,1978,8137,107400,2020
22005,36,125061,84811,27898,7215,33141,82594,44029,36304,7725,44029,224300,2020
22007,41.4,22236,14551,6639,701,6251,44742,8941,6935,2006,8941,118900,2020
22009,38.4,40465,26142,10997,801,9697,35530,15217,10603,4614,15217,103900,2020
22011,37.5,37387,30042,4613,1400,9413,49256,13812,10973,2839,13812,141600,2020
22013,42.1,13391,7219,5685,258,3426,27815,5855,4121,1734,5855,73700,2020
22015,35.5,126952,84199,29377,8466,32437,55448,49600,31586,18014,49600,176700,2020
22017,37.8,243243,107795,119245,6942,57351,42003,96043,59011,37032,96043,150200,2020
22019,36.1,202858,135772,50878,7770,51720,52866,78427,53713,24714,78427,160800,2020
22021,42.3,9959,7875,1815,107,2816,40690,3899,2785,1114,3899,79100,2020
22023,44.9,6963,6279,102,322,2406,56902,2902,2567,335,2902,124300,2020
22025,38.5,9586,6252,2896,356,2506,40973,3394,2703,691,3394,90600,2020
22027,41.8,15854,7086,8273,242,3498,26849,5808,3961,1847,5808,75500,2020
22029,37.4,19533,11072,7899,404,4627,36294,6694,4895,1799,6694,94500,2020
22031,39.3,27395,16151,9703,808,7406,44436,10951,7891,3060,10951,116500,2020
22033,34.2,443158,196221,201858,18896,98787,56076,164641,99008,65633,164641,201100,2020
22035,30.7,6947,1856,4920,51,952,24551,1688,959,729,1688,62800,2020
22037,43.1,19228,10294,8250,326,4715,54187,7010,5615,1395,7010,153800,2020
22039,36.2,33491,22064,8709,1278,7959,31427,12393,7680,4713,12393,99500,2020
22041,38.6,20109,13071,6716,119,5320,35759,7503,5425,2078,7503,86600,2020
22043,38.3,22339,17004,3594,1158,4730,51449,7054,5375,1679,7054,122600,2020
22045,37.1,70763,41136,22307,3058,19097,50602,26776,18165,8611,26776,120500,2020
22047,39.3,32626,15514,15766,886,8122,49539,11105,8313,2792,11105,139100,2020
22049,41.8,15822,10564,4587,277,3900,41760,5859,4066,1793,5859,85700,2020
22051,39.5,434903,226094,115719,63712,104394,54825,170398,106889,63509,170398,193600,2020
22053,37.4,31425,24497,5112,786,7914,42716,11565,8736,2829,11565,110800,2020
22055,35.5,243692,158812,62720,11174,59053,58761,92476,61780,30696,92476,189700,2020
22057,38.1,97980,75119,13146,4273,25419,54530,36645,27901,8744,36645,158800,2020
22059,38.4,14950,12364,1536,435,3663,51141,4868,4075,793,4868,107000,2020
22061,28.1,47118,25088,18891,1456,9897,36496,17861,9190,8671,17861,152400,2020
22063,36.8,140524,122432,8482,5563,36112,67365,48690,40511,8179,48690,173200,2020
22065,34.8,11137,3744,7089,250,2446,32585,3729,2087,1642,3729,77600,2020
22067,40.3,25189,12379,12386,120,5853,33780,9738,6515,3223,9738,94500,2020
22069,33.5,38505,19465,16092,923,7621,30625,14324,7156,7168,14324,148300,2020
22071,37.2,391249,119931,229253,21452,71567,43258,154826,77066,77760,154826,250000,2020
22073,36.2,154679,88725,58005,3458,35172,44934,56956,34160,22796,56956,150200,2020
22075,36.1,23305,14795,4359,1780,6434,65234,8600,6275,2325,8600,202700,2020
22077,43.1,21883,13193,7573,610,5363,44201,9056,6889,2167,9056,157900,2020
22079,37.5,130376,79490,41034,4280,32491,48013,49075,31505,17570,49075,147200,2020
22081,40.6,8462,4768,3425,37,2096,33817,3282,2353,929,3282,77900,2020
22083,39,20251,12271,7165,460,5150,40491,7563,4968,2595,7563,107700,2020
22085,41.6,23915,16011,3756,946,5694,39755,9370,6557,2813,9370,87600,2020
22087,34.5,46694,28851,10807,4729,10361,47873,15165,10828,4337,15165,152600,2020
22089,38,52856,34098,13912,3296,14209,68113,19308,15539,3769,19308,205600,2020
22091,41.4,10227,4514,5343,194,2836,45063,3885,3021,864,3885,115500,2020
22093,39.6,21142,10258,10440,371,5829,53209,7907,6383,1524,7907,168700,2020
22095,37.8,43055,14352,24464,2735,11054,55429,15251,12229,3022,15251,155900,2020
22097,36.8,82786,44860,34604,1882,21008,40859,30496,21079,9417,30496,122900,2020
22099,37.7,53607,34487,15545,1639,13689,48884,19655,15478,4177,19655,123700,2020
22101,39.4,50020,27956,15511,3491,10672,40218,19633,11910,7723,19633,105800,2020
22103,40.4,258447,201839,29999,14886,67149,70730,95054,74659,20395,95054,223300,2020
22105,35.5,133753,83979,39737,5831,32187,48745,48548,34133,14415,48548,167900,2020
22107,44.5,4435,1872,2452,100,1018,29767,1814,1276,538,1814,78900,2020
22109,36.1,111297,74030,21537,5726,27280,52224,40374,28996,11378,40374,155600,2020
22111,42.3,22270,15356,5488,1068,5322,45094,8399,6768,1631,8399,94700,2020
22113,38.3,59787,46798,8467,2149,15656,52219,22180,16497,5683,22180,127700,2020
22115,30.5,49315,34383,6952,4691,12039,50267,17516,9235,8281,17516,126000,2020
22117,39.8,46325,30228,14011,1108,11950,39185,17794,12657,5137,17794,114900,2020
22119,41.1,38813,23978,13260,775,10198,30324,16320,10825,5495,16320,85300,2020
22121,36.6,26395,14615,10530,848,7220,67813,9610,7232,2378,9610,197000,2020
22123,40.8,10934,8574,1706,435,2750,42545,4126,3195,931,4126,85800,2020
22125,42.1,15441,8081,6848,182,2503,59688,4202,3052,1150,4202,230400,2020
22127,41.3,14165,9179,4502,287,3369,37764,5361,3586,1775,5361,77000,2020
23001,40.7,107958,97338,2366,2042,27756,55002,45906,29796,16110,45906,166600,2020
23003,48,67431,63194,633,868,18198,43791,29594,21666,7928,29594,102600,2020
23005,42.1,294520,263199,9004,6315,73543,76014,123384,86357,37027,123384,288800,2020
23007,46.5,29933,28548,86,398,7501,51630,12426,9632,2794,12426,146900,2020
23009,49.1,54832,51809,429,833,14675,58345,24116,18505,5611,24116,218000,2020
23011,44.1,122158,115281,852,1964,31899,55368,52506,37144,15362,52506,164000,2020
23013,48.6,39809,37807,170,606,10563,57794,17497,13759,3738,17497,209900,2020
23015,51.2,34415,32583,168,442,9680,58125,15665,12319,3346,15665,220000,2020
23017,47.8,57741,54637,178,834,14436,49761,22359,18007,4352,22359,150700,2020
23019,42.2,151696,141678,1225,2199,38100,52128,63073,44198,18875,63073,148300,2020
23021,51.5,16864,15887,115,319,4424,42083,7180,5529,1651,7180,110100,2020
23023,47.2,35720,33635,233,654,10480,68039,16024,12084,3940,16024,222900,2020
23025,46.9,50573,48340,293,572,13358,45382,21645,16564,5081,21645,122400,2020
23027,46.2,39723,37650,164,618,11289,58034,17427,14012,3415,17427,169400,2020
23029,48.5,31378,28007,128,790,8774,44847,13830,10735,3095,13830,115200,2020
23031,45.3,206074,192520,1717,3689,55279,68932,86919,64632,22287,86919,260800,2020
24001,41.4,71002,61485,5816,1325,16583,49449,27369,18900,8469,27369,126500,2020
24003,38.5,575421,385867,94409,46230,148095,103225,213122,158420,54702,213122,370100,2020
24005,39.5,828193,465027,239709,46179,203226,78724,315347,208376,106971,315347,267400,2020
24009,40.5,92094,71488,11260,3818,24547,112696,32558,27589,4969,32558,364800,2020
24011,39.3,33260,25003,4374,2510,8686,59042,12160,8639,3521,12160,213400,2020
24013,42.2,168233,148612,5949,6217,45491,99569,61261,50285,10976,61261,343400,2020
24015,40.7,102889,86797,6606,4700,26271,79415,37293,27802,9491,37293,250400,2020
24017,38.5,161448,61795,75661,9779,42022,103678,57388,44157,13231,57388,326800,2020
24019,44.8,31994,20017,8112,1840,8641,52799,13433,9068,4365,13433,187300,2020
24021,39,255955,185309,24325,25528,68106,100685,94299,71556,22743,94299,341800,2020
24023,46.8,29155,28053,348,345,8406,54542,12745,10107,2638,12745,194600,2020
24025,40.8,253736,191074,34527,11856,69006,94003,95094,75117,19977,95094,302900,2020
24027,38.7,322407,163403,60494,22713,85446,124042,116457,84686,31771,116457,464500,2020
24029,48,19456,15058,2706,873,4950,60208,8274,5728,2546,8274,258500,2020
24031,39.4,1047661,451553,188234,204620,260678,111812,372825,244613,128212,372825,491700,2020
24033,37.5,910551,112285,557553,171094,203838,86994,315634,196113,119521,315634,319600,2020
24035,44.7,50163,42850,2932,2065,13794,96467,19000,15231,3769,19000,363300,2020
24037,36.5,113182,83320,16163,6007,29477,95864,41280,29020,12260,41280,318500,2020
24039,36.9,25699,13233,10434,946,5711,44980,8509,5607,2902,8509,131500,2020
24041,51,37087,28746,3941,2545,10452,73102,16810,11969,4841,16810,334000,2020
24043,40.7,150575,117471,16142,8169,37939,63510,56367,37540,18827,56367,221700,2020
24045,36,103222,64097,26745,5550,24213,60366,38142,22403,15739,38142,185000,2020
24047,50.5,51967,41534,6513,1882,14499,65396,22661,17155,5506,22661,267400,2020
24510,35.5,602274,164417,370749,32627,119301,52164,242499,115747,126752,242499,167300,2020
25001,53.7,213505,188560,5972,6915,59596,76863,95859,76319,19540,95859,414000,2020
25003,47.2,125927,110438,3161,6237,31780,62166,54786,38359,16427,54786,221000,2020
25005,41,563301,451430,21704,47071,144944,71450,220365,138424,81941,220365,317800,2020
25007,49,17430,14620,706,612,4117,77318,6887,4990,1897,6887,794000,2020
25009,40.9,787038,546725,25340,168536,197950,82225,297254,189708,107546,297254,436600,2020
25011,47,70529,63462,701,2988,17902,61198,30790,21256,9534,30790,239900,2020
25013,39.4,466647,289402,36034,119915,115269,57623,180492,111246,69246,180492,216100,2020
25015,36.6,161361,134314,3811,9438,35830,73518,59607,40466,19141,59607,289300,2020
25017,38.5,1605899,1140148,79412,129313,392836,106202,611850,380079,231771,611850,540300,2020
25019,41.7,11212,8094,810,1577,2531,112306,3709,2563,1146,3709,1117300,2020
25021,40.9,703740,518457,47660,33262,178449,105320,267967,184436,83531,267967,491000,2020
25023,42.7,518597,414785,47054,21000,133820,92906,190355,146967,43388,190355,386600,2020
25025,33,801162,359034,156503,183798,153494,74881,312978,113736,199242,312978,547300,2020
25027,40.2,826655,625553,37420,97478,205474,77155,314081,206343,107738,314081,295300,2020
26001,58.9,10396,9925,44,166,3153,43341,5115,4510,605,5115,118700,2020
26003,49.6,9098,7593,632,153,2006,45184,3246,2611,635,3246,141900,2020
26005,40.2,117104,102347,1409,8734,32052,65071,43927,37091,6836,43927,174000,2020
26007,48.1,28431,27064,164,411,7734,42603,12769,10015,2754,12769,104900,2020
26009,51.6,23301,21960,101,546,7044,57256,10166,8910,1256,10166,161700,2020
26011,50,15013,14183,66,304,4095,45679,6585,5587,998,6585,98600,2020
26013,45.8,8337,6062,722,139,2115,46581,3188,2506,682,3188,108200,2020
26015,42.2,61045,57302,261,1896,16801,65557,24342,20440,3902,24342,171800,2020
26017,43.6,103506,92885,1530,5703,27752,48290,44627,33948,10679,44627,106400,2020
26019,50.1,17703,16565,56,443,4605,64257,6940,6310,630,6940,195400,2020
26021,42.3,153797,114148,21681,8632,40687,52500,63136,44981,18155,63136,157500,2020
26023,41.3,43428,38992,899,2168,10980,52782,16716,12675,4041,16716,118200,2020
26025,40.1,133943,103177,13786,7272,33314,50219,54124,37636,16488,54124,115500,2020
26027,45.5,51613,43938,2594,2044,14661,57514,21226,17252,3974,21226,155600,2020
26029,49.1,26197,24510,120,563,7676,60433,11725,9579,2146,11725,171100,2020
26031,51.6,25435,23197,144,385,7227,49624,11219,9425,1794,11219,141800,2020
26033,40.8,37418,25533,2014,729,8669,50454,14323,10006,4317,14323,121600,2020
26035,47.7,30655,29039,188,643,7957,41163,12247,10235,2012,12247,91900,2020
26037,41.1,78957,70378,1416,3658,20748,72490,30182,24790,5392,30182,185500,2020
26039,50.9,13904,13067,44,289,3985,49987,6155,5016,1139,6155,111800,2020
26041,47.5,35874,32875,111,511,10339,47008,16154,12538,3616,16154,115400,2020
26043,47.4,25373,24061,157,414,7438,51704,11491,9125,2366,11491,109300,2020
26045,41.1,109730,90428,7424,6042,29302,67440,45037,32687,12350,45037,160000,2020
26047,45.7,33175,29651,232,602,9276,55947,14197,10540,3657,14197,206900,2020
26049,40.5,406770,291698,79151,14566,108430,50269,170581,119384,51197,170581,119500,2020
26051,50.6,25312,24120,89,462,7170,45957,11181,9662,1519,11181,111000,2020
26053,50,14715,13339,458,235,3747,38625,6896,5348,1548,6896,73500,2020
26055,43,92640,85669,711,2731,23706,66457,37939,29020,8919,37939,225400,2020
26057,40,40692,34820,2314,2580,9970,49795,15084,11450,3634,15084,97600,2020
26059,42.1,45707,43082,276,1100,11963,51535,18180,14076,4104,18180,131800,2020
26061,33.2,35890,33035,321,602,7587,44839,13805,9209,4596,13805,113700,2020
26063,49.3,31105,29476,115,789,8511,49541,13908,11200,2708,13908,109000,2020
26065,32.4,290923,201143,32783,23205,61107,55253,113678,66879,46799,113678,143900,2020
26067,38.6,64401,56595,2892,3170,16036,60139,23071,17619,5452,23071,140800,2020
26069,52.9,25213,23514,179,618,6910,42628,11772,9509,2263,11772,98200,2020
26071,53.6,11099,10453,107,246,2892,44183,5150,4256,894,5150,79500,2020
26073,28.7,70363,59489,1614,2817,14108,46783,24981,15676,9305,24981,136900,2020
26075,41.6,158174,133104,12312,5759,39908,54511,62216,46231,15985,62216,138900,2020
26077,34.5,264322,202945,28107,13573,62664,58836,104278,67255,37023,104278,168500,2020
26079,44.3,17725,16642,168,377,4718,49402,7173,6096,1077,7173,127600,2020
26081,35.4,652617,475874,58468,70152,162996,65722,244795,172222,72573,244795,188500,2020
26083,58.3,2102,2032,15,29,707,51750,1079,956,123,1079,141800,2020
26085,53.8,11805,10057,924,311,2819,38356,4985,4161,824,4985,89700,2020
26087,44.2,87975,80322,1022,4247,24491,65197,34041,28980,5061,34041,179900,2020
26089,54.6,21649,19454,73,909,6326,67330,9201,8178,1023,9201,285700,2020
26091,42.1,98310,84768,2177,8119,25851,57314,38693,30116,8577,38693,143000,2020
26093,43.7,190832,179472,1096,4851,52171,84274,72905,62039,10866,72905,256100,2020
26095,45.2,6286,4881,487,155,1477,50000,2258,1814,444,2258,97200,2020
26097,53.1,10781,7874,352,209,3189,50058,5268,3848,1420,5268,136100,2020
26099,41,870893,680560,102607,23551,226874,64641,349340,258973,90367,349340,174000,2020
26101,49.5,24539,21747,666,834,6197,51658,9701,8209,1492,9701,130900,2020
26103,39.2,66403,61126,1014,1052,15835,54585,27177,19435,7742,27177,154200,2020
26105,46.3,29062,26525,284,1344,7846,51568,12296,9339,2957,12296,151400,2020
26107,38,43481,39441,1319,1059,9811,45797,16276,12121,4155,16276,122500,2020
26109,49.2,22902,21273,127,437,6185,48548,10403,8154,2249,10403,112600,2020
26111,41.7,83445,75917,1199,2412,23057,64078,34253,26466,7787,34253,145900,2020
26113,43.3,15075,14088,69,462,4228,47370,6194,4940,1254,6194,123300,2020
26115,42.8,150000,136372,3555,5527,40480,65453,60804,49014,11790,60804,167400,2020
26117,40.8,63516,57925,1355,2265,16387,52390,24143,19248,4895,24143,121800,2020
26119,56,9270,8862,25,129,2799,42160,4490,3848,642,4490,113300,2020
26121,39.3,173679,132132,22869,10095,44390,53478,66064,50362,15702,66064,126400,2020
26123,42.4,48687,43832,481,2852,13300,51470,19365,16345,3020,19365,128900,2020
26125,41,1255340,892678,165699,53779,320117,81587,509589,363025,146564,509589,252800,2020
26127,43.6,26545,21610,253,3993,7349,51161,10208,8519,1689,10208,121900,2020
26129,50.6,20895,19693,74,468,5926,41752,9314,7595,1719,9314,103200,2020
26131,59.1,5802,5503,25,91,1729,41776,2823,2489,334,2823,74400,2020
26133,44.3,23323,21976,272,475,6469,46969,9332,7681,1651,9332,102800,2020
26135,52.3,8282,7857,51,141,2367,43457,3732,3204,528,3732,96800,2020
26137,44.8,24613,23235,145,442,6701,55917,9985,7736,2249,9985,147100,2020
26139,35.5,289162,240703,4097,28787,74969,72418,104586,81969,22617,104586,209400,2020
26141,55.7,12687,12090,52,189,3928,48734,5923,5256,667,5923,111200,2020
26143,56.6,23863,22514,73,474,6748,41828,11420,9165,2255,11420,111300,2020
26145,41,191166,131755,35178,16680,49274,49565,78980,56509,22471,78980,106200,2020
26147,44,159285,144725,3631,5531,43750,58722,65668,51845,13823,65668,162300,2020
26149,39.8,60789,52337,1170,4915,16239,53253,24319,18025,6294,24319,128800,2020
26151,45.4,41179,38589,217,1584,11682,49852,17920,14053,3867,17920,121500,2020
26153,52.3,8031,6871,39,94,2316,48443,3675,3078,597,3675,114400,2020
26155,43,68176,63879,515,2001,18661,56436,27762,21358,6404,27762,127500,2020
26157,44.8,52683,48875,530,1864,14258,51891,21719,18184,3535,21719,108200,2020
26159,41.1,75416,60854,2696,8753,21081,56652,29882,23188,6694,29882,147400,2020
26161,33.9,368385,256390,42933,17906,81292,75730,143040,87938,55102,143040,278500,2020
26163,37.9,1753059,862696,667128,106070,416034,49359,694858,434235,260623,694858,122700,2020
26165,41.7,33433,31254,238,688,9088,50335,13212,10382,2830,13212,115500,2020
27001,55.9,15826,14831,61,216,4811,49086,7594,6387,1207,7594,183400,2020
27003,38.6,353775,283436,23534,16769,91180,84379,129308,104555,24753,129308,244500,2020
27005,42.3,34227,29290,146,738,9356,60508,13942,10987,2955,13942,202600,2020
27007,34.1,46784,33506,399,1114,10942,50525,17882,12128,5754,17882,167000,2020
27009,36,40476,35979,1876,1086,10087,60564,16482,10841,5641,16482,187300,2020
27011,48.5,4974,4787,3,102,1391,55909,2294,1621,673,2294,108900,2020
27013,31.3,67368,58852,2794,2579,15404,61058,26390,16170,10220,26390,194800,2020
27015,42,25076,23354,179,1132,6892,59804,10643,8149,2494,10643,144000,2020
27017,41.2,35709,31459,909,638,9360,66201,13811,11023,2788,13811,179400,2020
27019,38.1,103561,91429,1820,4419,27661,104011,37386,30689,6697,37386,333400,2020
27021,48.9,29462,23697,125,683,8416,53845,13249,10641,2608,13249,200700,2020
27023,42.1,11876,10285,121,900,3313,57301,5133,3480,1653,5133,118100,2020
27025,41.3,55844,51758,662,1283,15115,86900,20370,17606,2764,20370,244600,2020
27027,32.7,64029,55375,2508,2976,15257,66069,24695,16442,8253,24695,205400,2020
27029,42.3,8872,7512,17,202,2253,51742,3452,2787,665,3452,139500,2020
27031,52.8,5402,4592,2,129,1644,59537,2608,2012,596,2608,251900,2020
27033,42.6,11279,9631,26,901,3033,51067,4915,3730,1185,4915,106900,2020
27035,44.7,64775,61215,538,969,17647,57779,27605,21094,6511,27605,208900,2020
27037,38,425271,328845,26711,31069,113001,88468,163463,122750,40713,163463,280300,2020
27039,38.7,20807,19042,30,1043,5822,79020,7776,6636,1140,7776,197100,2020
27041,44.3,37820,36193,83,652,10718,65430,16810,12430,4380,16810,226500,2020
27043,45.3,13727,12376,39,976,3785,53963,6074,4677,1397,6074,94100,2020
27045,42.1,21031,20087,97,364,5977,64375,8652,7030,1622,8652,159500,2020
27047,44.5,30465,25706,335,3066,8263,54628,13005,10042,2963,13005,121600,2020
27049,42.6,46330,42182,544,1616,12642,69334,19623,14712,4911,19623,212800,2020
27051,44.8,5962,5658,16,142,1710,59246,2578,2042,536,2578,129400,2020
27053,36.7,1255296,852045,163432,87216,294057,81169,513892,321314,192578,513892,292100,2020
27055,45.3,18670,17695,193,229,5399,59514,8286,6752,1534,8286,177000,2020
27057,49,21287,19714,112,495,6011,58475,8792,7227,1565,8792,208200,2020
27059,39.8,40004,37408,196,871,10371,76999,15169,12815,2354,15169,214400,2020
27061,46.6,45180,40966,231,708,12662,55744,19529,16090,3439,19529,163600,2020
27063,45,9873,9082,26,377,2823,62479,4480,3696,784,4480,122300,2020
27065,45.3,16205,15335,35,268,4407,57877,6631,5521,1110,6631,168900,2020
27067,39,42909,33945,2210,5365,11432,64252,16853,12442,4411,16853,178000,2020
27069,48,4272,4053,31,83,1169,55410,1834,1454,380,1834,96300,2020
27071,50,12355,11254,70,164,3389,52297,5796,4565,1231,5796,115500,2020
27073,49.9,6645,6288,34,157,1934,57802,3048,2516,532,3048,97500,2020
27075,50.5,10571,10085,65,156,3358,65201,5174,4362,812,5174,174300,2020
27077,51,3747,3447,3,3,876,50669,1522,1308,214,1522,179500,2020
27079,41,28425,25815,198,1796,7929,75925,11191,9011,2180,11191,226400,2020
27081,45.3,5641,5394,13,119,1499,53557,2459,1936,523,2459,107800,2020
27083,35.9,25696,21338,745,1821,6444,57274,10067,6909,3158,10067,152700,2020
27085,40.9,35788,32371,227,2317,9028,62885,14736,11250,3486,14736,171200,2020
27087,35.8,5508,2468,40,257,1265,45398,1956,1345,611,1956,111400,2020
27089,43.1,9353,8716,39,424,2604,60951,3952,3291,661,3952,121000,2020
27091,45.5,19737,18262,81,946,5452,53851,8824,6484,2340,8824,126400,2020
27093,41.8,23149,21705,108,946,6261,63841,9219,7446,1773,9219,175600,2020
27095,40.4,25963,23000,103,659,6717,57173,10535,7987,2548,10535,170500,2020
27097,41.9,33119,31638,53,585,9025,58826,13536,10712,2824,13536,178100,2020
27099,39.1,39931,30982,1468,4746,10287,55378,15750,11382,4368,15750,130800,2020
27101,47.9,8247,7622,29,353,2342,62839,3659,2956,703,3659,132500,2020
27103,36.1,34176,30080,836,1595,8457,69174,12821,9420,3401,12821,205000,2020
27105,36.1,21667,12640,811,6165,5400,56000,7898,5714,2184,7898,130400,2020
27107,43.2,6466,5766,46,342,1707,56081,2771,2232,539,2771,107600,2020
27109,37.4,156446,123695,9960,7919,40798,80403,63561,45901,17660,63561,233100,2020
27111,46.8,58416,53920,653,2084,16423,59456,24693,19684,5009,24693,203800,2020
27113,39.3,14110,12742,196,564,3656,60940,5976,4450,1526,5976,163400,2020
27115,45.6,29254,25970,599,871,6981,55606,11132,9105,2027,11132,170700,2020
27117,42.1,9163,8007,27,662,2445,53688,4002,3091,911,4002,101300,2020
27119,38.9,31384,26929,711,2091,7693,58682,12619,9021,3598,12619,169100,2020
27121,46.5,11107,10573,46,186,3232,62878,5010,4017,993,5010,185800,2020
27123,35.2,546598,332580,62897,41189,120801,67238,210424,126202,84222,210424,239000,2020
27125,43,4005,3683,29,152,1111,59698,1713,1408,305,1713,123000,2020
27127,41.5,15193,13167,92,547,3981,57243,6262,4863,1399,6262,114800,2020
27129,44,14572,12741,67,1268,3759,58542,6032,4663,1369,6032,112400,2020
27131,36.6,66549,54255,3792,5503,15702,70600,23183,17247,5936,23183,232800,2020
27133,41,9386,8752,56,301,2737,65744,3990,2979,1011,3990,160700,2020
27135,41.6,15259,13876,124,223,3980,62304,5940,4705,1235,5940,140800,2020
27137,41,199499,180204,3021,3580,48309,57480,86229,61414,24815,86229,161100,2020
27139,36.8,147201,117972,6257,7797,38724,103261,50487,42211,8276,50487,317500,2020
27141,36.1,96015,86342,2658,2577,24373,88671,32791,27181,5610,32791,244700,2020
27143,41.8,14871,13091,137,1355,3922,64170,6015,4736,1279,6015,166100,2020
27145,34.8,159788,135291,10932,5557,38039,65244,59576,41162,18414,59576,193500,2020
27147,39.2,36710,31640,1225,2913,9859,68172,14836,11393,3443,14836,173400,2020
27149,33.8,9770,8468,102,663,2290,65503,3683,2553,1130,3683,161000,2020
27151,43.8,9329,8417,148,491,2676,53457,4243,3017,1226,4243,113000,2020
27153,43.9,24603,22002,143,1588,6836,54502,9888,8313,1575,9888,151800,2020
27155,46.6,3282,2878,8,120,929,51216,1590,1238,352,1590,85700,2020
27157,45.4,21564,20379,109,652,6085,67906,9081,7204,1877,9081,189300,2020
27159,41.3,13681,12699,109,276,3580,46178,5748,4223,1525,5748,135000,2020
27161,40.6,18658,16601,258,1148,5005,60450,7547,5982,1565,7547,162000,2020
27163,39.5,259072,211750,12069,11229,68673,97584,95796,78168,17628,95796,301000,2020
27165,40.7,10903,7782,35,2819,2840,53304,4371,3367,1004,4371,98600,2020
27167,43,6264,5819,56,199,1734,56829,2799,2259,540,2799,138300,2020
27169,35.6,50744,46137,586,1532,11064,60020,19466,14012,5454,19466,173200,2020
27171,37.1,136387,125212,2360,4224,35741,87772,49097,40724,8373,49097,250800,2020
27173,42.5,9775,8725,68,468,2835,59289,4088,3320,768,4088,117900,2020
28001,39.9,31103,11276,16259,2923,6711,30633,11129,6907,4222,11129,94100,2020
28003,40,37058,30248,4479,1209,9524,40938,14610,9760,4850,14610,108600,2020
28005,47.3,12341,7085,5082,6,3526,30805,5416,4463,953,5416,85200,2020
28007,39.7,18308,9751,7882,374,4838,35631,6890,5054,1836,6890,88700,2020
28009,42.3,8275,4999,2768,225,2211,39758,3183,2575,608,3183,82800,2020
28011,36,31253,9997,20012,689,7717,32412,12114,6784,5330,12114,98800,2020
28013,42.3,14417,9274,4102,865,3772,40345,5771,4230,1541,5771,70500,2020
28015,46.9,9972,6416,3508,21,2790,46729,4018,3376,642,4018,93800,2020
28017,39.8,17060,8432,7517,809,4490,35592,6523,4614,1909,6523,70000,2020
28019,43.9,8206,5525,2555,41,2112,36648,3353,2715,638,3353,89700,2020
28021,34.1,9042,1004,7938,4,1816,32268,2900,2030,870,2900,69600,2020
28023,42.3,15612,9835,5600,128,4372,38631,6253,5322,931,6253,81100,2020
28025,39.2,19515,7547,11583,16,4860,33209,7728,5415,2313,7728,96700,2020
28027,35.4,22685,4630,17404,357,5442,30761,8614,4760,3854,8614,67900,2020
28029,38.6,28339,12346,14683,927,6597,44252,9568,7554,2014,9568,88900,2020
28031,37,18810,11341,6961,440,5014,32917,7042,5297,1745,7042,68100,2020
28033,37.1,182256,114497,51997,9107,47566,69990,64424,48168,16256,64424,177800,2020
28035,32.5,75162,42749,27715,2247,17552,42298,28116,16285,11831,28116,118100,2020
28037,43.2,7716,4858,2697,2,2236,39066,3031,2255,776,3031,81200,2020
28039,36.6,24098,21016,1887,687,5899,47044,8085,6641,1444,8085,119300,2020
28041,40.1,13619,9799,3563,128,2548,47033,3825,3292,533,3825,83100,2020
28043,39.7,20927,11284,9157,188,5278,39952,8476,5744,2732,8476,107800,2020
28045,44.7,47339,40097,3702,1802,14965,54860,21494,17161,4333,21494,167700,2020
28047,36.5,206169,130652,50841,11268,52766,48547,80097,46194,33903,80097,157900,2020
28049,35.3,235604,56874,171125,3561,54762,45380,88832,51403,37429,88832,121500,2020
28051,35,17414,2656,14589,84,3792,24074,6358,3750,2608,6358,58600,2020
28053,38,8198,1670,6400,70,2127,28628,3197,2056,1141,3197,70500,2020
28055,43.6,1223,476,734,12,242,28333,462,227,235,462,87500,2020
28057,40.5,23396,21034,1680,388,5997,47649,8525,6692,1833,8525,90700,2020
28059,38.9,142872,96285,29855,9589,35363,53726,53878,38586,15292,53878,143000,2020
28061,41.3,16454,7324,8851,79,4667,37877,6616,5532,1084,6616,89300,2020
28063,40.7,7129,930,5826,307,1696,29524,2543,1814,729,2543,62000,2020
28065,44.5,11182,4201,6838,66,3052,32214,4615,3708,907,4615,82400,2020
28067,37.5,68307,44020,20106,3102,17407,43391,24855,18244,6611,24855,101300,2020
28069,38.6,9829,3326,6093,34,2310,30735,3757,2811,946,3757,78600,2020
28071,30.5,54059,37768,12695,1386,10905,53318,18585,11292,7293,18585,217900,2020
28073,36.6,62693,46191,12814,1789,16351,61649,22467,15193,7274,22467,174600,2020
28075,37.9,75557,39310,32999,1715,19554,42922,29718,19077,10641,29718,103600,2020
28077,40.7,12595,8132,4137,102,3486,36239,5019,3714,1305,5019,104000,2020
28079,37.7,22791,10651,9575,1075,5336,36708,8113,5841,2272,8113,86200,2020
28081,37.5,85304,55325,25078,2354,21420,55861,31866,22316,9550,31866,140600,2020
28083,34.1,28764,6272,21473,766,5963,30077,9901,5397,4504,9901,86000,2020
28085,39.5,34197,22957,10636,424,8895,41355,13127,9965,3162,13127,105100,2020
28087,37.5,58896,30115,25598,1226,14148,48170,22457,13958,8499,22457,136300,2020
28089,37.4,105482,58200,39960,3160,27693,71621,40179,29000,11179,40179,224300,2020
28091,40.7,24785,15977,7898,407,5815,31629,9770,7721,2049,9770,94300,2020
28093,41.4,35502,16930,16854,1355,9546,43411,13311,9884,3427,13311,123700,2020
28095,41.2,35559,23806,10849,467,9208,45018,13482,10199,3283,13482,99100,2020
28097,42.8,9956,5182,4505,94,2796,38022,4366,2947,1419,4366,87500,2020
28099,37.3,29250,17001,6222,669,7000,40750,10495,7660,2835,10495,83600,2020
28101,37.6,21215,12713,6519,417,5514,42176,7926,6258,1668,7926,86200,2020
28103,37.5,10566,2717,7632,148,2689,36958,4015,2883,1132,4015,67100,2020
28105,26.1,49593,27820,18408,858,9479,39490,18849,9373,9476,18849,165000,2020
28107,39.2,34079,15955,16346,667,8041,37232,12354,8389,3965,12354,82700,2020
28109,41.7,55512,45036,7086,1795,15738,51538,21321,16817,4504,21321,150800,2020
28111,41.6,11981,9298,2057,187,3168,47173,4597,3720,877,4597,108000,2020
28113,37.5,39365,16929,21233,628,8284,32726,14561,9945,4616,14561,95800,2020
28115,37,31996,24390,4818,2258,7779,48980,10823,7928,2895,10823,115300,2020
28117,39.4,25155,20544,2457,379,6191,40163,9255,6844,2411,9255,95300,2020
28119,40.1,7038,1802,5103,73,1695,24233,3022,1789,1233,3022,54500,2020
28121,38,154119,113122,32823,4181,40382,68310,56640,44036,12604,56640,165200,2020
28123,36.7,28288,13944,10665,3191,7258,39971,10228,7426,2802,10228,78500,2020
28125,41.2,4427,1092,3296,17,1162,35711,1757,1085,672,1757,63400,2020
28127,39.9,26818,16493,9923,70,6653,43403,9647,7727,1920,9647,86600,2020
28129,42.1,15919,11764,3817,133,3787,44714,5888,4987,901,5888,108300,2020
28131,39.7,18282,13964,3267,384,4648,47683,6304,4825,1479,6304,124500,2020
28133,36.3,25759,6071,19046,483,5125,31515,8345,4450,3895,8345,86300,2020
28135,36.4,14041,4863,8293,699,2745,30433,4322,2754,1568,4322,68900,2020
28137,38.6,28419,18370,8688,764,7962,55738,10553,8129,2424,10553,139300,2020
28139,39.2,21976,16915,3606,1049,5305,37894,7842,5433,2409,7842,89200,2020
28141,43.2,19396,17856,537,631,4961,38302,7938,5804,2134,7938,97000,2020
28143,34.6,9807,1828,7872,95,2191,34485,3964,1545,2419,3964,101800,2020
28145,38.6,28578,22263,4714,1257,6757,47317,9849,7425,2424,9849,112900,2020
28147,39.6,14423,7573,6471,311,3421,33566,5707,4862,845,5707,98100,2020
28149,39.6,46030,21589,22657,972,11132,46909,18107,11939,6168,18107,133100,2020
28151,37.1,45072,11141,32347,756,11354,32011,17882,9759,8123,17882,80600,2020
28153,41.1,20344,11651,8290,328,5337,33612,7967,6782,1185,7967,78300,2020
28155,40.5,9727,7619,1901,145,2602,52382,3699,2904,795,3699,86600,2020
28157,38.5,8727,2418,6061,50,1932,30760,3345,2616,729,3345,70500,2020
28159,41.5,18116,9028,8501,244,4594,38986,7100,5286,1814,7100,96700,2020
28161,44,12276,7117,4790,285,3226,41440,5111,3583,1528,5111,85500,2020
28163,35.8,28511,9782,16183,2143,5244,32729,8577,5086,3491,8577,88600,2020
29001,27.9,25468,22696,942,646,4893,42301,9078,5589,3489,9078,123500,2020
29003,41.9,17554,16541,187,446,4722,58911,6799,5340,1459,6799,150200,2020
29005,48.3,5180,4989,21,76,1530,51625,2549,1762,787,2549,90400,2020
29007,40,25336,22141,1394,806,6138,44699,9349,6595,2754,9349,89200,2020
29009,43.6,35615,30050,80,3342,9746,45811,13872,10275,3597,13872,127400,2020
29011,41.7,11732,10778,20,327,3209,44510,4830,3318,1512,4830,91900,2020
29013,41.3,16282,15214,298,390,4430,46733,6565,4602,1963,6565,119600,2020
29015,54.1,19305,18238,80,401,5247,41751,8060,6697,1363,8060,122600,2020
29017,44.9,12181,11636,68,170,2944,45140,4426,3657,769,4426,113600,2020
29019,31.6,179704,140869,15910,6233,41144,58740,71919,40288,31631,71919,198700,2020
29021,38.3,87904,72663,4162,5744,20292,51933,33642,20882,12760,33642,126000,2020
29023,41.2,42570,37609,2119,926,10467,42227,16358,10454,5904,16358,116400,2020
29025,42.9,9052,8525,57,217,2489,51451,3703,2817,886,3703,109700,2020
29027,38.7,44944,40287,1880,956,11093,59835,16233,12104,4129,16233,156900,2020
29029,52.1,45823,43080,363,1291,11732,53520,17300,14093,3207,17300,213200,2020
29031,36.7,78834,67480,5728,1889,18717,53776,30215,19916,10299,30215,162400,2020
29033,44.2,8723,8236,64,145,2486,51414,3518,2550,968,3518,93400,2020
29035,41.5,6085,5732,5,305,1550,42403,2334,1675,659,2334,135800,2020
29037,39.9,104687,91451,4254,4800,29364,72522,40397,30476,9921,40397,196700,2020
29039,44.3,14144,13363,17,319,3521,39408,5573,3899,1674,5573,95200,2020
29041,46.2,7449,7029,159,70,1904,51545,2723,2104,619,2723,100700,2020
29043,38.6,87324,80998,650,2735,24052,64442,32487,24272,8215,32487,182800,2020
29045,44.4,6783,6544,19,53,1702,45842,2633,2003,630,2633,96800,2020
29047,37.2,246480,198055,14746,17175,62413,72047,92514,63246,29268,92514,185700,2020
29049,40.6,20503,19165,293,467,5673,62213,8100,6305,1795,8100,160800,2020
29051,39,76630,62316,9056,2192,18662,61184,30291,20331,9960,30291,169700,2020
29053,38.8,17522,15401,1002,347,4351,53003,6342,4712,1630,6342,150800,2020
29055,42.2,23984,22747,138,497,6315,44380,9798,7137,2661,9798,124400,2020
29057,46.4,7571,7076,32,167,2124,42117,3028,2239,789,3028,101800,2020
29059,43.3,16841,15893,5,357,4604,40404,6412,4836,1576,6412,131000,2020
29061,40.9,8294,7943,51,136,2112,52143,3002,2402,600,3002,114600,2020
29063,41,11872,10127,1055,310,2377,58433,3800,2645,1155,3800,125000,2020
29065,45.6,15518,14480,72,276,4169,42714,6355,4545,1810,6355,104900,2020
29067,47.8,13335,12638,54,286,3803,43714,5317,4392,925,5317,127300,2020
29069,39.4,29657,23501,3035,2005,7744,38020,12119,7472,4647,12119,78500,2020
29071,40.6,103629,97965,761,1843,28149,60129,41127,31765,9362,41127,171900,2020
29073,47.5,14673,14039,78,87,4166,56380,6154,4871,1283,6154,136800,2020
29075,40.3,6576,6298,36,116,1596,46774,2495,1897,598,2495,86200,2020
29077,36.3,291574,253203,8884,11148,73730,47053,127532,71746,55786,127532,151300,2020
29079,40.5,9885,9277,23,243,2277,46885,3900,2622,1278,3900,101100,2020
29081,42.8,8427,7980,68,208,2132,40615,3361,2311,1050,3361,75300,2020
29083,44.3,21854,20419,267,551,5876,47500,9284,6604,2680,9284,115600,2020
29085,55,9452,8946,2,169,2285,33342,4012,3348,664,4012,81500,2020
29087,48.7,4374,4186,44,45,1231,46442,2010,1539,471,2010,88900,2020
29089,38.8,10022,8861,564,170,2401,55000,3460,2754,706,3460,141400,2020
29091,40.8,40130,37763,111,899,10499,39482,15557,10614,4943,15557,114600,2020
29093,45.9,10150,9579,49,181,2766,40082,4102,3001,1101,4102,87100,2020
29095,36.8,700733,432933,161361,64160,167177,56960,291532,170399,121133,291532,157200,2020
29097,36.2,120528,100935,2323,9913,29947,49155,46461,29558,16903,46461,124200,2020
29099,39.6,224777,208273,1942,4548,61349,67606,84978,67585,17393,84978,167700,2020
29101,30.3,53948,46003,2080,2514,12591,56440,19931,12439,7492,19931,163300,2020
29103,44.2,3948,3796,21,40,882,37588,1400,1190,210,1400,75100,2020
29105,39.2,35680,32925,197,912,10112,46582,14413,9795,4618,14413,116600,2020
29107,42.4,32697,29987,767,1009,8662,62076,12711,9013,3698,12711,154300,2020
29109,38.7,38241,33951,122,2911,10249,44060,14849,10586,4263,14849,115300,2020
29111,40.9,9898,9152,386,92,2329,45118,3597,2751,846,3597,88200,2020
29113,37.4,57590,53519,1210,1459,14540,70424,19818,15920,3898,19818,165700,2020
29115,42,12004,11377,72,306,3441,51150,5002,3795,1207,5002,92600,2020
29117,40,14969,13804,401,288,3720,50818,5907,3940,1967,5907,111800,2020
29119,38.2,22882,16577,428,2626,6259,42876,8393,5715,2678,8393,102200,2020
29121,43.1,15154,14130,266,233,3699,44696,5908,4391,1517,5908,100500,2020
29123,41.9,12176,11525,77,289,3296,47984,4851,3419,1432,4851,120000,2020
29125,45.3,8791,8379,27,291,2438,48276,3808,2796,1012,3808,145400,2020
29127,38.9,28572,25674,1243,525,7661,54277,11537,7467,4070,11537,129000,2020
29129,42.7,3623,3401,13,95,821,50030,1333,1049,284,1333,85300,2020
29131,40.5,25369,24038,135,505,6956,47964,10452,7681,2771,10452,140500,2020
29133,41,13328,9390,3341,308,3426,34354,4998,3028,1970,4998,82900,2020
29135,37.7,15907,14210,577,788,3858,57012,5450,4171,1279,5450,138900,2020
29137,46.6,8630,7980,277,146,2388,43422,3731,2802,929,3731,119200,2020
29139,43.9,11414,10659,182,244,3296,52123,4995,3630,1365,4995,120700,2020
29141,46,20438,19210,198,472,5122,41477,7639,6202,1437,7639,150100,2020
29143,41.7,17275,13675,2715,335,4734,40129,7281,4540,2741,7281,77200,2020
29145,39.7,58288,48824,555,3198,15415,52067,22123,15998,6125,22123,131800,2020
29147,30,22199,20452,573,392,4644,46303,8510,4943,3567,8510,126600,2020
29149,46.5,10561,9932,10,196,2966,32766,4298,3137,1161,4298,98600,2020
29151,41.3,13613,13256,26,122,3825,62087,5273,4420,853,5273,159000,2020
29153,51.8,9138,8704,8,167,2505,33046,4082,3243,839,4082,109100,2020
29155,38.1,16330,11129,4364,435,4388,34709,6640,3545,3095,6640,88200,2020
29157,41.2,19227,18264,81,431,5037,56861,7577,5575,2002,7577,151900,2020
29159,37.8,42421,35800,1270,3758,10889,49315,16193,11193,5000,16193,128900,2020
29161,35.8,44587,39135,782,1179,11355,44987,18213,10891,7322,18213,146200,2020
29163,38.6,18158,16094,1233,411,4333,44920,6653,4753,1900,6653,96600,2020
29165,38.3,102848,82520,6681,6466,26679,82448,39918,26808,13110,39918,238800,2020
29167,38.1,32031,29863,298,813,8141,47614,11833,8158,3675,11833,141600,2020
29169,27.8,52359,36267,5642,5927,10381,58426,15061,7877,7184,15061,160700,2020
29171,46.4,4746,4542,13,68,1085,48833,1698,1337,361,1698,89300,2020
29173,45.2,10258,9661,170,101,2873,54194,4132,3530,602,4132,134700,2020
29175,39.2,24769,21813,1450,533,5844,50440,8872,6304,2568,8872,108600,2020
29177,42.4,22900,21321,252,588,6321,65303,8766,6821,1945,8766,139800,2020
29179,46.3,6274,5858,82,49,1819,39552,2580,2116,464,2580,96000,2020
29181,42.1,13484,12820,90,200,3283,36066,4973,3995,978,4973,86900,2020
29183,39,398472,345054,17895,13418,106608,87644,149472,121904,27568,149472,230100,2020
29185,49.3,9455,8861,58,221,2553,39000,4120,3314,806,4120,95100,2020
29186,43.7,17887,17087,386,213,5212,61746,7252,5868,1384,7252,171100,2020
29187,39.2,66653,60706,2707,1068,16480,46307,24572,16690,7882,24572,118000,2020
29189,40.4,996179,645623,240821,29396,258720,68661,409658,279715,129943,409658,206700,2020
29195,36.7,22932,18242,1158,2428,5097,47585,8235,5829,2406,8235,114600,2020
29197,39.5,4550,4407,13,102,904,44420,1440,1000,440,1440,81300,2020
29199,36.3,4923,4787,1,0,1148,47708,1687,1327,360,1687,100300,2020
29201,40.1,38538,31930,4290,942,10054,46310,15342,10157,5185,15342,113200,2020
29203,45,8207,7693,10,108,2254,36229,3063,2293,770,3063,119900,2020
29205,42.8,5975,5664,97,134,1635,43809,2485,1880,605,2485,71700,2020
29207,42,29255,27753,395,519,7582,42761,11545,8084,3461,11545,103600,2020
29209,54.2,31875,30155,66,743,8922,51476,12689,10571,2118,12689,185900,2020
29211,42.3,6163,4729,188,1129,1340,44056,2218,1635,583,2218,75600,2020
29213,43.2,55563,49154,1008,3404,15171,47860,22390,14669,7721,22390,149900,2020
29215,43.1,25518,23144,514,560,6759,35758,9852,7505,2347,9852,112600,2020
29217,41.7,20560,19257,82,461,5253,43910,8294,6129,2165,8294,102200,2020
29219,41.2,35090,31873,639,1220,10040,64735,13129,10440,2689,13129,184900,2020
29221,40.5,24819,23254,513,363,6320,42849,9278,7092,2186,9278,97700,2020
29223,48.2,13058,12222,79,248,3428,38018,5438,4068,1370,5438,93200,2020
29225,36.4,39127,36719,227,841,9905,55827,13697,10713,2984,13697,152500,2020
29227,48.2,2001,1921,12,48,537,47500,808,659,149,808,71200,2020
29229,41.5,18256,17074,25,376,4723,36711,6977,5286,1691,6977,109100,2020
29510,36,304709,133869,138482,12530,64848,45782,143566,63338,80228,143566,143700,2020
30001,42.6,9454,8515,7,467,2458,45819,4203,2686,1517,4203,206900,2020
30003,31.4,13302,3555,0,785,2654,48273,3622,2350,1272,3622,150300,2020
30005,33.5,6698,2960,31,231,1589,45361,2399,1397,1002,2399,90600,2020
30007,47.1,6080,5760,5,175,1512,57723,2436,2053,383,2436,238000,2020
30009,51.1,10689,9991,58,271,2801,61209,4524,3358,1166,4524,271500,2020
30011,53.3,1305,1256,0,0,390,42300,650,443,207,650,109400,2020
30013,38,81576,69287,1174,3826,20933,52049,34440,22928,11512,34440,184400,2020
30015,40.9,5731,4410,14,45,1584,45707,2301,1520,781,2301,155700,2020
30017,42.5,11563,10581,80,404,3029,54891,4837,3250,1587,4837,174500,2020
30019,51.4,1705,1564,0,30,478,56026,856,671,185,856,164700,2020
30021,41.7,8824,8148,44,269,2368,51681,3892,2561,1331,3892,152700,2020
30023,49,9153,8165,136,324,2351,42129,4069,2728,1341,4069,129100,2020
30025,35.3,2975,2788,1,40,737,69792,1274,918,356,1274,165900,2020
30027,45,11167,10441,80,148,2788,47618,5057,3564,1493,5057,138700,2020
30029,42.2,102001,94231,375,3017,25634,57763,39925,29460,10465,39925,294600,2020
30031,33.4,111401,101437,458,4349,26238,70124,45287,27693,17594,45287,388000,2020
30033,40.1,1051,1042,6,3,300,43750,437,300,137,437,155300,2020
30035,32.5,13706,4087,52,440,2625,37645,4158,2566,1592,4158,106400,2020
30037,55,814,687,0,87,237,49028,361,291,70,361,107600,2020
30039,54.6,3325,3129,7,76,805,50795,1355,1070,285,1355,252600,2020
30041,34.5,16422,11299,51,622,4224,50912,6471,4102,2369,6471,153800,2020
30043,47.5,12069,11157,82,322,3320,71779,4445,3744,701,4445,290700,2020
30045,53.9,1968,1838,0,64,550,50329,915,703,212,915,154200,2020
30047,42.3,30383,19746,100,1330,8090,52169,11869,8590,3279,11869,278400,2020
30049,41.3,68714,62243,231,2404,17093,66062,28502,20453,8049,28502,263900,2020
30051,40.1,2455,2415,0,27,602,46750,925,497,428,925,101600,2020
30053,52.5,19845,18203,38,638,5476,39820,8622,6860,1762,8622,197300,2020
30055,49.4,1826,1637,0,69,477,57045,818,676,142,818,151300,2020
30057,53.1,8530,7890,2,371,2231,55892,3707,2853,854,3707,316900,2020
30059,56.3,1795,1648,1,93,463,46815,759,650,109,759,170700,2020
30061,52.3,4330,3964,43,90,1208,48672,1926,1496,430,1926,194800,2020
30063,36,119062,104938,626,4058,27624,56247,49700,29113,20587,49700,302200,2020
30065,51.5,4682,4284,0,126,1409,46328,2211,1617,594,2211,173000,2020
30067,46.5,16513,15379,59,508,4584,53082,7961,5465,2496,7961,287800,2020
30069,49.6,464,449,0,0,124,40000,212,139,73,212,155700,2020
30071,47.5,4032,3346,0,120,1066,46686,1756,1401,355,1756,141600,2020
30073,41.1,5911,4799,6,40,1412,54235,2079,1495,584,2079,138900,2020
30075,50.2,1634,1497,0,76,525,57755,748,558,190,748,135900,2020
30077,46.1,6843,6079,48,141,1610,50332,2515,1557,958,2515,147400,2020
30079,52.5,1162,1121,0,18,293,42350,502,398,104,502,101000,2020
30081,49.3,43424,39806,72,1528,12452,55090,17823,13800,4023,17823,290400,2020
30083,38,11097,9779,0,610,2760,64158,4408,3022,1386,4408,229100,2020
30085,30.4,11091,3741,22,374,2031,45458,3248,2085,1163,3248,103800,2020
30087,36.5,9065,4750,23,435,2164,57769,3237,2187,1050,3237,115300,2020
30089,54.5,11804,10623,31,372,3097,42284,5281,4071,1210,5281,251600,2020
30091,43.7,3389,3055,0,145,900,54135,1543,1157,386,1543,114800,2020
30093,40.1,34895,31473,96,1629,8252,49359,15026,10454,4572,15026,155300,2020
30095,47.5,9562,8858,7,382,2585,67448,3840,3104,736,3840,256600,2020
30097,46.8,3676,3404,0,122,1041,53790,1515,1119,396,1515,243300,2020
30099,42.5,6127,5716,45,33,1582,56649,2496,1798,698,2496,186300,2020
30101,44.2,4812,4179,25,152,1066,49725,1827,1132,695,1827,124600,2020
30103,57.8,614,606,0,2,220,44671,333,238,95,333,161800,2020
30105,44.4,7424,6284,30,70,2034,51087,3324,2497,827,3324,150500,2020
30107,46.9,2138,2020,0,38,582,35265,897,646,251,897,117300,2020
30109,50.5,1037,944,0,76,316,50972,477,378,99,477,107600,2020
30111,38.7,160390,137578,765,9429,42284,62630,68047,46866,21181,68047,238700,2020
31001,38,31541,26912,163,3413,8085,56007,12786,8704,4082,12786,137700,2020
31003,44.8,6315,5995,65,217,1656,52569,2725,2063,662,2725,82100,2020
31005,48,439,418,0,7,116,48500,192,135,57,192,129200,2020
31007,50.4,645,587,0,43,207,53864,234,162,72,234,172900,2020
31009,57.5,467,467,0,0,141,55268,237,161,76,237,77700,2020
31011,44.6,5228,5036,7,118,1494,60094,2261,1745,516,2261,131700,2020
31013,39.6,10845,8796,400,1382,2962,61904,4601,3277,1324,4601,129200,2020
31015,56.2,1882,1783,4,57,578,53846,876,734,142,876,85000,2020
31017,48.6,2887,2725,1,72,756,41979,1333,1052,281,1333,85100,2020
31019,33.8,49594,42950,402,4597,11860,63513,19016,12592,6424,19016,185300,2020
31021,45.6,6503,6024,20,209,1845,51961,2881,2187,694,2881,104900,2020
31023,42.9,7997,7498,6,314,2158,59232,3387,2629,758,3387,127200,2020
31025,41.3,26022,24188,68,914,7142,73683,10073,8212,1861,10073,195500,2020
31027,42.2,8483,8168,10,173,2355,64703,3479,2791,688,3479,121800,2020
31029,44.2,3707,3099,3,522,1123,56135,1591,1235,356,1591,139200,2020
31031,42.1,5801,5059,9,113,1599,55431,2459,1465,994,2459,124900,2020
31033,41,9428,8371,61,692,2373,52270,4403,2905,1498,4403,98700,2020
31035,41.9,6193,5496,19,556,1782,63686,2575,2076,499,2575,102500,2020
31037,36,10681,5170,402,4855,2444,64269,3742,2695,1047,3742,92900,2020
31039,40.9,8882,7824,24,892,2501,59202,3854,2554,1300,3854,129100,2020
31041,43.6,10788,10179,11,357,3158,53891,4828,3362,1466,4828,116900,2020
31043,33,20124,9373,1152,7858,5125,61227,7350,4877,2473,7350,131400,2020
31045,34.3,8685,7393,237,482,2065,49379,3555,2256,1299,3555,125200,2020
31047,35.9,23638,13728,1463,7912,6518,56731,9007,5885,3122,9007,113700,2020
31049,50.1,1770,1538,4,166,563,48958,823,645,178,823,89800,2020
31051,41.4,5682,4758,5,806,1602,57243,2376,1773,603,2376,100000,2020
31053,39.2,36565,30376,328,4953,9756,58439,15284,9501,5783,15284,137100,2020
31055,34.9,565739,389520,60751,72462,136534,66600,221451,137435,84016,221451,180000,2020
31057,42.9,1928,1753,3,170,485,49211,842,648,194,842,76900,2020
31059,46.6,5542,5182,9,221,1538,62151,2488,1936,552,2488,89200,2020
31061,50.6,2970,2825,13,71,888,50231,1328,1086,242,1328,77100,2020
31063,44.5,2636,2500,22,55,752,59250,1136,785,351,1136,111100,2020
31065,47.2,4712,4387,8,213,1411,53533,2077,1643,434,2077,73700,2020
31067,43.4,21548,20292,121,585,5440,51812,9048,6149,2899,9048,124100,2020
31069,49.6,1916,1794,0,96,530,42076,929,711,218,929,77100,2020
31071,45.8,2081,2011,2,40,661,54659,906,716,190,906,106000,2020
31073,54,2001,1890,4,80,645,65086,940,710,230,940,165500,2020
31075,37.9,691,671,5,0,178,43625,297,205,92,297,72500,2020
31077,45.4,2361,2268,6,53,668,46830,1045,838,207,1045,74200,2020
31079,36.1,61338,40255,1633,17572,15947,58595,23496,14585,8911,23496,153800,2020
31081,41.7,9219,8710,8,337,2707,68649,3622,2872,750,3622,163900,2020
31083,46.3,3380,3182,26,110,899,51534,1515,1188,327,1515,113900,2020
31085,48.3,889,824,0,63,236,52396,389,277,112,389,81000,2020
31087,45.4,2788,2627,1,42,740,46000,1228,949,279,1228,75900,2020
31089,43.1,10123,9412,22,514,2738,60214,4390,3144,1246,4390,126000,2020
31091,46.1,741,639,4,53,170,48654,316,189,127,316,94000,2020
31093,42.6,6428,5937,10,168,1910,59432,2732,2007,725,2732,155300,2020
31095,47.1,7102,6615,51,316,1905,48981,3246,2296,950,3246,98600,2020
31097,39.8,5118,4103,271,524,1247,49382,1847,1292,555,1847,104700,2020
31099,39.1,6588,6010,5,470,1812,62899,2691,1969,722,2691,162200,2020
31101,49.3,8048,7198,132,601,2225,52169,3864,2763,1101,3864,135000,2020
31103,48.4,875,863,0,11,225,55250,349,257,92,349,65000,2020
31105,47.6,3576,3082,5,332,987,48056,1612,1112,500,1612,80500,2020
31107,45.5,8400,7162,26,260,2329,53653,3605,2673,932,3605,92300,2020
31109,33.8,315976,254480,11956,22972,76036,62464,126666,74937,51729,126666,190000,2020
31111,41.5,35042,30571,446,3200,9499,59995,14765,9962,4803,14765,153200,2020
31113,39.4,896,861,0,26,219,45990,319,246,73,319,107900,2020
31115,44.5,690,620,0,58,208,46111,316,238,78,316,82200,2020
31117,58.1,420,415,0,5,145,51932,199,157,42,199,78900,2020
31119,36.6,35023,27744,411,5392,8524,52334,14187,9622,4565,14187,155200,2020
31121,43.1,7826,7191,57,380,2048,52254,3330,2577,753,3330,119900,2020
31123,41.9,4711,3843,13,730,1143,46903,1969,1480,489,1969,103200,2020
31125,45.1,3525,3383,10,100,1024,53147,1530,1331,199,1530,78400,2020
31127,38.4,6978,6353,91,203,1839,50236,2912,2117,795,2912,97200,2020
31129,49.6,4204,3962,13,123,1145,52975,1852,1478,374,1852,73900,2020
31131,42,15965,14135,107,1298,4461,64755,6509,4718,1791,6509,145100,2020
31133,49.7,2640,2513,5,51,751,46063,1221,1005,216,1221,71400,2020
31135,42.7,2889,2727,5,127,879,61389,1202,953,249,1202,118400,2020
31137,41.6,9050,8293,9,536,2398,58105,3900,2775,1125,3900,139900,2020
31139,41.6,7132,6837,10,147,2019,57629,2990,2247,743,2990,134500,2020
31141,38.3,33250,25726,193,6618,8579,60878,13173,9453,3720,13173,159500,2020
31143,44.9,5208,4775,4,301,1411,59837,2048,1710,338,2048,117600,2020
31145,40.2,10725,9803,69,588,2561,48140,4503,3239,1264,4503,113600,2020
31147,47.3,7913,7278,24,158,2306,44524,3706,2777,929,3706,73700,2020
31149,41,1430,1379,24,11,425,51458,617,460,157,617,92100,2020
31151,37.5,14221,9755,175,3644,3664,52956,5292,3781,1511,5292,120800,2020
31153,34.8,183956,147279,6929,17854,48411,83051,67299,46396,20903,67299,211400,2020
31155,41.1,21356,20276,136,499,5849,70414,8542,6831,1711,8542,171600,2020
31157,39.1,35884,25606,215,8743,9386,53433,14657,9771,4886,14657,130400,2020
31159,37.8,17217,16271,112,469,4693,71111,6766,4819,1947,6766,172900,2020
31161,46.3,5215,4221,91,301,1446,45543,2312,1498,814,2312,78200,2020
31163,51.1,3015,2887,5,69,879,53158,1414,1045,369,1414,91000,2020
31165,35.4,1298,1191,37,54,374,47422,530,330,200,530,108800,2020
31167,41.3,5946,5393,116,355,1612,64808,2430,1905,525,2430,129200,2020
31169,46.8,5000,4711,26,140,1410,53234,2247,1710,537,2247,69900,2020
31171,33.6,586,579,0,0,170,59000,276,188,88,276,120000,2020
31173,28,7218,2533,14,501,1645,55574,2165,1328,837,2165,77700,2020
31175,47,4100,3937,17,96,1228,56205,1844,1431,413,1844,110500,2020
31177,40.9,20546,19364,95,597,5575,71505,8303,6428,1875,8303,204900,2020
31179,32.2,9388,8408,116,595,2183,58894,3793,2549,1244,3793,144100,2020
31181,45.7,3497,3201,7,184,1006,51684,1524,1240,284,1524,74600,2020
31183,58.9,689,672,0,14,204,48438,353,267,86,353,96900,2020
31185,39.8,13671,12331,204,714,3723,63105,5685,4184,1501,5685,135600,2020
32001,40.5,24606,17798,632,3543,6074,56335,9972,6837,3135,9972,198800,2020
32003,37.5,2228866,930203,255922,697554,516891,61048,809026,443247,365779,809026,285100,2020
32005,52.9,48486,38643,332,6222,14910,71415,21071,15688,5383,21071,416900,2020
32007,34.7,52537,34192,665,12840,12617,79375,18516,12813,5703,18516,225800,2020
32009,54.6,1030,736,15,263,208,31845,515,260,255,515,81100,2020
32011,42.5,1839,1669,1,91,507,67478,661,485,176,661,151000,2020
32013,37.1,16834,10921,174,4585,4197,66123,6579,4526,2053,6579,186200,2020
32015,37.6,5565,3876,5,1371,1621,73797,2315,1754,561,2315,167400,2020
32017,43.7,5177,4284,194,572,1157,56537,2003,1453,550,2003,132600,2020
32019,43.9,55667,41259,477,9823,14411,58814,21726,15865,5861,21726,238600,2020
32021,53.3,4487,2758,129,630,955,31500,1938,1414,524,1938,99900,2020
32023,53.1,45514,34078,946,6868,11719,47308,19253,13771,5482,19253,172300,2020
32027,42.6,6591,4244,208,1618,1361,57074,2009,1363,646,2009,114400,2020
32029,53,4086,3329,112,106,1048,64000,1704,1644,60,1704,264000,2020
32031,38.5,464182,288803,10305,114756,115905,68272,186116,107732,78384,186116,360500,2020
32033,40.8,9570,6846,592,1579,2291,57353,3749,2713,1036,3749,157100,2020
32510,42.2,55244,36520,1035,13377,14341,58305,22858,13299,9559,22858,299900,2020
33001,47.9,61174,57849,373,1083,16869,67328,25576,19588,5988,25576,232000,2020
33003,53.4,48461,46288,252,742,13729,66932,22235,17644,4591,22235,251400,2020
33005,43,76040,71399,589,1472,18640,64686,30513,20766,9747,30513,197700,2020
33007,48.7,31486,29677,610,592,8427,48945,13967,10091,3876,13967,132500,2020
33009,43.3,90331,81200,1057,2265,21367,67476,35141,24556,10585,35141,230700,2020
33011,40.8,415305,347545,9305,29387,105324,82099,162843,107043,55800,162843,287900,2020
33013,43.1,150902,138724,2170,3426,39851,77937,59209,42947,16262,59209,245400,2020
33015,44.7,308211,283422,2483,9651,84341,93962,122520,95348,27172,122520,344000,2020
33017,36.8,130161,117151,1261,3451,31733,72682,49831,33285,16546,49831,243500,2020
33019,46.9,43173,40774,243,723,11164,63760,17281,12571,4710,17281,174400,2020
34001,41.8,264650,147712,36017,50562,66993,63680,101103,67657,33446,101103,216600,2020
34003,41.9,931275,516790,48953,189827,246196,104623,342059,221603,120456,342059,477400,2020
34005,41.6,446301,297157,71728,37264,116972,90329,168195,126343,41852,168195,259600,2020
34007,38.8,506721,283475,92377,87299,126330,70957,190660,124997,65663,190660,200400,2020
34009,50.3,92701,78808,3634,7393,27085,72385,40670,31723,8947,40670,306200,2020
34011,37.6,150085,68165,27797,47012,34348,55709,50947,33769,17178,50947,166400,2020
34013,37.7,798698,239760,303671,185818,187965,63959,290680,129015,161665,290680,395900,2020
34015,40.4,291745,227276,29300,18922,75282,89056,106376,85575,20801,106376,224300,2020
34017,35.3,671923,191992,70317,286039,160586,75062,261289,84542,176747,261289,400800,2020
34019,46.6,125063,106076,3176,8483,35085,117858,47647,39978,7669,47647,418700,2020
34021,38.8,368085,179637,72229,66048,87704,83306,131440,83468,47972,131440,290100,2020
34023,39,825015,346259,78469,176010,208863,91731,287971,183379,104592,287971,351400,2020
34025,43.4,620821,465628,40609,67427,162745,103523,238235,177116,61119,238235,435300,2020
34027,42.8,492715,347576,15126,66311,130676,117298,184162,135987,48175,184162,462100,2020
34029,42.4,602018,507501,16797,55735,150317,72679,229454,184317,45137,229454,286700,2020
34031,37.3,502763,204783,51865,210461,123240,73562,168681,88299,80382,168681,352000,2020
34033,42.5,62754,46227,8400,5942,15753,64234,24414,16874,7540,24414,185700,2020
34035,41.8,330151,181828,31076,48653,85667,116510,119721,90666,29055,119721,436700,2020
34037,44.9,140996,120289,2927,12163,38568,96222,54166,45288,8878,54166,271500,2020
34039,38.9,555208,216483,111894,177402,138620,82644,191862,113015,78847,191862,378700,2020
34041,44.5,105730,85385,4772,10307,28311,83497,42322,30816,11506,42322,265700,2020
35001,38,679037,256847,16355,341790,159218,54308,272528,172529,99999,272528,205500,2020
35003,59.4,3547,2931,14,602,874,36607,1546,1352,194,1546,162400,2020
35005,36.1,64912,24763,935,37378,15888,46254,23641,16133,7508,23641,115400,2020
35006,37.5,26763,5028,325,10389,5807,44731,8408,6018,2390,8408,88800,2020
35007,50.3,12106,5639,82,5989,3339,36937,5946,4031,1915,5946,108900,2020
35009,31.7,49502,23096,2458,21210,12131,48903,18620,10501,8119,18620,132400,2020
35011,22.2,1995,611,85,1281,273,31532,554,344,210,554,130000,2020
35013,33.3,217696,58682,3330,149243,52075,44024,79421,51316,28105,79421,153600,2020
35015,35.4,57865,26247,812,28942,15122,65000,21548,15088,6460,21548,161100,2020
35017,46.5,27391,12519,113,13800,6146,37453,11496,7630,3866,11496,127100,2020
35019,43.7,4336,812,72,3091,688,31061,1345,910,435,1345,100500,2020
35021,43.5,432,217,0,172,94,32500,176,101,75,176,87500,2020
35023,43.2,4234,1601,36,2484,1224,44722,1742,1217,525,1742,91800,2020
35025,32,70359,24242,2341,42033,16580,61867,22868,15555,7313,22868,138600,2020
35027,51.5,19640,11962,363,6572,5356,44939,8478,6406,2072,8478,172800,2020
35028,41.8,18976,13543,153,3440,5005,119266,7895,5775,2120,7895,322200,2020
35029,37.2,24022,6916,316,16242,5342,32251,8911,5551,3360,8911,84700,2020
35031,32.8,71956,6043,329,10391,15081,36179,21247,14453,6794,21247,66700,2020
35033,56.6,4500,764,2,3667,1147,29458,2278,2013,265,2278,104300,2020
35035,36.2,66804,31944,2086,25868,14388,45032,23112,15237,7875,23112,120800,2020
35037,43,8265,4059,49,3777,1783,33962,3182,2206,976,3182,68500,2020
35039,41.5,38962,4714,187,27819,7958,42264,13035,10001,3034,13035,172900,2020
35041,30.3,18723,9579,438,8005,4165,42917,6785,3962,2823,6785,111700,2020
35043,40.3,144954,61938,3156,57442,37528,65071,52504,41981,10523,52504,211700,2020
35045,36.1,125608,46997,830,26518,30997,47643,43582,30871,12711,43582,155000,2020
35047,44.6,27546,4704,306,21443,6604,32310,11942,8353,3589,11942,138300,2020
35049,46.8,150319,64243,1313,76643,36442,60668,63152,44947,18205,63152,294800,2020
35051,55.9,10988,6867,41,3416,2828,33873,5402,3960,1442,5402,120100,2020
35053,39.9,16723,5616,117,8401,2898,40297,5002,3833,1169,5002,117900,2020
35055,48.9,32759,11573,82,18621,6793,41973,12592,9684,2908,12592,249000,2020
35057,42.9,15477,7761,263,6752,4089,38240,5957,4909,1048,5957,115500,2020
35059,38.9,4106,2102,55,1761,756,35484,1404,879,525,1404,93800,2020
35061,38.7,76518,24579,931,46606,18115,50801,26456,21336,5120,26456,151600,2020
36001,37.9,306165,218092,35290,18980,71314,68327,128122,71829,56293,128122,230300,2020
36003,39.3,46304,43664,722,782,11553,51227,18028,14266,3762,18028,78400,2020
36005,34.5,1427056,128717,411293,799765,329504,41895,510135,102325,407810,510135,427900,2020
36007,39.7,192042,158962,9503,8455,46354,52237,79528,51780,27748,79528,120200,2020
36009,42.5,76750,69202,1101,1672,20244,50700,31999,23090,8909,31999,90200,2020
36011,43.2,76958,68927,2906,2336,19068,57985,30870,21886,8984,30870,131700,2020
36013,42.8,127584,110961,3024,9817,32567,48315,53625,36795,16830,53625,92900,2020
36015,41.3,84115,72022,4765,2728,20953,54883,34328,23069,11259,34328,108900,2020
36017,44.8,47527,44894,352,1095,12880,51756,20834,15574,5260,20834,102300,2020
36019,40.3,80320,72136,3168,2367,18958,59510,31557,21421,10136,31557,139600,2020
36021,48.5,60016,51480,2456,2975,16205,68750,25323,18530,6793,25323,236500,2020
36023,36.4,47618,43865,971,1333,11624,59194,17980,11906,6074,17980,126700,2020
36025,48.3,44676,40913,734,1803,11587,49945,18930,14296,4634,18930,144000,2020
36027,42.5,293524,207050,29153,36957,72055,81842,110095,75080,35015,110095,290700,2020
36029,40.2,918873,688019,116511,52435,228440,59464,392910,254697,138213,392910,160700,2020
36031,48.3,37281,34175,1098,1158,10209,58109,16182,12363,3819,16182,160400,2020
36033,40.5,50389,41011,2815,1815,11882,52905,18880,13607,5273,18880,110600,2020
36035,44.2,53452,48794,923,1795,14552,51663,22406,15612,6794,22406,120100,2020
36037,43,57554,51937,1251,1959,14977,60635,24174,17501,6673,24174,125200,2020
36039,46.7,47335,40025,2592,2922,10701,56681,17681,13550,4131,17681,185600,2020
36041,55.5,4454,4170,24,77,939,60625,1416,1208,208,1416,170500,2020
36043,44.3,61738,57782,654,1411,15791,58438,25093,18647,6446,25093,106600,2020
36045,32.8,111454,90493,6085,8598,28391,54726,43046,23980,19066,43046,150100,2020
36047,35.4,2576771,938573,754576,486272,594423,63973,972314,295080,677234,972314,734800,2020
36049,42.2,26456,25270,239,457,7111,56192,10398,8407,1991,10398,122800,2020
36051,41.5,63218,56956,1646,2401,15535,60248,24496,18683,5813,24496,134000,2020
36053,42.3,70990,65518,1110,1636,16675,61176,25959,20365,5594,25959,140000,2020
36055,39,743084,519765,105359,67590,183050,62087,305210,193319,111891,305210,152000,2020
36057,40.9,49294,39493,1168,7225,12251,50146,19621,13241,6380,19621,110700,2020
36059,41.9,1355683,799547,150627,230740,346312,120036,449967,365052,84915,449967,524400,2020
36061,37.7,1629153,763202,199377,418442,325483,89812,758720,182507,576213,758720,1024500,2020
36063,43.4,210145,178123,14109,6755,55242,57252,90022,64549,25473,90022,131600,2020
36065,40.8,229074,186651,13063,13883,57270,59113,90675,62318,28357,90675,133100,2020
36067,39.2,461591,352458,48698,23602,113106,62668,187349,121902,65447,187349,148100,2020
36069,43.8,109774,98238,2322,5390,29061,64795,45711,33237,12474,45711,163100,2020
36071,37.1,382077,241184,38454,80256,91759,80816,130428,88453,41975,130428,278400,2020
36073,43.4,40624,34890,2342,2081,11047,52958,16634,12491,4143,16634,101400,2020
36075,40.6,117630,109977,1211,3118,30267,59070,46597,33912,12685,46597,109500,2020
36077,42,59593,54128,1006,2270,14714,56171,23768,17157,6611,23768,150700,2020
36079,44.2,98714,76625,2741,15388,26354,107246,34915,28797,6118,34915,366400,2020
36081,39.3,2270976,559778,385868,631657,530194,72028,783362,353375,429987,783362,575600,2020
36083,39.9,159013,131144,9176,8182,39401,72510,65455,41200,24255,65455,197100,2020
36085,40.2,475596,286462,43941,87733,123026,85381,167160,114975,52185,167160,546100,2020
36087,35.9,325213,204650,36313,58036,75714,94840,101167,68703,32464,101167,452500,2020
36089,39,108352,99410,2576,2554,25703,52071,41925,30387,11538,41925,97000,2020
36091,42.9,229313,206201,3519,7608,62035,85224,95898,69128,26770,95898,266000,2020
36093,39.9,155086,111949,15116,11351,33599,66488,57479,36775,20704,57479,172500,2020
36095,45.8,31189,28753,410,1055,8046,58926,12780,9630,3150,12780,142600,2020
36097,46.8,17845,16912,129,331,4574,53291,7402,5537,1865,7402,127000,2020
36099,41.9,34295,30307,1655,1244,8279,54865,13784,10011,3773,13784,107500,2020
36101,42.9,95843,89289,1464,1614,25921,55349,40099,29258,10841,40099,104200,2020
36103,41.7,1481364,991862,105591,290261,361133,105362,495667,403707,91960,495667,413900,2020
36105,42.8,75329,53148,5806,12321,17925,60433,28762,19980,8782,28762,175900,2020
36107,44.8,48431,45786,398,993,13860,61965,20643,16071,4572,20643,119800,2020
36109,31.3,102237,78613,3764,5343,21416,61361,40817,22025,18792,40817,218700,2020
36111,44.1,178371,137257,9834,18800,42244,65306,70088,48108,21980,70088,239400,2020
36113,46.9,64187,59995,632,1720,17369,64658,29034,20516,8518,29034,208600,2020
36115,44.2,61304,56136,1596,1738,15236,59613,24054,17494,6560,24054,151500,2020
36117,43.9,90103,80435,2145,4087,24664,62003,37281,29114,8167,37281,130000,2020
36119,41.1,968738,510754,130047,241442,242970,99489,353485,216939,136546,353485,544100,2020
36121,42.9,40027,35921,1809,1341,10544,58746,16055,12296,3759,16055,118800,2020
36123,40.7,24981,23646,243,555,5892,55307,8901,6805,2096,8901,142300,2020
37001,39.1,166144,104817,32650,21153,42129,51580,65455,43538,21917,65455,160900,2020
37003,43.9,37271,32317,1924,1779,10248,51329,14049,11232,2817,14049,138900,2020
37005,50.6,11085,9615,177,1080,3370,37158,5001,3774,1227,5001,150500,2020
37007,41.5,24430,10905,11775,1002,5751,39799,9803,6556,3247,9803,104100,2020
37009,48.6,27009,24959,199,1349,8051,43030,11885,9393,2492,11885,158200,2020
37011,45.4,17510,15515,742,877,4413,42695,6569,5105,1464,6569,151800,2020
37013,46.5,47160,30988,11549,3767,13244,48051,20219,14600,5619,20219,138000,2020
37015,46.2,19081,6534,11650,405,4714,35042,8008,5691,2317,8008,78500,2020
37017,44.8,33209,18195,11423,2514,8631,37188,13394,9666,3728,13394,98700,2020
37019,54.7,137303,111788,12836,6690,41251,59763,59416,48090,11326,59416,220400,2020
37021,42.3,259576,216260,15902,17396,60615,55032,105177,66631,38546,105177,250600,2020
37023,44.3,90148,73345,5490,5622,23459,43915,35664,26926,8738,35664,120600,2020
37025,38,211605,135642,38402,22444,53261,71177,72843,53160,19683,72843,219100,2020
37027,45.1,82056,71350,3464,4677,22563,46094,32798,24057,8741,32798,125200,2020
37029,41.8,10654,8536,1181,325,3183,63834,3912,3010,902,3912,221000,2020
37031,49.2,69301,59743,3399,3011,19265,57871,30060,21537,8523,30060,226700,2020
37033,46.2,22619,13778,7385,958,6186,47938,8993,6676,2317,8993,113600,2020
37035,41.6,158507,118594,13005,15636,42898,54690,62940,44608,18332,62940,156200,2020
37037,47.3,72853,52365,8234,8794,20719,69799,29904,23005,6899,29904,310000,2020
37039,52.1,28413,25762,365,980,8167,40793,12546,10230,2316,12546,163900,2020
37041,46.2,13995,8388,4788,502,4137,44050,6389,4162,2227,6389,139500,2020
37043,53.6,11150,10384,215,385,3171,42160,5300,3866,1434,5300,197600,2020
37045,41.9,97765,70917,20163,3618,24337,43512,36089,24670,11419,36089,130000,2020
37047,41.9,55659,32918,16493,3061,14313,38487,21545,15531,6014,21545,94800,2020
37049,37.6,102290,66719,21708,7644,26906,53894,41002,26646,14356,41002,161200,2020
37051,31.4,334562,142180,121430,40081,79010,48177,127532,65638,61894,127532,139700,2020
37053,43,27210,23672,1492,1138,7706,73741,10868,9113,1755,10868,263400,2020
37055,47.5,36698,31929,1043,2720,10284,65420,15830,12062,3768,15830,297200,2020
37057,42.5,166837,132663,15391,12265,46889,50454,67555,48642,18913,67555,149500,2020
37059,45.8,42543,35806,2035,2940,11448,62028,16303,13384,2919,16303,177100,2020
37061,40.7,58965,30263,13539,13225,14485,43422,21437,15415,6022,21437,89500,2020
37063,35.5,317665,135354,111729,43051,74763,62812,130128,72145,57983,130128,241800,2020
37065,41.7,52069,18697,29824,2512,14346,40489,20800,12864,7936,20800,88500,2020
37067,38.4,378499,212309,96055,49324,92950,53583,148890,92746,56144,148890,163800,2020
37069,41.3,68027,43055,16237,5875,18813,58172,25729,18838,6891,25729,161500,2020
37071,40,222119,158980,36434,16172,56299,53474,85286,56285,29001,85286,156800,2020
37073,47.2,11519,7252,3638,11,3074,45871,4690,3631,1059,4690,142400,2020
37075,46.4,8501,7335,16,318,2295,42207,3521,2940,581,3521,119000,2020
37077,43.1,59823,34500,17475,4941,15563,56924,21567,16184,5383,21567,168900,2020
37079,40.5,20987,9809,7043,3213,4677,43563,7218,5026,2192,7218,87500,2020
37081,37.4,532956,264497,180458,43379,129970,54794,208234,122959,85275,208234,172900,2020
37083,43.9,50678,19301,26362,1510,13699,35904,21061,12985,8076,21061,85800,2020
37085,34.7,134328,82035,27575,17509,31740,54565,46525,30780,15745,46525,160700,2020
37087,47.7,61862,57103,541,2557,17221,51548,26891,19547,7344,26891,185600,2020
37089,47.6,116298,96418,3856,11835,33448,58928,49715,36894,12821,49715,232000,2020
37091,42.8,23752,7868,14208,885,5296,42588,8903,5933,2970,8903,89800,2020
37093,33,54590,21310,17746,7592,12403,51140,18448,12542,5906,18448,146200,2020
37095,40.9,5089,2790,1497,677,1468,46667,2056,1307,749,2056,122300,2020
37097,40.8,178853,135146,21209,13958,49826,62551,68374,49129,19245,68374,200800,2020
37099,38.5,43435,34999,869,2663,9921,46820,17008,10827,6181,17008,206900,2020
37101,38.4,203308,136014,32197,27928,51865,61806,71332,52812,18520,71332,180200,2020
37103,48.1,9453,5893,2783,480,2621,38324,4069,3021,1048,4069,92200,2020
37105,39.4,61083,35446,11648,11761,15527,52294,22290,14435,7855,22290,145600,2020
37107,42.3,56350,27598,21614,4434,14022,39923,23494,13359,10135,23494,94000,2020
37109,43.6,84580,71335,4164,6083,23783,59592,33621,25486,8135,33621,187000,2020
37111,44.2,45402,39730,1658,2798,13340,47085,18275,13474,4801,18275,129400,2020
37113,50.4,35172,31243,498,2543,9945,45703,16062,11708,4354,16062,171700,2020
37115,44.6,21608,20274,302,533,5315,46190,8373,6271,2102,8373,200700,2020
37117,46.4,22644,11734,9497,942,6199,39909,9622,6371,3251,9622,86400,2020
37119,35.2,1095170,506691,340835,146710,256164,69240,421950,237994,183956,421950,253500,2020
37121,47.2,14959,13746,21,848,4074,48841,6402,5098,1304,6402,164200,2020
37123,43.9,27223,17212,4729,4201,7017,45147,10265,7521,2744,10265,120500,2020
37125,44.1,99263,76249,10926,6848,26473,63324,40575,31179,9396,40575,229400,2020
37127,41.7,94287,46380,38088,6692,25100,49949,37371,24158,13213,37371,133900,2020
37129,39,231448,178457,29708,13197,54049,56689,97998,57212,40786,97998,258200,2020
37131,49.9,19672,7609,10890,467,5321,38969,8424,5994,2430,8424,83600,2020
37133,26.5,198377,130601,27094,25483,47027,51560,66131,35858,30273,66131,162400,2020
37135,35.1,146354,101525,16003,12373,32907,74803,53222,33950,19272,53222,331800,2020
37137,54,12673,9426,2346,511,3534,48531,5506,4229,1277,5506,161600,2020
37139,39.6,39775,21713,14238,2302,9825,54439,14785,9144,5641,14785,166600,2020
37141,42.7,61891,46520,8791,4521,15165,60044,22812,18390,4422,22812,198100,2020
37143,50.2,13513,9767,3120,369,4084,51036,5886,4587,1299,5886,173200,2020
37145,43.6,39561,26177,10014,1756,10746,57323,16153,12626,3527,16153,134100,2020
37147,32.7,179961,97253,62446,11526,42411,49337,70683,37214,33469,70683,146700,2020
37149,53.7,20682,17941,986,1230,5564,52125,9252,6995,2257,9252,222700,2020
37151,41.8,143460,112755,8178,16739,39042,48984,56790,41432,15358,56790,128800,2020
37153,40.8,44759,25331,14245,2973,12024,39051,18201,12000,6201,18201,88200,2020
37155,36.7,131656,32703,31085,11688,30468,35362,45881,30438,15443,45881,75600,2020
37157,45,91051,65584,16474,5630,25659,45697,38532,26792,11740,38532,114900,2020
37159,40.3,140978,101124,22334,12736,36796,51054,54137,37719,16418,54137,146600,2020
37161,45.2,66741,55286,6138,3047,17592,43183,27525,19714,7811,27525,125100,2020
37163,40.3,63284,32082,15900,12665,16139,42914,23162,16678,6484,23162,97500,2020
37165,39.1,34921,14900,13515,1126,8211,35936,12951,7749,5202,12951,87600,2020
37167,42,62050,49951,7011,2706,16640,54104,23849,17821,6028,23849,150400,2020
37169,46.6,45688,41484,1810,1485,13074,51668,19608,15270,4338,19608,145000,2020
37171,44,71904,59968,2530,7822,19808,44979,29001,21075,7926,29001,129700,2020
37173,42.3,14241,8706,95,860,3863,45554,5741,4295,1446,5741,149300,2020
37175,51.9,34039,30745,1395,1131,9799,51509,14648,11071,3577,14648,231300,2020
37177,46.7,3978,2270,1413,175,1087,38250,1652,1204,448,1652,110900,2020
37179,38.6,235767,168665,26605,26526,62077,82557,77791,64363,13428,77791,254100,2020
37181,40.6,44614,17422,21863,3567,10932,41827,16895,9807,7088,16895,103700,2020
37183,36.4,1091662,647265,214636,110961,270784,83567,410552,262278,148274,410552,301600,2020
37185,48.1,19746,7492,9880,761,5013,37476,8122,5821,2301,8122,89500,2020
37187,46.9,11788,5216,5727,644,2819,30941,5237,3327,1910,5237,86400,2020
37189,32.7,55669,51012,935,2091,11125,46453,21453,13063,8390,21453,246000,2020
37191,37.6,123785,65500,37474,14944,32136,47221,48198,30316,17882,48198,125900,2020
37193,45.1,68341,59536,2556,4515,19256,44980,28902,21931,6971,28902,129200,2020
37195,40.5,81579,38035,32159,8577,20655,44594,31968,19322,12646,31968,127100,2020
37197,44.4,37589,31606,1134,4198,10345,46954,15247,11657,3590,15247,138500,2020
37199,47.9,17870,16515,114,928,5057,44554,7466,5444,2022,7466,166900,2020
38001,46.6,2271,2124,36,38,615,48750,1058,768,290,1058,95600,2020
38003,44.4,10592,9512,251,225,2895,60472,5039,3556,1483,5039,138300,2020
38005,31.2,6860,2783,15,250,1572,50329,2265,1638,627,2265,79800,2020
38007,43.2,886,886,0,0,250,64896,366,281,85,366,232400,2020
38009,44.3,6418,5839,38,155,1766,65074,2876,2260,616,2876,157300,2020
38011,41.1,3091,2893,0,166,790,70521,1323,1071,252,1323,154300,2020
38013,41.1,2142,1995,16,15,609,79405,950,747,203,950,114100,2020
38015,37.1,95509,83515,2155,2503,25134,72974,39805,27802,12003,39805,266800,2020
38017,32.6,179937,152179,10821,5042,43034,65976,77027,40437,36590,77027,234100,2020
38019,49.5,3769,3534,2,91,1049,54955,1778,1427,351,1778,108600,2020
38021,42.4,4857,4500,33,167,1341,64521,2127,1602,525,2127,129600,2020
38023,48.1,2289,2076,57,111,614,64650,1060,789,271,1060,124900,2020
38025,40.1,4362,3592,72,166,1098,82750,1700,1250,450,1700,213600,2020
38027,42.4,2262,1987,0,46,608,52895,1046,702,344,1046,92300,2020
38029,50.7,3262,3157,0,26,904,51012,1546,1245,301,1546,94500,2020
38031,44.3,3231,3070,18,17,889,61250,1483,1077,406,1483,151200,2020
38033,48.1,1796,1589,2,67,473,72308,814,618,196,814,113700,2020
38035,29.9,70243,58398,2601,3160,15659,53721,30779,14954,15825,30779,208200,2020
38037,48.2,2318,2202,0,16,634,53750,1082,951,131,1082,75600,2020
38039,54.4,2314,2230,0,36,623,53917,1031,824,207,1031,100900,2020
38041,46.9,2510,2273,11,72,666,59750,1093,855,238,1093,109500,2020
38043,48.6,2468,2275,14,119,707,52063,1123,846,277,1123,101600,2020
38045,46.8,4225,4036,13,91,1178,61477,1869,1499,370,1869,99900,2020
38047,52.7,1743,1688,0,18,522,60592,812,684,128,812,84500,2020
38049,43,5825,5551,29,125,1715,67039,2562,2144,418,2562,119500,2020
38051,53.9,2535,2399,10,76,707,51136,1292,922,370,1292,75700,2020
38053,30.3,13836,10649,211,1259,2612,75238,4478,2576,1902,4478,283400,2020
38055,45.8,9531,8456,38,245,2902,70261,4372,3496,876,4372,184800,2020
38057,45.1,8359,7633,56,229,2543,82087,3663,3056,607,3663,181100,2020
38059,37.6,31118,27805,380,1160,8843,72778,13502,9579,3923,13502,220900,2020
38061,33.3,10348,6196,151,859,2339,70412,3570,2286,1284,3570,171500,2020
38063,52.2,2864,2635,0,108,774,53063,1428,1072,356,1428,96100,2020
38065,48,1962,1790,0,73,615,66641,743,660,83,743,202400,2020
38067,47.6,6850,6242,28,243,1887,60910,3169,2299,870,3169,92000,2020
38069,45.7,4061,3765,20,39,1080,57398,1843,1411,432,1843,132300,2020
38071,40.2,11521,9538,17,359,2709,52688,4903,2919,1984,4903,154800,2020
38073,44.9,5258,4935,13,79,1438,62235,2380,1676,704,2380,139200,2020
38075,38,2387,2193,7,133,648,69848,931,785,146,931,127900,2020
38077,37,16245,14678,84,536,4155,60833,6806,4749,2057,6806,132800,2020
38079,31,14437,2608,87,328,3051,46481,4402,3149,1253,4402,85600,2020
38081,45.3,3899,3561,107,124,1179,64564,1897,1377,520,1897,110900,2020
38083,52.5,1289,1263,0,0,361,54250,684,555,129,684,95800,2020
38085,28.6,4339,534,5,213,828,41893,1107,539,568,1107,83300,2020
38087,49.6,788,753,19,1,238,65833,336,279,57,336,91000,2020
38089,34.3,31164,27114,808,1716,7631,69412,12635,8006,4629,12635,240800,2020
38091,45.9,1817,1742,9,48,524,77167,804,644,160,804,87000,2020
38093,40.2,20879,19169,334,566,4680,52815,8977,5607,3370,8977,158900,2020
38095,49.2,2191,1918,10,79,622,49464,1104,803,301,1104,93500,2020
38097,41,7999,7306,87,290,2168,67604,3394,2465,929,3394,152200,2020
38099,44.3,10642,8946,39,1236,2876,55428,4820,3697,1123,4820,94100,2020
38101,31.6,68962,56647,3124,4448,16750,68098,28432,16826,11606,28432,217700,2020
38103,52.9,3889,3784,0,92,1124,56519,1941,1455,486,1941,89600,2020
38105,31.5,36044,28141,1631,3064,8836,79508,14646,7756,6890,14646,254800,2020
39001,42.3,27685,26636,107,288,7286,40067,10396,7310,3086,10396,115000,2020
39003,39.4,102808,82303,11623,3403,25580,51892,41025,27373,13652,41025,120300,2020
39005,40.7,53533,51010,453,768,13783,55422,20504,15427,5077,20504,132200,2020
39007,42.7,97416,86782,3387,4269,24537,47925,38614,27593,11021,38614,117200,2020
39009,30,65945,59075,1842,1280,11718,42414,22539,13268,9271,22539,139100,2020
39011,40.4,45709,43508,347,792,12950,66193,19000,14413,4587,19000,146400,2020
39013,44.5,67424,62434,2332,702,16520,51574,25772,19612,6160,25772,110800,2020
39015,42.3,43508,41852,356,480,12141,57200,17811,13007,4804,17811,138200,2020
39017,36.9,382129,305253,29140,18478,96531,69023,140736,97280,43456,140736,180200,2020
39019,46.1,27195,26072,275,360,7444,52574,11286,8873,2413,11286,128400,2020
39021,41.6,38861,36021,702,613,10741,59909,15407,11268,4139,15407,137200,2020
39023,41.5,134409,112558,11088,4757,35354,51504,54862,36833,18029,54862,120500,2020
39025,40.2,205616,191105,2494,4154,55121,69720,79347,58573,20774,79347,178700,2020
39027,39.8,42000,39113,792,708,11103,54683,16741,11212,5529,16741,139100,2020
39029,44.3,102514,95785,2196,1923,26468,49407,41632,30567,11065,41632,105500,2020
39031,41.1,36558,35012,447,410,9994,48552,14579,10849,3730,14579,106300,2020
39033,43.1,41603,39489,474,703,11476,46391,17928,12545,5383,17928,93400,2020
39035,40.4,1241475,723024,360309,76316,301566,51741,547887,317564,230323,547887,137800,2020
39037,41.8,51387,49301,373,818,14219,54799,21171,14983,6188,21171,124700,2020
39039,40.7,38024,32743,544,3898,10683,62110,15385,11926,3459,15385,125100,2020
39041,39.2,205454,172445,6908,5551,55019,111411,71521,57685,13836,71521,320300,2020
39043,44.9,74419,61264,6487,3385,19998,58408,31319,21904,9415,31319,146800,2020
39045,39.6,156204,132874,11757,3618,40627,70906,57071,42915,14156,57071,197400,2020
39047,40.6,28609,26376,650,625,8042,48637,11737,7588,4149,11737,118200,2020
39049,34.2,1304715,811162,293240,74083,301991,62352,519237,278490,240747,519237,185900,2020
39051,41.3,42186,37394,139,3761,11544,61290,16582,13354,3228,16582,140300,2020
39053,40.7,29995,27892,552,414,7586,48975,11359,8517,2842,11359,118400,2020
39055,44.8,93657,89029,1171,1479,25833,83730,35303,30615,4688,35303,247700,2020
39057,38.3,167867,139031,11009,4987,42983,70055,65915,43494,22421,65915,180300,2020
39059,42.6,38996,36711,653,456,10334,46352,16244,11606,4638,16244,122800,2020
39061,36.8,815790,526944,206875,28022,197916,59190,344588,201607,142981,344588,163000,2020
39063,39.3,75765,67130,972,4304,19100,57384,32022,21903,10119,32022,152600,2020
39065,36.6,31393,29636,339,585,7823,50214,11777,8643,3134,11777,106200,2020
39067,46.1,15132,14337,430,56,3963,49454,6221,4879,1342,6221,100800,2020
39069,41.6,27068,24246,191,2094,7483,60425,11069,8540,2529,11069,130800,2020
39071,40.9,43080,40926,633,513,11658,47973,16747,11732,5015,16747,123400,2020
39073,42.9,28306,27120,228,284,8422,54774,11533,8950,2583,11533,139800,2020
39075,32.1,43954,42977,63,432,10033,64453,12351,9612,2739,12351,224400,2020
39077,40.1,58271,52341,736,3905,14959,55041,23050,16529,6521,23050,131600,2020
39079,40.1,32440,31130,316,360,9167,48915,12971,9437,3534,12971,105600,2020
39081,44.9,65943,59418,3719,1011,17431,46849,27541,19153,8388,27541,95300,2020
39083,39.4,61776,58438,528,975,16092,61590,23027,16627,6400,23027,162700,2020
39085,43.9,229755,201170,9598,10356,60144,65814,96534,71327,25207,96534,160200,2020
39087,41.6,59901,56649,1015,596,15544,46584,23208,16767,6441,23208,107700,2020
39089,40,175409,156773,7158,3587,45293,67736,64466,46764,17702,64466,183500,2020
39091,41.2,45315,42092,653,786,12604,60417,18604,14135,4469,18604,142400,2020
39093,41.9,309134,240439,23309,31425,78301,58798,121669,88160,33509,121669,156400,2020
39095,38.1,430319,292316,80197,31680,106276,49946,181472,108632,72840,181472,120900,2020
39097,41.1,44248,38960,2553,994,9969,68663,15017,11051,3966,15017,169200,2020
39099,43.5,228452,171874,32699,14366,59316,47092,98869,68815,30054,98869,108200,2020
39101,41.6,65179,57324,3153,1831,15343,49225,24617,16598,8019,24617,105800,2020
39103,42.5,179116,166746,2328,4100,49326,77784,69739,55479,14260,69739,205800,2020
39105,43.3,22974,22165,121,181,5798,43445,9090,7008,2082,9090,92500,2020
39107,39.4,41034,39035,279,777,10979,65566,16078,12747,3331,16078,163800,2020
39109,41.2,106074,97578,2048,1868,26976,62347,41260,29748,11512,41260,155000,2020
39111,47,13827,13420,63,15,3856,46241,5854,4569,1285,5854,109500,2020
39113,39.1,531988,373424,108843,16616,133824,53064,227077,139416,87661,227077,124900,2020
39115,44.8,14557,13325,537,139,4081,43791,6076,4640,1436,6076,102700,2020
39117,42.7,35148,33661,263,540,9685,61769,13064,10773,2291,13064,154900,2020
39119,40.5,86033,78431,2548,1052,21588,48350,33797,23575,10222,33797,126400,2020
39121,51.2,14410,13263,810,146,3026,50070,4969,4052,917,4969,106100,2020
39123,49.6,40557,37291,499,2105,11642,59306,18240,14406,3834,18240,154500,2020
39125,42.2,18742,17262,107,905,5409,56531,7692,6179,1513,7692,102600,2020
39127,40.7,36076,34794,257,319,9687,52978,13216,10013,3203,13216,120200,2020
39129,39.5,58112,53677,1864,862,14128,61629,19808,14585,5223,19808,171400,2020
39131,40.7,27914,26550,284,229,7680,44115,11037,7378,3659,11037,119900,2020
39133,38.3,162476,144121,6794,3106,39313,59485,62785,44309,18476,62785,160300,2020
39135,43.1,40995,39409,298,388,11379,61339,16417,12817,3600,16417,133900,2020
39137,40.2,33836,31158,139,2134,9738,67790,13301,10950,2351,13301,154500,2020
39139,41.5,121043,102888,10348,2425,30135,49186,48967,32762,16205,48967,115100,2020
39141,41.2,76816,68651,4241,1015,19010,51508,29080,20670,8410,29080,125000,2020
39143,42.4,58801,49263,1522,5984,15749,55245,23825,17046,6779,23825,118600,2020
39145,40.1,75441,70281,2190,1082,19229,41866,29561,19924,9637,29561,103400,2020
39147,40.4,55251,49348,1606,2928,14160,52897,21759,15940,5819,21759,108900,2020
39149,39.8,48610,44913,1152,759,12784,64522,18670,13181,5489,18670,147400,2020
39151,42.1,371516,319340,27273,7934,98253,55045,154322,105096,49226,154322,139000,2020
39153,40.9,540810,412419,76916,12164,137789,59253,226721,150587,76134,226721,151300,2020
39155,44.4,199144,172468,15979,3739,52648,47799,85917,60450,25467,85917,105500,2020
39157,41,92165,86745,474,2806,24435,54451,36906,26155,10751,36906,136700,2020
39159,38.1,57871,51448,1403,1071,15138,88565,20695,16576,4119,20695,220300,2020
39161,41.2,28213,26378,262,1016,8315,55991,11640,9042,2598,11640,111000,2020
39163,43.2,13045,12585,8,177,3625,45034,5221,3992,1229,5221,94800,2020
39165,39.6,232540,198602,8068,6771,63955,89410,84127,65284,18843,84127,236400,2020
39167,44.4,60217,57175,753,666,16125,51808,24803,18289,6514,24803,142100,2020
39169,38.6,116063,108651,1432,2379,30539,61424,44238,32907,11331,44238,156300,2020
39171,41.4,36760,33967,391,1722,9671,52855,15266,11569,3697,15266,108000,2020
39173,35.1,130662,114666,3076,7518,30392,63189,50645,33061,17584,50645,165400,2020
39175,43,21907,20778,24,660,6075,57925,9100,6492,2608,9100,129900,2020
40001,37.6,22171,8692,121,1551,5365,34375,7632,5252,2380,7632,92800,2020
40003,43.4,5791,4815,171,339,1297,64122,1897,1493,404,1897,86000,2020
40005,40.5,13815,9683,460,509,3662,42392,5200,3902,1298,5200,105200,2020
40007,39.8,5326,3764,44,1303,1409,55083,1994,1572,422,1994,97800,2020
40009,35.9,21860,16390,887,3249,4878,47095,7724,5184,2540,7724,127500,2020
40011,42.7,9521,6813,368,1165,2397,49638,3940,2866,1074,3940,99600,2020
40013,37,47325,33218,851,2998,12083,47175,17634,11051,6583,17634,119800,2020
40015,38.2,29179,16434,701,3906,7183,46499,10465,7669,2796,10465,84600,2020
40017,36,144610,107925,4453,13688,33659,73591,45724,34909,10815,45724,170700,2020
40019,38.3,48380,33409,3168,3792,11588,51148,18474,12395,6079,18474,117400,2020
40021,35.8,48871,22696,613,3683,11163,43378,17364,11683,5681,17364,126400,2020
40023,41.8,14727,8803,1556,682,3785,37121,6074,4121,1953,6074,99000,2020
40025,44.1,2159,1622,3,497,634,47095,952,698,254,952,62400,2020
40027,34.4,282189,200353,13273,25353,69730,65412,108070,69236,38834,108070,170700,2020
40029,41.4,5577,3764,6,257,1496,42277,2252,1732,520,2252,82000,2020
40031,33.3,121374,67274,18233,16428,27941,52377,43241,23075,20166,43241,124100,2020
40033,43,5783,4372,122,484,1550,49583,2215,1633,582,2215,75600,2020
40035,42.2,14274,8932,426,547,3505,43003,5428,3799,1629,5428,110700,2020
40037,40.4,71505,53875,1523,3136,18443,52315,26393,19779,6614,26393,130300,2020
40039,31.9,28929,19637,872,5322,6655,51351,10697,6859,3838,10697,140100,2020
40041,46.7,42741,27051,213,1672,11396,44268,16988,12848,4140,16988,124000,2020
40043,39.2,4885,3976,4,373,1167,51169,1715,1268,447,1715,99800,2020
40045,44.3,3936,3382,10,288,952,48264,1581,1219,362,1581,96000,2020
40047,35.8,61555,45232,1548,7935,15145,55435,23709,15501,8208,23709,119000,2020
40049,38.9,27789,20668,592,2612,6848,47321,10375,7032,3343,10375,103900,2020
40051,39.6,55315,44787,1242,3306,14818,64507,20107,15395,4712,20107,140800,2020
40053,42,4369,3769,38,234,1105,53147,1761,1351,410,1761,79000,2020
40055,38.6,5790,4277,319,686,1242,46794,2109,1492,617,2109,84600,2020
40057,40.5,2663,1482,260,796,714,53087,1091,754,337,1091,72100,2020
40059,36.4,3730,2799,3,871,809,44318,1236,994,242,1236,83700,2020
40061,41.4,12688,8802,83,590,3432,43950,4935,3780,1155,4935,99200,2020
40063,39,13265,8171,537,783,2716,38020,4106,3006,1100,4106,74200,2020
40065,34.4,24808,15412,1593,6112,6365,52535,9681,5930,3751,9681,99700,2020
40067,42.2,6084,4687,104,672,1469,43871,2382,1794,588,2382,64800,2020
40069,41,11028,7585,172,626,2899,44238,4313,3155,1158,4313,85900,2020
40071,38.5,44074,32458,849,3663,10954,47456,17392,11508,5884,17392,96700,2020
40073,37.9,15811,11919,196,2610,4080,61738,5769,4576,1193,5769,152000,2020
40075,43.1,8816,6511,369,1041,2400,34747,3554,2556,998,3554,66200,2020
40077,41.9,10239,6500,95,426,2909,40044,4083,2894,1189,4083,87300,2020
40079,39,49999,35288,871,3604,12778,41900,18309,13129,5180,18309,90900,2020
40081,41.1,34936,28610,635,1228,9010,51206,13022,10532,2490,13022,116800,2020
40083,39.1,47401,36602,3846,3079,11405,70456,15668,13249,2419,15668,176000,2020
40085,39.4,10128,7093,240,1651,2320,54423,3340,2528,812,3340,117900,2020
40087,38.8,39921,31456,450,3273,11270,70005,14783,11652,3131,14783,183800,2020
40089,38.5,32913,20104,2582,2045,8964,39091,12651,8952,3699,12651,86100,2020
40091,47.7,19677,13284,461,578,5458,39588,8216,6401,1815,8216,115900,2020
40093,39.9,7654,6429,19,765,2182,56781,3064,2474,590,3064,111500,2020
40095,43.2,16688,10746,285,3024,4582,48573,6384,4885,1499,6384,107900,2020
40097,40.5,41098,26242,158,1531,11357,50012,16071,12026,4045,16071,115900,2020
40099,42.7,13972,9914,247,981,3498,53696,5207,3716,1491,5207,130400,2020
40101,38.1,68451,37692,7026,4535,17160,41633,26535,17298,9237,26535,109300,2020
40103,41.3,11263,9079,51,456,3131,60019,4501,3519,982,4501,116300,2020
40105,42.3,10243,6743,197,337,2887,42051,4128,3016,1112,4128,91400,2020
40107,39.7,11987,7276,868,508,2898,40913,4036,2951,1085,4036,87800,2020
40109,34.9,792668,439111,117878,140112,187286,55519,305780,181874,123906,305780,157500,2020
40111,39.3,38553,23869,3078,1669,9587,45319,14644,10328,4316,14644,85900,2020
40113,43,47074,29670,5164,1772,13094,50105,18364,14122,4242,18364,126300,2020
40115,37.9,31283,20003,327,1841,7825,40662,11919,8204,3715,11919,88100,2020
40117,42,16402,12480,124,533,4431,50991,6260,4837,1423,6260,98900,2020
40119,27.3,81912,62800,3128,3908,16712,42103,31346,16201,15145,31346,172700,2020
40121,40.3,43955,30189,1169,2357,11993,47511,17846,12947,4899,17846,109000,2020
40123,36,38385,24728,883,2185,9345,51682,14234,9278,4956,14234,134700,2020
40125,37.7,72511,52011,2311,3913,18239,51150,26066,18540,7526,26066,123100,2020
40127,44,11055,7721,101,447,3020,38325,4477,3335,1142,4477,84000,2020
40129,40.7,3635,2996,12,270,976,54653,1377,1103,274,1377,131400,2020
40131,39.3,92052,65546,896,4507,25887,66038,35208,27385,7823,35208,168000,2020
40133,38.5,24624,15711,1069,1321,6576,38588,9357,6351,3006,9357,75100,2020
40135,40.8,41687,25762,804,1880,10717,41803,15437,11143,4294,15437,99100,2020
40137,41.1,43401,34560,719,3481,11302,51156,16607,12360,4247,16607,114700,2020
40139,31.2,20633,8765,866,9535,4532,50702,6761,4527,2234,6761,118200,2020
40141,42.7,7347,4290,548,2034,1761,39975,2794,2069,725,2794,52800,2020
40143,35.8,650291,397577,64269,85014,159053,57024,253909,151162,102747,253909,160700,2020
40145,38.8,80264,56613,2735,5220,21261,64958,29591,23425,6166,29591,162900,2020
40147,40,51995,37496,1336,3265,12969,53384,20376,14516,5860,20376,126100,2020
40149,40.1,11066,9159,152,1109,2997,52591,4296,3075,1221,4296,89800,2020
40151,32.9,8914,7373,267,653,1834,51985,3140,2146,994,3140,114100,2020
40153,36.6,20352,16192,284,2661,5067,56182,7608,5338,2270,7608,138800,2020
41001,48.2,16090,14484,168,736,4426,46250,7158,5041,2117,7158,180600,2020
41003,33.2,92168,73376,978,7031,20836,65142,36051,20460,15591,36051,357900,2020
41005,41.7,415084,336161,3409,36840,109219,82911,159330,113015,46315,159330,421100,2020
41007,44.4,39656,33045,298,3444,9304,57466,16019,9727,6292,16019,309500,2020
41009,43.3,52117,45794,256,2834,13619,68170,19872,15036,4836,19872,282600,2020
41011,48.7,64175,54352,234,4297,16979,49445,27819,19009,8810,27819,220400,2020
41013,46.8,23733,20897,33,1828,6971,59000,9998,7346,2652,9998,265100,2020
41015,56.3,22889,19614,35,1682,6657,53174,10790,7919,2871,10790,285600,2020
41017,42.4,191749,166323,1002,15520,51773,68937,77040,52335,24705,77040,389300,2020
41019,47,110015,96078,601,6523,30431,50031,46439,32544,13895,46439,210800,2020
41021,52.6,1896,1646,0,85,456,41838,905,680,225,905,112900,2020
41023,52.8,7174,6524,0,291,1994,48202,3453,2603,850,3453,153900,2020
41025,45.1,7310,6327,19,395,2157,43387,3176,2283,893,3176,140300,2020
41027,39.5,23270,14758,133,7320,5969,72418,8892,6086,2806,8892,411600,2020
41029,42.6,218781,175085,1687,28972,57093,56327,89690,57643,32047,89690,294500,2020
41031,41,24048,14058,173,4907,5912,55844,8395,5731,2664,8395,242200,2020
41033,47.5,87097,74693,497,6624,24622,47733,36606,25195,11411,36606,281500,2020
41035,42,67606,51905,431,9093,17669,48560,28376,18211,10165,28376,188700,2020
41037,47.5,7896,6644,23,679,2221,44237,3533,2196,1337,3533,161000,2020
41039,39.7,377749,307314,3666,34380,90434,54942,154516,91385,63131,154516,280000,2020
41041,51.8,49336,40144,118,4640,13087,50775,21841,14688,7153,21841,265800,2020
41043,39.9,127216,107303,627,11899,32784,59547,48290,32082,16208,48290,240200,2020
41045,36.1,30632,18587,319,10445,6654,44362,10059,5987,4072,10059,150400,2020
41047,36.9,343742,221233,3198,92533,82149,61817,120474,73190,47284,120474,270300,2020
41049,38.3,11425,6698,23,4223,3046,56572,4093,2987,1106,4093,160600,2020
41051,37.5,809869,558225,42490,95432,179054,71425,334849,182072,152777,334849,410800,2020
41053,37,84730,65704,530,12129,20724,65665,30726,20097,10629,30726,290100,2020
41055,47.8,1686,1490,1,109,431,51472,727,502,225,727,159300,2020
41057,48.6,26782,22502,137,2787,7144,54268,11075,7752,3323,11075,276700,2020
41059,36.7,77319,50281,756,21005,18447,57973,26823,17520,9303,26823,183300,2020
41061,40,26502,23441,187,1307,7111,53940,10785,7170,3615,10785,198200,2020
41063,52.4,7065,6502,51,241,1949,53423,3195,2312,883,3195,266800,2020
41065,40.2,26274,19441,38,4911,6625,54725,10333,6641,3692,10333,230800,2020
41067,36.9,595761,385254,12520,100090,150035,86626,223040,136707,86333,223040,413500,2020
41069,56.9,1417,1216,0,127,412,45354,669,505,164,669,178700,2020
41071,38.6,106087,81395,780,16920,26483,67296,37542,26349,11193,37542,320900,2020
42001,44,102627,91003,1381,7356,28110,68411,39628,30850,8778,39628,212300,2020
42003,40.8,1218380,948585,156233,26607,302593,62320,545695,350794,194901,545695,161600,2020
42005,47,65356,63260,566,520,18967,53545,28035,21805,6230,28035,112400,2020
42007,45.1,164781,146576,9691,2789,45554,59014,72086,52598,19488,72086,148700,2020
42009,47,48154,46482,494,597,13067,51531,19930,15824,4106,19930,141700,2020
42011,40.2,419062,295451,16772,91381,106063,66154,156389,111089,45300,156389,187600,2020
42013,43.6,122495,115375,2104,1549,32357,50856,51647,36288,15359,51647,128200,2020
42015,44.5,60721,57988,389,887,16483,52375,25084,18248,6836,25084,150900,2020
42017,44,627668,518679,23291,34670,173010,93181,240763,187963,52800,240763,340500,2020
42019,43.4,187798,177231,1849,2971,50629,72642,77725,59092,18633,77725,216900,2020
42021,45.6,131611,121551,4379,2212,35036,47644,56933,42554,14379,56933,94900,2020
42023,51.6,4512,4266,4,38,1354,40342,2334,1567,767,2334,77400,2020
42025,46.6,63964,58106,1200,3290,16808,57601,26545,19893,6652,26545,150400,2020
42027,32.9,162264,138442,5307,4815,33317,61921,59380,37083,22297,59380,242700,2020
42029,40.6,521980,411379,28107,38901,137325,104161,192951,144688,48263,192951,369500,2020
42031,41.8,38633,36890,557,394,10139,49695,15930,11075,4855,15930,123400,2020
42033,45.4,79466,73652,1969,2383,20734,50150,31704,24544,7160,31704,99400,2020
42035,39.4,38549,36637,617,610,9634,51145,15058,10487,4571,15058,145700,2020
42037,41.2,65390,60683,985,1933,16027,52219,26482,18072,8410,26482,153900,2020
42039,43.3,85074,80351,1232,1156,22963,51919,35169,25593,9576,35169,117400,2020
42041,40.7,251487,213304,9561,10516,64435,71979,101176,70533,30643,101176,209700,2020
42043,39.6,277071,178712,49051,26948,70722,63123,113759,72073,41686,113759,175700,2020
42045,38.9,565328,372568,120126,22577,140335,76238,209596,143938,65658,209596,247900,2020
42047,47.9,30077,29164,186,253,8689,54961,14215,11151,3064,14215,103100,2020
42049,39.7,272046,227513,18601,11982,67922,52863,110388,73941,36447,110388,138500,2020
42051,45.1,130329,119122,5266,1646,34536,49075,55346,40642,14704,55346,106200,2020
42053,47,7190,5127,1497,420,1170,41225,2131,1772,359,2131,91700,2020
42055,41.7,154954,135473,5575,9272,42964,63420,61617,43688,17929,61617,186300,2020
42057,45.7,14492,13852,183,179,4197,55424,6040,4726,1314,6040,165800,2020
42059,42.5,36484,33786,1085,560,9513,55993,14503,10912,3591,14503,122500,2020
42061,44.1,45145,40766,2363,907,11423,53597,16779,12927,3852,16779,142800,2020
42063,40.2,84463,78762,1844,1132,20717,49270,33855,23720,10135,33855,124100,2020
42065,43.9,43570,42242,181,421,11803,49604,18400,13765,4635,18400,108800,2020
42067,42.9,24657,23076,311,963,6483,53502,9380,6928,2452,9380,154200,2020
42069,42.1,210162,176639,5625,16882,53577,54064,87737,56316,31421,87737,154700,2020
42071,38.7,543050,441681,18166,58450,143101,69588,204003,141505,62498,204003,218700,2020
42073,45.3,86148,78773,3054,1316,24017,50080,37300,27882,9418,37300,113200,2020
42075,41.1,140410,114146,2828,19028,36777,61632,53857,37987,15870,53857,176000,2020
42077,39,367338,232125,20763,93175,94393,66214,140072,90661,49411,140072,215400,2020
42079,42.7,317547,254848,12211,41053,80819,53194,130039,88467,41572,130039,129600,2020
42081,41.5,114014,102486,5351,2362,30030,54906,46160,31653,14507,46160,161900,2020
42083,43.6,41021,38147,921,910,10781,49240,17059,12687,4372,17059,82300,2020
42085,45,110519,99344,6498,1681,29841,50529,46821,33620,13201,46821,123600,2020
42087,44,46179,44126,266,751,13430,52641,19075,13926,5149,19075,115400,2020
42089,43.3,168824,109458,21715,28024,42551,68734,59950,46207,13743,59950,173800,2020
42091,41.3,827180,619162,74909,44108,217427,93518,318648,228996,89652,318648,326200,2020
42093,43.4,18178,16533,366,483,4742,59915,7475,5156,2319,7475,186100,2020
42095,42.2,304233,230545,15898,41754,78388,73088,115300,82098,33202,115300,223800,2020
42097,44.5,91234,83785,1984,3395,24948,49273,39048,27794,11254,39048,119800,2020
42099,43.4,46133,43853,413,986,13128,70660,18512,15015,3497,18512,179400,2020
42101,34.6,1581531,539826,634204,238112,330898,49127,613125,323784,289341,613125,171600,2020
42103,48.6,55660,44283,2966,6252,15609,67495,22717,19151,3566,22717,186600,2020
42105,47.4,16685,16072,57,231,4374,47696,6630,5167,1463,6630,110400,2020
42107,44.3,141935,128299,3840,6878,37952,53703,58646,44108,14538,58646,106100,2020
42109,40.4,40452,38429,336,892,10420,60227,14824,10864,3960,14824,172900,2020
42111,46.2,73844,69359,1818,1134,19968,51255,29518,23558,5960,29518,113300,2020
42113,54.5,6038,5624,159,212,1612,49830,2751,2275,476,2751,160100,2020
42115,48.7,40604,39041,234,708,11245,55788,17027,13181,3846,17027,173100,2020
42117,44.9,40759,39157,322,528,11113,51838,16442,12264,4178,16442,151900,2020
42119,39.6,44831,37853,2870,2682,9542,56824,14762,10415,4347,14762,188400,2020
42121,47.4,51355,48973,556,568,14358,51405,22103,16172,5931,22103,96800,2020
42123,47.4,39466,37779,216,444,11195,52034,17124,13293,3831,17124,102000,2020
42125,44.5,207081,190052,6581,3659,55662,65478,85201,63856,21345,85201,170800,2020
42127,48.5,51268,46245,1659,2364,12686,55572,18938,15325,3613,18938,178700,2020
42129,47.2,350722,327908,8219,4362,98357,61398,153772,119286,34486,153772,157200,2020
42131,45.2,27078,24837,467,531,7223,60075,10887,8253,2634,10887,172300,2020
42133,41,447628,369676,23900,35063,119302,68940,174425,130524,43901,174425,183300,2020
44001,44.5,48645,44283,529,1526,12376,85413,18961,13312,5649,18961,364500,2020
44003,43.8,164122,143667,2575,8818,43840,75857,70085,49214,20871,70085,247700,2020
44005,45.8,82731,70546,3267,4842,21685,84282,34578,22434,12144,34578,399500,2020
44007,37.4,636161,382712,50909,148608,146202,62323,240886,132794,108092,240886,248500,2020
44009,45,126139,114500,1400,4213,33746,86970,50220,37696,12524,50220,359300,2020
45001,44.6,24582,16802,6690,392,6306,43090,9597,7193,2404,9597,100700,2020
45003,41.1,169947,111939,41476,9913,45291,53385,68266,50318,17948,68266,153700,2020
45005,44.7,8789,1937,6418,295,2051,26074,3426,2347,1079,3426,47100,2020
45007,40.7,200183,154394,31268,7695,53809,53598,78636,57104,21532,78636,153600,2020
45009,41.5,14236,5147,8394,305,3344,42830,5070,3910,1160,5070,78900,2020
45011,41.6,21170,10714,9425,538,5267,37572,8670,6285,2385,8670,87600,2020
45013,46.2,189732,129106,32221,21042,50858,71430,74231,55533,18698,74231,309600,2020
45015,36.5,222103,139175,51304,15110,56376,65443,79597,57554,22043,79597,197300,2020
45017,46,14608,7896,5940,563,4055,49844,6221,5062,1159,6221,104500,2020
45019,38,407543,263849,105775,21137,93812,67182,163411,101589,61822,163411,334600,2020
45021,39.3,57110,41432,11450,2581,11465,37787,20779,14722,6057,20779,98300,2020
45023,41.9,32260,18868,11875,670,8529,43985,12861,10133,2728,12861,94200,2020
45025,42.3,45833,27532,13962,2020,12108,41937,18213,12727,5486,18213,85600,2020
45027,45.6,33865,16206,15766,1081,8490,43881,12775,9875,2900,12775,105200,2020
45029,42.2,37624,21166,14365,1302,9370,36748,15281,11326,3955,15281,93500,2020
45031,41.5,66858,36419,27320,1430,16220,37141,26117,18192,7925,26117,102800,2020
45033,37.6,30473,13866,14538,855,7391,36429,11147,6551,4596,11147,84500,2020
45035,37.2,161309,102597,40251,9074,39565,63501,56939,41270,15669,56939,213000,2020
45037,43,27021,15352,9420,1633,6418,52491,9171,6953,2218,9171,132600,2020
45039,47.1,22406,8540,12795,513,6166,43861,9315,7014,2301,9315,106900,2020
45041,39.2,138237,71009,58879,3779,34423,49645,52880,34750,18130,52880,135000,2020
45043,50.1,62150,40084,19075,1915,17635,52488,25758,20552,5206,25758,197700,2020
45045,38.3,516126,349315,89417,48446,132726,62422,198015,135145,62870,198015,197400,2020
45047,39.8,70672,41946,22711,4359,17300,41081,27977,17439,10538,27977,128000,2020
45049,40.6,19223,7875,10098,755,4358,38178,6893,5237,1656,6893,76000,2020
45051,46.7,344186,266186,44340,20974,86930,51570,136219,100572,35647,136219,187800,2020
45053,40.8,29558,12874,12043,3974,7094,45924,10724,7885,2839,10724,159000,2020
45055,41.3,65926,45111,15436,3074,17229,53980,25293,20496,4797,25293,135500,2020
45057,42.5,95378,66784,19687,5340,24834,65421,35228,28377,6851,35228,217100,2020
45059,40.7,66990,45233,15719,3425,17184,44374,25555,18294,7261,25555,108100,2020
45061,42,17144,5563,10890,429,3897,32851,6455,4983,1472,6455,79000,2020
45063,39.1,295033,219154,43220,18031,78043,62740,115220,86749,28471,115220,163200,2020
45065,56.6,9495,4864,4185,115,2592,47402,3984,3099,885,3984,114700,2020
45067,40.7,30954,11862,17546,897,7315,30791,11282,7174,4108,11282,81800,2020
45069,40.5,26376,10284,13169,861,5730,31528,9384,6025,3359,9384,71500,2020
45071,42.2,38329,22972,11936,2940,10080,46038,14976,11221,3755,14976,118500,2020
45073,46.1,78314,66076,5548,4334,21559,49691,32440,23758,8682,32440,164000,2020
45075,40.5,86953,28788,53382,1974,19954,36802,33629,22585,11044,33629,91700,2020
45077,36.4,125381,107120,8117,4812,30716,51032,48522,33227,15295,48522,159200,2020
45079,33.7,414660,173158,194507,21993,92773,54441,155478,92936,62542,155478,167500,2020
45081,42.7,20292,11873,4960,3123,5453,43410,7360,5710,1650,7360,110100,2020
45083,38,313791,212852,62245,21983,80467,53757,118788,84689,34099,118788,153000,2020
45085,36.5,106675,47824,49893,4335,27434,46570,41704,26918,14786,41704,119800,2020
45087,44.4,27325,17557,8176,440,7730,41117,11707,7823,3884,11707,80300,2020
45089,43.3,30810,9680,19759,711,8110,35681,12705,9191,3514,12705,73900,2020
45091,38.9,273887,191130,51535,15729,72166,68555,103582,74898,28684,103582,218400,2020
46003,38.8,2757,2439,51,189,704,65132,1124,917,207,1124,86600,2020
46005,38.4,18338,13921,219,1956,4977,53461,7684,5077,2607,7684,120900,2020
46007,28.4,3430,1137,27,291,721,41887,1036,662,374,1036,100000,2020
46009,41.9,6914,5989,117,193,1554,50195,2556,1853,703,2556,89000,2020
46011,27.3,35115,31472,388,1199,6951,57471,13364,7875,5489,13364,187100,2020
46013,37.4,38988,33655,826,1267,9567,61816,16245,10656,5589,16245,171200,2020
46015,39.8,5233,4376,60,145,1386,57181,2228,1350,878,2228,157500,2020
46017,26.1,2005,269,3,155,363,35000,540,277,263,540,NA,2020
46019,40.5,10295,9252,74,394,2736,49353,4179,3403,776,4179,153000,2020
46021,50.6,1458,1420,0,23,441,54228,699,577,122,699,63500,2020
46023,36.3,9324,5820,7,344,2124,52348,3149,2215,934,3149,127900,2020
46025,40.9,3715,3465,9,133,969,50709,1584,1264,320,1584,108500,2020
46027,25.2,14076,12188,243,432,2699,51447,5259,2830,2429,5259,168100,2020
46029,39.4,28133,25820,166,842,7267,57885,12090,7949,4141,12090,182400,2020
46031,28.1,4106,1176,10,17,864,36705,1205,670,535,1205,55600,2020
46033,55.9,8826,7918,28,335,2738,64556,3893,3249,644,3893,232000,2020
46035,39.3,19890,17946,269,655,5076,48267,8651,5187,3464,8651,153600,2020
46037,48.1,5452,4691,0,120,1543,46753,2568,1909,659,2568,110600,2020
46039,42.9,4309,4137,1,152,1240,67396,1777,1393,384,1777,120300,2020
46041,27.4,5841,1135,11,252,1229,45859,1731,1036,695,1731,65900,2020
46043,45.1,2913,2743,0,23,874,61793,1203,894,309,1203,84100,2020
46045,41.1,3876,3717,10,42,1059,64896,1550,1277,273,1550,110600,2020
46047,54.4,6721,5679,0,144,1826,51383,3138,2337,801,3138,136800,2020
46049,49,2315,2212,5,5,585,49423,920,713,207,920,88200,2020
46051,42.5,7125,6578,42,325,2176,65327,3148,2630,518,3148,136200,2020
46053,45.5,4193,3667,0,86,1118,44706,1832,1362,470,1832,97300,2020
46055,43.6,1935,1820,1,10,486,40673,758,597,161,758,116200,2020
46057,34.6,6104,5676,24,294,1640,67626,2242,1799,443,2242,161400,2020
46059,47.8,3064,2951,4,50,913,58333,1426,976,450,1426,120100,2020
46061,37.6,3423,3329,0,1,742,63750,1039,912,127,1039,139900,2020
46063,44.8,1178,1088,0,31,322,61111,516,338,178,516,97400,2020
46065,38.5,17560,14337,10,591,4630,69575,7475,5276,2199,7475,181400,2020
46067,42.9,7308,6708,0,177,2024,61290,2977,2318,659,2977,111600,2020
46069,52.6,1446,1279,39,15,440,59844,616,467,149,616,104300,2020
46071,33.2,3296,1271,10,15,631,24549,815,485,330,815,58600,2020
46073,51.5,2009,1868,0,93,545,49265,940,718,222,940,74200,2020
46075,44.9,873,743,15,0,236,46688,419,289,130,419,84700,2020
46077,44.3,4936,4793,0,120,1412,61316,2172,1703,469,2172,118700,2020
46079,43.8,12747,11854,40,334,3143,63165,4712,3482,1230,4712,170300,2020
46081,42.3,25806,23349,239,868,6021,52146,11250,7236,4014,11250,224200,2020
46083,35.2,58887,54305,926,1341,15140,84260,20341,15441,4900,20341,240200,2020
46085,36.1,3831,2131,5,95,933,54484,1393,969,424,1393,109600,2020
46087,39.4,5543,5171,45,221,1494,66208,2206,1694,512,2206,152300,2020
46089,50.1,2316,2198,39,43,584,51379,996,756,240,996,62600,2020
46091,43.1,4881,4059,5,395,1259,68056,1898,1501,397,1898,126300,2020
46093,36.2,28149,24502,493,1233,7848,62275,11142,8255,2887,11142,207700,2020
46095,34.4,2065,791,4,7,458,33882,675,436,239,675,NA,2020
46097,44.9,2213,2104,5,42,595,53135,963,749,214,963,87000,2020
46099,35.1,191682,156399,11678,9992,47613,63699,78453,49221,29232,78453,201500,2020
46101,40.7,6508,4952,47,291,1794,61894,2608,1850,758,2608,152700,2020
46102,26.5,14277,637,9,558,2286,31423,2813,1395,1418,2813,35000,2020
46103,38.8,112504,89319,1460,6056,26921,58278,43947,30295,13652,43947,197200,2020
46105,45.6,2996,2753,0,22,866,61815,1329,1006,323,1329,100700,2020
46107,48.8,2311,2129,10,29,629,57120,997,761,236,997,106000,2020
46109,38.3,10310,5794,47,385,2577,50877,3889,2540,1349,3889,107000,2020
46111,40.6,2372,2211,0,102,649,55398,987,724,263,987,106700,2020
46115,44.2,6438,5952,10,214,1676,62125,2599,1960,639,2599,89500,2020
46117,47.3,3058,2654,0,148,1002,71602,1443,1181,262,1443,154900,2020
46119,48.6,1278,1190,0,15,371,60508,591,516,75,591,130800,2020
46121,23.6,10308,778,4,400,1863,24102,2674,1258,1416,2674,26600,2020
46123,45.2,5448,4393,0,81,1474,54054,2234,1637,597,2234,100800,2020
46125,41.7,8325,7903,43,203,2415,63062,3530,2818,712,3530,137500,2020
46127,40.2,15659,14188,124,545,4502,74006,6864,4676,2188,6864,206300,2020
46129,42.5,5431,4280,207,124,1370,51481,2263,1630,633,2263,96700,2020
46135,42,22746,19986,327,1135,5786,61878,9558,6637,2921,9558,152800,2020
46137,34,2767,661,0,93,628,36615,775,431,344,775,68800,2020
47001,43.1,76513,67828,2755,2345,21041,52338,30886,20886,10000,30886,152600,2020
47003,38.3,48937,37405,3529,6238,12822,52973,17490,12426,5064,17490,169800,2020
47005,47.5,16133,15386,146,388,4067,39019,6770,5130,1640,6770,87700,2020
47007,43.2,14961,13127,1091,395,3423,49382,4822,3696,1126,4822,139300,2020
47009,43.9,131641,119217,3416,4602,35552,60301,51274,39279,11995,51274,192800,2020
47011,39.7,106924,91087,4899,6847,27847,51872,40730,27212,13518,40730,167800,2020
47013,44.1,39818,38333,97,584,11035,41769,16461,10934,5527,16461,121000,2020
47015,41,14374,13490,284,336,3811,52518,5579,4285,1294,5579,172600,2020
47017,43,27841,23504,2758,779,7287,42877,10993,8094,2899,10993,97200,2020
47019,45.7,56452,53348,951,1115,15406,40820,23993,17269,6724,23993,125100,2020
47021,40.2,40539,37206,554,1353,11215,63988,15317,11863,3454,15317,198900,2020
47023,37.5,17260,14706,1658,474,4411,53336,5992,4624,1368,5992,118700,2020
47025,42.7,31827,30277,267,425,8750,37954,13561,9608,3953,13561,112000,2020
47027,47,7640,7218,250,122,2029,32064,3176,2473,703,3176,107400,2020
47029,45.3,35797,33295,454,919,9553,38530,14171,9864,4307,14171,112600,2020
47031,39.7,56024,49213,2095,2571,14576,51030,22034,14711,7323,22034,156200,2020
47033,41.1,14310,10500,1871,1542,3926,47581,5653,3965,1688,5653,99100,2020
47035,51.8,60016,56586,434,1801,18245,49423,26389,20869,5520,26389,159800,2020
47037,34.4,690540,386782,184488,70926,156379,62515,289191,157390,131801,289191,267400,2020
47039,46.5,11663,10705,411,383,3196,40389,4637,3695,942,4637,97800,2020
47041,42.6,20104,17655,337,1643,5561,44389,7782,5314,2468,7782,157500,2020
47043,38.8,53289,47624,2172,1982,13533,57804,19559,14891,4668,19559,183300,2020
47045,40.1,37201,29603,4538,1297,10107,45042,15271,9518,5753,15271,113800,2020
47047,46.2,40612,27373,11080,1144,11769,63618,16040,12587,3453,16040,218600,2020
47049,45.5,18405,17719,67,291,4640,40203,7368,5597,1771,7368,106800,2020
47051,42,41999,37070,2037,1465,10952,47777,16497,12124,4373,16497,146700,2020
47053,40,49193,37411,8300,1371,13204,45557,19594,12852,6742,19594,108600,2020
47055,43.6,29403,24671,2965,837,7660,49815,11700,8241,3459,11700,136600,2020
47057,46.2,23268,21830,45,796,6458,44703,9147,6990,2157,9147,124900,2020
47059,45,69077,64106,1681,2066,18437,43150,27515,20860,6655,27515,133600,2020
47061,43.5,13371,11628,90,180,3676,43116,4944,3885,1059,4944,90400,2020
47063,40.7,64479,52507,2272,7591,16087,43151,24490,16349,8141,24490,139000,2020
47065,39.7,364718,258213,67346,21081,89372,56606,148296,95010,53286,148296,191400,2020
47067,44.5,6568,6340,37,120,1695,28234,2731,2116,615,2731,99800,2020
47069,40.7,25247,13669,10609,463,5916,39636,9245,6414,2831,9245,94100,2020
47071,45.4,25665,23572,983,634,6996,42285,10087,7658,2429,10087,120200,2020
47073,45.2,56735,53866,802,897,15985,45318,23183,17732,5451,23183,127600,2020
47075,43,17391,7593,8836,754,4756,38994,7148,4209,2939,7148,103600,2020
47077,40.6,27956,24378,2361,694,6973,44534,10914,8055,2859,10914,108600,2020
47079,45.8,32251,28006,2650,834,8538,41037,13190,9913,3277,13190,104500,2020
47081,41.3,25017,22564,1306,643,5830,47457,8675,7124,1551,8675,122500,2020
47083,43.8,8201,7521,391,124,1778,43521,2919,2322,597,2919,126300,2020
47085,41.7,18528,16915,331,469,4449,48411,6869,5389,1480,6869,120000,2020
47087,47.4,11767,11136,39,254,2698,35880,4525,3641,884,4525,115800,2020
47089,44.2,54162,49904,975,1971,14496,51899,20038,15174,4864,20038,154800,2020
47091,46.1,17755,16406,556,371,4705,38090,6979,5272,1707,6979,133700,2020
47093,37.4,466184,381864,39986,20555,116628,59250,189536,123272,66264,189536,194200,2020
47095,40.3,7273,4864,2006,180,1251,34230,2167,1108,1059,2167,91800,2020
47097,39.1,25689,15493,8692,662,6712,41905,9609,5467,4142,9609,90700,2020
47099,39.4,43780,40756,757,1036,10939,43734,16140,12133,4007,16140,118500,2020
47101,42,12131,11298,157,291,3169,36977,4837,3790,1047,4837,98600,2020
47103,42.9,34158,29437,2331,1223,9479,53923,13788,10597,3191,13788,149400,2020
47105,47.8,53169,46234,565,4832,14828,61664,20967,16625,4342,20967,227100,2020
47107,42.4,53392,47349,1830,2240,14144,46872,21147,15711,5436,21147,140000,2020
47109,43.6,25814,23132,1503,573,6715,40327,9875,7525,2350,9875,101100,2020
47111,38.4,24208,22120,240,1248,6171,38080,9143,6707,2436,9143,124800,2020
47113,38.5,97838,54208,36056,3891,24662,48396,38266,23821,14445,38266,139500,2020
47115,43.2,28639,26239,1099,530,7797,50059,11438,8604,2834,11438,122700,2020
47117,39.7,33708,28402,1793,1872,8845,55299,12436,9085,3351,12436,159900,2020
47119,39.2,94615,74705,10589,5790,24992,60567,35163,25245,9918,35163,204500,2020
47121,45.9,12237,11381,232,272,3463,50733,5079,4056,1023,5079,148700,2020
47123,44.1,46413,41950,929,2041,12994,45576,18639,13800,4839,18639,146100,2020
47125,31,204992,128270,39346,21063,53135,60878,74606,45436,29170,74606,175000,2020
47127,45.9,6396,5926,119,1,1861,63762,2599,2176,423,2599,200500,2020
47129,41.5,21538,19615,1288,297,5366,41701,7524,6201,1323,7524,98000,2020
47131,42.4,30343,24691,3402,1415,8017,39985,12633,8110,4523,12633,96600,2020
47133,43.2,22171,21266,97,347,5873,36478,8969,6993,1976,8969,126300,2020
47135,43.1,8020,7342,65,212,2087,48716,2929,2325,604,2929,94100,2020
47137,50.7,5068,4882,11,161,1496,43125,2211,1787,424,2211,135600,2020
47139,46.3,16807,15592,144,362,5167,45326,7448,5544,1904,7448,112700,2020
47141,36.7,78542,68963,1861,5008,20091,45160,31777,19681,12096,31777,164000,2020
47143,40,32964,29564,569,1682,8557,46096,12324,9085,3239,12324,131100,2020
47145,47.3,53331,49376,1275,1043,14607,55578,21596,16337,5259,21596,157900,2020
47147,39,70982,58524,5103,5040,20110,66088,26122,19844,6278,26122,215900,2020
47149,33.6,324139,225604,48177,26978,81396,68718,115249,75174,40075,115249,234700,2020
47151,39.4,22020,21366,127,218,5902,37135,8625,6152,2473,8625,97300,2020
47153,44.4,14936,13905,64,536,4334,44217,5539,4231,1308,5539,150700,2020
47155,42.9,98007,87761,770,6211,26718,51734,37993,27005,10988,37993,189200,2020
47157,35.7,936611,329976,502392,60266,219410,52092,356607,195260,161347,356607,158700,2020
47159,40.6,19926,18258,432,572,5656,48611,7688,5821,1867,7688,162500,2020
47161,43.8,13553,12397,42,433,3435,49537,5226,3953,1273,5226,124600,2020
47163,45.3,157707,146987,2803,3137,42793,47438,66645,48071,18574,66645,145300,2020
47165,39.6,187680,155517,14599,9623,50155,69878,68654,50292,18362,68654,256000,2020
47167,38,61562,46216,11369,1733,16771,62474,21624,15926,5698,21624,161300,2020
47169,33.9,10910,9007,1129,108,2179,56981,3398,2532,866,3398,164300,2020
47171,47.4,17821,16463,48,946,4669,44526,7683,5573,2110,7683,136500,2020
47173,42.5,19678,18905,91,345,5719,45143,7463,5621,1842,7463,131800,2020
47175,46.5,5813,5557,10,78,1645,47576,2242,1793,449,2242,98100,2020
47177,40.1,40971,34744,987,3770,10175,42668,15515,10902,4613,15515,117000,2020
47179,40.1,128874,113489,4990,4647,33876,48923,54603,35004,19599,54603,167400,2020
47181,44,16638,14898,978,360,3840,42206,5737,4507,1230,5737,109100,2020
47183,38.5,33377,28884,2851,916,8719,41488,13563,8765,4798,13563,97900,2020
47185,43.3,27087,25229,507,711,6778,44282,10219,7918,2301,10219,124800,2020
47187,39.3,232380,194587,9473,11302,63847,111196,81041,64377,16664,81041,471300,2020
47189,40.2,140604,117685,9502,6288,38924,78962,51348,39082,12266,51348,283200,2020
48001,39.3,57917,33642,11919,10360,11705,45847,16555,11844,4711,16555,110000,2020
48003,32.3,18227,7217,418,10364,4425,75147,5649,4220,1429,5649,153200,2020
48005,37.6,87119,52457,13138,19418,22698,49684,31368,20617,10751,31368,110500,2020
48007,50,24220,16215,57,6779,6303,47924,9917,8117,1800,9917,183200,2020
48009,44.2,8754,7721,92,719,2459,63958,3513,2941,572,3513,152000,2020
48011,41.7,1950,1726,14,165,550,69386,720,595,125,720,156100,2020
48013,36,50194,16477,517,32491,12079,59251,15798,12279,3519,15798,106000,2020
48015,40.9,29892,18421,2543,8139,8634,64468,11569,9075,2494,11569,197200,2020
48017,33.7,6916,2202,20,4548,1395,55038,2056,1592,464,2056,75200,2020
48019,53.1,22770,17438,170,4391,6030,60361,8697,7540,1157,8697,202000,2020
48021,38,86839,44099,6196,33686,19208,71820,26173,20557,5616,26173,199300,2020
48023,47.2,3560,2854,83,543,1043,40946,1621,1196,425,1621,69100,2020
48025,35.3,32609,10096,2163,19313,5693,45287,8499,5503,2996,8499,88700,2020
48027,31.3,355700,158981,77218,90125,85281,54987,125747,67893,57854,125747,153500,2020
48029,33.8,1978826,536112,139381,1197120,421271,58288,644561,377055,267506,644561,171200,2020
48031,50.5,11733,8864,3,2317,3266,70397,4665,3643,1022,4665,261300,2020
48033,37.2,653,548,0,85,172,83281,223,155,68,223,156300,2020
48035,46.8,18428,14170,310,3459,5283,57337,7255,5524,1731,7255,135500,2020
48037,38.3,93622,59229,23156,7251,22706,51796,34283,21929,12354,34283,123200,2020
48039,36,368062,169687,51837,114094,92288,83325,124184,91024,33160,124184,213100,2020
48041,26.8,226370,124631,23492,58542,46221,50289,81514,38290,43224,81514,217700,2020
48043,43.8,9231,4599,19,4168,2300,45296,4292,2507,1785,4292,171700,2020
48045,46.9,1348,791,16,487,339,37875,588,420,168,588,72500,2020
48047,34.4,7100,563,8,6514,1419,25058,2475,1487,988,2475,64200,2020
48049,41.2,37805,26886,1283,8516,9599,49180,14614,10449,4165,14614,109500,2020
48051,43.8,18237,11714,2417,3806,4582,60058,6931,5386,1545,6931,126500,2020
48053,44.8,47548,34912,677,10625,12752,59919,17384,13704,3680,17384,203300,2020
48055,35.8,42817,16640,2119,22720,9499,59846,13774,9474,4300,13774,147200,2020
48057,37.7,21470,8919,350,10551,5502,57170,8027,5917,2110,8027,117400,2020
48059,43.9,13959,11976,114,1371,3567,51955,5372,4481,891,5372,100000,2020
48061,31.7,422135,36943,1609,379216,98120,41200,126968,84054,42914,126968,89700,2020
48063,38.1,12938,7144,2112,3292,2966,49539,4460,3208,1252,4460,109400,2020
48065,42.4,5957,5084,65,609,1644,74246,2332,1964,368,2332,108700,2020
48067,44,30002,22851,5132,1409,8412,47539,11962,9534,2428,11962,91100,2020
48069,35.7,7561,2382,77,4900,1823,49900,2557,1494,1063,2557,83300,2020
48071,35.2,42571,28135,3277,9870,11518,95989,14266,12245,2021,14266,224400,2020
48073,37.9,52341,31491,7205,12267,13937,50199,18540,13345,5195,18540,111600,2020
48075,32.9,7219,3980,563,2530,1646,43564,2308,1365,943,2308,86800,2020
48077,47,10444,9306,59,682,2938,63125,4159,3385,774,4159,110000,2020
48079,36.6,2860,1017,128,1691,711,41000,1026,738,288,1026,38000,2020
48081,47.9,3298,2461,37,727,1011,45072,1625,1085,540,1625,74100,2020
48083,47,8281,6345,168,1466,2203,46948,3492,2623,869,3492,83100,2020
48085,37,1006038,558786,97140,154396,261697,100541,353491,229049,124442,353491,337200,2020
48087,40.1,2939,1650,277,934,722,41202,1029,773,256,1029,57500,2020
48089,43.1,21357,11865,2665,6455,5185,52663,7442,6222,1220,7442,131400,2020
48091,42.1,148921,99164,3169,41293,40137,80781,54586,40865,13721,54586,293600,2020
48093,44.6,13597,9374,74,3848,3540,54889,5416,4446,970,5416,110900,2020
48095,46.1,3018,1683,56,1211,579,53333,876,713,163,876,107700,2020
48097,41.2,40428,30370,1112,7376,11139,62733,15530,10869,4661,15530,166700,2020
48099,32.2,75576,43743,9238,14169,15863,54712,22324,13590,8734,22324,120700,2020
48101,37.3,1624,1066,126,313,393,40250,703,438,265,703,44000,2020
48103,33.6,4739,1446,90,3079,1049,54596,1500,1329,171,1500,89000,2020
48105,44.1,3393,1242,41,2110,995,46695,1394,923,471,1394,102200,2020
48107,39,5753,2249,176,3237,1516,42470,2107,1530,577,2107,61300,2020
48109,37.2,2183,251,3,1816,400,34853,668,442,226,668,63700,2020
48111,31.5,7272,3841,14,3374,1650,58956,2344,1795,549,2344,95000,2020
48113,33.5,2622634,749571,585014,1055049,607453,61870,945996,476375,469621,945996,193900,2020
48115,33.6,12849,4118,1038,7458,2785,40469,4430,3102,1328,4430,80100,2020
48117,31.8,18617,4482,141,13689,4639,49790,6053,3962,2091,6053,91800,2020
48119,41.7,5277,4235,388,437,1365,49868,2066,1670,396,2066,107600,2020
48121,35.8,861690,501173,83378,166865,211887,90354,300585,196219,104366,300585,297100,2020
48123,41.7,20217,11030,1787,7211,4671,53815,6823,4900,1923,6823,121900,2020
48125,45.2,2182,1468,58,644,541,41141,861,668,193,861,53100,2020
48127,36.5,10232,1072,9,8938,2427,25996,3178,2227,951,3178,61300,2020
48129,41.6,3317,2665,201,374,883,51875,1344,980,364,1344,70200,2020
48131,36.4,11194,1041,153,9991,2349,45349,3407,2359,1048,3407,61800,2020
48133,41.5,18289,14405,388,3050,4483,41559,7017,5388,1629,7017,82600,2020
48135,30.6,162067,50661,7305,99853,36914,63096,53602,35106,18496,53602,147900,2020
48137,40.7,1944,929,1,1013,494,40643,787,581,206,787,71800,2020
48139,36.4,179484,106903,18492,47758,47096,79834,59399,44454,14945,59399,214500,2020
48141,32.4,836915,98336,24122,691920,198164,48292,273662,170433,103229,273662,126500,2020
48143,30.8,42226,31255,704,8990,9223,55383,14263,9261,5002,14263,166300,2020
48145,41,17281,8789,3946,4065,3412,36854,5552,4197,1355,5552,76900,2020
48147,41,35046,27479,1981,4067,8428,57898,12391,9205,3186,12391,139200,2020
48149,48.1,25247,17896,1615,5393,6282,62872,9033,7537,1496,9033,193200,2020
48151,44.5,3827,2548,117,1045,1098,52683,1676,1263,413,1676,63900,2020
48153,36.5,5782,2125,196,3391,1566,52714,2184,1631,553,2184,70300,2020
48155,55.1,1207,850,2,273,337,39306,509,420,89,509,48500,2020
48157,36.5,790892,254705,156577,194349,205044,100189,248299,192555,55744,248299,277600,2020
48159,42.4,10767,8415,475,1606,2885,59632,3960,3285,675,3960,144300,2020
48161,40.8,19744,12995,2845,3137,4766,52232,6736,5208,1528,6736,116800,2020
48163,31.7,20013,3050,722,15924,3306,48708,4673,3123,1550,4673,86000,2020
48165,28.1,21077,11639,292,8797,4614,62994,5878,4248,1630,5878,141200,2020
48167,37.7,337600,191561,41643,84243,85664,74633,125204,84565,40639,125204,212600,2020
48169,42.8,6028,2347,561,2954,1271,58938,1713,1171,542,1713,78200,2020
48171,50.1,26668,19781,23,6300,7377,61445,10820,7722,3098,10820,311300,2020
48173,36.6,1447,872,0,554,373,74375,435,285,150,435,303300,2020
48175,46.3,7578,4383,408,2730,1835,50000,2840,2284,556,2840,129000,2020
48177,36.7,20828,8585,1398,10652,5257,58210,7465,5230,2235,7465,113700,2020
48179,36.3,22063,13832,1036,6490,5166,54679,7843,5684,2159,7843,79800,2020
48181,39.4,133527,99574,6746,18247,33765,58296,49327,33648,15679,49327,152400,2020
48183,35.6,123633,70235,24003,23354,30633,52027,46174,27354,18820,46174,144300,2020
48185,40.5,28447,16510,4119,6874,6792,56086,9206,6999,2207,9206,163200,2020
48187,37,163030,80949,12586,62324,42206,75774,55710,43073,12637,55710,207700,2020
48189,33,33463,11143,1442,20023,7609,47500,10888,6890,3998,10888,84500,2020
48191,44.3,3025,1682,187,1047,856,40197,1252,858,394,1252,59900,2020
48193,45.3,8434,7067,30,1099,2002,46893,3007,2518,489,3007,123600,2020
48195,32.6,5431,2764,10,2601,1327,46507,1859,1428,431,1859,111300,2020
48197,44.6,3958,2642,228,926,1093,47188,1672,1159,513,1672,53100,2020
48199,39.6,57356,49350,3248,3447,15789,61221,21188,17197,3991,21188,135600,2020
48201,33.7,4680609,1356752,865997,2016625,1113437,63022,1635749,897913,737836,1635749,189400,2020
48203,39.4,66547,41889,13781,8837,17247,54234,23841,17460,6381,23841,137200,2020
48205,37.3,5588,3347,399,1500,1211,53722,1691,1104,587,1691,179200,2020
48207,42.8,5711,3673,241,1636,1430,48955,2162,1551,611,2162,60500,2020
48209,32.5,222827,116980,8326,87907,51047,68724,76724,47715,29009,76724,258000,2020
48211,36.7,3901,2385,9,1445,946,59605,1356,915,441,1356,180300,2020
48213,44,81969,63356,4791,10726,22028,49469,31649,24118,7531,31649,120700,2020
48215,29.4,861137,50969,3816,794879,195687,41846,243878,165793,78085,243878,90000,2020
48217,41.8,36109,25368,2159,7557,9250,55615,13094,9527,3567,13094,112200,2020
48219,33.9,22986,10557,744,11163,5577,47010,8071,5901,2170,8071,92900,2020
48221,46.6,60025,50396,587,7542,17081,71253,23215,18462,4753,23215,208700,2020
48223,39.5,36708,26807,2614,6264,9777,54600,13514,9347,4167,13514,119600,2020
48225,43.8,22942,14148,5681,2606,5509,40838,8234,5797,2437,8234,107500,2020
48227,37.5,36213,17147,1867,15686,7159,57761,11354,7536,3818,11354,103500,2020
48229,34.3,4687,789,50,3644,743,31505,1127,828,299,1127,54500,2020
48231,37.9,96202,68271,7328,16332,23568,57467,33596,23357,10239,33596,135800,2020
48233,38.2,21105,14701,453,4985,4876,57921,7074,5658,1416,7074,81600,2020
48235,43.3,1553,1053,76,424,424,53778,636,525,111,636,122000,2020
48237,40.1,8888,6839,316,1515,2111,54087,3169,2455,714,3169,95200,2020
48239,39.2,14822,8622,1071,4936,3650,58243,4924,3469,1455,4924,110100,2020
48241,41.9,35562,26466,5849,2438,9331,42756,13725,10446,3279,13725,105200,2020
48243,61.3,2245,1601,21,603,620,NA,991,830,161,991,134800,2020
48245,36.5,253136,101025,84529,53655,59971,50840,94012,57859,36153,94012,120300,2020
48247,29.7,5187,370,2,4805,1111,35736,1545,1102,443,1545,77000,2020
48249,35,40796,7257,296,32780,9581,45857,12924,9172,3752,12924,76900,2020
48251,36.9,171359,121662,6357,37660,44517,65311,58270,42693,15577,58270,168500,2020
48253,38.1,19874,10915,2620,5523,3942,52471,5646,4444,1202,5646,80800,2020
48255,35.6,15547,5472,867,8640,3156,52896,4552,3340,1212,4552,109500,2020
48257,35.3,129792,79675,16283,29087,30399,72179,39237,30075,9162,39237,195400,2020
48259,42.1,45491,32698,196,10996,11451,98692,14789,11239,3550,14789,378500,2020
48261,41.2,391,12,0,378,115,40083,129,27,102,129,NA,2020
48263,43.5,704,608,8,74,179,61706,286,233,53,286,64700,2020
48265,48,52195,35550,814,14282,14712,57196,21278,14561,6717,21278,193900,2020
48267,52,4375,3158,27,1125,1252,46602,1967,1488,479,1967,151700,2020
48269,39.4,279,219,0,60,66,39286,90,35,55,90,22800,2020
48271,51,3674,1428,0,2238,782,39972,1475,1110,365,1475,82000,2020
48273,28.4,30725,6148,937,22439,7175,47301,11140,5815,5325,11140,98500,2020
48275,41.6,3679,2116,160,1283,1001,50719,1394,1180,214,1394,43300,2020
48277,40.7,49705,36519,6409,4007,13395,48036,19995,12940,7055,19995,108500,2020
48279,36.4,13018,5069,418,7272,3111,44935,4706,3441,1265,4706,67900,2020
48281,43.4,21152,15247,801,4161,5635,64808,7823,6245,1578,7823,166500,2020
48283,36.3,7551,958,125,6396,1659,47162,2142,1585,557,2142,84000,2020
48285,43.6,20072,14704,1157,3851,5521,54211,7904,5973,1931,7904,171000,2020
48287,41.7,17174,10832,1932,4090,4658,56696,6159,4958,1201,6159,162800,2020
48289,44.7,17325,13145,1158,2550,4796,43392,6837,5338,1499,6837,120300,2020
48291,35,86173,52992,8145,23051,19617,50917,27417,21411,6006,27417,115300,2020
48293,40.3,23364,13415,3984,5170,5735,45781,8292,6138,2154,8292,115400,2020
48295,36.6,3301,2089,57,1004,872,63182,1158,855,303,1158,106700,2020
48297,42.7,12175,6853,249,4898,2609,50212,3854,3156,698,3854,106200,2020
48299,57.7,21452,18383,120,2304,5990,58941,9031,7009,2022,9031,235700,2020
48301,62.2,117,117,0,0,18,44076,62,11,51,62,NA,2020
48303,30.9,308392,163154,20602,110434,70197,53425,116535,64803,51732,116535,149200,2020
48305,38.5,5886,2939,37,2743,1589,46163,2199,1521,678,2199,89900,2020
48307,45.6,7970,4791,84,2606,1980,48618,3151,2200,951,3151,96300,2020
48309,33.6,254045,140810,35781,67422,59829,50210,91422,54151,37271,91422,152700,2020
48311,36.1,724,254,0,470,185,67386,229,194,35,229,111300,2020
48313,35.9,14329,7804,1946,3381,2994,60499,4205,3196,1009,4205,113200,2020
48315,50.8,9987,7072,2259,434,2664,39093,4535,3535,1000,4535,98200,2020
48317,32.8,5676,2911,28,2712,1356,70000,1722,1202,520,1722,145700,2020
48319,45.2,4248,3253,1,871,1128,61434,1668,1253,415,1668,219900,2020
48321,37.8,36791,15847,3788,15850,9274,48733,13900,9798,4102,13900,128100,2020
48323,29.8,58098,1466,273,55301,13402,41385,16647,11048,5599,16647,100900,2020
48325,38.4,50869,21627,1104,26609,12023,62701,15978,12780,3198,15978,151600,2020
48327,54.2,2108,1282,1,725,541,43826,1035,636,399,1035,87300,2020
48329,31.8,171238,76123,10453,77728,39642,83217,57917,38643,19274,57917,233200,2020
48331,41.8,24797,15336,2248,6639,6346,48253,9468,6972,2496,9468,111900,2020
48333,52.5,4877,3661,23,1113,1212,50198,1752,1545,207,1752,141700,2020
48335,34.2,8256,3958,727,3329,1421,44939,2419,1964,455,2419,67900,2020
48337,44.4,19640,16783,150,2202,5749,57511,7969,6101,1868,7969,120100,2020
48339,37.2,590188,383155,29373,144951,154426,83274,205719,147027,58692,205719,248100,2020
48341,30.8,21169,6731,773,12032,4924,53967,6659,4383,2276,6659,113100,2020
48343,43.2,12357,7917,2898,1259,3386,43995,5170,3789,1381,5170,92100,2020
48345,46.4,1362,1071,10,207,336,45417,496,352,144,496,60000,2020
48347,31,65080,38550,11406,12775,15408,44507,23765,13713,10052,23765,137300,2020
48349,38.2,49475,27427,5843,13803,12716,47574,17509,12191,5318,17509,109700,2020
48351,44.4,13788,10096,2916,524,3936,40690,5124,4228,896,5124,80700,2020
48353,37.1,14901,8124,769,5716,3792,43692,5516,3748,1768,5516,80300,2020
48355,35.7,362151,104979,13052,232273,88332,56784,130482,76550,53932,130482,148100,2020
48357,31.9,9907,4205,7,5430,2540,53431,3391,2483,908,3391,104300,2020
48359,32.5,2110,1599,86,382,475,64250,646,472,174,646,103800,2020
48361,38.3,83776,67093,7249,6790,22873,63488,31570,23449,8121,31570,116100,2020
48363,40.8,28792,21429,686,5741,7058,55986,10334,7703,2631,10334,115700,2020
48365,39.6,23186,16963,3748,2054,6013,51297,8662,6688,1974,8662,117000,2020
48367,39.8,138447,114688,1783,17660,35470,84189,45848,36917,8931,45848,236300,2020
48369,34.6,9639,3219,85,6154,2430,58558,3213,2104,1109,3213,110000,2020
48371,35.8,15725,3907,541,10855,3334,53879,4868,3614,1254,4868,106000,2020
48373,43.9,50155,35656,4727,7697,12659,50351,17945,13850,4095,17945,125500,2020
48375,34.1,118323,51539,11804,45928,28645,43652,43957,24037,19920,43957,97000,2020
48377,42.5,6808,1141,0,5461,1291,22716,2580,1392,1188,2580,77200,2020
48379,48.5,12001,10208,335,1114,2972,52612,4321,3386,935,4321,131100,2020
48381,36,136005,95638,3580,30436,34141,68186,50092,34873,15219,50092,174100,2020
48383,30.6,3766,1025,41,2633,863,61659,1117,735,382,1117,98300,2020
48385,52.8,3429,2558,40,827,845,38659,1254,901,353,1254,146900,2020
48387,47.5,12115,8891,1942,893,3336,37135,5143,4014,1129,5143,77900,2020
48389,35.2,15546,3629,71,11625,2388,61543,3772,3002,770,3772,91600,2020
48391,43.7,7015,2896,388,3563,1730,51054,2566,1869,697,2566,85500,2020
48393,47.2,784,666,0,93,245,61964,329,272,57,329,134200,2020
48395,41.4,17094,9715,3387,3617,4684,53823,6749,4960,1789,6749,121600,2020
48397,37.6,101175,70586,6720,18295,28224,105956,34457,28734,5723,34457,283000,2020
48399,40.4,10280,6287,251,3542,2591,48489,3891,2838,1053,3891,85200,2020
48401,38.2,53988,34140,8807,9224,13132,56223,18056,14298,3758,18056,131200,2020
48403,53,10470,8877,574,490,3171,38917,4524,3907,617,4524,99900,2020
48405,48.8,8260,5718,1812,609,2695,41568,3712,2711,1001,3712,75500,2020
48407,45.1,28574,21241,2634,3859,7000,44566,10143,8066,2077,10143,126700,2020
48409,35.6,66969,25350,988,38941,16838,56111,23422,15887,7535,23422,129400,2020
48411,42,6004,3831,90,1829,1405,45169,2134,1512,622,2134,119400,2020
48413,36.6,2898,1257,45,1549,678,45250,1036,808,228,1036,80900,2020
48415,36.5,16918,8714,659,6948,3985,50277,6115,4799,1316,6115,87600,2020
48417,44.7,3291,2802,7,385,914,48212,1367,1090,277,1367,110000,2020
48419,38.3,25263,15521,4675,4655,6892,41170,9486,7115,2371,9486,81800,2020
48421,40.3,3046,1623,4,1327,822,57130,1070,780,290,1070,93900,2020
48423,36.9,230184,136726,38885,45319,53943,59450,77809,52300,25509,77809,164200,2020
48425,42.8,8958,7148,103,1627,2360,64394,3145,2635,510,3145,205800,2020
48427,29,64032,619,26,63329,12836,30931,16281,12177,4104,16281,76900,2020
48429,39.5,9358,6584,280,2266,2278,44940,3408,2527,881,3408,81300,2020
48431,34.4,1274,785,0,486,333,53194,405,354,51,405,75000,2020
48433,40.8,1412,1040,25,341,384,58309,529,424,105,529,53200,2020
48435,37.7,3793,1196,2,2586,957,61190,1282,873,409,1282,101000,2020
48437,37,7403,3379,506,3287,1635,36337,2599,1881,718,2599,78600,2020
48439,34.6,2077153,952535,337963,602314,500989,70306,722446,435543,286903,722446,209600,2020
48441,32.6,137521,86121,10294,34104,33439,55568,50396,29409,20987,50396,137600,2020
48443,59.1,903,403,14,454,218,42823,419,404,15,419,81400,2020
48445,34.5,12408,5145,289,6884,2797,44052,4101,2593,1508,4101,78500,2020
48447,48.4,1500,1277,16,181,435,41875,713,523,190,713,58600,2020
48449,34.2,32709,14567,2982,14265,8339,53406,11064,7525,3539,11064,99900,2020
48451,34.3,118645,62252,4664,48092,27500,57670,42953,28175,14778,42953,149700,2020
48453,34.5,1250884,607813,98769,420236,280144,80668,491531,260455,231076,491531,347700,2020
48455,50,14689,11464,1269,1535,4319,44052,6105,4658,1447,6105,87500,2020
48457,42.6,21524,16954,2255,1720,4693,47865,7109,5895,1214,7109,91000,2020
48459,41.2,41386,33113,3307,3601,10263,54330,14392,11087,3305,14392,153800,2020
48461,38.9,3651,1450,173,1980,909,59008,1344,1034,310,1344,78900,2020
48463,33.8,26899,6876,98,19334,6206,45936,8921,6185,2736,8921,103000,2020
48465,32.2,49018,7264,621,40299,12174,47675,16388,10623,5765,16388,105400,2020
48467,42.3,55970,46610,1608,6325,15370,57203,20494,16185,4309,20494,152200,2020
48469,35.9,92044,40580,5224,43528,22172,58959,32520,21872,10648,32520,152900,2020
48471,35.3,72295,40630,16575,13066,12826,41508,22515,11677,10838,22515,160100,2020
48473,29.5,53626,22956,12989,16312,11419,61752,15586,10798,4788,15586,222700,2020
48475,34.3,11745,4624,567,6372,2952,61915,4100,3058,1042,4100,98700,2020
48477,42,35275,22361,6038,5752,8715,59623,13321,9817,3504,13321,193000,2020
48479,28.9,274847,9577,854,262499,61334,50296,76382,48093,28289,76382,135000,2020
48481,37.3,41672,18384,5259,17424,10596,51770,15248,10116,5132,15248,148700,2020
48483,40.6,5187,3567,142,1339,1432,49036,2060,1449,611,2060,83600,2020
48485,34.6,132154,85537,13157,25823,30812,49710,48538,29577,18961,48538,103200,2020
48487,39.2,12717,7267,1161,3777,2964,45121,5008,2973,2035,5008,73200,2020
48489,33.4,21419,2277,154,18888,4375,37906,5882,3939,1943,5882,62100,2020
48491,36.6,570437,332829,34918,140449,136092,90834,188113,128240,59873,188113,282700,2020
48493,39.9,50110,28131,536,20072,13235,80082,15975,13943,2032,15975,210600,2020
48495,34.1,7822,2633,223,4809,1914,63585,2618,2119,499,2618,82800,2020
48497,38.6,67884,51739,810,13295,17294,67726,22254,17720,4534,22254,178200,2020
48499,48.3,45054,36995,2175,4610,11767,56749,16716,13609,3107,16716,151400,2020
48501,30.5,8612,2706,13,5766,1976,69004,2601,2010,591,2601,152900,2020
48503,40.8,17961,13911,329,3411,5159,52158,7491,5547,1944,7491,122100,2020
48505,30,14243,573,0,13467,3254,32945,4689,3287,1402,4689,88700,2020
48507,32.8,11930,626,80,11200,3039,40090,3674,2710,964,3674,59400,2020
49001,32.8,6594,5561,0,790,1769,66705,2213,1805,408,2213,209000,2020
49003,32.9,54953,47657,266,5231,13659,63573,17811,13614,4197,17811,226200,2020
49005,25.4,126336,105632,859,13503,30190,60530,39581,24772,14809,39581,256400,2020
49007,37.9,20401,16892,199,2741,5228,50328,7802,5637,2165,7802,148600,2020
49009,38.9,590,573,1,14,134,74911,169,120,49,169,152500,2020
49011,31.3,350761,291999,4180,34780,85617,87570,107104,83205,23899,107104,320100,2020
49013,31.9,19950,16983,32,1643,5455,61655,7038,5210,1828,7038,188300,2020
49015,37.2,10099,9188,7,632,2776,57772,3732,2811,921,3732,137400,2020
49017,42,5000,4431,2,309,1312,44279,1851,1453,398,1851,182500,2020
49019,40.8,9698,7944,41,997,2927,56639,4442,2912,1530,4442,287900,2020
49021,29.3,53148,45396,337,4814,12829,52045,17381,11340,6041,17381,231300,2020
49023,30.1,11623,10651,44,635,2844,68333,3478,2722,756,3478,250900,2020
49025,42,7658,6949,1,370,1686,49486,2847,2196,651,2847,239900,2020
49027,34.5,12963,10783,35,1643,3482,63221,4293,3160,1133,4293,166900,2020
49029,32.6,11950,11248,95,346,3090,100408,3434,3039,395,3434,417600,2020
49031,53.4,1870,1792,4,61,380,29125,590,525,65,590,182400,2020
49033,33,2415,2158,0,231,525,63917,641,470,171,641,205300,2020
49035,33,1146215,808106,20642,211869,265385,77128,383324,258905,124419,383324,336100,2020
49037,32.6,15295,6772,24,900,3373,49690,4577,3575,1002,4577,128700,2020
49039,33.2,30421,26149,200,2898,6842,55820,8887,6862,2025,8887,206800,2020
49041,35.8,21475,19708,132,1116,5732,55361,7487,5905,1582,7487,173600,2020
49043,40.2,41680,35194,262,4650,10677,106973,14474,11308,3166,14474,678500,2020
49045,31.6,69740,57134,437,8834,17180,76737,21147,17074,4073,21147,236600,2020
49047,31.1,35736,28922,165,3025,7550,59428,10739,8242,2497,10739,194000,2020
49049,25,621506,509139,3492,74069,139817,77057,171899,116732,55167,171899,336200,2020
49051,34.3,33053,27512,90,4492,8055,85807,10505,7754,2751,10505,452900,2020
49053,37.7,172127,144595,1088,18297,44865,61747,59699,41927,17772,59699,306900,2020
49055,42,2698,2473,2,167,768,49299,995,730,265,995,228800,2020
49057,32.9,255284,193651,2345,47010,62139,71275,85205,63658,21547,85205,249100,2020
50001,43.7,36947,34099,371,885,9053,70262,14700,11067,3633,14700,257100,2020
50003,46.3,35649,33393,272,753,8987,58200,14585,10699,3886,14585,210600,2020
50005,45,30027,28268,182,517,7907,52481,12618,9470,3148,12618,172700,2020
50007,36.5,163414,143764,4157,3956,37611,76316,66478,41815,24663,66478,314200,2020
50009,51.4,6179,5869,46,86,1856,47035,2882,2393,489,2882,137600,2020
50011,40.5,49275,46162,188,818,12747,65314,19045,14762,4283,19045,219200,2020
50013,48.7,7075,6517,63,144,2040,81667,2976,2557,419,2976,287200,2020
50015,40.4,25376,23912,230,481,6534,64179,10770,7761,3009,10770,228200,2020
50017,46.7,28873,27496,121,398,8065,62737,12670,10219,2451,12670,196900,2020
50019,46.1,26843,25435,197,407,7448,54390,11678,9109,2569,11678,169400,2020
50021,47,58527,55432,397,903,14847,57176,25349,18126,7223,25349,174800,2020
50023,43.7,58336,54664,446,1147,15019,64862,25310,17793,7517,25310,230400,2020
50025,47.2,42628,39444,459,1027,10400,54188,19162,12974,6188,19162,217600,2020
50027,48,55191,52146,367,996,14591,61503,24629,18629,6000,24629,219500,2020
51001,45.8,32560,19505,9390,2880,8978,46178,13641,8861,4780,13641,173700,2020
51003,39.4,108819,83403,9936,6272,26522,84643,42381,27625,14756,42381,376000,2020
51005,48,15030,13733,790,231,3968,48513,6529,5170,1359,6529,121100,2020
51007,45,12970,9463,2871,408,3473,63918,5034,4184,850,5034,215600,2020
51009,44.9,31782,23755,5747,787,8150,57368,12161,9408,2753,12161,159900,2020
51011,42.7,15814,12148,2989,286,4402,55457,6158,4741,1417,6158,160600,2020
51013,34.8,236434,143786,21126,36492,49806,122604,108604,46205,62399,108604,731700,2020
51015,45.1,75754,68319,3164,2273,20803,65076,30165,23938,6227,30165,219600,2020
51017,48.9,4248,3900,202,33,1173,55481,1831,1499,332,1831,168400,2020
51019,46.6,78965,68785,5252,1872,23151,67136,31424,26448,4976,31424,211600,2020
51021,46.1,6334,5934,245,49,1506,50365,2326,1919,407,2326,125600,2020
51023,47.4,33440,31015,950,601,9454,72719,13171,11291,1880,13171,230500,2020
51025,44.6,16336,6630,8827,391,3744,46111,6138,4545,1593,6138,113600,2020
51027,47.6,21374,20240,531,170,5558,34302,8270,6602,1668,8270,69500,2020
51029,42.9,17087,10451,5521,418,4037,48603,5948,4391,1557,5948,135600,2020
51031,43.1,55406,43814,7788,1505,15234,52319,23157,16916,6241,23157,159400,2020
51033,39.5,30581,19317,8098,1541,7911,67901,10978,8823,2155,10978,218000,2020
51035,48.3,29911,28176,135,1119,7963,44518,12134,9619,2515,12134,112500,2020
51036,51.3,6965,2981,3052,135,1892,60096,2998,2531,467,2998,168200,2020
51037,46.1,11953,8119,3318,274,3013,40924,4836,3295,1541,4836,121000,2020
51041,39,348500,212226,78805,31718,92424,84645,127230,97590,29640,127230,252600,2020
51043,48.1,14498,12373,716,842,3961,86154,5690,4415,1275,5690,366100,2020
51045,47.9,5103,5012,2,1,1514,57792,2219,1575,644,2219,147900,2020
51047,39.8,51935,35831,6646,5837,13040,80663,17474,12829,4645,17474,310700,2020
51049,44.9,9869,6256,3216,105,2607,50565,4112,3128,984,4112,159600,2020
51051,45.2,14524,14156,83,141,3707,30116,5727,4298,1429,5727,81300,2020
51053,42.8,28686,17802,9113,1038,7114,65485,10403,8033,2370,10403,185200,2020
51057,46.7,10960,5995,4276,416,2891,51125,4551,3100,1451,4551,196500,2020
51059,38.1,1149439,574760,108847,186680,281773,127866,398653,273428,125225,398653,576700,2020
51061,41.2,70353,55909,5085,6082,18099,105665,24617,18939,5678,24617,420600,2020
51063,47.6,15766,14699,257,457,4416,51250,6657,5726,931,6657,170000,2020
51065,43.6,26873,20828,3879,966,7131,78885,9967,8215,1752,9967,234500,2020
51067,48,56231,48970,4366,1582,15475,56779,22730,18549,4181,22730,174600,2020
51069,40.7,88054,72947,3305,7896,23191,80011,32094,24939,7155,32094,265700,2020
51071,44.7,16760,15861,304,301,4375,57279,6715,5128,1587,6715,127800,2020
51073,44.9,37362,31492,3637,1379,10259,71649,14792,11830,2962,14792,230300,2020
51075,48.6,23472,18203,3444,687,6600,97146,8711,7466,1245,8711,379200,2020
51077,48.4,15651,14006,834,559,4328,41558,6388,5367,1021,6388,109800,2020
51079,38.5,19734,16001,1297,1176,5372,67266,7491,6061,1430,7491,239100,2020
51081,39.7,11403,4125,6556,282,2142,49756,3441,2473,968,3441,120900,2020
51083,46.3,34295,20486,11803,729,9041,43714,14155,10592,3563,14155,118500,2020
51085,42.7,106538,88873,9174,3272,28848,91444,39226,32519,6707,39226,288800,2020
51087,39.1,330076,172663,97057,19083,82894,72295,130434,83448,46986,130434,253900,2020
51089,48.1,51032,35486,11367,2867,12198,38511,21012,15121,5891,21012,97400,2020
51091,59.5,2202,2112,0,0,621,51831,987,862,125,987,161000,2020
51093,44.4,37107,26058,8373,1302,10355,77870,14611,11220,3391,14611,280600,2020
51095,46.8,76032,56879,9524,4487,21096,91675,29681,22709,6972,29681,346100,2020
51097,48,7011,4628,1965,235,1789,65385,2816,2382,434,2816,207400,2020
51099,38.1,26679,19381,4397,1495,7002,96711,9387,7137,2250,9387,315100,2020
51101,41,16985,13084,2558,458,4948,73284,6393,5651,742,6393,205800,2020
51103,57.2,10686,7187,2966,94,3143,59736,5287,4010,1277,5287,236500,2020
51105,45.4,23723,22068,876,485,5586,35006,8843,6130,2713,8843,85500,2020
51107,36.5,405312,223329,30117,55180,103902,147111,132565,103019,29546,132565,534600,2020
51109,45.3,36654,28620,5163,1140,10249,67027,14383,11407,2976,14383,234700,2020
51111,44.5,12294,7259,4137,637,3043,45884,4472,3187,1285,4472,123900,2020
51113,46.4,13208,11191,1203,389,3715,63482,5098,4004,1094,5098,264100,2020
51115,53.7,8760,7499,714,239,2231,74489,3881,3247,634,3881,265600,2020
51117,48.5,30726,18497,10510,913,7745,50224,12371,8962,3409,12371,148800,2020
51119,54.7,10642,8271,1583,173,2932,57060,4764,3746,1018,4764,265500,2020
51121,29.6,98495,82127,4022,3297,19279,59126,35388,19618,15770,35388,230000,2020
51125,51.3,14812,12035,1915,645,4372,62203,6398,4805,1593,6398,233400,2020
51127,43.9,22310,17481,2864,789,6217,97688,8117,7302,815,8117,296700,2020
51131,49.8,11826,6464,3906,1047,3311,50819,5151,3244,1907,5151,194000,2020
51133,59.3,12151,8422,3208,171,3843,59437,5686,5081,605,5686,270900,2020
51135,40.8,15338,8304,6193,699,3707,49983,5568,3748,1820,5568,151000,2020
51137,42.7,36501,28366,4643,1916,10037,74446,13926,10890,3036,13926,261000,2020
51139,45.3,23862,22286,282,503,6379,51878,9413,6760,2653,9413,167900,2020
51141,50.4,17660,15845,959,551,5013,46941,7830,6064,1766,7830,123700,2020
51143,47.6,60867,44975,12248,1654,18401,49520,26205,19866,6339,26205,125200,2020
51145,45.5,29253,24899,2763,664,8220,93833,10392,9647,745,10392,291300,2020
51147,32.1,22892,13967,7217,698,4235,44253,7394,4671,2723,7394,162800,2020
51149,37.1,38292,20856,11678,3227,8676,75123,11763,8065,3698,11763,219300,2020
51153,35.4,466834,194705,95384,111707,111212,107707,144159,105332,38827,144159,390500,2020
51155,47.1,34113,30926,1538,621,9277,53689,14666,10184,4482,14666,156600,2020
51157,49.2,7360,6497,334,289,2005,82077,2827,2181,646,2827,392600,2020
51159,44.4,8951,5423,2420,647,2019,53298,2939,1886,1053,2939,193700,2020
51161,43.5,94103,80431,5549,2997,24817,70076,38234,28547,9687,38234,207300,2020
51163,49,22728,20884,661,456,6389,54133,9301,6973,2328,9301,206300,2020
51165,40.9,81138,71485,1840,5832,21762,64496,31306,23289,8017,31306,217600,2020
51167,46.3,26937,25998,246,197,6735,38564,10975,8207,2768,10975,89200,2020
51169,47.6,21761,21009,147,298,5432,41540,8710,6918,1792,8710,106900,2020
51171,44.5,43441,37857,696,3208,11437,56114,17541,12219,5322,17541,214900,2020
51173,45.4,30539,28703,674,639,8572,41088,12694,8901,3793,12694,99500,2020
51175,46.7,17829,10856,5875,334,4662,63034,6618,4923,1695,6618,176600,2020
51177,38.5,134683,90587,21421,13679,34302,90913,45463,35937,9526,45463,289200,2020
51179,35.7,150185,89842,26283,20154,37758,112247,48160,37266,10894,48160,356000,2020
51181,50,6459,3412,2786,169,1859,56525,2794,2014,780,2794,201000,2020
51183,41,11202,4309,6217,356,2486,51701,3792,2769,1023,3792,123200,2020
51185,45.3,41201,38609,1317,441,10995,42207,16371,12227,4144,16371,102600,2020
51187,41.5,39888,34416,1612,1961,10046,70109,14641,11077,3564,14641,251600,2020
51191,46.4,54005,51419,697,824,14552,50928,22104,16820,5284,22104,159000,2020
51193,48.1,17873,11401,4470,1153,4546,53790,7910,5848,2062,7910,201000,2020
51195,41.6,38032,34733,2106,483,9771,41285,14916,10262,4654,14916,87300,2020
51197,45.9,28725,26935,585,366,8091,51639,12393,9539,2854,12393,130000,2020
51199,39.6,68389,47836,8916,4618,19009,93356,25517,18383,7134,25517,338200,2020
51510,36.8,158309,81674,33715,26027,33876,102227,71289,30931,40358,71289,572700,2020
51520,42.4,17059,14936,1213,78,4323,39679,7482,4600,2882,7482,127900,2020
51530,35.6,6477,5690,389,92,1696,36634,2509,1539,970,2509,125700,2020
51540,32.3,47217,30973,8716,2623,8950,59598,18814,7550,11264,18814,329100,2020
51550,37,242647,136878,70466,15813,64258,81261,86524,62590,23934,86524,286000,2020
51570,40.3,17283,12338,2713,1095,4652,60522,7094,4674,2420,7094,179200,2020
51580,42.1,5653,4550,706,151,1535,41024,2382,1796,586,2382,70400,2020
51590,40.9,40668,16917,19720,1817,9992,37147,18266,9180,9086,18266,95500,2020
51595,34.8,5408,1443,3217,339,1375,30058,2076,852,1224,2076,121600,2020
51600,38,23312,12918,1198,4038,5647,109708,8751,6115,2636,8751,587000,2020
51610,39.2,14309,10183,654,1523,3555,146922,5631,3312,2319,5631,810900,2020
51620,40.3,8015,2983,4377,241,2314,49811,3516,1957,1559,3516,179200,2020
51630,30.7,29059,16879,5350,3225,5646,69528,11059,4398,6661,11059,376700,2020
51640,42.3,6402,4649,423,1214,1629,35184,2614,1774,840,2614,97400,2020
51650,36.3,135169,50636,66701,8208,32490,57041,54847,31233,23614,54847,188600,2020
51660,25.8,53558,34955,3722,10714,9356,49117,16751,6790,9961,16751,220100,2020
51670,36.1,22500,10169,9521,1891,6048,43262,9362,4407,4955,9362,126100,2020
51678,22.2,7205,5722,452,401,935,50714,2066,1130,936,2066,235400,2020
51680,28.5,80970,50382,22834,3530,16743,49201,28223,14050,14173,28223,162900,2020
51683,34.7,41038,16248,5169,15253,9722,86227,13066,9058,4008,13066,338100,2020
51685,35.3,17548,5704,2452,7032,3285,81639,4596,2790,1806,4596,299700,2020
51690,41.7,12646,5498,5736,780,3266,36166,5597,3121,2476,5597,79000,2020
51700,33.8,179582,75587,71917,16816,42567,54511,70376,34014,36362,70376,194700,2020
51710,30.8,244300,105247,97851,20452,51043,53026,89398,38853,50545,89398,215800,2020
51720,43.7,3969,3711,204,0,952,30518,1877,972,905,1877,79400,2020
51730,37.2,30791,4610,23479,1516,6242,43029,13231,4771,8460,13231,111800,2020
51735,43.2,12121,10976,182,352,3596,100696,4632,3792,840,4632,344300,2020
51740,35.5,94961,35156,49340,4427,21907,53213,36650,20257,16393,36650,174200,2020
51750,23.7,17833,14827,1727,534,2360,34576,5677,2736,2941,5677,171000,2020
51760,34.1,229233,94400,104961,16220,40232,51421,91005,39801,51204,91005,244200,2020
51770,38.2,99122,57543,28306,6346,21901,45664,41694,21792,19902,41694,134900,2020
51775,41.2,25290,21390,1653,868,6191,63411,9876,6365,3511,9876,200000,2020
51790,41.5,24660,19860,2639,837,6196,52292,10638,6272,4366,10638,171600,2020
51800,38.1,91383,44706,37218,4098,24777,79899,34603,24341,10262,34603,265600,2020
51810,36.4,450882,275271,82565,37894,118630,78136,172452,111517,60935,172452,287400,2020
51820,40.8,22300,16614,2667,1910,4928,43480,9169,5418,3751,9169,183600,2020
51830,25.7,15034,10214,2285,1085,2244,59288,4485,2340,2145,4485,334100,2020
51840,37.3,27912,18102,2777,4980,6122,61102,10669,4767,5902,10669,247800,2020
53001,28,19702,6579,87,12595,4601,51601,6035,3679,2356,6035,159600,2020
53003,44.9,22636,20312,105,962,5701,53941,9286,6703,2583,9286,211900,2020
53005,36,200715,139714,3167,44714,50497,72046,73073,50485,22588,73073,255000,2020
53007,40.5,76653,51761,247,21531,19666,61304,29383,18658,10725,29383,311900,2020
53009,50.9,76482,62839,708,5147,20550,55090,33197,23679,9518,33197,267900,2020
53011,38.6,481950,373376,8308,48262,123522,77184,178478,119725,58753,178478,355000,2020
53013,49,4024,3413,53,326,1196,61779,1795,1286,509,1795,199600,2020
53015,41,108399,89261,885,10027,28007,58791,42354,27982,14372,42354,245500,2020
53017,37.8,42520,26874,187,13602,11303,65730,15435,10504,4931,15435,284900,2020
53019,52.1,7643,5584,15,373,1934,41685,3175,2400,775,3175,183000,2020
53021,30.4,93681,37350,1725,49876,21177,66904,27263,18891,8372,27263,226500,2020
53023,49.7,2258,2005,0,31,677,56923,986,748,238,986,152400,2020
53025,33.2,96648,50910,1003,40593,23117,59165,31908,20619,11289,31908,191600,2020
53027,44.3,73769,58450,914,7551,18847,50665,29433,20253,9180,29433,192600,2020
53029,44.1,84187,66189,2179,6846,24157,70765,35326,25127,10199,35326,382900,2020
53031,59,31825,27760,184,1211,9206,57693,15051,11674,3377,15051,362300,2020
53033,37,2225064,1295401,141566,218763,534762,99158,900061,508346,391715,900061,601100,2020
53035,39.2,268945,204485,6716,21641,71415,78969,105758,72040,33718,105758,362700,2020
53037,33.7,47097,38673,473,4248,10744,59703,19162,11459,7703,19162,315800,2020
53039,46.8,22055,18080,254,2644,5632,56667,9268,6550,2718,9268,281600,2020
53041,42.9,79430,65654,358,8464,20756,54970,31118,21903,9215,31118,231900,2020
53043,48.5,10732,9762,55,375,3217,58584,4628,3600,1028,4628,173000,2020
53045,45.3,65326,51805,373,6687,16372,60565,25242,19512,5730,25242,249100,2020
53047,43,42080,27195,58,8592,12153,48528,17884,11720,6164,17884,205300,2020
53049,54.4,22121,17774,138,2203,6052,50873,9714,8004,1710,9714,185600,2020
53051,50.8,13588,11810,26,550,4047,55021,5798,4492,1306,5798,243100,2020
53053,36.2,891862,585988,59311,100534,222167,76438,330999,209486,121513,330999,336600,2020
53055,56.7,16953,14952,124,1105,5206,64753,8459,6296,2163,8459,535200,2020
53057,41.6,127442,93874,809,23730,33252,71021,49263,34465,14798,49263,341600,2020
53059,47,11906,10381,56,785,3483,69296,4866,3844,1022,4866,335600,2020
53061,38,811572,552513,25918,85321,206594,89273,298815,203320,95495,298815,440100,2020
53063,37.8,513402,430536,8935,30770,129359,60101,206502,130298,76204,206502,245400,2020
53065,47,45233,39049,184,1723,12254,54426,17883,14128,3755,17883,219500,2020
53067,39.1,284698,210483,8212,26375,73946,75867,112323,74168,38155,112323,315600,2020
53069,55.7,4318,3696,53,326,1344,54524,1900,1691,209,1900,228600,2020
53071,37.5,60785,43266,1026,13115,14792,60615,22773,14570,8203,22773,244400,2020
53073,37.5,224538,175337,2123,21734,53699,65420,88978,55361,33617,88978,369000,2020
53075,25.2,49577,38469,945,3186,8633,42288,18485,8171,10314,18485,230200,2020
53077,32.9,250649,106349,2240,125004,60339,54917,83765,52222,31543,83765,191400,2020
54001,42,16543,15613,172,221,4043,38906,6484,4744,1740,6484,103800,2020
54003,38.9,117615,97854,8945,5424,30045,65286,45702,33975,11727,45702,187400,2020
54005,44,21897,21365,150,46,6085,45297,8691,6793,1898,8691,76700,2020
54007,46.4,14032,12890,103,29,3808,43819,5341,4196,1145,5341,93700,2020
54009,46.2,22162,20952,349,206,5891,48168,9792,7104,2688,9792,97200,2020
54011,39,93328,83791,4242,1331,21757,41472,39296,24457,14839,39296,126900,2020
54013,48.7,7185,7134,1,0,1859,38668,2814,2254,560,2814,100800,2020
54015,44.4,8599,8520,7,6,2335,35154,3385,2654,731,3385,86100,2020
54017,46,8499,8140,98,43,1993,51300,2623,2387,236,2623,124300,2020
54019,44.5,43087,39840,2167,517,11581,43722,17388,13639,3749,17388,95100,2020
54021,39.9,7970,6477,919,336,1636,42883,2516,1771,745,2516,79900,2020
54023,46.7,11565,11162,184,83,2958,43313,4842,3915,927,4842,140900,2020
54025,45.9,34893,31918,1009,677,9232,39807,15436,11158,4278,15436,123000,2020
54027,47.6,23304,22287,281,347,5910,48528,9165,7374,1791,9165,155300,2020
54029,47,29118,27238,634,450,7501,48140,12676,9262,3414,12676,94600,2020
54031,45.4,13789,12388,718,126,4070,46513,5933,4456,1477,5933,141500,2020
54033,42,67620,63590,1006,1142,17245,52134,27213,20060,7153,27213,123000,2020
54035,43.5,28793,27838,89,271,7396,49115,11427,8798,2629,11427,126100,2020
54037,40.9,56922,47158,3291,3350,14525,82551,20957,16474,4483,20957,261500,2020
54039,43.6,181014,158047,12419,2060,47230,47122,78137,54908,23229,78137,115300,2020
54041,44.3,16024,15073,29,185,4210,43894,6472,4786,1686,6472,108400,2020
54043,43.1,20617,20042,149,132,6149,42064,8295,6505,1790,8295,86300,2020
54045,43.9,32593,31241,525,320,10058,36250,14164,10204,3960,14164,97700,2020
54047,45.5,18083,16058,1435,246,5000,26072,7431,5797,1634,7431,39500,2020
54049,41,56233,51765,1960,747,15060,52856,23033,17135,5898,23033,122700,2020
54051,46,30900,29838,226,303,7950,48179,12350,9976,2374,12350,111100,2020
54053,44.4,26700,25716,74,194,7609,51820,10593,8749,1844,10593,100200,2020
54055,43.4,59370,53303,3517,719,15983,40716,25088,17298,7790,25088,100900,2020
54057,44.4,27047,25269,888,258,7040,51723,10810,8485,2325,10810,144500,2020
54059,43.1,23808,22806,445,61,6934,35454,10174,7272,2902,10174,78000,2020
54061,32.2,106196,92805,3794,2291,21665,54198,40233,23418,16815,40233,212300,2020
54063,46.7,13344,12828,149,141,3694,44828,5496,4294,1202,5496,115300,2020
54065,48.5,17800,16923,94,290,5085,57116,7485,6303,1182,7485,189800,2020
54067,45.3,24857,24078,163,114,7290,40318,10280,8108,2172,10280,95800,2020
54069,43.2,41875,38314,1529,506,9965,48056,17254,11657,5597,17254,127600,2020
54071,51.8,6968,6557,255,65,2297,46358,3194,2624,570,3194,130000,2020
54073,44,7457,7140,15,222,1991,55508,2822,2367,455,2822,110500,2020
54075,49.5,8382,8227,24,24,2173,37642,3578,3016,562,3578,119600,2020
54077,43.3,33610,30630,1604,502,8523,51992,12430,10100,2330,12430,121300,2020
54079,42.2,56604,53770,446,671,15778,63954,21694,17867,3827,21694,175700,2020
54081,42.3,74452,64707,5331,1212,20830,43283,31116,23066,8050,31116,110600,2020
54083,43.8,28763,26856,546,276,6708,45206,10977,7811,3166,10977,117300,2020
54085,47.1,9747,9434,53,3,2963,44328,4161,3345,816,4161,96100,2020
54087,46.1,13831,13212,12,162,3548,38895,5599,4263,1336,5599,97900,2020
54089,49.6,12710,11687,529,250,3625,37769,5617,4179,1438,5617,96000,2020
54091,43.9,16817,16065,146,167,4385,52958,6649,5239,1410,6649,116000,2020
54093,49.8,6943,6751,20,39,1966,47527,3176,2528,648,3176,126700,2020
54095,47.9,8736,8477,10,45,2088,47598,3402,2900,502,3402,90900,2020
54097,42,24451,23144,469,334,6069,40802,9592,7296,2296,9592,118400,2020
54099,44.5,39952,38755,253,272,10100,43710,15228,11418,3810,15228,103800,2020
54101,47.4,8289,8156,0,5,2410,33358,3582,2662,920,3582,74200,2020
54103,46.6,15291,14802,122,151,3759,44539,6022,4892,1130,6022,97000,2020
54105,46.1,5764,5578,78,20,1659,45315,2557,2099,458,2557,93500,2020
54107,43.8,84387,80180,1220,1002,22202,48711,35189,25390,9799,35189,126300,2020
54109,45,20890,20292,239,85,6525,44095,8674,7358,1316,8674,72900,2020
55001,54.2,20208,18184,524,836,5610,48906,9111,7530,1581,9111,140000,2020
55003,41.6,15524,12778,119,464,3852,47869,6483,4581,1902,6483,115300,2020
55005,44.4,45182,41938,654,1184,12517,52346,19059,14464,4595,19059,159300,2020
55007,52.6,15088,12728,46,331,4664,57257,7110,5796,1314,7110,176900,2020
55009,37.5,262559,210667,6605,23547,66801,64728,106031,68791,37240,106031,181300,2020
55011,46.6,13087,12500,72,300,3809,58364,5751,4403,1348,5751,164100,2020
55013,53.1,15363,13892,95,300,4662,53555,7242,5992,1250,7242,163200,2020
55015,40.9,50005,45276,462,2198,14650,76065,19951,16175,3776,19951,189700,2020
55017,41.3,64175,59864,970,1185,17360,61215,26044,19078,6966,26044,180000,2020
55019,37.6,34668,32008,78,1752,8845,54463,12914,10130,2784,12914,128200,2020
55021,42.7,57331,52800,946,2063,15926,69262,24336,18141,6195,24336,202000,2020
55023,47,16155,15203,307,269,4051,51218,6676,4968,1708,6676,136600,2020
55025,35.2,542459,427110,25673,35232,125826,75179,226600,133695,92905,226600,277000,2020
55027,43,87569,78421,2362,4387,22612,62591,35007,24270,10737,35007,169000,2020
55029,53.3,27621,25830,123,918,8816,61765,13429,10680,2749,13429,223200,2020
55031,42.3,43497,39522,543,730,11423,56855,18994,13014,5980,18994,149100,2020
55033,35.1,45029,41598,276,888,10248,59588,17124,11505,5619,17124,172500,2020
55035,34.9,104132,92903,1167,2662,23872,62508,41602,26688,14914,41602,180000,2020
55037,54.3,4312,4193,28,19,1298,50821,2038,1783,255,2038,130700,2020
55039,41.7,102654,90984,1429,5537,27483,64147,41890,29588,12302,41890,162600,2020
55041,47.2,9003,6990,91,247,2444,48394,3929,3073,856,3929,131600,2020
55043,36.1,51570,48822,794,944,12044,54144,19655,13621,6034,19655,151600,2020
55045,43.4,36790,34616,201,1184,9886,66212,15240,11392,3848,15240,177000,2020
55047,45.6,18807,17300,170,966,5258,57339,8024,6145,1879,8024,149600,2020
55049,42.9,23632,22308,196,455,6381,68714,9811,7263,2548,9811,194600,2020
55051,55.6,5679,5414,10,77,1633,45588,2859,2263,596,2859,130100,2020
55053,42,20556,17672,403,745,5031,55228,8246,6261,1985,8246,143600,2020
55055,41.3,84837,75849,599,6148,22263,67167,33349,23751,9598,33349,194300,2020
55057,45.6,26603,24300,620,855,6671,53928,10779,8240,2539,10779,131100,2020
55059,38.7,168998,126773,11274,22782,42020,66595,64595,42915,21680,64595,188400,2020
55061,44.2,20398,19215,139,650,5922,68474,8249,6660,1589,8249,166900,2020
55063,36.3,118168,105586,1940,2355,27311,60307,48105,30074,18031,48105,184500,2020
55065,41.7,16682,15623,93,680,4523,61070,6777,5238,1539,6777,143600,2020
55067,48.8,19167,17919,128,417,5497,52074,8539,6695,1844,8539,113600,2020
55069,47.9,27687,26258,186,522,7812,59183,12654,9857,2797,12654,141700,2020
55071,44.9,78977,70964,843,3377,21374,58464,34435,26144,8291,34435,133200,2020
55073,40.8,135485,118484,643,3905,37138,63029,55998,39804,16194,55998,161500,2020
55075,48.9,40312,38341,284,757,11229,52385,18869,14274,4595,18869,125600,2020
55077,50.2,15380,14332,99,546,4154,53293,6770,5458,1312,6770,156500,2020
55078,31,4566,436,8,331,1064,47188,1400,936,464,1400,105900,2020
55079,35,949180,477362,246274,146352,210959,52260,383703,188430,195273,383703,164200,2020
55081,39.8,46155,41604,816,2213,11835,60595,18025,12750,5275,18025,157600,2020
55083,47.2,37870,35794,109,739,10967,64528,16283,13459,2824,16283,162400,2020
55085,51.4,35480,33589,170,579,9632,58156,15677,12979,2698,15677,179000,2020
55087,38.4,186829,162791,2579,8272,49130,68441,74597,53209,21388,74597,176900,2020
55089,44,89179,81109,1258,2782,24978,84394,36166,27223,8943,36166,292200,2020
55091,46.8,7261,6983,24,150,2109,58750,3127,2499,628,3127,151200,2020
55093,37.3,42336,39570,280,980,10249,73873,15856,11462,4394,15856,224900,2020
55095,45.9,43549,41298,186,845,12356,61814,18647,14876,3771,18647,177100,2020
55097,37.2,70822,64306,519,2379,17368,60316,28912,19921,8991,28912,178600,2020
55099,51.9,13351,12530,73,254,4000,49749,6676,5294,1382,6676,119800,2020
55101,40.1,195859,138845,21667,26795,51478,62556,77648,52896,24752,77648,187700,2020
55103,45.8,17408,16368,109,433,4678,52052,7580,5722,1858,7580,141800,2020
55105,39.8,162532,133095,7460,14693,41544,59519,65237,44625,20612,65237,156800,2020
55107,48.9,14074,13305,88,279,4037,48961,6414,5050,1364,6414,111900,2020
55109,39.2,89702,83947,639,2224,25108,84985,34683,26767,7916,34683,264100,2020
55111,41,64152,58095,444,3426,17217,62808,26751,18721,8030,26751,185000,2020
55113,50.7,16477,12652,66,455,4921,52022,7893,5796,2097,7893,174000,2020
55115,45.5,40813,35204,178,1209,11265,57322,17153,13343,3810,17153,141300,2020
55117,41.3,115152,96192,2253,7615,30134,62101,47754,33556,14198,47754,165400,2020
55119,43.9,20320,19434,4,458,5841,52860,8623,6658,1965,8623,145800,2020
55121,40.7,29525,26308,131,2581,7702,59606,12143,8767,3376,12143,161500,2020
55123,42,30759,29467,75,504,7836,54549,12146,9354,2792,12146,161900,2020
55125,55.1,21923,18560,77,567,6732,50039,10917,8577,2340,10917,212700,2020
55127,40.4,103391,88146,765,11567,27034,66034,41414,28454,12960,41414,212900,2020
55129,51.7,15726,14775,44,290,4596,51711,7290,5830,1460,7290,163300,2020
55131,43.2,135529,125302,1785,4465,38229,80839,54787,42235,12552,54787,248000,2020
55133,43.1,402637,352161,6076,19642,111102,88985,159780,121773,38007,159780,293500,2020
55135,45.5,50997,48001,296,1648,14485,60106,22486,16604,5882,22486,154000,2020
55137,49.6,24256,21623,398,1568,6670,54320,10053,8249,1804,10053,149300,2020
55139,38.3,170924,150071,3910,7230,41256,59947,71132,46737,24395,71132,158400,2020
55141,43.9,72892,66984,573,2328,19936,55684,32707,23348,9359,32707,133700,2020
56001,28.2,38664,31709,383,3740,7858,51362,16137,8387,7750,16137,243500,2020
56003,40.8,11809,10333,41,1082,2847,51237,4408,3290,1118,4408,160000,2020
56005,34.6,46958,40986,364,4017,12599,80887,17506,13056,4450,17506,224400,2020
56007,39.2,15073,11610,163,2780,4131,62423,6226,4398,1828,6226,183800,2020
56009,40.2,13842,12258,0,1144,3692,73806,5461,4177,1284,5461,224900,2020
56011,42,7502,7054,0,182,2014,66898,2826,2241,585,2826,239300,2020
56013,38.5,39711,27549,182,2914,9089,54291,14834,10383,4451,14834,195500,2020
56015,44.1,13301,11289,42,1438,3523,55955,5234,3791,1443,5234,184500,2020
56017,47.9,4550,4185,0,143,1420,53398,2187,1555,632,2187,164400,2020
56019,46.4,8518,7773,49,412,2565,56565,3961,2808,1153,3961,248200,2020
56021,37.4,99272,77541,1641,14982,26128,69369,40202,29169,11033,40202,239900,2020
56023,40.1,19640,18047,10,922,5009,71898,7348,5906,1442,7348,253400,2020
56025,37.3,80067,69291,821,6958,20626,62168,32896,23220,9676,32896,215400,2020
56027,40.4,2377,2077,18,149,566,46111,900,681,219,900,141600,2020
56029,44.6,29273,26532,206,1663,8314,63684,12575,9243,3332,12575,280400,2020
56031,48.8,8572,7365,5,714,2599,57784,3846,2916,930,3846,188600,2020
56033,42.7,30397,27780,43,1329,7863,59380,13294,8991,4303,13294,284200,2020
56035,39.7,9865,8748,1,723,2296,78655,3529,2932,597,3529,290300,2020
56037,35.7,43352,34147,473,6917,10565,73384,15726,11852,3874,15726,205100,2020
56039,40.3,23356,18969,170,3449,6038,87053,10027,5609,4418,10027,850800,2020
56041,36,20374,17793,55,1929,5352,72458,7789,5996,1793,7789,181600,2020
56043,42.6,7933,6487,1,1134,2280,57306,3437,2510,927,3437,165900,2020
56045,42.4,6942,6293,44,133,1979,53333,2882,2419,463,2882,166600,2020
72001,42.9,17614,65,0,17542,4100,14253,5810,3688,2122,5810,81800,2020
72003,43.6,37307,2334,0,34575,9266,16802,13005,9958,3047,13005,85800,2020
72005,43,51552,727,94,50418,14900,16065,21774,12873,8901,21774,116100,2020
72007,42.6,25298,93,19,25158,6383,20190,8629,5560,3069,8629,121400,2020
72009,43.6,22545,64,0,22432,6203,20631,8795,6845,1950,8795,109900,2020
72011,43.2,26555,1135,0,25260,6320,20167,8866,6578,2288,8866,87100,2020
72013,43.5,83682,415,37,83063,22136,19266,32405,21168,11237,32405,95200,2020
72015,40.8,17502,34,0,17468,4099,16206,6070,4755,1315,6070,87000,2020
72017,41.1,23913,90,0,23772,5683,17815,8152,5965,2187,8152,101300,2020
72019,37.5,28026,34,0,27992,6657,18924,8829,6168,2661,8829,108300,2020
72021,42.8,173695,1300,249,171633,45636,26853,67487,45896,21591,67487,129800,2020
72023,44.6,47977,147,32,47691,10954,17261,16211,11181,5030,16211,105300,2020
72025,42.5,126734,1679,126,124439,32576,25823,48446,32521,15925,48446,127000,2020
72027,43.3,31066,218,1,30847,8228,18571,11349,8532,2817,11349,93300,2020
72029,40.8,45120,37,16,45006,10545,21614,14705,10635,4070,14705,101600,2020
72031,43.2,150378,1297,273,148283,40241,29398,61898,43136,18762,61898,137200,2020
72033,40.7,23698,258,0,23423,6044,18647,8773,5274,3499,8773,116500,2020
72035,43.7,43126,68,0,42927,11286,23104,16233,10213,6020,16233,122300,2020
72037,44,11207,166,12,10983,2833,19092,4261,3072,1189,4261,93400,2020
72039,42.9,16188,120,0,16068,4420,17783,5813,4093,1720,5813,87000,2020
72041,41.5,38977,138,72,38767,9290,20664,13054,8424,4630,13054,120900,2020
72043,43.1,38603,272,11,38320,8736,18319,13199,10117,3082,13199,91600,2020
72045,40.6,18942,80,0,18862,3529,14297,5264,2445,2819,5264,101600,2020
72047,40.9,32928,384,0,32511,8098,16933,10765,7809,2956,10765,98300,2020
72049,43.4,1371,99,0,1260,278,25658,514,326,188,514,161700,2020
72051,41.9,36475,1027,0,35408,8440,29852,11842,9233,2609,11842,133600,2020
72053,42.4,30263,102,68,29952,8278,19957,12412,8180,4232,12412,102000,2020
72054,40.5,11513,148,0,11365,3222,20221,4268,3064,1204,4268,95700,2020
72055,43.5,15825,129,0,15629,3316,12283,5623,3936,1687,5623,83600,2020
72057,39.6,40198,296,89,39786,9294,17319,14215,10089,4126,14215,84700,2020
72059,42.1,18080,47,0,18014,4722,17796,6539,4737,1802,6539,78000,2020
72061,45.1,85312,1123,96,83897,20071,36073,31465,22155,9310,31465,173600,2020
72063,40.1,46948,780,238,45547,10755,35367,14675,11714,2961,14675,139900,2020
72065,43,39561,90,37,39395,10255,18998,13914,10318,3596,13914,90700,2020
72067,47.5,15731,17,7,15668,4117,19848,6291,4559,1732,6291,100500,2020
72069,44.5,51586,440,0,50973,12066,21802,17816,12892,4924,17816,99000,2020
72071,43.1,41084,350,111,40365,10483,16996,15159,9355,5804,15159,105000,2020
72073,40.4,14239,120,0,14119,3853,16003,5017,2907,2110,5017,94100,2020
72075,40.1,45414,70,3,45332,11218,20889,15479,11403,4076,15479,92800,2020
72077,39.2,38471,140,0,38250,9365,20350,13025,9287,3738,13025,102700,2020
72079,46.3,22391,237,0,21987,5233,14439,7933,5135,2798,7933,88900,2020
72081,43.9,24945,45,0,24822,7599,16841,10119,6411,3708,10119,87000,2020
72083,42.9,8131,34,0,8079,1915,14765,2725,2064,661,2725,85300,2020
72085,41.1,37233,33,20,37145,9074,22848,12143,9579,2564,12143,116000,2020
72087,40.4,25164,6,34,25080,6142,17363,8734,6130,2604,8734,100200,2020
72089,43.1,17924,136,10,17778,4536,21805,6660,4680,1980,6660,111000,2020
72091,42.6,38062,620,60,37184,10371,18885,14815,10855,3960,14815,106200,2020
72093,44.6,5900,54,0,5846,1289,15387,1873,1380,493,1873,84100,2020
72095,44.4,10568,156,0,10412,2776,20561,3893,2752,1141,3893,84900,2020
72097,42.1,73336,449,47,72767,17317,14761,29542,16429,13113,29542,97100,2020
72099,41,35547,102,53,35292,9734,16033,13482,8478,5004,13482,89900,2020
72101,39.6,30652,95,19,30521,7651,21191,9691,6992,2699,9691,103900,2020
72103,39.4,25931,162,59,25673,5671,19224,8276,6245,2031,8276,92700,2020
72105,41.5,27719,1,0,27718,6176,18778,8453,5907,2546,8453,90300,2020
72107,40.6,20608,36,29,20543,4960,15805,6924,4674,2250,6924,83100,2020
72109,45.7,16591,46,0,16545,4029,17138,6101,4168,1933,6101,89100,2020
72111,39.7,19797,83,0,19683,5140,17313,6855,4912,1943,6855,76700,2020
72113,42,135674,656,117,134741,34486,17263,52439,35314,17125,52439,98300,2020
72115,41.8,23261,250,26,22917,5703,17425,8229,5815,2414,8229,98900,2020
72117,46.9,13849,1138,22,12508,3330,20145,5430,3739,1691,5430,125800,2020
72119,42.5,48828,171,43,48582,11183,23738,15584,11618,3966,15584,113900,2020
72121,43,22140,123,1,21997,4785,18290,7063,5417,1646,7063,95700,2020
72123,42.1,27638,19,66,27522,6672,17694,9973,7865,2108,9973,81900,2020
72125,44.7,30811,262,0,30512,7067,16561,11550,8057,3493,11550,79600,2020
72127,43.8,326953,4913,577,320397,80864,23642,145066,77844,67222,145066,151500,2020
72129,43,36586,9,22,36438,9349,19385,13676,10245,3431,13676,108900,2020
72131,44.8,36292,1068,0,34922,10068,15995,13740,9297,4443,13740,96300,2020
72133,39.5,21474,48,0,21426,4761,20000,7368,5780,1588,7368,93000,2020
72135,39.4,72450,712,123,71536,17015,27626,22413,18362,4051,22413,132700,2020
72137,41.3,76008,865,71,74987,18792,25090,27915,20513,7402,27915,119500,2020
72139,40.9,65011,530,0,64437,17378,32611,23805,16275,7530,23805,146700,2020
72141,44.4,28041,164,21,27768,6859,15021,10087,5735,4352,10087,88600,2020
72143,40.2,36559,296,127,36034,9079,20809,12124,8241,3883,12124,117100,2020
72145,42.4,51089,1347,8,49596,13318,20126,19343,14974,4369,19343,105000,2020
72147,43.8,8508,520,28,7960,1340,14040,2405,1690,715,2405,97500,2020
72149,41.3,21899,36,17,21846,5844,19355,7932,5684,2248,7932,91200,2020
72151,44.1,32867,22,0,32845,7739,16828,11687,8387,3300,11687,87000,2020
72153,45.1,34501,138,23,34179,7353,14813,11654,8695,2959,11654,91700,2020
